fen,move,eval_before,eval_after,delta,label
rnbqkbnr/pppppppp/8/8/8/8/PPPPPPPP/RNBQKBNR w KQkq - 0 1,d4,33,28,-5,1
rnbqkbnr/pppppppp/8/8/3P4/8/PPP1PPPP/RNBQKBNR b KQkq - 0 1,c5,27,67,40,1
rnbqkbnr/pp1ppppp/8/2p5/3P4/8/PPP1PPPP/RNBQKBNR w KQkq - 0 2,e3,80,21,-59,1
rnbqkbnr/pp1ppppp/8/2p5/3P4/4P3/PPP2PPP/RNBQKBNR b KQkq - 0 2,cxd4,17,29,12,1
rnbqkbnr/pp1ppppp/8/8/3p4/4P3/PPP2PPP/RNBQKBNR w KQkq - 0 3,exd4,29,25,-4,1
rnbqkbnr/pp1ppppp/8/8/3P4/8/PPP2PPP/RNBQKBNR b KQkq - 0 3,d5,23,19,-4,1
rnbqkbnr/pp2pppp/8/3p4/3P4/8/PPP2PPP/RNBQKBNR w KQkq - 0 4,c3,18,22,4,1
rnbqkbnr/pp2pppp/8/3p4/3P4/2P5/PP3PPP/RNBQKBNR b KQkq - 0 4,Nc6,24,29,5,1
r1bqkbnr/pp2pppp/2n5/3p4/3P4/2P5/PP3PPP/RNBQKBNR w KQkq - 1 5,f4,30,-43,-73,1
r1bqkbnr/pp2pppp/2n5/3p4/3P1P2/2P5/PP4PP/RNBQKBNR b KQkq - 0 5,e5,-45,39,84,1
r1bqkbnr/pp3ppp/2n5/3pp3/3P1P2/2P5/PP4PP/RNBQKBNR w KQkq - 0 6,Nf3,39,-87,-126,0
r1bqkbnr/pp3ppp/2n5/3pp3/3P1P2/2P2N2/PP4PP/RNBQKB1R b KQkq - 1 6,e4,-110,-110,0,1
r1bqkbnr/pp3ppp/2n5/3p4/3PpP2/2P2N2/PP4PP/RNBQKB1R w KQkq - 0 7,Ne5,-99,-96,3,1
r1bqkbnr/pp3ppp/2n5/3pN3/3PpP2/2P5/PP4PP/RNBQKB1R b KQkq - 1 7,f6,-102,173,275,1
r1bqkbnr/pp4pp/2n2p2/3pN3/3PpP2/2P5/PP4PP/RNBQKB1R w KQkq - 0 8,Qh5+,169,165,-4,1
r1bqkbnr/pp4pp/2n2p2/3pN2Q/3PpP2/2P5/PP4PP/RNB1KB1R b KQkq - 1 8,g6,160,164,4,1
r1bqkbnr/pp5p/2n2pp1/3pN2Q/3PpP2/2P5/PP4PP/RNB1KB1R w KQkq - 0 9,Nxg6,161,172,11,1
r1bqkbnr/pp5p/2n2pN1/3p3Q/3PpP2/2P5/PP4PP/RNB1KB1R b KQkq - 0 9,hxg6,168,178,10,1
r1bqkbnr/pp6/2n2pp1/3p3Q/3PpP2/2P5/PP4PP/RNB1KB1R w KQkq - 0 10,Qxh8,192,193,1,1
r1bqkbnQ/pp6/2n2pp1/3p4/3PpP2/2P5/PP4PP/RNB1KB1R b KQq - 0 10,Kf7,191,193,2,1
r1bq1bnQ/pp3k2/2n2pp1/3p4/3PpP2/2P5/PP4PP/RNB1KB1R w KQ - 1 11,Qh7+,209,230,21,1
r1bq1bn1/pp3k1Q/2n2pp1/3p4/3PpP2/2P5/PP4PP/RNB1KB1R b KQ - 2 11,Bg7,225,226,1,1
r1bq2n1/pp3kbQ/2n2pp1/3p4/3PpP2/2P5/PP4PP/RNB1KB1R w KQ - 3 12,f5,223,128,-95,1
r1bq2n1/pp3kbQ/2n2pp1/3p1P2/3Pp3/2P5/PP4PP/RNB1KB1R b KQ - 0 12,g5,150,271,121,1
r1bq2n1/pp3kbQ/2n2p2/3p1Pp1/3Pp3/2P5/PP4PP/RNB1KB1R w KQ - 0 13,h4,320,216,-104,0
r1bq2n1/pp3kbQ/2n2p2/3p1Pp1/3Pp2P/2P5/PP4P1/RNB1KB1R b KQ - 0 13,gxh4,240,320,80,1
r1bq2n1/pp3kbQ/2n2p2/3p1P2/3Pp2p/2P5/PP4P1/RNB1KB1R w KQ - 0 14,Bh6,355,-361,-716,0
r1bq2n1/pp3kbQ/2n2p1B/3p1P2/3Pp2p/2P5/PP4P1/RN2KB1R b KQ - 1 14,Qf8,-346,483,829,1
r1b2qn1/pp3kbQ/2n2p1B/3p1P2/3Pp2p/2P5/PP4P1/RN2KB1R w KQ - 2 15,Rxh4,438,107,-331,0
r1b2qn1/pp3kbQ/2n2p1B/3p1P2/3Pp2R/2P5/PP4P1/RN2KB2 b Q - 0 15,Nxh6,93,59,-34,1
r1b2q2/pp3kbQ/2n2p1n/3p1P2/3Pp2R/2P5/PP4P1/RN2KB2 w Q - 0 16,Rxh6,76,59,-17,1
r1b2q2/pp3kbQ/2n2p1R/3p1P2/3Pp3/2P5/PP4P1/RN2KB2 b Q - 0 16,Ne7,76,287,211,1
r1b2q2/pp2nkbQ/5p1R/3p1P2/3Pp3/2P5/PP4P1/RN2KB2 w Q - 1 17,Rh3,300,135,-165,0
r1b2q2/pp2nkbQ/5p2/3p1P2/3Pp3/2P4R/PP4P1/RN2KB2 b Q - 2 17,Bxf5,110,124,14,1
r4q2/pp2nkbQ/5p2/3p1b2/3Pp3/2P4R/PP4P1/RN2KB2 w Q - 0 18,Qh4,109,-162,-271,0
r4q2/pp2nkb1/5p2/3p1b2/3Pp2Q/2P4R/PP4P1/RN2KB2 b Q - 1 18,Bxh3,-145,-135,10,1
r4q2/pp2nkb1/5p2/3p4/3Pp2Q/2P4b/PP4P1/RN2KB2 w Q - 0 19,Qxh3,-147,-201,-54,1
r4q2/pp2nkb1/5p2/3p4/3Pp3/2P4Q/PP4P1/RN2KB2 b Q - 0 19,Qh8,-214,-216,-2,1
r6q/pp2nkb1/5p2/3p4/3Pp3/2P4Q/PP4P1/RN2KB2 w Q - 1 20,Qd7,-227,-293,-66,1
r6q/pp1Qnkb1/5p2/3p4/3Pp3/2P5/PP4P1/RN2KB2 b Q - 2 20,Qh4+,-335,-319,16,1
r7/pp1Qnkb1/5p2/3p4/3Pp2q/2P5/PP4P1/RN2KB2 w Q - 3 21,Kd2,-358,-457,-99,1
r7/pp1Qnkb1/5p2/3p4/3Pp2q/2P5/PP1K2P1/RN3B2 b - - 4 21,Bh6+,-532,-374,158,1
r7/pp1Qnk2/5p1b/3p4/3Pp2q/2P5/PP1K2P1/RN3B2 w - - 5 22,Kc2,-401,-407,-6,1
r7/pp1Qnk2/5p1b/3p4/3Pp2q/2P5/PPK3P1/RN3B2 b - - 6 22,Qf2+,-395,-382,13,1
r7/pp1Qnk2/5p1b/3p4/3Pp3/2P5/PPK2qP1/RN3B2 w - - 7 23,Nd2,-393,-413,-20,1
r7/pp1Qnk2/5p1b/3p4/3Pp3/2P5/PPKN1qP1/R4B2 b - - 8 23,Qxd2+,-427,-321,106,1
r7/pp1Qnk2/5p1b/3p4/3Pp3/2P5/PPKq2P1/R4B2 w - - 0 24,Kb3,-321,-344,-23,1
r7/pp1Qnk2/5p1b/3p4/3Pp3/1KP5/PP1q2P1/R4B2 b - - 1 24,e3,-331,-262,69,1
rnbqkbnr/pppppppp/8/8/8/8/PPPPPPPP/RNBQKBNR w KQkq - 0 1,e4,40,27,-13,1
rnbqkbnr/pppppppp/8/8/4P3/8/PPPP1PPP/RNBQKBNR b KQkq - 0 1,e5,28,26,-2,1
rnbqkbnr/pppp1ppp/8/4p3/4P3/8/PPPP1PPP/RNBQKBNR w KQkq - 0 2,d3,38,-14,-52,1
rnbqkbnr/pppp1ppp/8/4p3/4P3/3P4/PPP2PPP/RNBQKBNR b KQkq - 0 2,Nf6,-13,-8,5,1
rnbqkb1r/pppp1ppp/5n2/4p3/4P3/3P4/PPP2PPP/RNBQKBNR w KQkq - 1 3,Nf3,-14,-23,-9,1
rnbqkb1r/pppp1ppp/5n2/4p3/4P3/3P1N2/PPP2PPP/RNBQKB1R b KQkq - 2 3,d5,-16,9,25,1
rnbqkb1r/ppp2ppp/5n2/3pp3/4P3/3P1N2/PPP2PPP/RNBQKB1R w KQkq - 0 4,Nc3,13,-43,-56,1
rnbqkb1r/ppp2ppp/5n2/3pp3/4P3/2NP1N2/PPP2PPP/R1BQKB1R b KQkq - 1 4,Nc6,-62,-29,33,1
r1bqkb1r/ppp2ppp/2n2n2/3pp3/4P3/2NP1N2/PPP2PPP/R1BQKB1R w KQkq - 2 5,exd5,-26,-19,7,1
r1bqkb1r/ppp2ppp/2n2n2/3Pp3/8/2NP1N2/PPP2PPP/R1BQKB1R b KQkq - 0 5,Nxd5,-19,-23,-4,1
r1bqkb1r/ppp2ppp/2n5/3np3/8/2NP1N2/PPP2PPP/R1BQKB1R w KQkq - 0 6,Nxd5,-21,-57,-36,1
r1bqkb1r/ppp2ppp/2n5/3Np3/8/3P1N2/PPP2PPP/R1BQKB1R b KQkq - 0 6,Qxd5,-63,-47,16,1
r1b1kb1r/ppp2ppp/2n5/3qp3/8/3P1N2/PPP2PPP/R1BQKB1R w KQkq - 0 7,c4,-70,-133,-63,1
r1b1kb1r/ppp2ppp/2n5/3qp3/2P5/3P1N2/PP3PPP/R1BQKB1R b KQkq - 0 7,Bb4+,-134,-136,-2,1
r1b1k2r/ppp2ppp/2n5/3qp3/1bP5/3P1N2/PP3PPP/R1BQKB1R w KQkq - 1 8,Bd2,-119,-135,-16,1
r1b1k2r/ppp2ppp/2n5/3qp3/1bP5/3P1N2/PP1B1PPP/R2QKB1R b KQkq - 2 8,Bxd2+,-148,-150,-2,1
r1b1k2r/ppp2ppp/2n5/3qp3/2P5/3P1N2/PP1b1PPP/R2QKB1R w KQkq - 0 9,Qxd2,-139,-136,3,1
r1b1k2r/ppp2ppp/2n5/3qp3/2P5/3P1N2/PP1Q1PPP/R3KB1R b KQkq - 0 9,Qd7,-140,-40,100,1
r1b1k2r/pppq1ppp/2n5/4p3/2P5/3P1N2/PP1Q1PPP/R3KB1R w KQkq - 1 10,Be2,-30,-51,-21,1
r1b1k2r/pppq1ppp/2n5/4p3/2P5/3P1N2/PP1QBPPP/R3K2R b KQkq - 2 10,Qd6,-49,-52,-3,1
r1b1k2r/ppp2ppp/2nq4/4p3/2P5/3P1N2/PP1QBPPP/R3K2R w KQkq - 3 11,O-O,-43,-66,-23,1
r1b1k2r/ppp2ppp/2nq4/4p3/2P5/3P1N2/PP1QBPPP/R4RK1 b kq - 4 11,Bf5,-52,-46,6,1
r3k2r/ppp2ppp/2nq4/4pb2/2P5/3P1N2/PP1QBPPP/R4RK1 w kq - 5 12,Rfe1,-62,-94,-32,1
r3k2r/ppp2ppp/2nq4/4pb2/2P5/3P1N2/PP1QBPPP/R3R1K1 b kq - 6 12,O-O-O,-80,-103,-23,1
2kr3r/ppp2ppp/2nq4/4pb2/2P5/3P1N2/PP1QBPPP/R3R1K1 w - - 7 13,b3,-88,-165,-77,1
2kr3r/ppp2ppp/2nq4/4pb2/2P5/1P1P1N2/P2QBPPP/R3R1K1 b - - 0 13,f6,-173,-170,3,1
2kr3r/ppp3pp/2nq1p2/4pb2/2P5/1P1P1N2/P2QBPPP/R3R1K1 w - - 0 14,Qe3,-175,-192,-17,1
2kr3r/ppp3pp/2nq1p2/4pb2/2P5/1P1PQN2/P3BPPP/R3R1K1 b - - 1 14,Bxd3,-205,-77,128,1
2kr3r/ppp3pp/2nq1p2/4p3/2P5/1P1bQN2/P3BPPP/R3R1K1 w - - 0 15,Bxd3,-39,-278,-239,0
2kr3r/ppp3pp/2nq1p2/4p3/2P5/1P1BQN2/P4PPP/R3R1K1 b - - 0 15,Qxd3,-280,-279,1,1
2kr3r/ppp3pp/2n2p2/4p3/2P5/1P1qQN2/P4PPP/R3R1K1 w - - 0 16,Qxd3,-278,-308,-30,1
2kr3r/ppp3pp/2n2p2/4p3/2P5/1P1Q1N2/P4PPP/R3R1K1 b - - 0 16,Rxd3,-299,-287,12,1
2k4r/ppp3pp/2n2p2/4p3/2P5/1P1r1N2/P4PPP/R3R1K1 w - - 0 17,Nh4,-289,-305,-16,1
2k4r/ppp3pp/2n2p2/4p3/2P4N/1P1r4/P4PPP/R3R1K1 b - - 1 17,Rhd8,-317,-319,-2,1
2kr4/ppp3pp/2n2p2/4p3/2P4N/1P1r4/P4PPP/R3R1K1 w - - 2 18,Nf5,-318,-319,-1,1
2kr4/ppp3pp/2n2p2/4pN2/2P5/1P1r4/P4PPP/R3R1K1 b - - 3 18,R8d7,-288,-284,4,1
2k5/pppr2pp/2n2p2/4pN2/2P5/1P1r4/P4PPP/R3R1K1 w - - 4 19,Kh1,-291,-363,-72,1
2k5/pppr2pp/2n2p2/4pN2/2P5/1P1r4/P4PPP/R3R2K b - - 5 19,Nb4,-330,-359,-29,1
2k5/pppr2pp/5p2/4pN2/1nP5/1P1r4/P4PPP/R3R2K w - - 6 20,Rec1,-351,-373,-22,1
2k5/pppr2pp/5p2/4pN2/1nP5/1P1r4/P4PPP/R1R4K b - - 7 20,Rd2,-394,-372,22,1
2k5/pppr2pp/5p2/4pN2/1nP5/1P6/P2r1PPP/R1R4K w - - 8 21,a3,-388,-508,-120,0
2k5/pppr2pp/5p2/4pN2/1nP5/PP6/3r1PPP/R1R4K b - - 0 21,Nd3,-544,-452,92,1
2k5/pppr2pp/5p2/4pN2/2P5/PP1n4/3r1PPP/R1R4K w - - 1 22,Rd1,-464,-644,-180,0
2k5/pppr2pp/5p2/4pN2/2P5/PP1n4/3r1PPP/R2R3K b - - 2 22,Nxf2+,-662,-679,-17,1
2k5/pppr2pp/5p2/4pN2/2P5/PP6/3r1nPP/R2R3K w - - 0 23,Kg1,-647,-656,-9,1
2k5/pppr2pp/5p2/4pN2/2P5/PP6/3r1nPP/R2R2K1 b - - 1 23,Nxd1,-660,-681,-21,1
2k5/pppr2pp/5p2/4pN2/2P5/PP6/3r2PP/R2n2K1 w - - 0 24,h3,-703,-713,-10,1
2k5/pppr2pp/5p2/4pN2/2P5/PP5P/3r2P1/R2n2K1 b - - 0 24,Nc3,-737,-717,20,1
2k5/pppr2pp/5p2/4pN2/2P5/PPn4P/3r2P1/R5K1 w - - 1 25,Rf1,-691,-755,-64,1
2k5/pppr2pp/5p2/4pN2/2P5/PPn4P/3r2P1/5RK1 b - - 2 25,Ne4,-737,-663,74,1
2k5/pppr2pp/5p2/4pN2/2P1n3/PP5P/3r2P1/5RK1 w - - 3 26,b4,-682,-739,-57,1
2k5/pppr2pp/5p2/4pN2/1PP1n3/P6P/3r2P1/5RK1 b - - 0 26,Rd1,-722,-652,70,1
2k5/pppr2pp/5p2/4pN2/1PP1n3/P6P/6P1/3r1RK1 w - - 1 27,Ne7+,-657,-748,-91,1
2k5/ppprN1pp/5p2/4p3/1PP1n3/P6P/6P1/3r1RK1 b - - 2 27,Rxe7,-721,-565,156,1
2k5/ppp1r1pp/5p2/4p3/1PP1n3/P6P/6P1/3r1RK1 w - - 0 28,Rxd1,-538,-548,-10,1
2k5/ppp1r1pp/5p2/4p3/1PP1n3/P6P/6P1/3R2K1 b - - 0 28,Rd7,-560,-550,10,1
2k5/pppr2pp/5p2/4p3/1PP1n3/P6P/6P1/3R2K1 w - - 1 29,Rxd7,-520,-585,-65,1
rnbqkbnr/pppppppp/8/8/8/8/PPPPPPPP/RNBQKBNR w KQkq - 0 1,e4,34,22,-12,1
rnbqkbnr/pppppppp/8/8/4P3/8/PPPP1PPP/RNBQKBNR b KQkq - 0 1,d5,29,72,43,1
rnbqkbnr/ppp1pppp/8/3p4/4P3/8/PPPP1PPP/RNBQKBNR w KQkq - 0 2,e5,76,-11,-87,1
rnbqkbnr/ppp1pppp/8/3pP3/8/8/PPPP1PPP/RNBQKBNR b KQkq - 0 2,Nc6,-7,42,49,1
r1bqkbnr/ppp1pppp/2n5/3pP3/8/8/PPPP1PPP/RNBQKBNR w KQkq - 1 3,d4,43,49,6,1
r1bqkbnr/ppp1pppp/2n5/3pP3/3P4/8/PPP2PPP/RNBQKBNR b KQkq - 0 3,g6,45,81,36,1
r1bqkbnr/ppp1pp1p/2n3p1/3pP3/3P4/8/PPP2PPP/RNBQKBNR w KQkq - 0 4,Bg5,87,10,-77,1
r1bqkbnr/ppp1pp1p/2n3p1/3pP1B1/3P4/8/PPP2PPP/RN1QKBNR b KQkq - 1 4,Bg7,-7,8,15,1
r1bqk1nr/ppp1ppbp/2n3p1/3pP1B1/3P4/8/PPP2PPP/RN1QKBNR w KQkq - 2 5,Nd2,-4,-214,-210,0
r1bqk1nr/ppp1ppbp/2n3p1/3pP1B1/3P4/8/PPPN1PPP/R2QKBNR b KQkq - 3 5,f6,-210,-48,162,1
r1bqk1nr/ppp1p1bp/2n2pp1/3pP1B1/3P4/8/PPPN1PPP/R2QKBNR w KQkq - 0 6,exf6,-42,-25,17,1
r1bqk1nr/ppp1p1bp/2n2Pp1/3p2B1/3P4/8/PPPN1PPP/R2QKBNR b KQkq - 0 6,Nxf6,-32,10,42,1
r1bqk2r/ppp1p1bp/2n2np1/3p2B1/3P4/8/PPPN1PPP/R2QKBNR w KQkq - 0 7,Nb3,26,-125,-151,0
r1bqk2r/ppp1p1bp/2n2np1/3p2B1/3P4/1N6/PPP2PPP/R2QKBNR b KQkq - 1 7,e5,-87,-91,-4,1
r1bqk2r/ppp3bp/2n2np1/3pp1B1/3P4/1N6/PPP2PPP/R2QKBNR w KQkq - 0 8,dxe5,-90,-107,-17,1
r1bqk2r/ppp3bp/2n2np1/3pP1B1/8/1N6/PPP2PPP/R2QKBNR b KQkq - 0 8,Nxe5,-105,-85,20,1
r1bqk2r/ppp3bp/5np1/3pn1B1/8/1N6/PPP2PPP/R2QKBNR w KQkq - 0 9,Qe2,-96,-223,-127,0
r1bqk2r/ppp3bp/5np1/3pn1B1/8/1N6/PPP1QPPP/R3KBNR b KQkq - 1 9,Qd6,-241,-115,126,1
r1b1k2r/ppp3bp/3q1np1/3pn1B1/8/1N6/PPP1QPPP/R3KBNR w KQkq - 2 10,O-O-O,-84,-229,-145,0
r1b1k2r/ppp3bp/3q1np1/3pn1B1/8/1N6/PPP1QPPP/2KR1BNR b kq - 3 10,h6,-257,75,332,1
r1b1k2r/ppp3b1/3q1npp/3pn1B1/8/1N6/PPP1QPPP/2KR1BNR w kq - 0 11,f4,226,-78,-304,0
r1b1k2r/ppp3b1/3q1npp/3pn1B1/5P2/1N6/PPP1Q1PP/2KR1BNR b kq - 0 11,hxg5,-131,356,487,1
r1b1k2r/ppp3b1/3q1np1/3pn1p1/5P2/1N6/PPP1Q1PP/2KR1BNR w kq - 0 12,fxe5,371,406,35,1
r1b1k2r/ppp3b1/3q1np1/3pP1p1/8/1N6/PPP1Q1PP/2KR1BNR b kq - 0 12,Qc6,389,803,414,1
r1b1k2r/ppp3b1/2q2np1/3pP1p1/8/1N6/PPP1Q1PP/2KR1BNR w kq - 1 13,exf6+,785,809,24,1
r1b1k2r/ppp3b1/2q2Pp1/3p2p1/8/1N6/PPP1Q1PP/2KR1BNR b kq - 0 13,Kf7,787,9998,9211,1
r1b4r/ppp2kb1/2q2Pp1/3p2p1/8/1N6/PPP1Q1PP/2KR1BNR w - - 1 14,fxg7,9998,612,-9386,0
r1b4r/ppp2kP1/2q3p1/3p2p1/8/1N6/PPP1Q1PP/2KR1BNR b - - 0 14,Bf5,622,736,114,1
r6r/ppp2kP1/2q3p1/3p1bp1/8/1N6/PPP1Q1PP/2KR1BNR w - - 1 15,gxh8=Q,757,743,-14,1
r6Q/ppp2k2/2q3p1/3p1bp1/8/1N6/PPP1Q1PP/2KR1BNR b - - 0 15,Rxh8,772,793,21,1
7r/ppp2k2/2q3p1/3p1bp1/8/1N6/PPP1Q1PP/2KR1BNR w - - 0 16,Nd4,793,768,-25,1
7r/ppp2k2/2q3p1/3p1bp1/3N4/8/PPP1Q1PP/2KR1BNR b - - 1 16,Qc5,798,838,40,1
7r/ppp2k2/6p1/2qp1bp1/3N4/8/PPP1Q1PP/2KR1BNR w - - 2 17,Ngf3,850,791,-59,1
7r/ppp2k2/6p1/2qp1bp1/3N4/5N2/PPP1Q1PP/2KR1B1R b - - 3 17,Re8,812,850,38,1
4r3/ppp2k2/6p1/2qp1bp1/3N4/5N2/PPP1Q1PP/2KR1B1R w - - 4 18,Qb5,850,869,19,1
4r3/ppp2k2/6p1/1Qqp1bp1/3N4/5N2/PPP3PP/2KR1B1R b - - 5 18,b6,859,849,-10,1
4r3/p1p2k2/1p4p1/1Qqp1bp1/3N4/5N2/PPP3PP/2KR1B1R w - - 0 19,Qxc5,840,872,32,1
4r3/p1p2k2/1p4p1/2Qp1bp1/3N4/5N2/PPP3PP/2KR1B1R b - - 0 19,bxc5,837,843,6,1
4r3/p1p2k2/6p1/2pp1bp1/3N4/5N2/PPP3PP/2KR1B1R w - - 0 20,Nxf5,838,837,-1,1
4r3/p1p2k2/6p1/2pp1Np1/8/5N2/PPP3PP/2KR1B1R b - - 0 20,gxf5,810,824,14,1
4r3/p1p2k2/8/2pp1pp1/8/5N2/PPP3PP/2KR1B1R w - - 0 21,Rxd5,832,802,-30,1
4r3/p1p2k2/8/2pR1pp1/8/5N2/PPP3PP/2K2B1R b - - 0 21,g4,804,837,33,1
4r3/p1p2k2/8/2pR1p2/6p1/5N2/PPP3PP/2K2B1R w - - 0 22,Bb5,843,813,-30,1
4r3/p1p2k2/8/1BpR1p2/6p1/5N2/PPP3PP/2K4R b - - 1 22,Re4,815,863,48,1
8/p1p2k2/8/1BpR1p2/4r1p1/5N2/PPP3PP/2K4R w - - 2 23,Ng5+,877,898,21,1
rnbqkbnr/pppppppp/8/8/8/8/PPPPPPPP/RNBQKBNR w KQkq - 0 1,e4,37,25,-12,1
rnbqkbnr/pppppppp/8/8/4P3/8/PPPP1PPP/RNBQKBNR b KQkq - 0 1,e5,30,31,1,1
rnbqkbnr/pppp1ppp/8/4p3/4P3/8/PPPP1PPP/RNBQKBNR w KQkq - 0 2,Nf3,32,33,1,1
rnbqkbnr/pppp1ppp/8/4p3/4P3/5N2/PPPP1PPP/RNBQKB1R b KQkq - 1 2,d6,24,49,25,1
rnbqkbnr/ppp2ppp/3p4/4p3/4P3/5N2/PPPP1PPP/RNBQKB1R w KQkq - 0 3,Bc4,34,15,-19,1
rnbqkbnr/ppp2ppp/3p4/4p3/2B1P3/5N2/PPPP1PPP/RNBQK2R b KQkq - 1 3,h6,34,103,69,1
rnbqkbnr/ppp2pp1/3p3p/4p3/2B1P3/5N2/PPPP1PPP/RNBQK2R w KQkq - 0 4,Bb3,113,25,-88,1
rnbqkbnr/ppp2pp1/3p3p/4p3/4P3/1B3N2/PPPP1PPP/RNBQK2R b KQkq - 1 4,Nf6,21,19,-2,1
rnbqkb1r/ppp2pp1/3p1n1p/4p3/4P3/1B3N2/PPPP1PPP/RNBQK2R w KQkq - 2 5,Nc3,25,15,-10,1
rnbqkb1r/ppp2pp1/3p1n1p/4p3/4P3/1BN2N2/PPPP1PPP/R1BQK2R b KQkq - 3 5,Qe7,11,94,83,1
rnb1kb1r/ppp1qpp1/3p1n1p/4p3/4P3/1BN2N2/PPPP1PPP/R1BQK2R w KQkq - 4 6,O-O,96,68,-28,1
rnb1kb1r/ppp1qpp1/3p1n1p/4p3/4P3/1BN2N2/PPPP1PPP/R1BQ1RK1 b kq - 5 6,c6,65,81,16,1
rnb1kb1r/pp2qpp1/2pp1n1p/4p3/4P3/1BN2N2/PPPP1PPP/R1BQ1RK1 w kq - 0 7,h3,84,29,-55,1
rnb1kb1r/pp2qpp1/2pp1n1p/4p3/4P3/1BN2N1P/PPPP1PP1/R1BQ1RK1 b kq - 0 7,Be6,30,117,87,1
rn2kb1r/pp2qpp1/2ppbn1p/4p3/4P3/1BN2N1P/PPPP1PP1/R1BQ1RK1 w kq - 1 8,a3,107,34,-73,1
rn2kb1r/pp2qpp1/2ppbn1p/4p3/4P3/PBN2N1P/1PPP1PP1/R1BQ1RK1 b kq - 0 8,Bxb3,47,49,2,1
rn2kb1r/pp2qpp1/2pp1n1p/4p3/4P3/PbN2N1P/1PPP1PP1/R1BQ1RK1 w kq - 0 9,cxb3,43,44,1,1
rn2kb1r/pp2qpp1/2pp1n1p/4p3/4P3/PPN2N1P/1P1P1PP1/R1BQ1RK1 b kq - 0 9,d5,34,233,199,1
rn2kb1r/pp2qpp1/2p2n1p/3pp3/4P3/PPN2N1P/1P1P1PP1/R1BQ1RK1 w kq - 0 10,exd5,228,248,20,1
rn2kb1r/pp2qpp1/2p2n1p/3Pp3/8/PPN2N1P/1P1P1PP1/R1BQ1RK1 b kq - 0 10,cxd5,253,231,-22,1
rn2kb1r/pp2qpp1/5n1p/3pp3/8/PPN2N1P/1P1P1PP1/R1BQ1RK1 w kq - 0 11,Re1,233,205,-28,1
rn2kb1r/pp2qpp1/5n1p/3pp3/8/PPN2N1P/1P1P1PP1/R1BQR1K1 b kq - 1 11,Nbd7,223,358,135,1
r3kb1r/pp1nqpp1/5n1p/3pp3/8/PPN2N1P/1P1P1PP1/R1BQR1K1 w kq - 2 12,Nd4,358,98,-260,0
r3kb1r/pp1nqpp1/5n1p/3pp3/3N4/PPN4P/1P1P1PP1/R1BQR1K1 b kq - 3 12,Qc5,106,173,67,1
r3kb1r/pp1n1pp1/5n1p/2qpp3/3N4/PPN4P/1P1P1PP1/R1BQR1K1 w kq - 4 13,Nf3,184,161,-23,1
r3kb1r/pp1n1pp1/5n1p/2qpp3/8/PPN2N1P/1P1P1PP1/R1BQR1K1 b kq - 5 13,Bd6,190,555,365,1
r3k2r/pp1n1pp1/3b1n1p/2qpp3/8/PPN2N1P/1P1P1PP1/R1BQR1K1 w kq - 6 14,b4,532,162,-370,0
r3k2r/pp1n1pp1/3b1n1p/2qpp3/1P6/P1N2N1P/1P1P1PP1/R1BQR1K1 b kq - 0 14,Qc6,152,194,42,1
r3k2r/pp1n1pp1/2qb1n1p/3pp3/1P6/P1N2N1P/1P1P1PP1/R1BQR1K1 w kq - 1 15,Qe2,208,-113,-321,0
r3k2r/pp1n1pp1/2qb1n1p/3pp3/1P6/P1N2N1P/1P1PQPP1/R1B1R1K1 b kq - 2 15,O-O,-107,-113,-6,1
r4rk1/pp1n1pp1/2qb1n1p/3pp3/1P6/P1N2N1P/1P1PQPP1/R1B1R1K1 w - - 3 16,Qb5,-91,-132,-41,1
r4rk1/pp1n1pp1/2qb1n1p/1Q1pp3/1P6/P1N2N1P/1P1P1PP1/R1B1R1K1 b - - 4 16,Qc7,-149,-65,84,1
r4rk1/ppqn1pp1/3b1n1p/1Q1pp3/1P6/P1N2N1P/1P1P1PP1/R1B1R1K1 w - - 5 17,Nxd5,-65,-94,-29,1
r4rk1/ppqn1pp1/3b1n1p/1Q1Np3/1P6/P4N1P/1P1P1PP1/R1B1R1K1 b - - 0 17,Nxd5,-93,-84,9,1
r4rk1/ppqn1pp1/3b3p/1Q1np3/1P6/P4N1P/1P1P1PP1/R1B1R1K1 w - - 0 18,Qxd5,-103,-100,3,1
r4rk1/ppqn1pp1/3b3p/3Qp3/1P6/P4N1P/1P1P1PP1/R1B1R1K1 b - - 0 18,Nf6,-103,-97,6,1
r4rk1/ppq2pp1/3b1n1p/3Qp3/1P6/P4N1P/1P1P1PP1/R1B1R1K1 w - - 1 19,Qd3,-107,-259,-152,0
r4rk1/ppq2pp1/3b1n1p/4p3/1P6/P2Q1N1P/1P1P1PP1/R1B1R1K1 b - - 2 19,e4,-262,-254,8,1
r4rk1/ppq2pp1/3b1n1p/8/1P2p3/P2Q1N1P/1P1P1PP1/R1B1R1K1 w - - 0 20,Rxe4,-255,-242,13,1
r4rk1/ppq2pp1/3b1n1p/8/1P2R3/P2Q1N1P/1P1P1PP1/R1B3K1 b - - 0 20,Nxe4,-237,-245,-8,1
r4rk1/ppq2pp1/3b3p/8/1P2n3/P2Q1N1P/1P1P1PP1/R1B3K1 w - - 0 21,Qxe4,-264,-268,-4,1
r4rk1/ppq2pp1/3b3p/8/1P2Q3/P4N1P/1P1P1PP1/R1B3K1 b - - 0 21,Rae8,-266,-247,19,1
4rrk1/ppq2pp1/3b3p/8/1P2Q3/P4N1P/1P1P1PP1/R1B3K1 w - - 1 22,Qd5,-274,-333,-59,1
4rrk1/ppq2pp1/3b3p/3Q4/1P6/P4N1P/1P1P1PP1/R1B3K1 b - - 2 22,Re5,-332,225,557,1
5rk1/ppq2pp1/3b3p/3Qr3/1P6/P4N1P/1P1P1PP1/R1B3K1 w - - 3 23,Qb3,256,-169,-425,0
5rk1/ppq2pp1/3b3p/4r3/1P6/PQ3N1P/1P1P1PP1/R1B3K1 b - - 4 23,Re2,-180,-173,7,1
5rk1/ppq2pp1/3b3p/8/1P6/PQ3N1P/1P1PrPP1/R1B3K1 w - - 5 24,g3,-173,-476,-303,0
5rk1/ppq2pp1/3b3p/8/1P6/PQ3NPP/1P1PrP2/R1B3K1 b - - 0 24,b6,-549,-324,225,1
5rk1/p1q2pp1/1p1b3p/8/1P6/PQ3NPP/1P1PrP2/R1B3K1 w - - 0 25,Kg2,-334,-591,-257,0
5rk1/p1q2pp1/1p1b3p/8/1P6/PQ3NPP/1P1PrPK1/R1B5 b - - 1 25,Rfe8,-541,-302,239,1
4r1k1/p1q2pp1/1p1b3p/8/1P6/PQ3NPP/1P1PrPK1/R1B5 w - - 2 26,Nd4,-311,-316,-5,1
4r1k1/p1q2pp1/1p1b3p/8/1P1N4/PQ4PP/1P1PrPK1/R1B5 b - - 3 26,Bxg3,-363,191,554,1
4r1k1/p1q2pp1/1p5p/8/1P1N4/PQ4bP/1P1PrPK1/R1B5 w - - 0 27,Nxe2,133,-214,-347,0
4r1k1/p1q2pp1/1p5p/8/1P6/PQ4bP/1P1PNPK1/R1B5 b - - 0 27,Rxe2,-254,35,289,1
6k1/p1q2pp1/1p5p/8/1P6/PQ4bP/1P1PrPK1/R1B5 w - - 0 28,Qxg3,30,28,-2,1
6k1/p1q2pp1/1p5p/8/1P6/P5QP/1P1PrPK1/R1B5 b - - 0 28,Qc6+,49,143,94,1
6k1/p4pp1/1pq4p/8/1P6/P5QP/1P1PrPK1/R1B5 w - - 1 29,Kh2,134,0,-134,0
6k1/p4pp1/1pq4p/8/1P6/P5QP/1P1PrP1K/R1B5 b - - 2 29,Re5,0,687,687,1
6k1/p4pp1/1pq4p/4r3/1P6/P5QP/1P1P1P1K/R1B5 w - - 3 30,d4,662,0,-662,0
6k1/p4pp1/1pq4p/4r3/1P1P4/P5QP/1P3P1K/R1B5 b - - 0 30,Rg5,0,597,597,1
6k1/p4pp1/1pq4p/6r1/1P1P4/P5QP/1P3P1K/R1B5 w - - 1 31,Bxg5,541,596,55,1
6k1/p4pp1/1pq4p/6B1/1P1P4/P5QP/1P3P1K/R7 b - - 0 31,hxg5,626,626,0,1
6k1/p4pp1/1pq5/6p1/1P1P4/P5QP/1P3P1K/R7 w - - 0 32,Qxg5,548,617,69,1
6k1/p4pp1/1pq5/6Q1/1P1P4/P6P/1P3P1K/R7 b - - 0 32,Qd6+,621,669,48,1
6k1/p4pp1/1p1q4/6Q1/1P1P4/P6P/1P3P1K/R7 w - - 1 33,Qg3,692,619,-73,1
6k1/p4pp1/1p1q4/8/1P1P4/P5QP/1P3P1K/R7 b - - 2 33,Qxd4,649,619,-30,1
6k1/p4pp1/1p6/8/1P1q4/P5QP/1P3P1K/R7 w - - 0 34,Qc3,610,436,-174,0
6k1/p4pp1/1p6/8/1P1q4/P1Q4P/1P3P1K/R7 b - - 1 34,Qf4+,454,605,151,1
6k1/p4pp1/1p6/8/1P3q2/P1Q4P/1P3P1K/R7 w - - 2 35,Qg3,585,548,-37,1
6k1/p4pp1/1p6/8/1P3q2/P5QP/1P3P1K/R7 b - - 3 35,Qd4,590,608,18,1
6k1/p4pp1/1p6/8/1P1q4/P5QP/1P3P1K/R7 w - - 4 36,Qe3,596,576,-20,1
6k1/p4pp1/1p6/8/1P1q4/P3Q2P/1P3P1K/R7 b - - 5 36,Qxb2,554,548,-6,1
6k1/p4pp1/1p6/8/1P6/P3Q2P/1q3P1K/R7 w - - 0 37,Qc1,587,239,-348,0
6k1/p4pp1/1p6/8/1P6/P6P/1q3P1K/R1Q5 b - - 1 37,Qe5+,265,499,234,1
rnbqkbnr/pppppppp/8/8/8/8/PPPPPPPP/RNBQKBNR w KQkq - 0 1,e4,35,42,7,1
rnbqkbnr/pppppppp/8/8/4P3/8/PPPP1PPP/RNBQKBNR b KQkq - 0 1,c5,31,47,16,1
rnbqkbnr/pp1ppppp/8/2p5/4P3/8/PPPP1PPP/RNBQKBNR w KQkq - 0 2,Nf3,41,29,-12,1
rnbqkbnr/pp1ppppp/8/2p5/4P3/5N2/PPPP1PPP/RNBQKB1R b KQkq - 1 2,d6,41,48,7,1
rnbqkbnr/pp2pppp/3p4/2p5/4P3/5N2/PPPP1PPP/RNBQKB1R w KQkq - 0 3,d4,55,36,-19,1
rnbqkbnr/pp2pppp/3p4/2p5/3PP3/5N2/PPP2PPP/RNBQKB1R b KQkq - 0 3,cxd4,39,47,8,1
rnbqkbnr/pp2pppp/3p4/8/3pP3/5N2/PPP2PPP/RNBQKB1R w KQkq - 0 4,Nxd4,61,49,-12,1
rnbqkbnr/pp2pppp/3p4/8/3NP3/8/PPP2PPP/RNBQKB1R b KQkq - 0 4,Nf6,43,56,13,1
rnbqkb1r/pp2pppp/3p1n2/8/3NP3/8/PPP2PPP/RNBQKB1R w KQkq - 1 5,Bd3,46,26,-20,1
rnbqkb1r/pp2pppp/3p1n2/8/3NP3/3B4/PPP2PPP/RNBQK2R b KQkq - 2 5,e6,-7,43,50,1
rnbqkb1r/pp3ppp/3ppn2/8/3NP3/3B4/PPP2PPP/RNBQK2R w KQkq - 0 6,O-O,54,48,-6,1
rnbqkb1r/pp3ppp/3ppn2/8/3NP3/3B4/PPP2PPP/RNBQ1RK1 b kq - 1 6,Be7,37,35,-2,1
rnbqk2r/pp2bppp/3ppn2/8/3NP3/3B4/PPP2PPP/RNBQ1RK1 w kq - 2 7,f4,31,20,-11,1
rnbqk2r/pp2bppp/3ppn2/8/3NPP2/3B4/PPP3PP/RNBQ1RK1 b kq - 0 7,O-O,11,24,13,1
rnbq1rk1/pp2bppp/3ppn2/8/3NPP2/3B4/PPP3PP/RNBQ1RK1 w - - 1 8,Kh1,26,26,0,1
rnbq1rk1/pp2bppp/3ppn2/8/3NPP2/3B4/PPP3PP/RNBQ1R1K b - - 2 8,Qb6,24,82,58,1
rnb2rk1/pp2bppp/1q1ppn2/8/3NPP2/3B4/PPP3PP/RNBQ1R1K w - - 3 9,c3,96,20,-76,1
rnb2rk1/pp2bppp/1q1ppn2/8/3NPP2/2PB4/PP4PP/RNBQ1R1K b - - 0 9,Nc6,16,34,18,1
r1b2rk1/pp2bppp/1qnppn2/8/3NPP2/2PB4/PP4PP/RNBQ1R1K w - - 1 10,Nxc6,38,33,-5,1
r1b2rk1/pp2bppp/1qNppn2/8/4PP2/2PB4/PP4PP/RNBQ1R1K b - - 0 10,bxc6,35,33,-2,1
r1b2rk1/p3bppp/1qpppn2/8/4PP2/2PB4/PP4PP/RNBQ1R1K w - - 0 11,e5,62,28,-34,1
r1b2rk1/p3bppp/1qpppn2/4P3/5P2/2PB4/PP4PP/RNBQ1R1K b - - 0 11,Nd5,37,71,34,1
r1b2rk1/p3bppp/1qppp3/3nP3/5P2/2PB4/PP4PP/RNBQ1R1K w - - 1 12,Qh5,73,27,-46,1
r1b2rk1/p3bppp/1qppp3/3nP2Q/5P2/2PB4/PP4PP/RNB2R1K b - - 2 12,g6,19,17,-2,1
r1b2rk1/p3bp1p/1qppp1p1/3nP2Q/5P2/2PB4/PP4PP/RNB2R1K w - - 0 13,Qh3,14,-28,-42,1
r1b2rk1/p3bp1p/1qppp1p1/3nP3/5P2/2PB3Q/PP4PP/RNB2R1K b - - 1 13,dxe5,-35,-7,28,1
r1b2rk1/p3bp1p/1qp1p1p1/3np3/5P2/2PB3Q/PP4PP/RNB2R1K w - - 0 14,fxe5,3,-12,-15,1
r1b2rk1/p3bp1p/1qp1p1p1/3nP3/8/2PB3Q/PP4PP/RNB2R1K b - - 0 14,Bc5,3,223,220,1
r1b2rk1/p4p1p/1qp1p1p1/2bnP3/8/2PB3Q/PP4PP/RNB2R1K w - - 1 15,Bh6,221,222,1,1
r1b2rk1/p4p1p/1qp1p1pB/2bnP3/8/2PB3Q/PP4PP/RN3R1K b - - 2 15,Ne3,217,277,60,1
r1b2rk1/p4p1p/1qp1p1pB/2b1P3/8/2PBn2Q/PP4PP/RN3R1K w - - 3 16,Re1,270,-89,-359,0
r1b2rk1/p4p1p/1qp1p1pB/2b1P3/8/2PBn2Q/PP4PP/RN2R2K b - - 4 16,Nf5,-40,236,276,1
r1b2rk1/p4p1p/1qp1p1pB/2b1Pn2/8/2PB3Q/PP4PP/RN2R2K w - - 5 17,Bxf5,220,120,-100,1
r1b2rk1/p4p1p/1qp1p1pB/2b1PB2/8/2P4Q/PP4PP/RN2R2K b - - 0 17,exf5,118,113,-5,1
r1b2rk1/p4p1p/1qp3pB/2b1Pp2/8/2P4Q/PP4PP/RN2R2K w - - 0 18,Bxf8,130,128,-2,1
r1b2Bk1/p4p1p/1qp3p1/2b1Pp2/8/2P4Q/PP4PP/RN2R2K b - - 0 18,Bxf8,103,121,18,1
r1b2bk1/p4p1p/1qp3p1/4Pp2/8/2P4Q/PP4PP/RN2R2K w - - 0 19,b3,116,107,-9,1
r1b2bk1/p4p1p/1qp3p1/4Pp2/8/1PP4Q/P5PP/RN2R2K b - - 0 19,Bb7,120,213,93,1
r4bk1/pb3p1p/1qp3p1/4Pp2/8/1PP4Q/P5PP/RN2R2K w - - 1 20,Nd2,201,231,30,1
r4bk1/pb3p1p/1qp3p1/4Pp2/8/1PP4Q/P2N2PP/R3R2K b - - 2 20,Qf2,241,218,-23,1
r4bk1/pb3p1p/2p3p1/4Pp2/8/1PP4Q/P2N1qPP/R3R2K w - - 3 21,Nf3,216,220,4,1
r4bk1/pb3p1p/2p3p1/4Pp2/8/1PP2N1Q/P4qPP/R3R2K b - - 4 21,c5,221,372,151,1
r4bk1/pb3p1p/6p1/2p1Pp2/8/1PP2N1Q/P4qPP/R3R2K w - - 0 22,Rf1,351,151,-200,0
r4bk1/pb3p1p/6p1/2p1Pp2/8/1PP2N1Q/P4qPP/R4R1K b - - 1 22,Qb2,156,144,-12,1
r4bk1/pb3p1p/6p1/2p1Pp2/8/1PP2N1Q/Pq4PP/R4R1K w - - 2 23,c4,196,88,-108,0
r4bk1/pb3p1p/6p1/2p1Pp2/2P5/1P3N1Q/Pq4PP/R4R1K b - - 0 23,Rd8,119,143,24,1
3r1bk1/pb3p1p/6p1/2p1Pp2/2P5/1P3N1Q/Pq4PP/R4R1K w - - 1 24,Ng5,114,83,-31,1
3r1bk1/pb3p1p/6p1/2p1PpN1/2P5/1P5Q/Pq4PP/R4R1K b - - 2 24,h5,45,58,13,1
3r1bk1/pb3p2/6p1/2p1PpNp/2P5/1P5Q/Pq4PP/R4R1K w - - 0 25,e6,45,0,-45,1
3r1bk1/pb3p2/4P1p1/2p2pNp/2P5/1P5Q/Pq4PP/R4R1K b - - 0 25,Rd2,-31,218,249,1
5bk1/pb3p2/4P1p1/2p2pNp/2P5/1P5Q/Pq1r2PP/R4R1K w - - 1 26,Rg1,215,-395,-610,0
5bk1/pb3p2/4P1p1/2p2pNp/2P5/1P5Q/Pq1r2PP/R5RK b - - 2 26,f6,-419,241,660,1
5bk1/pb6/4Ppp1/2p2pNp/2P5/1P5Q/Pq1r2PP/R5RK w - - 0 27,Nf3,271,261,-10,1
5bk1/pb6/4Ppp1/2p2p1p/2P5/1P3N1Q/Pq1r2PP/R5RK b - - 1 27,Rd3,290,365,75,1
5bk1/pb6/4Ppp1/2p2p1p/2P5/1P1r1N1Q/Pq4PP/R5RK w - - 2 28,Qg3,378,441,63,1
5bk1/pb6/4Ppp1/2p2p1p/2P5/1P1r1NQ1/Pq4PP/R5RK b - - 3 28,Kg7,430,590,160,1
5b2/pb4k1/4Ppp1/2p2p1p/2P5/1P1r1NQ1/Pq4PP/R5RK w - - 4 29,Qc7+,515,564,49,1
5b2/pbQ3k1/4Ppp1/2p2p1p/2P5/1P1r1N2/Pq4PP/R5RK b - - 5 29,Kh6,555,594,39,1
5b2/pbQ5/4Pppk/2p2p1p/2P5/1P1r1N2/Pq4PP/R5RK w - - 6 30,Qxb7,524,561,37,1
5b2/pQ6/4Pppk/2p2p1p/2P5/1P1r1N2/Pq4PP/R5RK b - - 0 30,Bd6,570,619,49,1
8/pQ6/3bPppk/2p2p1p/2P5/1P1r1N2/Pq4PP/R5RK w - - 1 31,e7,651,571,-80,1
8/pQ2P3/3b1ppk/2p2p1p/2P5/1P1r1N2/Pq4PP/R5RK b - - 0 31,Bxe7,573,642,69,1
8/pQ2b3/5ppk/2p2p1p/2P5/1P1r1N2/Pq4PP/R5RK w - - 0 32,Qxe7,650,688,38,1
8/p3Q3/5ppk/2p2p1p/2P5/1P1r1N2/Pq4PP/R5RK b - - 0 32,Rxf3,677,707,30,1
8/p3Q3/5ppk/2p2p1p/2P5/1P3r2/Pq4PP/R5RK w - - 0 33,gxf3,749,723,-26,1
8/p3Q3/5ppk/2p2p1p/2P5/1P3P2/Pq5P/R5RK b - - 0 33,h4,762,9994,9232,1
8/p3Q3/5ppk/2p2p2/2P4p/1P3P2/Pq5P/R5RK w - - 0 34,Qf8+,9994,9995,1,1
5Q2/p7/5ppk/2p2p2/2P4p/1P3P2/Pq5P/R5RK b - - 1 34,Kh5,9995,9999,4,1
5Q2/p7/5pp1/2p2p1k/2P4p/1P3P2/Pq5P/R5RK w - - 2 35,Qh8#,9999,10000,1,1
rnbqkbnr/pppppppp/8/8/8/8/PPPPPPPP/RNBQKBNR w KQkq - 0 1,e4,37,40,3,1
rnbqkbnr/pppppppp/8/8/4P3/8/PPPP1PPP/RNBQKBNR b KQkq - 0 1,e5,32,30,-2,1
rnbqkbnr/pppp1ppp/8/4p3/4P3/8/PPPP1PPP/RNBQKBNR w KQkq - 0 2,f4,33,-54,-87,1
rnbqkbnr/pppp1ppp/8/4p3/4PP2/8/PPPP2PP/RNBQKBNR b KQkq - 0 2,exf4,-34,-33,1,1
rnbqkbnr/pppp1ppp/8/8/4Pp2/8/PPPP2PP/RNBQKBNR w KQkq - 0 3,Nf3,-27,-20,7,1
rnbqkbnr/pppp1ppp/8/8/4Pp2/5N2/PPPP2PP/RNBQKB1R b KQkq - 1 3,f6,-20,148,168,1
rnbqkbnr/pppp2pp/5p2/8/4Pp2/5N2/PPPP2PP/RNBQKB1R w KQkq - 0 4,Bc4,125,78,-47,1
rnbqkbnr/pppp2pp/5p2/8/2B1Pp2/5N2/PPPP2PP/RNBQK2R b KQkq - 1 4,Bc5,100,190,90,1
rnbqk1nr/pppp2pp/5p2/2b5/2B1Pp2/5N2/PPPP2PP/RNBQK2R w KQkq - 2 5,d4,222,222,0,1
rnbqk1nr/pppp2pp/5p2/2b5/2BPPp2/5N2/PPP3PP/RNBQK2R b KQkq - 0 5,Bb6,182,217,35,1
rnbqk1nr/pppp2pp/1b3p2/8/2BPPp2/5N2/PPP3PP/RNBQK2R w KQkq - 1 6,c3,228,117,-111,0
rnbqk1nr/pppp2pp/1b3p2/8/2BPPp2/2P2N2/PP4PP/RNBQK2R b KQkq - 0 6,c6,136,161,25,1
rnbqk1nr/pp1p2pp/1bp2p2/8/2BPPp2/2P2N2/PP4PP/RNBQK2R w KQkq - 0 7,Bxf4,144,102,-42,1
rnbqk1nr/pp1p2pp/1bp2p2/8/2BPPB2/2P2N2/PP4PP/RN1QK2R b KQkq - 0 7,d5,111,115,4,1
rnbqk1nr/pp4pp/1bp2p2/3p4/2BPPB2/2P2N2/PP4PP/RN1QK2R w KQkq - 0 8,exd5,136,122,-14,1
rnbqk1nr/pp4pp/1bp2p2/3P4/2BP1B2/2P2N2/PP4PP/RN1QK2R b KQkq - 0 8,cxd5,101,108,7,1
rnbqk1nr/pp4pp/1b3p2/3p4/2BP1B2/2P2N2/PP4PP/RN1QK2R w KQkq - 0 9,Bb5+,104,39,-65,1
rnbqk1nr/pp4pp/1b3p2/1B1p4/3P1B2/2P2N2/PP4PP/RN1QK2R b KQkq - 1 9,Nc6,42,53,11,1
r1bqk1nr/pp4pp/1bn2p2/1B1p4/3P1B2/2P2N2/PP4PP/RN1QK2R w KQkq - 2 10,O-O,56,47,-9,1
r1bqk1nr/pp4pp/1bn2p2/1B1p4/3P1B2/2P2N2/PP4PP/RN1Q1RK1 b kq - 3 10,Bg4,46,74,28,1
r2qk1nr/pp4pp/1bn2p2/1B1p4/3P1Bb1/2P2N2/PP4PP/RN1Q1RK1 w kq - 4 11,Re1+,74,31,-43,1
r2qk1nr/pp4pp/1bn2p2/1B1p4/3P1Bb1/2P2N2/PP4PP/RN1QR1K1 b kq - 5 11,Ne7,26,29,3,1
r2qk2r/pp2n1pp/1bn2p2/1B1p4/3P1Bb1/2P2N2/PP4PP/RN1QR1K1 w kq - 6 12,Nbd2,32,27,-5,1
r2qk2r/pp2n1pp/1bn2p2/1B1p4/3P1Bb1/2P2N2/PP1N2PP/R2QR1K1 b kq - 7 12,Bc7,32,84,52,1
r2qk2r/ppb1n1pp/2n2p2/1B1p4/3P1Bb1/2P2N2/PP1N2PP/R2QR1K1 w kq - 8 13,Bxc7,89,67,-22,1
r2qk2r/ppB1n1pp/2n2p2/1B1p4/3P2b1/2P2N2/PP1N2PP/R2QR1K1 b kq - 0 13,Qxc7,61,67,6,1
r3k2r/ppq1n1pp/2n2p2/1B1p4/3P2b1/2P2N2/PP1N2PP/R2QR1K1 w kq - 0 14,Qa4,75,15,-60,1
r3k2r/ppq1n1pp/2n2p2/1B1p4/Q2P2b1/2P2N2/PP1N2PP/R3R1K1 b kq - 1 14,O-O,20,23,3,1
r4rk1/ppq1n1pp/2n2p2/1B1p4/Q2P2b1/2P2N2/PP1N2PP/R3R1K1 w - - 2 15,Rac1,18,11,-7,1
r4rk1/ppq1n1pp/2n2p2/1B1p4/Q2P2b1/2P2N2/PP1N2PP/2R1R1K1 b - - 3 15,a6,6,12,6,1
r4rk1/1pq1n1pp/p1n2p2/1B1p4/Q2P2b1/2P2N2/PP1N2PP/2R1R1K1 w - - 0 16,Bxc6,14,-32,-46,1
r4rk1/1pq1n1pp/p1B2p2/3p4/Q2P2b1/2P2N2/PP1N2PP/2R1R1K1 b - - 0 16,Nxc6,-19,-15,4,1
r4rk1/1pq3pp/p1n2p2/3p4/Q2P2b1/2P2N2/PP1N2PP/2R1R1K1 w - - 0 17,c4,-15,-64,-49,1
r4rk1/1pq3pp/p1n2p2/3p4/Q1PP2b1/5N2/PP1N2PP/2R1R1K1 b - - 0 17,dxc4,-73,22,95,1
r4rk1/1pq3pp/p1n2p2/8/Q1pP2b1/5N2/PP1N2PP/2R1R1K1 w - - 0 18,Qxc4+,29,36,7,1
r4rk1/1pq3pp/p1n2p2/8/2QP2b1/5N2/PP1N2PP/2R1R1K1 b - - 0 18,Kh8,8,92,84,1
r4r1k/1pq3pp/p1n2p2/8/2QP2b1/5N2/PP1N2PP/2R1R1K1 w - - 1 19,d5,76,82,6,1
r4r1k/1pq3pp/p1n2p2/3P4/2Q3b1/5N2/PP1N2PP/2R1R1K1 b - - 0 19,Bxf3,82,127,45,1
r4r1k/1pq3pp/p1n2p2/3P4/2Q5/5b2/PP1N2PP/2R1R1K1 w - - 0 20,Nxf3,135,63,-72,1
r4r1k/1pq3pp/p1n2p2/3P4/2Q5/5N2/PP4PP/2R1R1K1 b - - 0 20,Rac8,99,486,387,1
2r2r1k/1pq3pp/p1n2p2/3P4/2Q5/5N2/PP4PP/2R1R1K1 w - - 1 21,dxc6,484,505,21,1
2r2r1k/1pq3pp/p1P2p2/8/2Q5/5N2/PP4PP/2R1R1K1 b - - 0 21,bxc6,504,551,47,1
2r2r1k/2q3pp/p1p2p2/8/2Q5/5N2/PP4PP/2R1R1K1 w - - 0 22,Nd4,535,433,-102,0
2r2r1k/2q3pp/p1p2p2/8/2QN4/8/PP4PP/2R1R1K1 b - - 1 22,Qb6,443,434,-9,1
2r2r1k/6pp/pqp2p2/8/2QN4/8/PP4PP/2R1R1K1 w - - 2 23,Kh1,447,409,-38,1
2r2r1k/6pp/pqp2p2/8/2QN4/8/PP4PP/2R1R2K b - - 3 23,c5,433,457,24,1
2r2r1k/6pp/pq3p2/2p5/2QN4/8/PP4PP/2R1R2K w - - 0 24,Ne6,438,427,-11,1
2r2r1k/6pp/pq2Np2/2p5/2Q5/8/PP4PP/2R1R2K b - - 1 24,Rfe8,475,478,3,1
2r1r2k/6pp/pq2Np2/2p5/2Q5/8/PP4PP/2R1R2K w - - 2 25,Nxc5,428,390,-38,1
2r1r2k/6pp/pq3p2/2N5/2Q5/8/PP4PP/2R1R2K b - - 0 25,Rxe1+,390,474,84,1
2r4k/6pp/pq3p2/2N5/2Q5/8/PP4PP/2R1r2K w - - 0 26,Rxe1,460,434,-26,1
2r4k/6pp/pq3p2/2N5/2Q5/8/PP4PP/4R2K b - - 0 26,Qxb2,439,447,8,1
2r4k/6pp/p4p2/2N5/2Q5/8/Pq4PP/4R2K w - - 0 27,Nxa6,472,436,-36,1
2r4k/6pp/N4p2/8/2Q5/8/Pq4PP/4R2K b - - 0 27,Qb7,419,448,29,1
2r4k/1q4pp/N4p2/8/2Q5/8/P5PP/4R2K w - - 1 28,Nc5,437,367,-70,1
2r4k/1q4pp/5p2/2N5/2Q5/8/P5PP/4R2K b - - 2 28,Qb8,384,464,80,1
1qr4k/6pp/5p2/2N5/2Q5/8/P5PP/4R2K w - - 3 29,Qf7,429,477,48,1
1qr4k/5Qpp/5p2/2N5/8/8/P5PP/4R2K b - - 4 29,h6,489,467,-22,1
1qr4k/5Qp1/5p1p/2N5/8/8/P5PP/4R2K w - - 0 30,Nd7,460,359,-101,0
1qr4k/3N1Qp1/5p1p/8/8/8/P5PP/4R2K b - - 1 30,Qc7,388,807,419,1
2r4k/2qN1Qp1/5p1p/8/8/8/P5PP/4R2K w - - 2 31,Re8+,860,876,16,1
2r1R2k/2qN1Qp1/5p1p/8/8/8/P5PP/7K b - - 3 31,Rxe8,9988,9988,0,1
4r2k/2qN1Qp1/5p1p/8/8/8/P5PP/7K w - - 0 32,Qxe8+,9988,9989,1,1
4Q2k/2qN2p1/5p1p/8/8/8/P5PP/7K b - - 0 32,Kh7,9989,9989,0,1
4Q3/2qN2pk/5p1p/8/8/8/P5PP/7K w - - 1 33,Nf8+,9989,9990,1,1
4QN2/2q3pk/5p1p/8/8/8/P5PP/7K b - - 2 33,Kg8,9990,9990,0,1
4QNk1/2q3p1/5p1p/8/8/8/P5PP/7K w - - 3 34,Ne6+,9990,9991,1,1
4Q1k1/2q3p1/4Np1p/8/8/8/P5PP/7K b - - 4 34,Kh7,9991,9992,1,1
4Q3/2q3pk/4Np1p/8/8/8/P5PP/7K w - - 5 35,Nxc7,9992,9993,1,1
rnbqkbnr/pppppppp/8/8/8/8/PPPPPPPP/RNBQKBNR w KQkq - 0 1,e4,40,34,-6,1
rnbqkbnr/pppppppp/8/8/4P3/8/PPPP1PPP/RNBQKBNR b KQkq - 0 1,c6,38,58,20,1
rnbqkbnr/pp1ppppp/2p5/8/4P3/8/PPPP1PPP/RNBQKBNR w KQkq - 0 2,d4,41,39,-2,1
rnbqkbnr/pp1ppppp/2p5/8/3PP3/8/PPP2PPP/RNBQKBNR b KQkq - 0 2,d5,35,36,1,1
rnbqkbnr/pp2pppp/2p5/3p4/3PP3/8/PPP2PPP/RNBQKBNR w KQkq - 0 3,e5,41,43,2,1
rnbqkbnr/pp2pppp/2p5/3pP3/3P4/8/PPP2PPP/RNBQKBNR b KQkq - 0 3,Bf5,43,38,-5,1
rn1qkbnr/pp2pppp/2p5/3pPb2/3P4/8/PPP2PPP/RNBQKBNR w KQkq - 1 4,g4,39,1,-38,1
rn1qkbnr/pp2pppp/2p5/3pPb2/3P2P1/8/PPP2P1P/RNBQKBNR b KQkq - 0 4,Bg6,6,56,50,1
rn1qkbnr/pp2pppp/2p3b1/3pP3/3P2P1/8/PPP2P1P/RNBQKBNR w KQkq - 1 5,h4,43,-18,-61,1
rn1qkbnr/pp2pppp/2p3b1/3pP3/3P2PP/8/PPP2P2/RNBQKBNR b KQkq - 0 5,h6,-10,105,115,1
rn1qkbnr/pp2ppp1/2p3bp/3pP3/3P2PP/8/PPP2P2/RNBQKBNR w KQkq - 0 6,h5,115,89,-26,1
rn1qkbnr/pp2ppp1/2p3bp/3pP2P/3P2P1/8/PPP2P2/RNBQKBNR b KQkq - 0 6,Be4,108,105,-3,1
rn1qkbnr/pp2ppp1/2p4p/3pP2P/3Pb1P1/8/PPP2P2/RNBQKBNR w KQkq - 1 7,e6,106,-270,-376,0
rn1qkbnr/pp2ppp1/2p1P2p/3p3P/3Pb1P1/8/PPP2P2/RNBQKBNR b KQkq - 0 7,Bxh1,-239,-255,-16,1
rn1qkbnr/pp2ppp1/2p1P2p/3p3P/3P2P1/8/PPP2P2/RNBQKBNb w Qkq - 0 8,exf7+,-236,-252,-16,1
rn1qkbnr/pp2pPp1/2p4p/3p3P/3P2P1/8/PPP2P2/RNBQKBNb b Qkq - 0 8,Kxf7,-239,-229,10,1
rn1q1bnr/pp2pkp1/2p4p/3p3P/3P2P1/8/PPP2P2/RNBQKBNb w Q - 0 9,Qe2,-250,-287,-37,1
rn1q1bnr/pp2pkp1/2p4p/3p3P/3P2P1/8/PPP1QP2/RNB1KBNb b Q - 1 9,Nf6,-279,-301,-22,1
rn1q1b1r/pp2pkp1/2p2n1p/3p3P/3P2P1/8/PPP1QP2/RNB1KBNb w Q - 2 10,f3,-260,-342,-82,1
rn1q1b1r/pp2pkp1/2p2n1p/3p3P/3P2P1/5P2/PPP1Q3/RNB1KBNb b Q - 0 10,Qd6,-332,-334,-2,1
rn3b1r/pp2pkp1/2pq1n1p/3p3P/3P2P1/5P2/PPP1Q3/RNB1KBNb w Q - 1 11,Nh3,-387,-404,-17,1
rn3b1r/pp2pkp1/2pq1n1p/3p3P/3P2P1/5P1N/PPP1Q3/RNB1KB1b b Q - 2 11,Qg3+,-405,-440,-35,1
rn3b1r/pp2pkp1/2p2n1p/3p3P/3P2P1/5PqN/PPP1Q3/RNB1KB1b w Q - 3 12,Qf2,-427,-436,-9,1
rn3b1r/pp2pkp1/2p2n1p/3p3P/3P2P1/5PqN/PPP2Q2/RNB1KB1b b Q - 4 12,Qxf2+,-414,-316,98,1
rn3b1r/pp2pkp1/2p2n1p/3p3P/3P2P1/5P1N/PPP2q2/RNB1KB1b w Q - 0 13,Kxf2,-330,-350,-20,1
rn3b1r/pp2pkp1/2p2n1p/3p3P/3P2P1/5P1N/PPP2K2/RNB2B1b b - - 0 13,Nxg4+,-335,-337,-2,1
rn3b1r/pp2pkp1/2p4p/3p3P/3P2n1/5P1N/PPP2K2/RNB2B1b w - - 0 14,fxg4,-353,-337,16,1
rn3b1r/pp2pkp1/2p4p/3p3P/3P2P1/7N/PPP2K2/RNB2B1b b - - 0 14,Be4,-331,-291,40,1
rn3b1r/pp2pkp1/2p4p/3p3P/3Pb1P1/7N/PPP2K2/RNB2B2 w - - 1 15,Nc3,-282,-331,-49,1
rn3b1r/pp2pkp1/2p4p/3p3P/3Pb1P1/2N4N/PPP2K2/R1B2B2 b - - 2 15,Bxc2,-347,-335,12,1
rn3b1r/pp2pkp1/2p4p/3p3P/3P2P1/2N4N/PPb2K2/R1B2B2 w - - 0 16,Bf4,-321,-339,-18,1
rn3b1r/pp2pkp1/2p4p/3p3P/3P1BP1/2N4N/PPb2K2/R4B2 b - - 1 16,Nd7,-327,-292,35,1
r4b1r/pp1npkp1/2p4p/3p3P/3P1BP1/2N4N/PPb2K2/R4B2 w - - 2 17,Re1,-341,-376,-35,1
r4b1r/pp1npkp1/2p4p/3p3P/3P1BP1/2N4N/PPb2K2/4RB2 b - - 3 17,e6,-405,-389,16,1
r4b1r/pp1n1kp1/2p1p2p/3p3P/3P1BP1/2N4N/PPb2K2/4RB2 w - - 0 18,Bg2,-395,-418,-23,1
r4b1r/pp1n1kp1/2p1p2p/3p3P/3P1BP1/2N4N/PPb2KB1/4R3 b - - 1 18,Bb4,-430,-406,24,1
r6r/pp1n1kp1/2p1p2p/3p3P/1b1P1BP1/2N4N/PPb2KB1/4R3 w - - 2 19,a3,-420,-435,-15,1
r6r/pp1n1kp1/2p1p2p/3p3P/1b1P1BP1/P1N4N/1Pb2KB1/4R3 b - - 0 19,Bxc3,-440,-372,68,1
r6r/pp1n1kp1/2p1p2p/3p3P/3P1BP1/P1b4N/1Pb2KB1/4R3 w - - 0 20,bxc3,-325,-346,-21,1
r6r/pp1n1kp1/2p1p2p/3p3P/3P1BP1/P1P4N/2b2KB1/4R3 b - - 0 20,Rhe8,-356,-319,37,1
r3r3/pp1n1kp1/2p1p2p/3p3P/3P1BP1/P1P4N/2b2KB1/4R3 w - - 1 21,g5,-309,-324,-15,1
r3r3/pp1n1kp1/2p1p2p/3p2PP/3P1B2/P1P4N/2b2KB1/4R3 b - - 0 21,e5,-295,-277,18,1
r3r3/pp1n1kp1/2p4p/3pp1PP/3P1B2/P1P4N/2b2KB1/4R3 w - - 0 22,g6+,-335,-323,12,1
r3r3/pp1n1kp1/2p3Pp/3pp2P/3P1B2/P1P4N/2b2KB1/4R3 b - - 0 22,Kf6,-336,-283,53,1
r3r3/pp1n2p1/2p2kPp/3pp2P/3P1B2/P1P4N/2b2KB1/4R3 w - - 1 23,dxe5+,-316,-445,-129,0
r3r3/pp1n2p1/2p2kPp/3pP2P/5B2/P1P4N/2b2KB1/4R3 b - - 0 23,Nxe5,-395,-413,-18,1
r3r3/pp4p1/2p2kPp/3pn2P/5B2/P1P4N/2b2KB1/4R3 w - - 0 24,Kg3,-440,-448,-8,1
r3r3/pp4p1/2p2kPp/3pn2P/5B2/P1P3KN/2b3B1/4R3 b - - 1 24,Nd3,-414,-424,-10,1
r3r3/pp4p1/2p2kPp/3p3P/5B2/P1Pn2KN/2b3B1/4R3 w - - 2 25,Rf1,-426,-448,-22,1
r3r3/pp4p1/2p2kPp/3p3P/5B2/P1Pn2KN/2b3B1/5R2 b - - 3 25,Nxf4,-423,-419,4,1
r3r3/pp4p1/2p2kPp/3p3P/5n2/P1P3KN/2b3B1/5R2 w - - 0 26,Rxf4+,-412,-448,-36,1
r3r3/pp4p1/2p2kPp/3p3P/5R2/P1P3KN/2b3B1/8 b - - 0 26,Ke6,-445,-456,-11,1
r3r3/pp4p1/2p1k1Pp/3p3P/5R2/P1P3KN/2b3B1/8 w - - 1 27,Nf2,-448,-492,-44,1
r3r3/pp4p1/2p1k1Pp/3p3P/5R2/P1P3K1/2b2NB1/8 b - - 2 27,Kd6,-467,-463,4,1
r3r3/pp4p1/2pk2Pp/3p3P/5R2/P1P3K1/2b2NB1/8 w - - 3 28,Ng4,-471,-470,1,1
r3r3/pp4p1/2pk2Pp/3p3P/5RN1/P1P3K1/2b3B1/8 b - - 4 28,Rf8,-471,-448,23,1
r4r2/pp4p1/2pk2Pp/3p3P/5RN1/P1P3K1/2b3B1/8 w - - 5 29,Rb4,-459,-471,-12,1
r4r2/pp4p1/2pk2Pp/3p3P/1R4N1/P1P3K1/2b3B1/8 b - - 6 29,b6,-467,-429,38,1
r4r2/p5p1/1ppk2Pp/3p3P/1R4N1/P1P3K1/2b3B1/8 w - - 0 30,Bh3,-493,-548,-55,1
r4r2/p5p1/1ppk2Pp/3p3P/1R4N1/P1P3KB/2b5/8 b - - 1 30,Rae8,-551,-557,-6,1
4rr2/p5p1/1ppk2Pp/3p3P/1R4N1/P1P3KB/2b5/8 w - - 2 31,a4,-527,-609,-82,1
4rr2/p5p1/1ppk2Pp/3p3P/PR4N1/2P3KB/2b5/8 b - - 0 31,Be4,-587,-571,16,1
4rr2/p5p1/1ppk2Pp/3p3P/PR2b1N1/2P3KB/8/8 w - - 1 32,Ne3,-554,-681,-127,0
4rr2/p5p1/1ppk2Pp/3p3P/PR2b3/2P1N1KB/8/8 b - - 2 32,Rf3+,-717,-679,38,1
4r3/p5p1/1ppk2Pp/3p3P/PR2b3/2P1NrKB/8/8 w - - 3 33,Kh4,-678,-738,-60,1
4r3/p5p1/1ppk2Pp/3p3P/PR2b2K/2P1Nr1B/8/8 b - - 4 33,Rxe3,-714,-741,-27,1
4r3/p5p1/1ppk2Pp/3p3P/PR2b2K/2P1r2B/8/8 w - - 0 34,a5,-698,-738,-40,1
4r3/p5p1/1ppk2Pp/P2p3P/1R2b2K/2P1r2B/8/8 b - - 0 34,Bf5,-755,-600,155,1
4r3/p5p1/1ppk2Pp/P2p1b1P/1R5K/2P1r2B/8/8 w - - 1 35,axb6,-571,-9999,-9428,0
4r3/p5p1/1Ppk2Pp/3p1b1P/1R5K/2P1r2B/8/8 b - - 0 35,Rxh3#,-9999,-10000,-1,1
rnbqkbnr/pppppppp/8/8/8/8/PPPPPPPP/RNBQKBNR w KQkq - 0 1,e4,28,30,2,1
rnbqkbnr/pppppppp/8/8/4P3/8/PPPP1PPP/RNBQKBNR b KQkq - 0 1,e6,32,53,21,1
rnbqkbnr/pppp1ppp/4p3/8/4P3/8/PPPP1PPP/RNBQKBNR w KQkq - 0 2,Nc3,43,25,-18,1
rnbqkbnr/pppp1ppp/4p3/8/4P3/2N5/PPPP1PPP/R1BQKBNR b KQkq - 1 2,c6,32,83,51,1
rnbqkbnr/pp1p1ppp/2p1p3/8/4P3/2N5/PPPP1PPP/R1BQKBNR w KQkq - 0 3,f4,83,41,-42,1
rnbqkbnr/pp1p1ppp/2p1p3/8/4PP2/2N5/PPPP2PP/R1BQKBNR b KQkq - 0 3,d5,47,42,-5,1
rnbqkbnr/pp3ppp/2p1p3/3p4/4PP2/2N5/PPPP2PP/R1BQKBNR w KQkq - 0 4,f5,45,-187,-232,0
rnbqkbnr/pp3ppp/2p1p3/3p1P2/4P3/2N5/PPPP2PP/R1BQKBNR b KQkq - 0 4,exf5,-178,-174,4,1
rnbqkbnr/pp3ppp/2p5/3p1p2/4P3/2N5/PPPP2PP/R1BQKBNR w KQkq - 0 5,exd5,-193,-197,-4,1
rnbqkbnr/pp3ppp/2p5/3P1p2/8/2N5/PPPP2PP/R1BQKBNR b KQkq - 0 5,cxd5,-194,-201,-7,1
rnbqkbnr/pp3ppp/8/3p1p2/8/2N5/PPPP2PP/R1BQKBNR w KQkq - 0 6,d4,-181,-201,-20,1
rnbqkbnr/pp3ppp/8/3p1p2/3P4/2N5/PPP3PP/R1BQKBNR b KQkq - 0 6,Qe7+,-180,-137,43,1
rnb1kbnr/pp2qppp/8/3p1p2/3P4/2N5/PPP3PP/R1BQKBNR w KQkq - 1 7,Be2,-140,-165,-25,1
rnb1kbnr/pp2qppp/8/3p1p2/3P4/2N5/PPP1B1PP/R1BQK1NR b KQkq - 2 7,Nf6,-160,-87,73,1
rnb1kb1r/pp2qppp/5n2/3p1p2/3P4/2N5/PPP1B1PP/R1BQK1NR w KQkq - 3 8,Bf4,-131,-177,-46,1
rnb1kb1r/pp2qppp/5n2/3p1p2/3P1B2/2N5/PPP1B1PP/R2QK1NR b KQkq - 4 8,Ne4,-175,322,497,1
rnb1kb1r/pp2qppp/8/3p1p2/3PnB2/2N5/PPP1B1PP/R2QK1NR w KQkq - 5 9,Nxd5,302,300,-2,1
rnb1kb1r/pp2qppp/8/3N1p2/3PnB2/8/PPP1B1PP/R2QK1NR b KQkq - 0 9,Be6,314,513,199,1
rn2kb1r/pp2qppp/4b3/3N1p2/3PnB2/8/PPP1B1PP/R2QK1NR w KQkq - 1 10,Nc7+,532,265,-267,0
rnbqkbnr/pppppppp/8/8/8/8/PPPPPPPP/RNBQKBNR w KQkq - 0 1,e4,34,34,0,1
rnbqkbnr/pppppppp/8/8/4P3/8/PPPP1PPP/RNBQKBNR b KQkq - 0 1,g6,29,56,27,1
rnbqkbnr/pppppp1p/6p1/8/4P3/8/PPPP1PPP/RNBQKBNR w KQkq - 0 2,Bc4,66,45,-21,1
rnbqkbnr/pppppp1p/6p1/8/2B1P3/8/PPPP1PPP/RNBQK1NR b KQkq - 1 2,Bg7,36,54,18,1
rnbqk1nr/ppppppbp/6p1/8/2B1P3/8/PPPP1PPP/RNBQK1NR w KQkq - 2 3,c3,43,12,-31,1
rnbqk1nr/ppppppbp/6p1/8/2B1P3/2P5/PP1P1PPP/RNBQK1NR b KQkq - 0 3,Nf6,17,113,96,1
rnbqk2r/ppppppbp/5np1/8/2B1P3/2P5/PP1P1PPP/RNBQK1NR w KQkq - 1 4,e5,96,104,8,1
rnbqk2r/ppppppbp/5np1/4P3/2B5/2P5/PP1P1PPP/RNBQK1NR b KQkq - 0 4,Ng4,92,98,6,1
rnbqk2r/ppppppbp/6p1/4P3/2B3n1/2P5/PP1P1PPP/RNBQK1NR w KQkq - 1 5,d4,109,115,6,1
rnbqk2r/ppppppbp/6p1/4P3/2BP2n1/2P5/PP3PPP/RNBQK1NR b KQkq - 0 5,d5,90,122,32,1
rnbqk2r/ppp1ppbp/6p1/3pP3/2BP2n1/2P5/PP3PPP/RNBQK1NR w KQkq d6 0 6,Bb3,107,111,4,1
rnbqk2r/ppp1ppbp/6p1/3pP3/3P2n1/1BP5/PP3PPP/RNBQK1NR b KQkq - 1 6,Nc6,94,150,56,1
r1bqk2r/ppp1ppbp/2n3p1/3pP3/3P2n1/1BP5/PP3PPP/RNBQK1NR w KQkq - 2 7,h3,143,155,12,1
r1bqk2r/ppp1ppbp/2n3p1/3pP3/3P2n1/1BP4P/PP3PP1/RNBQK1NR b KQkq - 0 7,Nh6,143,114,-29,1
r1bqk2r/ppp1ppbp/2n3pn/3pP3/3P4/1BP4P/PP3PP1/RNBQK1NR w KQkq - 1 8,Nf3,145,121,-24,1
r1bqk2r/ppp1ppbp/2n3pn/3pP3/3P4/1BP2N1P/PP3PP1/RNBQK2R b KQkq - 2 8,Nf5,113,182,69,1
r1bqk2r/ppp1ppbp/2n3p1/3pPn2/3P4/1BP2N1P/PP3PP1/RNBQK2R w KQkq - 3 9,Bg5,203,89,-114,0
r1bqk2r/ppp1ppbp/2n3p1/3pPnB1/3P4/1BP2N1P/PP3PP1/RN1QK2R b KQkq - 4 9,O-O,81,113,32,1
r1bq1rk1/ppp1ppbp/2n3p1/3pPnB1/3P4/1BP2N1P/PP3PP1/RN1QK2R w KQ - 5 10,Nbd2,132,1,-131,0
r1bq1rk1/ppp1ppbp/2n3p1/3pPnB1/3P4/1BP2N1P/PP1N1PP1/R2QK2R b KQ - 6 10,f6,-3,15,18,1
r1bq1rk1/ppp1p1bp/2n2pp1/3pPnB1/3P4/1BP2N1P/PP1N1PP1/R2QK2R w KQ - 0 11,exf6,17,-28,-45,1
r1bq1rk1/ppp1p1bp/2n2Pp1/3p1nB1/3P4/1BP2N1P/PP1N1PP1/R2QK2R b KQ - 0 11,exf6,-32,-24,8,1
r1bq1rk1/ppp3bp/2n2pp1/3p1nB1/3P4/1BP2N1P/PP1N1PP1/R2QK2R w KQ - 0 12,Be3,11,-166,-177,0
r1bq1rk1/ppp3bp/2n2pp1/3p1n2/3P4/1BP1BN1P/PP1N1PP1/R2QK2R b KQ - 1 12,Nxe3,-145,-57,88,1
r1bq1rk1/ppp3bp/2n2pp1/3p4/3P4/1BP1nN1P/PP1N1PP1/R2QK2R w KQ - 0 13,fxe3,-62,-68,-6,1
r1bq1rk1/ppp3bp/2n2pp1/3p4/3P4/1BP1PN1P/PP1N2P1/R2QK2R b KQ - 0 13,Na5,-46,-37,9,1
r1bq1rk1/ppp3bp/5pp1/n2p4/3P4/1BP1PN1P/PP1N2P1/R2QK2R w KQ - 1 14,O-O,-30,-35,-5,1
r1bq1rk1/ppp3bp/5pp1/n2p4/3P4/1BP1PN1P/PP1N2P1/R2Q1RK1 b - - 2 14,Be6,-36,-35,1,1
r2q1rk1/ppp3bp/4bpp1/n2p4/3P4/1BP1PN1P/PP1N2P1/R2Q1RK1 w - - 3 15,Bc2,-10,-20,-10,1
r2q1rk1/ppp3bp/4bpp1/n2p4/3P4/2P1PN1P/PPBN2P1/R2Q1RK1 b - - 4 15,Qd7,-31,-25,6,1
r4rk1/pppq2bp/4bpp1/n2p4/3P4/2P1PN1P/PPBN2P1/R2Q1RK1 w - - 5 16,e4,-27,-16,11,1
r4rk1/pppq2bp/4bpp1/n2p4/3PP3/2P2N1P/PPBN2P1/R2Q1RK1 b - - 0 16,Bxh3,-16,304,320,1
r4rk1/pppq2bp/5pp1/n2p4/3PP3/2P2N1b/PPBN2P1/R2Q1RK1 w - - 0 17,gxh3,301,287,-14,1
r4rk1/pppq2bp/5pp1/n2p4/3PP3/2P2N1P/PPBN4/R2Q1RK1 b - - 0 17,Qxh3,317,337,20,1
r4rk1/ppp3bp/5pp1/n2p4/3PP3/2P2N1q/PPBN4/R2Q1RK1 w - - 0 18,Kf2,342,326,-16,1
r4rk1/ppp3bp/5pp1/n2p4/3PP3/2P2N1q/PPBN1K2/R2Q1R2 b - - 1 18,dxe4,300,288,-12,1
r4rk1/ppp3bp/5pp1/n7/3Pp3/2P2N1q/PPBN1K2/R2Q1R2 w - - 0 19,Bxe4,343,266,-77,1
r4rk1/ppp3bp/5pp1/n7/3PB3/2P2N1q/PP1N1K2/R2Q1R2 b - - 0 19,c6,267,325,58,1
r4rk1/pp4bp/2p2pp1/n7/3PB3/2P2N1q/PP1N1K2/R2Q1R2 w - - 0 20,Ke3,354,51,-303,0
r4rk1/pp4bp/2p2pp1/n7/3PB3/2P1KN1q/PP1N4/R2Q1R2 b - - 1 20,g5,73,283,210,1
r4rk1/pp4bp/2p2p2/n5p1/3PB3/2P1KN1q/PP1N4/R2Q1R2 w - - 0 21,Rh1,246,205,-41,1
r4rk1/pp4bp/2p2p2/n5p1/3PB3/2P1KN1q/PP1N4/R2Q3R b - - 1 21,Qe6,201,203,2,1
r4rk1/pp4bp/2p1qp2/n5p1/3PB3/2P1KN2/PP1N4/R2Q3R w - - 2 22,Kd3,216,221,5,1
r4rk1/pp4bp/2p1qp2/n5p1/3PB3/2PK1N2/PP1N4/R2Q3R b - - 3 22,h6,268,295,27,1
r4rk1/pp4b1/2p1qp1p/n5p1/3PB3/2PK1N2/PP1N4/R2Q3R w - - 0 23,Kc2,263,264,1,1
r4rk1/pp4b1/2p1qp1p/n5p1/3PB3/2P2N2/PPKN4/R2Q3R b - - 1 23,f5,257,339,82,1
r4rk1/pp4b1/2p1q2p/n4pp1/3PB3/2P2N2/PPKN4/R2Q3R w - - 0 24,Bd3,301,345,44,1
r4rk1/pp4b1/2p1q2p/n4pp1/3P4/2PB1N2/PPKN4/R2Q3R b - - 1 24,Rad8,349,364,15,1
3r1rk1/pp4b1/2p1q2p/n4pp1/3P4/2PB1N2/PPKN4/R2Q3R w - - 2 25,Re1,401,339,-62,1
3r1rk1/pp4b1/2p1q2p/n4pp1/3P4/2PB1N2/PPKN4/R2QR3 b - - 3 25,Qd6,388,399,11,1
3r1rk1/pp4b1/2pq3p/n4pp1/3P4/2PB1N2/PPKN4/R2QR3 w - - 4 26,Nc4,364,383,19,1
3r1rk1/pp4b1/2pq3p/n4pp1/2NP4/2PB1N2/PPK5/R2QR3 b - - 5 26,Nxc4,352,326,-26,1
3r1rk1/pp4b1/2pq3p/5pp1/2nP4/2PB1N2/PPK5/R2QR3 w - - 0 27,Bxc4+,301,346,45,1
3r1rk1/pp4b1/2pq3p/5pp1/2BP4/2P2N2/PPK5/R2QR3 b - - 0 27,Kh7,349,343,-6,1
3r1r2/pp4bk/2pq3p/5pp1/2BP4/2P2N2/PPK5/R2QR3 w - - 1 28,Re6,303,325,22,1
3r1r2/pp4bk/2pqR2p/5pp1/2BP4/2P2N2/PPK5/R2Q4 b - - 2 28,Qd7,366,640,274,1
3r1r2/pp1q2bk/2p1R2p/5pp1/2BP4/2P2N2/PPK5/R2Q4 w - - 3 29,Ne5,644,387,-257,0
3r1r2/pp1q2bk/2p1R2p/4Npp1/2BP4/2P5/PPK5/R2Q4 b - - 4 29,Qc7,402,603,201,1
3r1r2/ppq3bk/2p1R2p/4Npp1/2BP4/2P5/PPK5/R2Q4 w - - 5 30,Qh5,714,711,-3,1
3r1r2/ppq3bk/2p1R2p/4NppQ/2BP4/2P5/PPK5/R7 b - - 6 30,Rd6,711,796,85,1
5r2/ppq3bk/2prR2p/4NppQ/2BP4/2P5/PPK5/R7 w - - 7 31,Qg6+,769,797,28,1
5r2/ppq3bk/2prR1Qp/4Npp1/2BP4/2P5/PPK5/R7 b - - 8 31,Kh8,782,813,31,1
5r1k/ppq3b1/2prR1Qp/4Npp1/2BP4/2P5/PPK5/R7 w - - 9 32,Rxd6,790,772,-18,1
5r1k/ppq3b1/2pR2Qp/4Npp1/2BP4/2P5/PPK5/R7 b - - 0 32,Bxe5,824,9997,9173,1
5r1k/ppq5/2pR2Qp/4bpp1/2BP4/2P5/PPK5/R7 w - - 0 33,Qxh6+,9997,9998,1,1
5r1k/ppq5/2pR3Q/4bpp1/2BP4/2P5/PPK5/R7 b - - 0 33,Qh7,9998,9998,0,1
5r1k/pp5q/2pR3Q/4bpp1/2BP4/2P5/PPK5/R7 w - - 1 34,Qxh7+,9998,765,-9233,0
5r1k/pp5Q/2pR4/4bpp1/2BP4/2P5/PPK5/R7 b - - 0 34,Kxh7,686,708,22,1
5r2/pp5k/2pR4/4bpp1/2BP4/2P5/PPK5/R7 w - - 0 35,dxe5,695,712,17,1
5r2/pp5k/2pR4/4Ppp1/2B5/2P5/PPK5/R7 b - - 0 35,f4,724,9992,9268,1
5r2/pp5k/2pR4/4P1p1/2B2p2/2P5/PPK5/R7 w - - 0 36,Rh1+,9992,9993,1,1
5r2/pp5k/2pR4/4P1p1/2B2p2/2P5/PPK5/7R b - - 1 36,Kg7,9993,9993,0,1
5r2/pp4k1/2pR4/4P1p1/2B2p2/2P5/PPK5/7R w - - 2 37,Rhh6,9993,744,-9249,0
5r2/pp4k1/2pR3R/4P1p1/2B2p2/2P5/PPK5/8 b - - 3 37,f3,813,9999,9186,1
5r2/pp4k1/2pR3R/4P1p1/2B5/2P2p2/PPK5/8 w - - 0 38,Rdg6#,9999,10000,1,1
rnbqkbnr/pppppppp/8/8/8/8/PPPPPPPP/RNBQKBNR w KQkq - 0 1,d4,38,20,-18,1
rnbqkbnr/pppppppp/8/8/3P4/8/PPP1PPPP/RNBQKBNR b KQkq - 0 1,d5,17,25,8,1
rnbqkbnr/ppp1pppp/8/3p4/3P4/8/PPP1PPPP/RNBQKBNR w KQkq - 0 2,c4,27,21,-6,1
rnbqkbnr/ppp1pppp/8/3p4/2PP4/8/PP2PPPP/RNBQKBNR b KQkq - 0 2,c6,19,32,13,1
rnbqkbnr/pp2pppp/2p5/3p4/2PP4/8/PP2PPPP/RNBQKBNR w KQkq - 0 3,Nc3,34,35,1,1
rnbqkbnr/pp2pppp/2p5/3p4/2PP4/2N5/PP2PPPP/R1BQKBNR b KQkq - 1 3,Nf6,33,34,1,1
rnbqkb1r/pp2pppp/2p2n2/3p4/2PP4/2N5/PP2PPPP/R1BQKBNR w KQkq - 2 4,Nf3,30,14,-16,1
rnbqkb1r/pp2pppp/2p2n2/3p4/2PP4/2N2N2/PP2PPPP/R1BQKB1R b KQkq - 3 4,Bf5,27,60,33,1
rn1qkb1r/pp2pppp/2p2n2/3p1b2/2PP4/2N2N2/PP2PPPP/R1BQKB1R w KQkq - 4 5,Qb3,94,44,-50,1
rn1qkb1r/pp2pppp/2p2n2/3p1b2/2PP4/1QN2N2/PP2PPPP/R1B1KB1R b KQkq - 5 5,Qd7,55,197,142,1
rn2kb1r/pp1qpppp/2p2n2/3p1b2/2PP4/1QN2N2/PP2PPPP/R1B1KB1R w KQkq - 6 6,cxd5,229,220,-9,1
rn2kb1r/pp1qpppp/2p2n2/3P1b2/3P4/1QN2N2/PP2PPPP/R1B1KB1R b KQkq - 0 6,cxd5,220,230,10,1
rn2kb1r/pp1qpppp/5n2/3p1b2/3P4/1QN2N2/PP2PPPP/R1B1KB1R w KQkq - 0 7,Ne5,233,200,-33,1
rn2kb1r/pp1qpppp/5n2/3pNb2/3P4/1QN5/PP2PPPP/R1B1KB1R b KQkq - 1 7,Qc8,245,218,-27,1
rnq1kb1r/pp2pppp/5n2/3pNb2/3P4/1QN5/PP2PPPP/R1B1KB1R w KQkq - 2 8,e4,251,251,0,1
rnq1kb1r/pp2pppp/5n2/3pNb2/3PP3/1QN5/PP3PPP/R1B1KB1R b KQkq - 0 8,Bxe4,270,360,90,1
rnq1kb1r/pp2pppp/5n2/3pN3/3Pb3/1QN5/PP3PPP/R1B1KB1R w KQkq - 0 9,Nxe4,388,385,-3,1
rnq1kb1r/pp2pppp/5n2/3pN3/3PN3/1Q6/PP3PPP/R1B1KB1R b KQkq - 0 9,Nxe4,392,385,-7,1
rnq1kb1r/pp2pppp/8/3pN3/3Pn3/1Q6/PP3PPP/R1B1KB1R w KQkq - 0 10,Qxd5,379,157,-222,0
rnq1kb1r/pp2pppp/8/3QN3/3Pn3/8/PP3PPP/R1B1KB1R b KQkq - 0 10,Nd6,180,175,-5,1
rnq1kb1r/pp2pppp/3n4/3QN3/3P4/8/PP3PPP/R1B1KB1R w KQkq - 1 11,Bf4,184,186,2,1
rnq1kb1r/pp2pppp/3n4/3QN3/3P1B2/8/PP3PPP/R3KB1R b KQkq - 2 11,e6,202,187,-15,1
rnq1kb1r/pp3ppp/3np3/3QN3/3P1B2/8/PP3PPP/R3KB1R w KQkq - 0 12,Qb3,189,174,-15,1
rnq1kb1r/pp3ppp/3np3/4N3/3P1B2/1Q6/PP3PPP/R3KB1R b KQkq - 1 12,Be7,182,225,43,1
rnq1k2r/pp2bppp/3np3/4N3/3P1B2/1Q6/PP3PPP/R3KB1R w KQkq - 2 13,Rc1,216,206,-10,1
rnq1k2r/pp2bppp/3np3/4N3/3P1B2/1Q6/PP3PPP/2R1KB1R b Kkq - 3 13,Nc6,204,221,17,1
r1q1k2r/pp2bppp/2nnp3/4N3/3P1B2/1Q6/PP3PPP/2R1KB1R w Kkq - 4 14,Nxc6,196,91,-105,0
r1q1k2r/pp2bppp/2Nnp3/8/3P1B2/1Q6/PP3PPP/2R1KB1R b Kkq - 0 14,bxc6,92,86,-6,1
r1q1k2r/p3bppp/2pnp3/8/3P1B2/1Q6/PP3PPP/2R1KB1R w Kkq - 0 15,Bxd6,84,11,-73,1
r1q1k2r/p3bppp/2pBp3/8/3P4/1Q6/PP3PPP/2R1KB1R b Kkq - 0 15,Bxd6,18,22,4,1
r1q1k2r/p4ppp/2pbp3/8/3P4/1Q6/PP3PPP/2R1KB1R w Kkq - 0 16,Rxc6,24,24,0,1
r1q1k2r/p4ppp/2Rbp3/8/3P4/1Q6/PP3PPP/4KB1R b Kkq - 0 16,Qxc6,30,375,345,1
r3k2r/p4ppp/2qbp3/8/3P4/1Q6/PP3PPP/4KB1R w Kkq - 0 17,Bb5,343,356,13,1
r3k2r/p4ppp/2qbp3/1B6/3P4/1Q6/PP3PPP/4K2R b Kkq - 1 17,Rc8,386,429,43,1
2r1k2r/p4ppp/2qbp3/1B6/3P4/1Q6/PP3PPP/4K2R w Kk - 2 18,O-O,447,224,-223,0
2r1k2r/p4ppp/2qbp3/1B6/3P4/1Q6/PP3PPP/5RK1 b k - 3 18,O-O,273,252,-21,1
2r2rk1/p4ppp/2qbp3/1B6/3P4/1Q6/PP3PPP/5RK1 w - - 4 19,Bxc6,249,250,1,1
2r2rk1/p4ppp/2Bbp3/8/3P4/1Q6/PP3PPP/5RK1 b - - 0 19,Rxc6,241,248,7,1
5rk1/p4ppp/2rbp3/8/3P4/1Q6/PP3PPP/5RK1 w - - 0 20,a3,268,215,-53,1
5rk1/p4ppp/2rbp3/8/3P4/PQ6/1P3PPP/5RK1 b - - 0 20,Rfc8,227,237,10,1
2r3k1/p4ppp/2rbp3/8/3P4/PQ6/1P3PPP/5RK1 w - - 1 21,g3,248,275,27,1
2r3k1/p4ppp/2rbp3/8/3P4/PQ4P1/1P3P1P/5RK1 b - - 0 21,Bf8,281,205,-76,1
2r2bk1/p4ppp/2r1p3/8/3P4/PQ4P1/1P3P1P/5RK1 w - - 1 22,Kg2,222,96,-126,0
2r2bk1/p4ppp/2r1p3/8/3P4/PQ4P1/1P3PKP/5R2 b - - 2 22,g6,103,205,102,1
2r2bk1/p4p1p/2r1p1p1/8/3P4/PQ4P1/1P3PKP/5R2 w - - 0 23,Qa4,211,186,-25,1
2r2bk1/p4p1p/2r1p1p1/8/Q2P4/P5P1/1P3PKP/5R2 b - - 1 23,Bg7,225,326,101,1
2r3k1/p4pbp/2r1p1p1/8/Q2P4/P5P1/1P3PKP/5R2 w - - 2 24,Qxa7,279,311,32,1
2r3k1/Q4pbp/2r1p1p1/8/3P4/P5P1/1P3PKP/5R2 b - - 0 24,R6c7,288,286,-2,1
2r3k1/Q1r2pbp/4p1p1/8/3P4/P5P1/1P3PKP/5R2 w - - 1 25,Qb6,308,242,-66,1
2r3k1/2r2pbp/1Q2p1p1/8/3P4/P5P1/1P3PKP/5R2 b - - 2 25,Rc6,290,290,0,1
2r3k1/5pbp/1Qr1p1p1/8/3P4/P5P1/1P3PKP/5R2 w - - 3 26,Qb4,289,253,-36,1
2r3k1/5pbp/2r1p1p1/8/1Q1P4/P5P1/1P3PKP/5R2 b - - 4 26,Rc4,216,240,24,1
2r3k1/5pbp/4p1p1/8/1QrP4/P5P1/1P3PKP/5R2 w - - 5 27,Qb7,257,196,-61,1
2r3k1/1Q3pbp/4p1p1/8/2rP4/P5P1/1P3PKP/5R2 b - - 6 27,Bxd4,186,182,-4,1
2r3k1/1Q3p1p/4p1p1/8/2rb4/P5P1/1P3PKP/5R2 w - - 0 28,b4,198,190,-8,1
2r3k1/1Q3p1p/4p1p1/8/1Prb4/P5P1/5PKP/5R2 b - - 0 28,Bb2,160,346,186,1
2r3k1/1Q3p1p/4p1p1/8/1Pr5/P5P1/1b3PKP/5R2 w - - 1 29,a4,307,275,-32,1
2r3k1/1Q3p1p/4p1p1/8/PPr5/6P1/1b3PKP/5R2 b - - 0 29,R4c7,284,334,50,1
2r3k1/1Qr2p1p/4p1p1/8/PP6/6P1/1b3PKP/5R2 w - - 1 30,Qe4,300,313,13,1
2r3k1/2r2p1p/4p1p1/8/PP2Q3/6P1/1b3PKP/5R2 b - - 2 30,Bd4,319,505,186,1
2r3k1/2r2p1p/4p1p1/8/PP1bQ3/6P1/5PKP/5R2 w - - 3 31,b5,501,343,-158,0
2r3k1/2r2p1p/4p1p1/1P6/P2bQ3/6P1/5PKP/5R2 b - - 0 31,Rc4,385,372,-13,1
2r3k1/5p1p/4p1p1/1P6/P1rbQ3/6P1/5PKP/5R2 w - - 1 32,Qd3,336,262,-74,1
2r3k1/5p1p/4p1p1/1P6/P1rb4/3Q2P1/5PKP/5R2 b - - 2 32,Bxf2,212,508,296,1
2r3k1/5p1p/4p1p1/1P6/P1r5/3Q2P1/5bKP/5R2 w - - 0 33,Rxf2,532,526,-6,1
2r3k1/5p1p/4p1p1/1P6/P1r5/3Q2P1/5RKP/8 b - - 0 33,Rc3,514,527,13,1
2r3k1/5p1p/4p1p1/1P6/P7/2rQ2P1/5RKP/8 w - - 1 34,Qxc3,547,492,-55,1
2r3k1/5p1p/4p1p1/1P6/P7/2Q3P1/5RKP/8 b - - 0 34,Rxc3,515,519,4,1
6k1/5p1p/4p1p1/1P6/P7/2r3P1/5RKP/8 w - - 0 35,Rb2,523,491,-32,1
6k1/5p1p/4p1p1/1P6/P7/2r3P1/1R4KP/8 b - - 1 35,Ra3,521,568,47,1
6k1/5p1p/4p1p1/1P6/P7/r5P1/1R4KP/8 w - - 2 36,b6,569,553,-16,1
6k1/5p1p/1P2p1p1/8/P7/r5P1/1R4KP/8 b - - 0 36,Rxa4,585,580,-5,1
6k1/5p1p/1P2p1p1/8/r7/6P1/1R4KP/8 w - - 0 37,b7,581,586,5,1
6k1/1P3p1p/4p1p1/8/r7/6P1/1R4KP/8 b - - 0 37,Ra2,576,758,182,1
6k1/1P3p1p/4p1p1/8/8/6P1/rR4KP/8 w - - 1 38,b8=Q+,804,819,15,1
1Q4k1/5p1p/4p1p1/8/8/6P1/rR4KP/8 b - - 0 38,Kg7,962,933,-29,1
1Q6/5pkp/4p1p1/8/8/6P1/rR4KP/8 w - - 1 39,Qe5+,9989,9990,1,1
8/5pkp/4p1p1/4Q3/8/6P1/rR4KP/8 b - - 2 39,Kh6,9990,9991,1,1
8/5p1p/4p1pk/4Q3/8/6P1/rR4KP/8 w - - 3 40,Rxa2,9991,9989,-2,1
8/5p1p/4p1pk/4Q3/8/6P1/R5KP/8 b - - 0 40,f6,9989,9994,5,1
8/7p/4pppk/4Q3/8/6P1/R5KP/8 w - - 0 41,Ra5,9996,631,-9365,0
8/7p/4pppk/R3Q3/8/6P1/6KP/8 b - - 1 41,fxe5,620,620,0,1
8/7p/4p1pk/R3p3/8/6P1/6KP/8 w - - 0 42,Rxe5,636,607,-29,1
8/7p/4p1pk/4R3/8/6P1/6KP/8 b - - 0 42,Kg7,582,580,-2,1
8/6kp/4p1p1/4R3/8/6P1/6KP/8 w - - 1 43,Re3,570,540,-30,1
8/6kp/4p1p1/8/8/4R1P1/6KP/8 b - - 2 43,Kh6,567,626,59,1
rnbqkbnr/pppppppp/8/8/8/8/PPPPPPPP/RNBQKBNR w KQkq - 0 1,e4,31,33,2,1
rnbqkbnr/pppppppp/8/8/4P3/8/PPPP1PPP/RNBQKBNR b KQkq - 0 1,d5,38,65,27,1
rnbqkbnr/ppp1pppp/8/3p4/4P3/8/PPPP1PPP/RNBQKBNR w KQkq - 0 2,exd5,73,58,-15,1
rnbqkbnr/ppp1pppp/8/3P4/8/8/PPPP1PPP/RNBQKBNR b KQkq - 0 2,Nf6,66,67,1,1
rnbqkb1r/ppp1pppp/5n2/3P4/8/8/PPPP1PPP/RNBQKBNR w KQkq - 1 3,Bb5+,69,57,-12,1
rnbqkb1r/ppp1pppp/5n2/1B1P4/8/8/PPPP1PPP/RNBQK1NR b KQkq - 2 3,Bd7,51,64,13,1
rn1qkb1r/pppbpppp/5n2/1B1P4/8/8/PPPP1PPP/RNBQK1NR w KQkq - 3 4,Bxd7+,60,8,-52,1
rn1qkb1r/pppBpppp/5n2/3P4/8/8/PPPP1PPP/RNBQK1NR b KQkq - 0 4,Qxd7,-5,-5,0,1
rn2kb1r/pppqpppp/5n2/3P4/8/8/PPPP1PPP/RNBQK1NR w KQkq - 0 5,c4,35,-19,-54,1
rn2kb1r/pppqpppp/5n2/3P4/2P5/8/PP1P1PPP/RNBQK1NR b KQkq - 0 5,e5,-16,141,157,1
rn2kb1r/pppq1ppp/5n2/3Pp3/2P5/8/PP1P1PPP/RNBQK1NR w KQkq e6 0 6,d4,142,96,-46,1
rn2kb1r/pppq1ppp/5n2/3Pp3/2PP4/8/PP3PPP/RNBQK1NR b KQkq - 0 6,exd4,109,100,-9,1
rn2kb1r/pppq1ppp/5n2/3P4/2Pp4/8/PP3PPP/RNBQK1NR w KQkq - 0 7,Qxd4,85,83,-2,1
rn2kb1r/pppq1ppp/5n2/3P4/2PQ4/8/PP3PPP/RNB1K1NR b KQkq - 0 7,Nc6,102,167,65,1
r3kb1r/pppq1ppp/2n2n2/3P4/2PQ4/8/PP3PPP/RNB1K1NR w KQkq - 1 8,Qe3+,155,167,12,1
r3kb1r/pppq1ppp/2n2n2/3P4/2P5/4Q3/PP3PPP/RNB1K1NR b KQkq - 2 8,Ne7,173,180,7,1
r3kb1r/pppqnppp/5n2/3P4/2P5/4Q3/PP3PPP/RNB1K1NR w KQkq - 3 9,Nf3,183,169,-14,1
r3kb1r/pppqnppp/5n2/3P4/2P5/4QN2/PP3PPP/RNB1K2R b KQkq - 4 9,O-O-O,152,320,168,1
2kr1b1r/pppqnppp/5n2/3P4/2P5/4QN2/PP3PPP/RNB1K2R w KQ - 5 10,Nc3,301,15,-286,0
2kr1b1r/pppqnppp/5n2/3P4/2P5/2N1QN2/PP3PPP/R1B1K2R b KQ - 6 10,Re8,0,245,245,1
2k1rb1r/pppqnppp/5n2/3P4/2P5/2N1QN2/PP3PPP/R1B1K2R w KQ - 7 11,Ne5,246,56,-190,0
2k1rb1r/pppqnppp/5n2/3PN3/2P5/2N1Q3/PP3PPP/R1B1K2R b KQ - 8 11,Nexd5,13,408,395,1
2k1rb1r/pppq1ppp/5n2/3nN3/2P5/2N1Q3/PP3PPP/R1B1K2R w KQ - 0 12,Nxd7,418,400,-18,1
2k1rb1r/pppN1ppp/5n2/3n4/2P5/2N1Q3/PP3PPP/R1B1K2R b KQ - 0 12,Nxe3,379,418,39,1
2k1rb1r/pppN1ppp/5n2/8/2P5/2N1n3/PP3PPP/R1B1K2R w KQ - 0 13,Nb6+,421,-103,-524,0
2k1rb1r/ppp2ppp/1N3n2/8/2P5/2N1n3/PP3PPP/R1B1K2R b KQ - 1 13,axb6,-89,-81,8,1
2k1rb1r/1pp2ppp/1p3n2/8/2P5/2N1n3/PP3PPP/R1B1K2R w KQ - 0 14,Bxe3,-94,-73,21,1
2k1rb1r/1pp2ppp/1p3n2/8/2P5/2N1B3/PP3PPP/R3K2R b KQ - 0 14,Bc5,-68,-56,12,1
2k1r2r/1pp2ppp/1p3n2/2b5/2P5/2N1B3/PP3PPP/R3K2R w KQ - 1 15,Ke2,-52,-198,-146,0
2k1r2r/1pp2ppp/1p3n2/2b5/2P5/2N1B3/PP2KPPP/R6R b - - 2 15,Ng4,-202,-201,1,1
2k1r2r/1pp2ppp/1p6/2b5/2P3n1/2N1B3/PP2KPPP/R6R w - - 3 16,Nd1,-195,-209,-14,1
2k1r2r/1pp2ppp/1p6/2b5/2P3n1/4B3/PP2KPPP/R2N3R b - - 4 16,Nxe3,-207,-155,52,1
2k1r2r/1pp2ppp/1p6/2b5/2P5/4n3/PP2KPPP/R2N3R w - - 0 17,Nxe3,-159,-151,8,1
2k1r2r/1pp2ppp/1p6/2b5/2P5/4N3/PP2KPPP/R6R b - - 0 17,f5,-151,-143,8,1
2k1r2r/1pp3pp/1p6/2b2p2/2P5/4N3/PP2KPPP/R6R w - - 0 18,g3,-139,-198,-59,1
2k1r2r/1pp3pp/1p6/2b2p2/2P5/4N1P1/PP2KP1P/R6R b - - 0 18,g5,-205,-150,55,1
2k1r2r/1pp4p/1p6/2b2pp1/2P5/4N1P1/PP2KP1P/R6R w - - 0 19,Kf3,-128,-213,-85,1
2k1r2r/1pp4p/1p6/2b2pp1/2P5/4NKP1/PP3P1P/R6R b - - 1 19,g4+,-186,-99,87,1
2k1r2r/1pp4p/1p6/2b2p2/2P3p1/4NKP1/PP3P1P/R6R w - - 0 20,Ke2,-102,-174,-72,1
2k1r2r/1pp4p/1p6/2b2p2/2P3p1/4N1P1/PP2KP1P/R6R b - - 1 20,Rhf8,-215,-240,-25,1
2k1rr2/1pp4p/1p6/2b2p2/2P3p1/4N1P1/PP2KP1P/R6R w - - 2 21,a3,-236,-250,-14,1
2k1rr2/1pp4p/1p6/2b2p2/2P3p1/P3N1P1/1P2KP1P/R6R b - - 0 21,f4,-244,-249,-5,1
2k1rr2/1pp4p/1p6/2b5/2P2pp1/P3N1P1/1P2KP1P/R6R w - - 0 22,gxf4,-241,-223,18,1
2k1rr2/1pp4p/1p6/2b5/2P2Pp1/P3N3/1P2KP1P/R6R b - - 0 22,Rxf4,-245,-261,-16,1
2k1r3/1pp4p/1p6/2b5/2P2rp1/P3N3/1P2KP1P/R6R w - - 0 23,b4,-254,-325,-71,1
2k1r3/1pp4p/1p6/2b5/1PP2rp1/P3N3/4KP1P/R6R b - - 0 23,Bd4,-351,-210,141,1
2k1r3/1pp4p/1p6/8/1PPb1rp1/P3N3/4KP1P/R6R w - - 1 24,Rad1,-224,-213,11,1
2k1r3/1pp4p/1p6/8/1PPb1rp1/P3N3/4KP1P/3R3R b - - 2 24,Rfe4,-231,-211,20,1
2k1r3/1pp4p/1p6/8/1PPbr1p1/P3N3/4KP1P/3R3R w - - 3 25,Rd3,-201,-229,-28,1
2k1r3/1pp4p/1p6/8/1PPbr1p1/P2RN3/4KP1P/7R b - - 4 25,Bxe3,-202,-3,199,1
2k1r3/1pp4p/1p6/8/1PP1r1p1/P2Rb3/4KP1P/7R w - - 0 26,Rxe3,-14,-23,-9,1
2k1r3/1pp4p/1p6/8/1PP1r1p1/P3R3/4KP1P/7R b - - 0 26,h5,-15,-6,9,1
2k1r3/1pp5/1p6/7p/1PP1r1p1/P3R3/4KP1P/7R w - - 0 27,Rd1,0,-4,-4,1
2k1r3/1pp5/1p6/7p/1PP1r1p1/P3R3/4KP1P/3R4 b - - 1 27,c6,7,12,5,1
2k1r3/1p6/1pp5/7p/1PP1r1p1/P3R3/4KP1P/3R4 w - - 0 28,Rd3,22,8,-14,1
2k1r3/1p6/1pp5/7p/1PP1r1p1/P2RR3/4KP1P/8 b - - 1 28,Kc7,5,5,0,1
4r3/1pk5/1pp5/7p/1PP1r1p1/P2RR3/4KP1P/8 w - - 2 29,f3,8,9,1,1
4r3/1pk5/1pp5/7p/1PP1r1p1/P2RRP2/4K2P/8 b - - 0 29,gxf3+,7,25,18,1
4r3/1pk5/1pp5/7p/1PP1r3/P2RRp2/4K2P/8 w - - 0 30,Kxf3,24,18,-6,1
4r3/1pk5/1pp5/7p/1PP1r3/P2RRK2/7P/8 b - - 0 30,Rxe3+,20,19,-1,1
4r3/1pk5/1pp5/7p/1PP5/P2RrK2/7P/8 w - - 0 31,Rxe3,19,21,2,1
4r3/1pk5/1pp5/7p/1PP5/P3RK2/7P/8 b - - 0 31,Rg8,23,37,14,1
6r1/1pk5/1pp5/7p/1PP5/P3RK2/7P/8 w - - 1 32,Re5,18,4,-14,1
6r1/1pk5/1pp5/4R2p/1PP5/P4K2/7P/8 b - - 2 32,Rh8,0,22,22,1
7r/1pk5/1pp5/4R2p/1PP5/P4K2/7P/8 w - - 3 33,Kg3,26,0,-26,1
7r/1pk5/1pp5/4R2p/1PP5/P5K1/7P/8 b - - 4 33,Kd6,6,17,11,1
7r/1p6/1ppk4/4R2p/1PP5/P5K1/7P/8 w - - 5 34,Rg5,13,-15,-28,1
7r/1p6/1ppk4/6Rp/1PP5/P5K1/7P/8 b - - 6 34,Ke6,-17,22,39,1
7r/1p6/1pp1k3/6Rp/1PP5/P5K1/7P/8 w - - 7 35,h4,9,3,-6,1
7r/1p6/1pp1k3/6Rp/1PP4P/P5K1/8/8 b - - 0 35,Kf6,0,20,20,1
7r/1p6/1pp2k2/6Rp/1PP4P/P5K1/8/8 w - - 1 36,Kf4,12,14,2,1
7r/1p6/1pp2k2/6Rp/1PP2K1P/P7/8/8 b - - 2 36,Rh6,6,78,72,1
8/1p6/1pp2k1r/6Rp/1PP2K1P/P7/8/8 w - - 3 37,Rg8,75,27,-48,1
6R1/1p6/1pp2k1r/7p/1PP2K1P/P7/8/8 b - - 4 37,Rh7,55,49,-6,1
6R1/1p5r/1pp2k2/7p/1PP2K1P/P7/8/8 w - - 5 38,Rg5,68,36,-32,1
8/1p5r/1pp2k2/6Rp/1PP2K1P/P7/8/8 b - - 6 38,Ke6,50,185,135,1
8/1p5r/1pp1k3/6Rp/1PP2K1P/P7/8/8 w - - 7 39,a4,196,74,-122,0
8/1p5r/1pp1k3/6Rp/PPP2K1P/8/8/8 b - - 0 39,Kf6,61,60,-1,1
8/1p5r/1pp2k2/6Rp/PPP2K1P/8/8/8 w - - 1 40,Rf5+,57,56,-1,1
8/1p5r/1pp2k2/5R1p/PPP2K1P/8/8/8 b - - 2 40,Ke6,65,49,-16,1
8/1p5r/1pp1k3/5R1p/PPP2K1P/8/8/8 w - - 3 41,Rg5,41,34,-7,1
8/1p5r/1pp1k3/6Rp/PPP2K1P/8/8/8 b - - 4 41,Kf6,29,41,12,1
8/1p5r/1pp2k2/6Rp/PPP2K1P/8/8/8 w - - 5 42,Ke4,39,41,2,1
8/1p5r/1pp2k2/6Rp/PPP1K2P/8/8/8 b - - 6 42,Ke6,48,80,32,1
8/1p5r/1pp1k3/6Rp/PPP1K2P/8/8/8 w - - 7 43,Kd4,81,33,-48,1
8/1p5r/1pp1k3/6Rp/PPPK3P/8/8/8 b - - 8 43,Kd6,19,70,51,1
8/1p5r/1ppk4/6Rp/PPPK3P/8/8/8 w - - 9 44,Rg6+,72,44,-28,1
8/1p5r/1ppk2R1/7p/PPPK3P/8/8/8 b - - 10 44,Kc7,48,64,16,1
8/1pk4r/1pp3R1/7p/PPPK3P/8/8/8 w - - 11 45,Rg5,43,42,-1,1
8/1pk4r/1pp5/6Rp/PPPK3P/8/8/8 b - - 12 45,Kd6,34,45,11,1
8/1p5r/1ppk4/6Rp/PPPK3P/8/8/8 w - - 13 46,b5,35,7,-28,1
8/1p5r/1ppk4/1P4Rp/P1PK3P/8/8/8 b - - 0 46,c5+,19,88,69,1
8/1p5r/1p1k4/1Pp3Rp/P1PK3P/8/8/8 w - - 0 47,Ke4,107,93,-14,1
8/1p5r/1p1k4/1Pp3Rp/P1P1K2P/8/8/8 b - - 1 47,Kc7,92,85,-7,1
8/1pk4r/1p6/1Pp3Rp/P1P1K2P/8/8/8 w - - 2 48,Kd5,92,78,-14,1
8/1pk4r/1p6/1PpK2Rp/P1P4P/8/8/8 b - - 3 48,Rd7+,57,85,28,1
8/1pkr4/1p6/1PpK2Rp/P1P4P/8/8/8 w - - 4 49,Ke6,56,79,23,1
8/1pkr4/1p2K3/1Pp3Rp/P1P4P/8/8/8 b - - 5 49,Rd4,58,72,14,1
8/1pk5/1p2K3/1Pp3Rp/P1Pr3P/8/8/8 w - - 6 50,Rxh5,86,88,2,1
8/1pk5/1p2K3/1Pp4R/P1Pr3P/8/8/8 b - - 0 50,Rxc4,81,33,-48,1
8/1pk5/1p2K3/1Pp4R/P1r4P/8/8/8 w - - 0 51,Rh7+,59,48,-11,1
8/1pk4R/1p2K3/1Pp5/P1r4P/8/8/8 b - - 1 51,Kb8,42,144,102,1
1k6/1p5R/1p2K3/1Pp5/P1r4P/8/8/8 w - - 2 52,Kd6,125,0,-125,0
1k6/1p5R/1p1K4/1Pp5/P1r4P/8/8/8 b - - 3 52,Rxa4,0,0,0,1
1k6/1p5R/1p1K4/1Pp5/r6P/8/8/8 w - - 0 53,Rh8+,0,0,0,1
1k5R/1p6/1p1K4/1Pp5/r6P/8/8/8 b - - 1 53,Ka7,0,0,0,1
7R/kp6/1p1K4/1Pp5/r6P/8/8/8 w - - 2 54,Kc7,0,-143,-143,0
7R/kpK5/1p6/1Pp5/r6P/8/8/8 b - - 3 54,Rb4,-204,-257,-53,1
7R/kpK5/1p6/1Pp5/1r5P/8/8/8 w - - 4 55,Rb8,-153,-246,-93,1
1R6/kpK5/1p6/1Pp5/1r5P/8/8/8 b - - 5 55,Rxb5,-296,-278,18,1
1R6/kpK5/1p6/1rp5/7P/8/8/8 w - - 0 56,Rxb7+,-275,-318,-43,1
8/kRK5/1p6/1rp5/7P/8/8/8 b - - 0 56,Ka6,-321,-329,-8,1
8/1RK5/kp6/1rp5/7P/8/8/8 w - - 1 57,h5,-329,-442,-113,0
8/1RK5/kp6/1rp4P/8/8/8/8 b - - 0 57,c4,-492,-501,-9,1
8/1RK5/kp6/1r5P/2p5/8/8/8 w - - 0 58,h6,-497,-499,-2,1
8/1RK5/kp5P/1r6/2p5/8/8/8 b - - 0 58,Rh5,-500,-13,487,1
8/1RK5/kp5P/7r/2p5/8/8/8 w - - 1 59,Kb8,0,-594,-594,0
1K6/1R6/kp5P/7r/2p5/8/8/8 b - - 2 59,Rxh6,-605,-584,21,1
1K6/1R6/kp5r/8/2p5/8/8/8 w - - 0 60,Rc7,-593,-794,-201,0
rnbqkbnr/pppppppp/8/8/8/8/PPPPPPPP/RNBQKBNR w KQkq - 0 1,e4,37,36,-1,1
rnbqkbnr/pppppppp/8/8/4P3/8/PPPP1PPP/RNBQKBNR b KQkq - 0 1,e5,32,30,-2,1
rnbqkbnr/pppp1ppp/8/4p3/4P3/8/PPPP1PPP/RNBQKBNR w KQkq - 0 2,Nf3,38,38,0,1
rnbqkbnr/pppp1ppp/8/4p3/4P3/5N2/PPPP1PPP/RNBQKB1R b KQkq - 1 2,d6,30,48,18,1
rnbqkbnr/ppp2ppp/3p4/4p3/4P3/5N2/PPPP1PPP/RNBQKB1R w KQkq - 0 3,Bc4,45,35,-10,1
rnbqkbnr/ppp2ppp/3p4/4p3/2B1P3/5N2/PPPP1PPP/RNBQK2R b KQkq - 1 3,Be7,39,45,6,1
rnbqk1nr/ppp1bppp/3p4/4p3/2B1P3/5N2/PPPP1PPP/RNBQK2R w KQkq - 2 4,O-O,36,21,-15,1
rnbqk1nr/ppp1bppp/3p4/4p3/2B1P3/5N2/PPPP1PPP/RNBQ1RK1 b kq - 3 4,Nf6,21,25,4,1
rnbqk2r/ppp1bppp/3p1n2/4p3/2B1P3/5N2/PPPP1PPP/RNBQ1RK1 w kq - 4 5,d3,33,23,-10,1
rnbqk2r/ppp1bppp/3p1n2/4p3/2B1P3/3P1N2/PPP2PPP/RNBQ1RK1 b kq - 0 5,h6,22,27,5,1
rnbqk2r/ppp1bpp1/3p1n1p/4p3/2B1P3/3P1N2/PPP2PPP/RNBQ1RK1 w kq - 0 6,a4,24,22,-2,1
rnbqk2r/ppp1bpp1/3p1n1p/4p3/P1B1P3/3P1N2/1PP2PPP/RNBQ1RK1 b kq - 0 6,O-O,23,20,-3,1
rnbq1rk1/ppp1bpp1/3p1n1p/4p3/P1B1P3/3P1N2/1PP2PPP/RNBQ1RK1 w - - 1 7,a5,25,15,-10,1
rnbq1rk1/ppp1bpp1/3p1n1p/P3p3/2B1P3/3P1N2/1PP2PPP/RNBQ1RK1 b - - 0 7,a6,22,30,8,1
rnbq1rk1/1pp1bpp1/p2p1n1p/P3p3/2B1P3/3P1N2/1PP2PPP/RNBQ1RK1 w - - 0 8,b3,29,-111,-140,0
rnbq1rk1/1pp1bpp1/p2p1n1p/P3p3/2B1P3/1P1P1N2/2P2PPP/RNBQ1RK1 b - - 0 8,Be6,-111,14,125,1
rn1q1rk1/1pp1bpp1/p2pbn1p/P3p3/2B1P3/1P1P1N2/2P2PPP/RNBQ1RK1 w - - 1 9,Bxe6,18,-20,-38,1
rn1q1rk1/1pp1bpp1/p2pBn1p/P3p3/4P3/1P1P1N2/2P2PPP/RNBQ1RK1 b - - 0 9,fxe6,-22,-24,-2,1
rn1q1rk1/1pp1b1p1/p2ppn1p/P3p3/4P3/1P1P1N2/2P2PPP/RNBQ1RK1 w - - 0 10,Be3,-28,-45,-17,1
rn1q1rk1/1pp1b1p1/p2ppn1p/P3p3/4P3/1P1PBN2/2P2PPP/RN1Q1RK1 b - - 1 10,c5,-42,-41,1,1
rn1q1rk1/1p2b1p1/p2ppn1p/P1p1p3/4P3/1P1PBN2/2P2PPP/RN1Q1RK1 w - - 0 11,Qd2,-43,-104,-61,1
rn1q1rk1/1p2b1p1/p2ppn1p/P1p1p3/4P3/1P1PBN2/2PQ1PPP/RN3RK1 b - - 1 11,Nc6,-113,-122,-9,1
r2q1rk1/1p2b1p1/p1nppn1p/P1p1p3/4P3/1P1PBN2/2PQ1PPP/RN3RK1 w - - 2 12,Nc3,-116,-137,-21,1
r2q1rk1/1p2b1p1/p1nppn1p/P1p1p3/4P3/1PNPBN2/2PQ1PPP/R4RK1 b - - 3 12,d5,-131,-105,26,1
r2q1rk1/1p2b1p1/p1n1pn1p/P1ppp3/4P3/1PNPBN2/2PQ1PPP/R4RK1 w - - 0 13,exd5,-99,-127,-28,1
r2q1rk1/1p2b1p1/p1n1pn1p/P1pPp3/8/1PNPBN2/2PQ1PPP/R4RK1 b - - 0 13,exd5,-130,-142,-12,1
r2q1rk1/1p2b1p1/p1n2n1p/P1ppp3/8/1PNPBN2/2PQ1PPP/R4RK1 w - - 0 14,Ne2,-118,-144,-26,1
r2q1rk1/1p2b1p1/p1n2n1p/P1ppp3/8/1P1PBN2/2PQNPPP/R4RK1 b - - 1 14,d4,-161,-139,22,1
r2q1rk1/1p2b1p1/p1n2n1p/P1p1p3/3p4/1P1PBN2/2PQNPPP/R4RK1 w - - 0 15,Bxh6,-160,-144,16,1
r2q1rk1/1p2b1p1/p1n2n1B/P1p1p3/3p4/1P1P1N2/2PQNPPP/R4RK1 b - - 0 15,gxh6,-150,-107,43,1
r2q1rk1/1p2b3/p1n2n1p/P1p1p3/3p4/1P1P1N2/2PQNPPP/R4RK1 w - - 0 16,Qxh6,-113,-116,-3,1
r2q1rk1/1p2b3/p1n2n1Q/P1p1p3/3p4/1P1P1N2/2P1NPPP/R4RK1 b - - 0 16,Nh7,-119,-118,1,1
r2q1rk1/1p2b2n/p1n4Q/P1p1p3/3p4/1P1P1N2/2P1NPPP/R4RK1 w - - 1 17,Ng3,-112,-145,-33,1
r2q1rk1/1p2b2n/p1n4Q/P1p1p3/3p4/1P1P1NN1/2P2PPP/R4RK1 b - - 2 17,Bg5,-148,-18,130,1
r2q1rk1/1p5n/p1n4Q/P1p1p1b1/3p4/1P1P1NN1/2P2PPP/R4RK1 w - - 3 18,Qg6+,-24,-136,-112,0
r2q1rk1/1p5n/p1n3Q1/P1p1p1b1/3p4/1P1P1NN1/2P2PPP/R4RK1 b - - 4 18,Kh8,-143,-155,-12,1
r2q1r1k/1p5n/p1n3Q1/P1p1p1b1/3p4/1P1P1NN1/2P2PPP/R4RK1 w - - 5 19,Rae1,-130,-233,-103,0
r2q1r1k/1p5n/p1n3Q1/P1p1p1b1/3p4/1P1P1NN1/2P2PPP/4RRK1 b - - 6 19,Qf6,-195,-128,67,1
r4r1k/1p5n/p1n2qQ1/P1p1p1b1/3p4/1P1P1NN1/2P2PPP/4RRK1 w - - 7 20,Qxf6+,-129,-198,-69,1
r4r1k/1p5n/p1n2Q2/P1p1p1b1/3p4/1P1P1NN1/2P2PPP/4RRK1 b - - 0 20,Bxf6,-207,-204,3,1
r4r1k/1p5n/p1n2b2/P1p1p3/3p4/1P1P1NN1/2P2PPP/4RRK1 w - - 0 21,Ne4,-205,-190,15,1
r4r1k/1p5n/p1n2b2/P1p1p3/3pN3/1P1P1N2/2P2PPP/4RRK1 b - - 1 21,Nxa5,-192,-100,92,1
r4r1k/1p5n/p4b2/n1p1p3/3pN3/1P1P1N2/2P2PPP/4RRK1 w - - 0 22,Nxf6,-120,-142,-22,1
r4r1k/1p5n/p4N2/n1p1p3/3p4/1P1P1N2/2P2PPP/4RRK1 b - - 0 22,Rxf6,-111,-109,2,1
r6k/1p5n/p4r2/n1p1p3/3p4/1P1P1N2/2P2PPP/4RRK1 w - - 0 23,Rxe5,-124,-140,-16,1
r6k/1p5n/p4r2/n1p1R3/3p4/1P1P1N2/2P2PPP/5RK1 b - - 0 23,b6,-136,-126,10,1
r6k/7n/pp3r2/n1p1R3/3p4/1P1P1N2/2P2PPP/5RK1 w - - 0 24,Re7,-128,-137,-9,1
r6k/4R2n/pp3r2/n1p5/3p4/1P1P1N2/2P2PPP/5RK1 b - - 1 24,Rg8,-163,-104,59,1
6rk/4R2n/pp3r2/n1p5/3p4/1P1P1N2/2P2PPP/5RK1 w - - 2 25,Rfe1,-99,-268,-169,0
6rk/4R2n/pp3r2/n1p5/3p4/1P1P1N2/2P2PPP/4R1K1 b - - 3 25,Rxf3,-307,-267,40,1
6rk/4R2n/pp6/n1p5/3p4/1P1P1r2/2P2PPP/4R1K1 w - - 0 26,Rd7,-231,-364,-133,0
6rk/3R3n/pp6/n1p5/3p4/1P1P1r2/2P2PPP/4R1K1 b - - 1 26,Rf6,-394,-361,33,1
6rk/3R3n/pp3r2/n1p5/3p4/1P1P4/2P2PPP/4R1K1 w - - 2 27,Ree7,-348,-388,-40,1
6rk/3RR2n/pp3r2/n1p5/3p4/1P1P4/2P2PPP/6K1 b - - 3 27,Rh6,-383,-389,-6,1
6rk/3RR2n/pp5r/n1p5/3p4/1P1P4/2P2PPP/6K1 w - - 4 28,h3,-406,-457,-51,1
6rk/3RR2n/pp5r/n1p5/3p4/1P1P3P/2P2PP1/6K1 b - - 0 28,Nc6,-440,-464,-24,1
6rk/3RR2n/ppn4r/2p5/3p4/1P1P3P/2P2PP1/6K1 w - - 1 29,Rf7,-474,-584,-110,0
6rk/3R1R1n/ppn4r/2p5/3p4/1P1P3P/2P2PP1/6K1 b - - 2 29,Ne5,-569,-561,8,1
rnbqkbnr/pppppppp/8/8/8/8/PPPPPPPP/RNBQKBNR w KQkq - 0 1,d4,41,28,-13,1
rnbqkbnr/pppppppp/8/8/3P4/8/PPP1PPPP/RNBQKBNR b KQkq - 0 1,Nf6,28,30,2,1
rnbqkb1r/pppppppp/5n2/8/3P4/8/PPP1PPPP/RNBQKBNR w KQkq - 1 2,c4,33,30,-3,1
rnbqkb1r/pppppppp/5n2/8/2PP4/8/PP2PPPP/RNBQKBNR b KQkq - 0 2,a6,25,77,52,1
rnbqkb1r/1ppppppp/p4n2/8/2PP4/8/PP2PPPP/RNBQKBNR w KQkq - 0 3,Nc3,54,49,-5,1
rnbqkb1r/1ppppppp/p4n2/8/2PP4/2N5/PP2PPPP/R1BQKBNR b KQkq - 1 3,b6,32,104,72,1
rnbqkb1r/2pppppp/pp3n2/8/2PP4/2N5/PP2PPPP/R1BQKBNR w KQkq - 0 4,e4,114,115,1,1
rnbqkb1r/2pppppp/pp3n2/8/2PPP3/2N5/PP3PPP/R1BQKBNR b KQkq - 0 4,Bb7,104,178,74,1
rn1qkb1r/1bpppppp/pp3n2/8/2PPP3/2N5/PP3PPP/R1BQKBNR w KQkq - 1 5,e5,189,158,-31,1
rn1qkb1r/1bpppppp/pp3n2/4P3/2PP4/2N5/PP3PPP/R1BQKBNR b KQkq - 0 5,Ng8,161,183,22,1
rn1qkbnr/1bpppppp/pp6/4P3/2PP4/2N5/PP3PPP/R1BQKBNR w KQkq - 1 6,Nh3,200,156,-44,1
rn1qkbnr/1bpppppp/pp6/4P3/2PP4/2N4N/PP3PPP/R1BQKB1R b KQkq - 2 6,h6,157,229,72,1
rn1qkbnr/1bppppp1/pp5p/4P3/2PP4/2N4N/PP3PPP/R1BQKB1R w KQkq - 0 7,Be2,232,-3,-235,0
rn1qkbnr/1bppppp1/pp5p/4P3/2PP4/2N4N/PP2BPPP/R1BQK2R b KQkq - 1 7,e6,83,204,121,1
rn1qkbnr/1bpp1pp1/pp2p2p/4P3/2PP4/2N4N/PP2BPPP/R1BQK2R w KQkq - 0 8,Rg1,216,0,-216,0
rn1qkbnr/1bpp1pp1/pp2p2p/4P3/2PP4/2N4N/PP2BPPP/R1BQK1R1 b Qkq - 1 8,g6,15,100,85,1
rn1qkbnr/1bpp1p2/pp2p1pp/4P3/2PP4/2N4N/PP2BPPP/R1BQK1R1 w Qkq - 0 9,Bf4,106,64,-42,1
rn1qkbnr/1bpp1p2/pp2p1pp/4P3/2PP1B2/2N4N/PP2BPPP/R2QK1R1 b Qkq - 1 9,Bg7,71,54,-17,1
rn1qk1nr/1bpp1pb1/pp2p1pp/4P3/2PP1B2/2N4N/PP2BPPP/R2QK1R1 w Qkq - 2 10,Ne4,45,-410,-455,0
rn1qk1nr/1bpp1pb1/pp2p1pp/4P3/2PPNB2/7N/PP2BPPP/R2QK1R1 b Qkq - 3 10,Bxe4,-394,-395,-1,1
rn1qk1nr/2pp1pb1/pp2p1pp/4P3/2PPbB2/7N/PP2BPPP/R2QK1R1 w Qkq - 0 11,c5,-376,-572,-196,0
rn1qk1nr/2pp1pb1/pp2p1pp/2P1P3/3PbB2/7N/PP2BPPP/R2QK1R1 b Qkq - 0 11,bxc5,-581,-515,66,1
rn1qk1nr/2pp1pb1/p3p1pp/2p1P3/3PbB2/7N/PP2BPPP/R2QK1R1 w Qkq - 0 12,Qa4,-468,-551,-83,1
rn1qk1nr/2pp1pb1/p3p1pp/2p1P3/Q2PbB2/7N/PP2BPPP/R3K1R1 b Qkq - 1 12,cxd4,-553,-534,19,1
rn1qk1nr/2pp1pb1/p3p1pp/4P3/Q2pbB2/7N/PP2BPPP/R3K1R1 w Qkq - 0 13,Rc1,-544,-614,-70,1
rn1qk1nr/2pp1pb1/p3p1pp/4P3/Q2pbB2/7N/PP2BPPP/2R1K1R1 b kq - 1 13,Bc6,-616,-550,66,1
rn1qk1nr/2pp1pb1/p1b1p1pp/4P3/Q2p1B2/7N/PP2BPPP/2R1K1R1 w kq - 2 14,Qa5,-566,-608,-42,1
rn1qk1nr/2pp1pb1/p1b1p1pp/Q3P3/3p1B2/7N/PP2BPPP/2R1K1R1 b kq - 3 14,Ne7,-622,-563,59,1
rn1qk2r/2ppnpb1/p1b1p1pp/Q3P3/3p1B2/7N/PP2BPPP/2R1K1R1 w kq - 4 15,Bc4,-557,-676,-119,0
rn1qk2r/2ppnpb1/p1b1p1pp/Q3P3/2Bp1B2/7N/PP3PPP/2R1K1R1 b kq - 5 15,O-O,-604,-479,125,1
rn1q1rk1/2ppnpb1/p1b1p1pp/Q3P3/2Bp1B2/7N/PP3PPP/2R1K1R1 w - - 6 16,b4,-484,-599,-115,0
rn1q1rk1/2ppnpb1/p1b1p1pp/Q3P3/1PBp1B2/7N/P4PPP/2R1K1R1 b - - 0 16,Nd5,-638,-507,131,1
rn1q1rk1/2pp1pb1/p1b1p1pp/Q2nP3/1PBp1B2/7N/P4PPP/2R1K1R1 w - - 1 17,g3,-552,-581,-29,1
rn1q1rk1/2pp1pb1/p1b1p1pp/Q2nP3/1PBp1B2/6PN/P4P1P/2R1K1R1 b - - 0 17,Nxf4,-606,-612,-6,1
rn1q1rk1/2pp1pb1/p1b1p1pp/Q3P3/1PBp1n2/6PN/P4P1P/2R1K1R1 w - - 0 18,gxf4,-588,-616,-28,1
rn1q1rk1/2pp1pb1/p1b1p1pp/Q3P3/1PBp1P2/7N/P4P1P/2R1K1R1 b - - 0 18,Bb7,-570,-553,17,1
rn1q1rk1/1bpp1pb1/p3p1pp/Q3P3/1PBp1P2/7N/P4P1P/2R1K1R1 w - - 1 19,Rd1,-537,-622,-85,1
rn1q1rk1/1bpp1pb1/p3p1pp/Q3P3/1PBp1P2/7N/P4P1P/3RK1R1 b - - 2 19,Nc6,-641,-624,17,1
r2q1rk1/1bpp1pb1/p1n1p1pp/Q3P3/1PBp1P2/7N/P4P1P/3RK1R1 w - - 3 20,Qa4,-579,-597,-18,1
r2q1rk1/1bpp1pb1/p1n1p1pp/4P3/QPBp1P2/7N/P4P1P/3RK1R1 b - - 4 20,d5,-626,-588,38,1
r2q1rk1/1bp2pb1/p1n1p1pp/3pP3/QPBp1P2/7N/P4P1P/3RK1R1 w - d6 0 21,Bd3,-567,-605,-38,1
r2q1rk1/1bp2pb1/p1n1p1pp/3pP3/QP1p1P2/3B3N/P4P1P/3RK1R1 b - - 1 21,Qe7,-558,-564,-6,1
r4rk1/1bp1qpb1/p1n1p1pp/3pP3/QP1p1P2/3B3N/P4P1P/3RK1R1 w - - 2 22,b5,-506,-612,-106,0
r4rk1/1bp1qpb1/p1n1p1pp/1P1pP3/Q2p1P2/3B3N/P4P1P/3RK1R1 b - - 0 22,axb5,-612,-630,-18,1
r4rk1/1bp1qpb1/2n1p1pp/1p1pP3/Q2p1P2/3B3N/P4P1P/3RK1R1 w - - 0 23,Qxb5,-579,-558,21,1
r4rk1/1bp1qpb1/2n1p1pp/1Q1pP3/3p1P2/3B3N/P4P1P/3RK1R1 b - - 0 23,Rfb8,-605,-563,42,1
rr4k1/1bp1qpb1/2n1p1pp/1Q1pP3/3p1P2/3B3N/P4P1P/3RK1R1 w - - 1 24,a4,-576,-636,-60,1
rr4k1/1bp1qpb1/2n1p1pp/1Q1pP3/P2p1P2/3B3N/5P1P/3RK1R1 b - - 0 24,Ra5,-599,-636,-37,1
1r4k1/1bp1qpb1/2n1p1pp/rQ1pP3/P2p1P2/3B3N/5P1P/3RK1R1 w - - 1 25,Qb3,-610,-642,-32,1
1r4k1/1bp1qpb1/2n1p1pp/r2pP3/P2p1P2/1Q1B3N/5P1P/3RK1R1 b - - 2 25,Qh4,-627,-541,86,1
1r4k1/1bp2pb1/2n1p1pp/r2pP3/P2p1P1q/1Q1B3N/5P1P/3RK1R1 w - - 3 26,Rg3,-433,-602,-169,0
1r4k1/1bp2pb1/2n1p1pp/r2pP3/P2p1P1q/1Q1B2RN/5P1P/3RK3 b - - 4 26,Qd8,-564,-434,130,1
1r1q2k1/1bp2pb1/2n1p1pp/r2pP3/P2p1P2/1Q1B2RN/5P1P/3RK3 w - - 5 27,Bb5,-434,-685,-251,0
1r1q2k1/1bp2pb1/2n1p1pp/rB1pP3/P2p1P2/1Q4RN/5P1P/3RK3 b - - 6 27,Ne7,-655,-649,6,1
1r1q2k1/1bp1npb1/4p1pp/rB1pP3/P2p1P2/1Q4RN/5P1P/3RK3 w - - 7 28,Rxd4,-649,-711,-62,1
1r1q2k1/1bp1npb1/4p1pp/rB1pP3/P2R1P2/1Q4RN/5P1P/4K3 b - - 0 28,c5,-732,-726,6,1
1r1q2k1/1b2npb1/4p1pp/rBppP3/P2R1P2/1Q4RN/5P1P/4K3 w - - 0 29,Rd2,-690,-708,-18,1
1r1q2k1/1b2npb1/4p1pp/rBppP3/P4P2/1Q4RN/3R1P1P/4K3 b - - 1 29,Bc6,-694,-659,35,1
1r1q2k1/4npb1/2b1p1pp/rBppP3/P4P2/1Q4RN/3R1P1P/4K3 w - - 2 30,Qc3,-632,-737,-105,0
1r1q2k1/4npb1/2b1p1pp/rBppP3/P4P2/2Q3RN/3R1P1P/4K3 b - - 3 30,Bxb5,-741,-769,-28,1
1r1q2k1/4npb1/4p1pp/rbppP3/P4P2/2Q3RN/3R1P1P/4K3 w - - 0 31,Rb2,-753,-745,8,1
1r1q2k1/4npb1/4p1pp/rbppP3/P4P2/2Q3RN/1R3P1P/4K3 b - - 1 31,Rxa4,-868,-845,23,1
1r1q2k1/4npb1/4p1pp/1bppP3/r4P2/2Q3RN/1R3P1P/4K3 w - - 0 32,Qxc5,-851,-906,-55,1
1r1q2k1/4npb1/4p1pp/1bQpP3/r4P2/6RN/1R3P1P/4K3 b - - 0 32,Rc4,-878,-755,123,1
1r1q2k1/4npb1/4p1pp/1bQpP3/2r2P2/6RN/1R3P1P/4K3 w - - 1 33,Qa3,-819,-917,-98,1
1r1q2k1/4npb1/4p1pp/1b1pP3/2r2P2/Q5RN/1R3P1P/4K3 b - - 2 33,Nf5,-853,-864,-11,1
1r1q2k1/5pb1/4p1pp/1b1pPn2/2r2P2/Q5RN/1R3P1P/4K3 w - - 3 34,Rgb3,-833,-843,-10,1
1r1q2k1/5pb1/4p1pp/1b1pPn2/2r2P2/QR5N/1R3P1P/4K3 b - - 4 34,Nd4,-809,-805,4,1
1r1q2k1/5pb1/4p1pp/1b1pP3/2rn1P2/QR5N/1R3P1P/4K3 w - - 5 35,Rc3,-806,-894,-88,1
1r1q2k1/5pb1/4p1pp/1b1pP3/2rn1P2/Q1R4N/1R3P1P/4K3 b - - 6 35,Rbc8,-877,-887,-10,1
2rq2k1/5pb1/4p1pp/1b1pP3/2rn1P2/Q1R4N/1R3P1P/4K3 w - - 7 36,Ng1,-830,-823,7,1
2rq2k1/5pb1/4p1pp/1b1pP3/2rn1P2/Q1R5/1R3P1P/4K1N1 b - - 8 36,Rxc3,-854,-900,-46,1
2rq2k1/5pb1/4p1pp/1b1pP3/3n1P2/Q1r5/1R3P1P/4K1N1 w - - 0 37,Qb4,-919,-1025,-106,0
2rq2k1/5pb1/4p1pp/1b1pP3/1Q1n1P2/2r5/1R3P1P/4K1N1 b - - 1 37,R8c4,-982,-900,82,1
3q2k1/5pb1/4p1pp/1b1pP3/1Qrn1P2/2r5/1R3P1P/4K1N1 w - - 2 38,Qxb5,-891,-870,21,1
3q2k1/5pb1/4p1pp/1Q1pP3/2rn1P2/2r5/1R3P1P/4K1N1 b - - 0 38,Nxb5,-916,-886,30,1
rnbqkbnr/pppppppp/8/8/8/8/PPPPPPPP/RNBQKBNR w KQkq - 0 1,d4,32,29,-3,1
rnbqkbnr/pppppppp/8/8/3P4/8/PPP1PPPP/RNBQKBNR b KQkq - 0 1,d5,31,35,4,1
rnbqkbnr/ppp1pppp/8/3p4/3P4/8/PPP1PPPP/RNBQKBNR w KQkq - 0 2,f4,34,-48,-82,1
rnbqkbnr/ppp1pppp/8/3p4/3P1P2/8/PPP1P1PP/RNBQKBNR b KQkq - 0 2,Nc6,-41,-3,38,1
r1bqkbnr/ppp1pppp/2n5/3p4/3P1P2/8/PPP1P1PP/RNBQKBNR w KQkq - 1 3,Nc3,7,-43,-50,1
r1bqkbnr/ppp1pppp/2n5/3p4/3P1P2/2N5/PPP1P1PP/R1BQKBNR b KQkq - 2 3,Nxd4,-29,375,404,1
r1bqkbnr/ppp1pppp/8/3p4/3n1P2/2N5/PPP1P1PP/R1BQKBNR w KQkq - 0 4,Nxd5,372,-163,-535,0
r1bqkbnr/ppp1pppp/8/3N4/3n1P2/8/PPP1P1PP/R1BQKBNR b KQkq - 0 4,Qxd5,-156,-81,75,1
rnbqkbnr/pppppppp/8/8/8/8/PPPPPPPP/RNBQKBNR w KQkq - 0 1,e4,31,29,-2,1
rnbqkbnr/pppppppp/8/8/4P3/8/PPPP1PPP/RNBQKBNR b KQkq - 0 1,d6,37,55,18,1
rnbqkbnr/ppp1pppp/3p4/8/4P3/8/PPPP1PPP/RNBQKBNR w KQkq - 0 2,Qf3,68,-32,-100,1
rnbqkbnr/ppp1pppp/3p4/8/4P3/5Q2/PPPP1PPP/RNB1KBNR b KQkq - 1 2,f6,-22,135,157,1
rnbqkbnr/ppp1p1pp/3p1p2/8/4P3/5Q2/PPPP1PPP/RNB1KBNR w KQkq - 0 3,h3,135,31,-104,0
rnbqkbnr/ppp1p1pp/3p1p2/8/4P3/5Q1P/PPPP1PP1/RNB1KBNR b KQkq - 0 3,e5,38,84,46,1
rnbqkbnr/ppp3pp/3p1p2/4p3/4P3/5Q1P/PPPP1PP1/RNB1KBNR w KQkq - 0 4,Bc4,85,94,9,1
rnbqkbnr/ppp3pp/3p1p2/4p3/2B1P3/5Q1P/PPPP1PP1/RNB1K1NR b KQkq - 1 4,Nh6,94,126,32,1
rnbqkb1r/ppp3pp/3p1p1n/4p3/2B1P3/5Q1P/PPPP1PP1/RNB1K1NR w KQkq - 2 5,c3,150,47,-103,0
rnbqkb1r/ppp3pp/3p1p1n/4p3/2B1P3/2P2Q1P/PP1P1PP1/RNB1K1NR b KQkq - 0 5,Qe7,65,66,1,1
rnb1kb1r/ppp1q1pp/3p1p1n/4p3/2B1P3/2P2Q1P/PP1P1PP1/RNB1K1NR w KQkq - 1 6,b4,86,14,-72,1
rnb1kb1r/ppp1q1pp/3p1p1n/4p3/1PB1P3/2P2Q1P/P2P1PP1/RNB1K1NR b KQkq - 0 6,Be6,18,45,27,1
rn2kb1r/ppp1q1pp/3pbp1n/4p3/1PB1P3/2P2Q1P/P2P1PP1/RNB1K1NR w KQkq - 1 7,Bb5+,52,-51,-103,0
rn2kb1r/ppp1q1pp/3pbp1n/1B2p3/1P2P3/2P2Q1P/P2P1PP1/RNB1K1NR b KQkq - 2 7,c6,-53,-49,4,1
rn2kb1r/pp2q1pp/2ppbp1n/1B2p3/1P2P3/2P2Q1P/P2P1PP1/RNB1K1NR w KQkq - 0 8,Bd3,-47,-139,-92,1
rn2kb1r/pp2q1pp/2ppbp1n/4p3/1P2P3/2PB1Q1P/P2P1PP1/RNB1K1NR b KQkq - 1 8,Nd7,-137,-58,79,1
r3kb1r/pp1nq1pp/2ppbp1n/4p3/1P2P3/2PB1Q1P/P2P1PP1/RNB1K1NR w KQkq - 2 9,a4,-63,-162,-99,1
r3kb1r/pp1nq1pp/2ppbp1n/4p3/PP2P3/2PB1Q1P/3P1PP1/RNB1K1NR b KQkq - 0 9,a5,-155,-124,31,1
r3kb1r/1p1nq1pp/2ppbp1n/p3p3/PP2P3/2PB1Q1P/3P1PP1/RNB1K1NR w KQkq - 0 10,b5,-101,-90,11,1
r3kb1r/1p1nq1pp/2ppbp1n/pP2p3/P3P3/2PB1Q1P/3P1PP1/RNB1K1NR b KQkq - 0 10,Nf7,-91,-38,53,1
r3kb1r/1p1nqnpp/2ppbp2/pP2p3/P3P3/2PB1Q1P/3P1PP1/RNB1K1NR w KQkq - 1 11,Bc2,-34,-43,-9,1
r3kb1r/1p1nqnpp/2ppbp2/pP2p3/P3P3/2P2Q1P/2BP1PP1/RNB1K1NR b KQkq - 2 11,Nc5,-45,-5,40,1
r3kb1r/1p2qnpp/2ppbp2/pPn1p3/P3P3/2P2Q1P/2BP1PP1/RNB1K1NR w KQkq - 3 12,d3,11,-57,-68,1
r3kb1r/1p2qnpp/2ppbp2/pPn1p3/P3P3/2PP1Q1P/2B2PP1/RNB1K1NR b KQkq - 0 12,d5,-67,-59,8,1
r3kb1r/1p2qnpp/2p1bp2/pPnpp3/P3P3/2PP1Q1P/2B2PP1/RNB1K1NR w KQkq - 0 13,Ne2,-58,-88,-30,1
r3kb1r/1p2qnpp/2p1bp2/pPnpp3/P3P3/2PP1Q1P/2B1NPP1/RNB1K2R b KQkq - 1 13,Nh6,-93,72,165,1
r3kb1r/1p2q1pp/2p1bp1n/pPnpp3/P3P3/2PP1Q1P/2B1NPP1/RNB1K2R w KQkq - 2 14,Bxh6,81,67,-14,1
r3kb1r/1p2q1pp/2p1bp1B/pPnpp3/P3P3/2PP1Q1P/2B1NPP1/RN2K2R b KQkq - 0 14,g6,52,421,369,1
r3kb1r/1p2q2p/2p1bppB/pPnpp3/P3P3/2PP1Q1P/2B1NPP1/RN2K2R w KQkq - 0 15,Bxf8,417,417,0,1
r3kB1r/1p2q2p/2p1bpp1/pPnpp3/P3P3/2PP1Q1P/2B1NPP1/RN2K2R b KQkq - 0 15,Rxf8,414,373,-41,1
r3kr2/1p2q2p/2p1bpp1/pPnpp3/P3P3/2PP1Q1P/2B1NPP1/RN2K2R w KQq - 0 16,O-O,353,326,-27,1
r3kr2/1p2q2p/2p1bpp1/pPnpp3/P3P3/2PP1Q1P/2B1NPP1/RN3RK1 b q - 1 16,O-O-O,324,351,27,1
2kr1r2/1p2q2p/2p1bpp1/pPnpp3/P3P3/2PP1Q1P/2B1NPP1/RN3RK1 w - - 2 17,bxc6,366,354,-12,1
2kr1r2/1p2q2p/2P1bpp1/p1npp3/P3P3/2PP1Q1P/2B1NPP1/RN3RK1 b - - 0 17,bxc6,388,375,-13,1
2kr1r2/4q2p/2p1bpp1/p1npp3/P3P3/2PP1Q1P/2B1NPP1/RN3RK1 w - - 0 18,Ng3,403,240,-163,0
2kr1r2/4q2p/2p1bpp1/p1npp3/P3P3/2PP1QNP/2B2PP1/RN3RK1 b - - 1 18,Bf7,287,466,179,1
2kr1r2/4qb1p/2p2pp1/p1npp3/P3P3/2PP1QNP/2B2PP1/RN3RK1 w - - 2 19,Nd2,452,445,-7,1
2kr1r2/4qb1p/2p2pp1/p1npp3/P3P3/2PP1QNP/2BN1PP1/R4RK1 b - - 3 19,Qa7,439,518,79,1
2kr1r2/q4b1p/2p2pp1/p1npp3/P3P3/2PP1QNP/2BN1PP1/R4RK1 w - - 4 20,Nb3,482,249,-233,0
2kr1r2/q4b1p/2p2pp1/p1npp3/P3P3/1NPP1QNP/2B2PP1/R4RK1 b - - 5 20,dxe4,274,306,32,1
2kr1r2/q4b1p/2p2pp1/p1n1p3/P3p3/1NPP1QNP/2B2PP1/R4RK1 w - - 0 21,dxe4,352,-3,-355,0
2kr1r2/q4b1p/2p2pp1/p1n1p3/P3P3/1NP2QNP/2B2PP1/R4RK1 b - - 0 21,Nxb3,-6,116,122,1
2kr1r2/q4b1p/2p2pp1/p3p3/P3P3/1nP2QNP/2B2PP1/R4RK1 w - - 0 22,Bxb3,110,125,15,1
2kr1r2/q4b1p/2p2pp1/p3p3/P3P3/1BP2QNP/5PP1/R4RK1 b - - 0 22,Bxb3,96,92,-4,1
2kr1r2/q6p/2p2pp1/p3p3/P3P3/1bP2QNP/5PP1/R4RK1 w - - 0 23,Rfb1,109,77,-32,1
2kr1r2/q6p/2p2pp1/p3p3/P3P3/1bP2QNP/5PP1/RR4K1 b - - 1 23,Bc4,72,87,15,1
2kr1r2/q6p/2p2pp1/p3p3/P1b1P3/2P2QNP/5PP1/RR4K1 w - - 2 24,Rd1,120,35,-85,1
2kr1r2/q6p/2p2pp1/p3p3/P1b1P3/2P2QNP/5PP1/R2R2K1 b - - 3 24,Qa6,43,217,174,1
2kr1r2/7p/q1p2pp1/p3p3/P1b1P3/2P2QNP/5PP1/R2R2K1 w - - 4 25,Rxd8+,230,199,-31,1
2kR1r2/7p/q1p2pp1/p3p3/P1b1P3/2P2QNP/5PP1/R5K1 b - - 0 25,Kxd8,193,176,-17,1
3k1r2/7p/q1p2pp1/p3p3/P1b1P3/2P2QNP/5PP1/R5K1 w - - 0 26,Rd1+,192,109,-83,1
3k1r2/7p/q1p2pp1/p3p3/P1b1P3/2P2QNP/5PP1/3R2K1 b - - 1 26,Ke7,119,202,83,1
5r2/4k2p/q1p2pp1/p3p3/P1b1P3/2P2QNP/5PP1/3R2K1 w - - 2 27,Qg4,183,-9,-192,0
5r2/4k2p/q1p2pp1/p3p3/P1b1P1Q1/2P3NP/5PP1/3R2K1 b - - 3 27,Qb6,-9,9999,10008,1
5r2/4k2p/1qp2pp1/p3p3/P1b1P1Q1/2P3NP/5PP1/3R2K1 w - - 4 28,Qd7#,9999,10000,1,1
rnbqkbnr/pppppppp/8/8/8/8/PPPPPPPP/RNBQKBNR w KQkq - 0 1,e4,40,40,0,1
rnbqkbnr/pppppppp/8/8/4P3/8/PPPP1PPP/RNBQKBNR b KQkq - 0 1,d5,36,85,49,1
rnbqkbnr/ppp1pppp/8/3p4/4P3/8/PPPP1PPP/RNBQKBNR w KQkq - 0 2,exd5,65,76,11,1
rnbqkbnr/ppp1pppp/8/3P4/8/8/PPPP1PPP/RNBQKBNR b KQkq - 0 2,Nf6,62,70,8,1
rnbqkb1r/ppp1pppp/5n2/3P4/8/8/PPPP1PPP/RNBQKBNR w KQkq - 1 3,Nc3,72,33,-39,1
rnbqkb1r/ppp1pppp/5n2/3P4/8/2N5/PPPP1PPP/R1BQKBNR b KQkq - 2 3,Nxd5,28,32,4,1
rnbqkb1r/ppp1pppp/8/3n4/8/2N5/PPPP1PPP/R1BQKBNR w KQkq - 0 4,Nxd5,29,-14,-43,1
rnbqkb1r/ppp1pppp/8/3N4/8/8/PPPP1PPP/R1BQKBNR b KQkq - 0 4,Qxd5,-15,-11,4,1
rnb1kb1r/ppp1pppp/8/3q4/8/8/PPPP1PPP/R1BQKBNR w KQkq - 0 5,Nf3,-1,-13,-12,1
rnb1kb1r/ppp1pppp/8/3q4/8/5N2/PPPP1PPP/R1BQKB1R b KQkq - 1 5,Bg4,-23,17,40,1
rn2kb1r/ppp1pppp/8/3q4/6b1/5N2/PPPP1PPP/R1BQKB1R w KQkq - 2 6,Be2,21,12,-9,1
rn2kb1r/ppp1pppp/8/3q4/6b1/5N2/PPPPBPPP/R1BQK2R b KQkq - 3 6,Nc6,11,17,6,1
r3kb1r/ppp1pppp/2n5/3q4/6b1/5N2/PPPPBPPP/R1BQK2R w KQkq - 4 7,h3,22,17,-5,1
r3kb1r/ppp1pppp/2n5/3q4/6b1/5N1P/PPPPBPP1/R1BQK2R b KQkq - 0 7,Bh5,9,33,24,1
r3kb1r/ppp1pppp/2n5/3q3b/8/5N1P/PPPPBPP1/R1BQK2R w KQkq - 1 8,c3,28,-56,-84,1
r3kb1r/ppp1pppp/2n5/3q3b/8/2P2N1P/PP1PBPP1/R1BQK2R b KQkq - 0 8,e5,-36,-27,9,1
r3kb1r/ppp2ppp/2n5/3qp2b/8/2P2N1P/PP1PBPP1/R1BQK2R w KQkq - 0 9,O-O,-25,-94,-69,1
r3kb1r/ppp2ppp/2n5/3qp2b/8/2P2N1P/PP1PBPP1/R1BQ1RK1 b kq - 1 9,O-O-O,-116,-26,90,1
2kr1b1r/ppp2ppp/2n5/3qp2b/8/2P2N1P/PP1PBPP1/R1BQ1RK1 w - - 2 10,Re1,-21,-61,-40,1
2kr1b1r/ppp2ppp/2n5/3qp2b/8/2P2N1P/PP1PBPP1/R1BQR1K1 b - - 3 10,e4,-63,-77,-14,1
2kr1b1r/ppp2ppp/2n5/3q3b/4p3/2P2N1P/PP1PBPP1/R1BQR1K1 w - - 0 11,Nh2,-47,-187,-140,0
2kr1b1r/ppp2ppp/2n5/3q3b/4p3/2P4P/PP1PBPPN/R1BQR1K1 b - - 1 11,Bg6,-215,-124,91,1
2kr1b1r/ppp2ppp/2n3b1/3q4/4p3/2P4P/PP1PBPPN/R1BQR1K1 w - - 2 12,Ng4,-123,-131,-8,1
2kr1b1r/ppp2ppp/2n3b1/3q4/4p1N1/2P4P/PP1PBPP1/R1BQR1K1 b - - 3 12,f5,-145,-108,37,1
2kr1b1r/ppp3pp/2n3b1/3q1p2/4p1N1/2P4P/PP1PBPP1/R1BQR1K1 w - - 0 13,Ne3,-126,-104,22,1
2kr1b1r/ppp3pp/2n3b1/3q1p2/4p3/2P1N2P/PP1PBPP1/R1BQR1K1 b - - 1 13,Qd7,-98,-87,11,1
2kr1b1r/pppq2pp/2n3b1/5p2/4p3/2P1N2P/PP1PBPP1/R1BQR1K1 w - - 2 14,b4,-77,-150,-73,1
2kr1b1r/pppq2pp/2n3b1/5p2/1P2p3/2P1N2P/P2PBPP1/R1BQR1K1 b - - 0 14,Ne5,-164,-118,46,1
2kr1b1r/pppq2pp/6b1/4np2/1P2p3/2P1N2P/P2PBPP1/R1BQR1K1 w - - 1 15,d4,-162,-252,-90,1
2kr1b1r/pppq2pp/6b1/4np2/1P1Pp3/2P1N2P/P3BPP1/R1BQR1K1 b - d3 0 15,Nf7,-284,153,437,1
2kr1b1r/pppq1npp/6b1/5p2/1P1Pp3/2P1N2P/P3BPP1/R1BQR1K1 w - - 1 16,a4,150,150,0,1
2kr1b1r/pppq1npp/6b1/5p2/PP1Pp3/2P1N2P/4BPP1/R1BQR1K1 b - - 0 16,h5,156,168,12,1
2kr1b1r/pppq1np1/6b1/5p1p/PP1Pp3/2P1N2P/4BPP1/R1BQR1K1 w - - 0 17,d5,188,-50,-238,0
2kr1b1r/pppq1np1/6b1/3P1p1p/PP2p3/2P1N2P/4BPP1/R1BQR1K1 b - - 0 17,f4,-52,-45,7,1
2kr1b1r/pppq1np1/6b1/3P3p/PP2pp2/2P1N2P/4BPP1/R1BQR1K1 w - - 0 18,Bb5,-32,-89,-57,1
2kr1b1r/pppq1np1/6b1/1B1P3p/PP2pp2/2P1N2P/5PP1/R1BQR1K1 b - - 1 18,c6,-95,149,244,1
2kr1b1r/pp1q1np1/2p3b1/1B1P3p/PP2pp2/2P1N2P/5PP1/R1BQR1K1 w - - 0 19,dxc6,179,117,-62,1
2kr1b1r/pp1q1np1/2P3b1/1B5p/PP2pp2/2P1N2P/5PP1/R1BQR1K1 b - - 0 19,Qxd1,121,123,2,1
2kr1b1r/pp3np1/2P3b1/1B5p/PP2pp2/2P1N2P/5PP1/R1BqR1K1 w - - 0 20,Nxd1,100,73,-27,1
2kr1b1r/pp3np1/2P3b1/1B5p/PP2pp2/2P4P/5PP1/R1BNR1K1 b - - 0 20,Nd6,94,444,350,1
2kr1b1r/pp4p1/2Pn2b1/1B5p/PP2pp2/2P4P/5PP1/R1BNR1K1 w - - 1 21,cxb7+,350,353,3,1
2kr1b1r/pP4p1/3n2b1/1B5p/PP2pp2/2P4P/5PP1/R1BNR1K1 b - - 0 21,Kxb7,366,395,29,1
3r1b1r/pk4p1/3n2b1/1B5p/PP2pp2/2P4P/5PP1/R1BNR1K1 w - - 0 22,Bxf4,375,371,-4,1
3r1b1r/pk4p1/3n2b1/1B5p/PP2pB2/2P4P/5PP1/R2NR1K1 b - - 0 22,a6,357,412,55,1
3r1b1r/1k4p1/p2n2b1/1B5p/PP2pB2/2P4P/5PP1/R2NR1K1 w - - 0 23,Bxd6,425,214,-211,0
3r1b1r/1k4p1/p2B2b1/1B5p/PP2p3/2P4P/5PP1/R2NR1K1 b - - 0 23,Bxd6,209,219,10,1
3r3r/1k4p1/p2b2b1/1B5p/PP2p3/2P4P/5PP1/R2NR1K1 w - - 0 24,Bc4,217,247,30,1
3r3r/1k4p1/p2b2b1/7p/PPB1p3/2P4P/5PP1/R2NR1K1 b - - 1 24,Be5,217,213,-4,1
3r3r/1k4p1/p5b1/4b2p/PPB1p3/2P4P/5PP1/R2NR1K1 w - - 2 25,Rc1,227,222,-5,1
3r3r/1k4p1/p5b1/4b2p/PPB1p3/2P4P/5PP1/2RNR1K1 b - - 3 25,Rd2,219,213,-6,1
7r/1k4p1/p5b1/4b2p/PPB1p3/2P4P/3r1PP1/2RNR1K1 w - - 4 26,Ne3,210,209,-1,1
7r/1k4p1/p5b1/4b2p/PPB1p3/2P1N2P/3r1PP1/2R1R1K1 b - - 5 26,Rf8,232,253,21,1
5r2/1k4p1/p5b1/4b2p/PPB1p3/2P1N2P/3r1PP1/2R1R1K1 w - - 6 27,Re2,242,250,8,1
5r2/1k4p1/p5b1/4b2p/PPB1p3/2P1N2P/3rRPP1/2R3K1 b - - 7 27,Rdd8,262,296,34,1
3r1r2/1k4p1/p5b1/4b2p/PPB1p3/2P1N2P/4RPP1/2R3K1 w - - 8 28,Bd5+,296,330,34,1
3r1r2/1k4p1/p5b1/3Bb2p/PP2p3/2P1N2P/4RPP1/2R3K1 b - - 9 28,Ka7,309,312,3,1
3r1r2/k5p1/p5b1/3Bb2p/PP2p3/2P1N2P/4RPP1/2R3K1 w - - 10 29,c4,322,302,-20,1
3r1r2/k5p1/p5b1/3Bb2p/PPP1p3/4N2P/4RPP1/2R3K1 b - - 0 29,Bf4,310,371,61,1
3r1r2/k5p1/p5b1/3B3p/PPP1pb2/4N2P/4RPP1/2R3K1 w - - 1 30,b5,347,320,-27,1
3r1r2/k5p1/p5b1/1P1B3p/P1P1pb2/4N2P/4RPP1/2R3K1 b - - 0 30,axb5,329,458,129,1
3r1r2/k5p1/6b1/1p1B3p/P1P1pb2/4N2P/4RPP1/2R3K1 w - - 0 31,axb5,432,454,22,1
3r1r2/k5p1/6b1/1P1B3p/2P1pb2/4N2P/4RPP1/2R3K1 b - - 0 31,Bh7,460,541,81,1
3r1r2/k5pb/8/1P1B3p/2P1pb2/4N2P/4RPP1/2R3K1 w - - 1 32,g3,512,463,-49,1
3r1r2/k5pb/8/1P1B3p/2P1pb2/4N1PP/4RP2/2R3K1 b - - 0 32,Be5,459,435,-24,1
3r1r2/k5pb/8/1P1Bb2p/2P1p3/4N1PP/4RP2/2R3K1 w - - 1 33,Nc2,442,366,-76,1
3r1r2/k5pb/8/1P1Bb2p/2P1p3/6PP/2N1RP2/2R3K1 b - - 2 33,Bb2,365,463,98,1
3r1r2/k5pb/8/1P1B3p/2P1p3/6PP/1bN1RP2/2R3K1 w - - 3 34,Rb1,476,431,-45,1
3r1r2/k5pb/8/1P1B3p/2P1p3/6PP/1bN1RP2/1R4K1 b - - 4 34,Bc3,491,449,-42,1
3r1r2/k5pb/8/1P1B3p/2P1p3/2b3PP/2N1RP2/1R4K1 w - - 5 35,Rb3,477,485,8,1
3r1r2/k5pb/8/1P1B3p/2P1p3/1Rb3PP/2N1RP2/6K1 b - - 6 35,Bf6,452,508,56,1
3r1r2/k5pb/5b2/1P1B3p/2P1p3/1R4PP/2N1RP2/6K1 w - - 7 36,Nb4,479,397,-82,1
3r1r2/k5pb/5b2/1P1B3p/1NP1p3/1R4PP/4RP2/6K1 b - - 8 36,Rde8,395,692,297,1
4rr2/k5pb/5b2/1P1B3p/1NP1p3/1R4PP/4RP2/6K1 w - - 9 37,Ra3+,684,515,-169,0
4rr2/k5pb/5b2/1P1B3p/1NP1p3/R5PP/4RP2/6K1 b - - 10 37,Kb8,473,750,277,1
1k2rr2/6pb/5b2/1P1B3p/1NP1p3/R5PP/4RP2/6K1 w - - 11 38,Nc6+,748,596,-152,0
1k2rr2/6pb/2N2b2/1P1B3p/2P1p3/R5PP/4RP2/6K1 b - - 12 38,Kc7,620,774,154,1
4rr2/2k3pb/2N2b2/1P1B3p/2P1p3/R5PP/4RP2/6K1 w - - 13 39,Ra7+,844,414,-430,0
4rr2/R1k3pb/2N2b2/1P1B3p/2P1p3/6PP/4RP2/6K1 b - - 14 39,Kb6,365,432,67,1
4rr2/R5pb/1kN2b2/1P1B3p/2P1p3/6PP/4RP2/6K1 w - - 15 40,Ra6+,407,452,45,1
4rr2/6pb/RkN2b2/1P1B3p/2P1p3/6PP/4RP2/6K1 b - - 16 40,Kc5,456,432,-24,1
4rr2/6pb/R1N2b2/1PkB3p/2P1p3/6PP/4RP2/6K1 w - - 17 41,b6,453,396,-57,1
4rr2/6pb/RPN2b2/2kB3p/2P1p3/6PP/4RP2/6K1 b - - 0 41,g5,402,472,70,1
4rr2/7b/RPN2b2/2kB2pp/2P1p3/6PP/4RP2/6K1 w - - 0 42,b7,492,487,-5,1
4rr2/1P5b/R1N2b2/2kB2pp/2P1p3/6PP/4RP2/6K1 b - - 0 42,e3,473,589,116,1
4rr2/1P5b/R1N2b2/2kB2pp/2P5/4p1PP/4RP2/6K1 w - - 0 43,b8=Q,622,429,-193,0
1Q2rr2/7b/R1N2b2/2kB2pp/2P5/4p1PP/4RP2/6K1 b - - 0 43,Rxb8,411,463,52,1
1r3r2/7b/R1N2b2/2kB2pp/2P5/4p1PP/4RP2/6K1 w - - 0 44,Nxb8,421,447,26,1
1N3r2/7b/R4b2/2kB2pp/2P5/4p1PP/4RP2/6K1 b - - 0 44,exf2+,463,465,2,1
1N3r2/7b/R4b2/2kB2pp/2P5/6PP/4Rp2/6K1 w - - 0 45,Rxf2,476,475,-1,1
1N3r2/7b/R4b2/2kB2pp/2P5/6PP/5R2/6K1 b - - 0 45,Bd4,479,621,142,1
1N3r2/7b/R7/2kB2pp/2Pb4/6PP/5R2/6K1 w - - 1 46,Nd7+,616,639,23,1
5r2/3N3b/R7/2kB2pp/2Pb4/6PP/5R2/6K1 b - - 2 46,Kb4,664,649,-15,1
5r2/3N3b/R7/3B2pp/1kPb4/6PP/5R2/6K1 w - - 3 47,Nxf8,656,633,-23,1
5N2/7b/R7/3B2pp/1kPb4/6PP/5R2/6K1 b - - 0 47,Bxf2+,617,688,71,1
5N2/7b/R7/3B2pp/1kP5/6PP/5b2/6K1 w - - 0 48,Kxf2,700,705,5,1
5N2/7b/R7/3B2pp/1kP5/6PP/5K2/8 b - - 0 48,h4,679,787,108,1
5N2/7b/R7/3B2p1/1kP4p/6PP/5K2/8 w - - 0 49,Nxh7,796,848,52,1
8/7N/R7/3B2p1/1kP4p/6PP/5K2/8 b - - 0 49,hxg3+,868,897,29,1
8/7N/R7/3B2p1/1kP5/6pP/5K2/8 w - - 0 50,Kxg3,903,911,8,1
8/7N/R7/3B2p1/1kP5/6KP/8/8 b - - 0 50,Kc5,979,978,-1,1
8/7N/R7/2kB2p1/2P5/6KP/8/8 w - - 1 51,Rc6+,969,988,19,1
8/7N/2R5/2kB2p1/2P5/6KP/8/8 b - - 2 51,Kd4,984,982,-2,1
8/7N/2R5/3B2p1/2Pk4/6KP/8/8 w - - 3 52,Kg4,980,982,2,1
8/7N/2R5/3B2p1/2Pk2K1/7P/8/8 b - - 4 52,Ke5,992,992,0,1
8/7N/2R5/3Bk1p1/2P3K1/7P/8/8 w - - 5 53,Kxg5,974,992,18,1
8/7N/2R5/3Bk1K1/2P5/7P/8/8 b - - 0 53,Kd4,1000,1003,3,1
8/7N/2R5/3B2K1/2Pk4/7P/8/8 w - - 1 54,Re6,1006,997,-9,1
8/7N/4R3/3B2K1/2Pk4/7P/8/8 b - - 2 54,Kc5,1021,1032,11,1
8/7N/4R3/2kB2K1/2P5/7P/8/8 w - - 3 55,Kf4,1042,1025,-17,1
8/7N/4R3/2kB4/2P2K2/7P/8/8 b - - 4 55,Kd4,1037,1043,6,1
8/7N/4R3/3B4/2Pk1K2/7P/8/8 w - - 5 56,Re4+,1053,999,-54,1
8/7N/8/3B4/2PkRK2/7P/8/8 b - - 6 56,Kc5,1031,1061,30,1
8/7N/8/2kB4/2P1RK2/7P/8/8 w - - 7 57,Ke3,1065,912,-153,0
8/7N/8/2kB4/2P1R3/4K2P/8/8 b - - 8 57,Kb6,1003,1017,14,1
8/7N/1k6/3B4/2P1R3/4K2P/8/8 w - - 9 58,Kd4,999,924,-75,1
8/7N/1k6/3B4/2PKR3/7P/8/8 b - - 10 58,Kc7,989,1006,17,1
8/2k4N/8/3B4/2PKR3/7P/8/8 w - - 11 59,Re6,1073,1098,25,1
8/2k4N/4R3/3B4/2PK4/7P/8/8 b - - 12 59,Kd7,9990,9990,0,1
8/3k3N/4R3/3B4/2PK4/7P/8/8 w - - 13 60,Nf6+,9990,9989,-1,1
8/3k4/4RN2/3B4/2PK4/7P/8/8 b - - 14 60,Kc7,9989,9989,0,1
8/2k5/4RN2/3B4/2PK4/7P/8/8 w - - 15 61,Kc5,1126,9991,8865,1
8/2k5/4RN2/2KB4/2P5/7P/8/8 b - - 16 61,Kd8,9991,9998,7,1
3k4/8/4RN2/2KB4/2P5/7P/8/8 w - - 17 62,Kc6,9998,9999,1,1
rnbqkbnr/pppppppp/8/8/8/8/PPPPPPPP/RNBQKBNR w KQkq - 0 1,e4,38,29,-9,1
rnbqkbnr/pppppppp/8/8/4P3/8/PPPP1PPP/RNBQKBNR b KQkq - 0 1,d5,40,76,36,1
rnbqkbnr/ppp1pppp/8/3p4/4P3/8/PPPP1PPP/RNBQKBNR w KQkq - 0 2,exd5,77,76,-1,1
rnbqkbnr/ppp1pppp/8/3P4/8/8/PPPP1PPP/RNBQKBNR b KQkq - 0 2,Qxd5,68,87,19,1
rnb1kbnr/ppp1pppp/8/3q4/8/8/PPPP1PPP/RNBQKBNR w KQkq - 0 3,d4,73,18,-55,1
rnb1kbnr/ppp1pppp/8/3q4/3P4/8/PPP2PPP/RNBQKBNR b KQkq - 0 3,Qe4+,27,151,124,1
rnb1kbnr/ppp1pppp/8/8/3Pq3/8/PPP2PPP/RNBQKBNR w KQkq - 1 4,Ne2,133,105,-28,1
rnb1kbnr/ppp1pppp/8/8/3Pq3/8/PPP1NPPP/RNBQKB1R b KQkq - 2 4,b6,91,141,50,1
rnb1kbnr/p1p1pppp/1p6/8/3Pq3/8/PPP1NPPP/RNBQKB1R w KQkq - 0 5,Nc3,149,162,13,1
rnb1kbnr/p1p1pppp/1p6/8/3Pq3/2N5/PPP1NPPP/R1BQKB1R b KQkq - 1 5,Qe6,152,233,81,1
rnb1kbnr/p1p1pppp/1p2q3/8/3P4/2N5/PPP1NPPP/R1BQKB1R w KQkq - 2 6,Nb5,266,109,-157,0
rnb1kbnr/p1p1pppp/1p2q3/1N6/3P4/8/PPP1NPPP/R1BQKB1R b KQkq - 3 6,Kd7,95,332,237,1
rnb2bnr/p1pkpppp/1p2q3/1N6/3P4/8/PPP1NPPP/R1BQKB1R w KQ - 4 7,Bf4,327,320,-7,1
rnb2bnr/p1pkpppp/1p2q3/1N6/3P1B2/8/PPP1NPPP/R2QKB1R b KQ - 5 7,Ba6,329,490,161,1
rn3bnr/p1pkpppp/bp2q3/1N6/3P1B2/8/PPP1NPPP/R2QKB1R w KQ - 6 8,Nxc7,510,499,-11,1
rn3bnr/p1Nkpppp/bp2q3/8/3P1B2/8/PPP1NPPP/R2QKB1R b KQ - 0 8,Bxe2,535,556,21,1
rn3bnr/p1Nkpppp/1p2q3/8/3P1B2/8/PPP1bPPP/R2QKB1R w KQ - 0 9,Bxe2,547,558,11,1
rn3bnr/p1Nkpppp/1p2q3/8/3P1B2/8/PPP1BPPP/R2QK2R b KQ - 0 9,g5,575,836,261,1
rn3bnr/p1Nkpp1p/1p2q3/6p1/3P1B2/8/PPP1BPPP/R2QK2R w KQ - 0 10,Nxe6,854,915,61,1
rn3bnr/p2kpp1p/1p2N3/6p1/3P1B2/8/PPP1BPPP/R2QK2R b KQ - 0 10,Kxe6,882,963,81,1
rn3bnr/p3pp1p/1p2k3/6p1/3P1B2/8/PPP1BPPP/R2QK2R w KQ - 0 11,Bxg5,941,922,-19,1
rn3bnr/p3pp1p/1p2k3/6B1/3P4/8/PPP1BPPP/R2QK2R b KQ - 0 11,f6,929,945,16,1
rn3bnr/p3p2p/1p2kp2/6B1/3P4/8/PPP1BPPP/R2QK2R w KQ - 0 12,Bf3,970,930,-40,1
rn3bnr/p3p2p/1p2kp2/6B1/3P4/5B2/PPP2PPP/R2QK2R b KQ - 1 12,Bh6,841,954,113,1
rn4nr/p3p2p/1p2kp1b/6B1/3P4/5B2/PPP2PPP/R2QK2R w KQ - 2 13,Bxh6,957,927,-30,1
rn4nr/p3p2p/1p2kp1B/8/3P4/5B2/PPP2PPP/R2QK2R b KQ - 0 13,Nxh6,971,920,-51,1
rn5r/p3p2p/1p2kp1n/8/3P4/5B2/PPP2PPP/R2QK2R w KQ - 0 14,Bxa8,943,934,-9,1
Bn5r/p3p2p/1p2kp1n/8/3P4/8/PPP2PPP/R2QK2R b KQ - 0 14,Nc6,942,1035,93,1
B6r/p3p2p/1pn1kp1n/8/3P4/8/PPP2PPP/R2QK2R w KQ - 1 15,Bxc6,1033,1008,-25,1
7r/p3p2p/1pB1kp1n/8/3P4/8/PPP2PPP/R2QK2R b KQ - 0 15,Rd8,1036,1079,43,1
rnbqkbnr/pppppppp/8/8/8/8/PPPPPPPP/RNBQKBNR w KQkq - 0 1,e4,35,42,7,1
rnbqkbnr/pppppppp/8/8/4P3/8/PPPP1PPP/RNBQKBNR b KQkq - 0 1,e5,47,31,-16,1
rnbqkbnr/pppp1ppp/8/4p3/4P3/8/PPPP1PPP/RNBQKBNR w KQkq - 0 2,d3,107,-22,-129,0
rnbqkbnr/pppp1ppp/8/4p3/4P3/3P4/PPP2PPP/RNBQKBNR b KQkq - 0 2,Bc5,-23,17,40,1
rnbqk1nr/pppp1ppp/8/2b1p3/4P3/3P4/PPP2PPP/RNBQKBNR w KQkq - 1 3,Be3,7,-16,-23,1
rnbqk1nr/pppp1ppp/8/2b1p3/4P3/3PB3/PPP2PPP/RN1QKBNR b KQkq - 2 3,Bb6,-11,25,36,1
rnbqk1nr/pppp1ppp/1b6/4p3/4P3/3PB3/PPP2PPP/RN1QKBNR w KQkq - 3 4,Bxb6,22,25,3,1
rnbqk1nr/pppp1ppp/1B6/4p3/4P3/3P4/PPP2PPP/RN1QKBNR b KQkq - 0 4,axb6,10,3,-7,1
rnbqk1nr/1ppp1ppp/1p6/4p3/4P3/3P4/PPP2PPP/RN1QKBNR w KQkq - 0 5,Nc3,13,5,-8,1
rnbqk1nr/1ppp1ppp/1p6/4p3/4P3/2NP4/PPP2PPP/R2QKBNR b KQkq - 1 5,d6,-4,25,29,1
rnbqk1nr/1pp2ppp/1p1p4/4p3/4P3/2NP4/PPP2PPP/R2QKBNR w KQkq - 0 6,Nd5,31,-72,-103,0
rnbqk1nr/1pp2ppp/1p1p4/3Np3/4P3/3P4/PPP2PPP/R2QKBNR b KQkq - 1 6,c6,-45,-24,21,1
rnbqk1nr/1p3ppp/1ppp4/3Np3/4P3/3P4/PPP2PPP/R2QKBNR w KQkq - 0 7,Ne3,-23,-37,-14,1
rnbqk1nr/1p3ppp/1ppp4/4p3/4P3/3PN3/PPP2PPP/R2QKBNR b KQkq - 1 7,Nf6,-53,-30,23,1
rnbqk2r/1p3ppp/1ppp1n2/4p3/4P3/3PN3/PPP2PPP/R2QKBNR w KQkq - 2 8,f3,-45,-110,-65,1
rnbqk2r/1p3ppp/1ppp1n2/4p3/4P3/3PNP2/PPP3PP/R2QKBNR b KQkq - 0 8,O-O,-64,-45,19,1
rnbq1rk1/1p3ppp/1ppp1n2/4p3/4P3/3PNP2/PPP3PP/R2QKBNR w KQ - 1 9,g4,-45,-156,-111,0
rnbq1rk1/1p3ppp/1ppp1n2/4p3/4P1P1/3PNP2/PPP4P/R2QKBNR b KQ - 0 9,d5,-137,-137,0,1
rnbq1rk1/1p3ppp/1pp2n2/3pp3/4P1P1/3PNP2/PPP4P/R2QKBNR w KQ - 0 10,h3,-134,-170,-36,1
rnbq1rk1/1p3ppp/1pp2n2/3pp3/4P1P1/3PNP1P/PPP5/R2QKBNR b KQ - 0 10,d4,-199,-103,96,1
rnbq1rk1/1p3ppp/1pp2n2/4p3/3pP1P1/3PNP1P/PPP5/R2QKBNR w KQ - 0 11,Nc4,-108,-164,-56,1
rnbq1rk1/1p3ppp/1pp2n2/4p3/2NpP1P1/3P1P1P/PPP5/R2QKBNR b KQ - 1 11,Qc7,-187,-119,68,1
rnb2rk1/1pq2ppp/1pp2n2/4p3/2NpP1P1/3P1P1P/PPP5/R2QKBNR w KQ - 2 12,Ne2,-113,-126,-13,1
rnb2rk1/1pq2ppp/1pp2n2/4p3/2NpP1P1/3P1P1P/PPP1N3/R2QKB1R b KQ - 3 12,b5,-135,-110,25,1
rnb2rk1/1pq2ppp/2p2n2/1p2p3/2NpP1P1/3P1P1P/PPP1N3/R2QKB1R w KQ - 0 13,Nd2,-97,-103,-6,1
rnb2rk1/1pq2ppp/2p2n2/1p2p3/3pP1P1/3P1P1P/PPPNN3/R2QKB1R b KQ - 1 13,c5,-120,-141,-21,1
rnb2rk1/1pq2ppp/5n2/1pp1p3/3pP1P1/3P1P1P/PPPNN3/R2QKB1R w KQ - 0 14,Ng3,-127,-235,-108,0
rnb2rk1/1pq2ppp/5n2/1pp1p3/3pP1P1/3P1PNP/PPPN4/R2QKB1R b KQ - 1 14,Be6,-228,-200,28,1
rn3rk1/1pq2ppp/4bn2/1pp1p3/3pP1P1/3P1PNP/PPPN4/R2QKB1R w KQ - 2 15,Nf5,-230,-292,-62,1
rn3rk1/1pq2ppp/4bn2/1pp1pN2/3pP1P1/3P1P1P/PPPN4/R2QKB1R b KQ - 3 15,c4,-297,-300,-3,1
rn3rk1/1pq2ppp/4bn2/1p2pN2/2ppP1P1/3P1P1P/PPPN4/R2QKB1R w KQ - 0 16,h4,-287,-331,-44,1
rn3rk1/1pq2ppp/4bn2/1p2pN2/2ppP1PP/3P1P2/PPPN4/R2QKB1R b KQ - 0 16,cxd3,-314,-162,152,1
rn3rk1/1pq2ppp/4bn2/1p2pN2/3pP1PP/3p1P2/PPPN4/R2QKB1R w KQ - 0 17,Bxd3,-150,-158,-8,1
rn3rk1/1pq2ppp/4bn2/1p2pN2/3pP1PP/3B1P2/PPPN4/R2QK2R b KQ - 0 17,Rxa2,-172,-15,157,1
1n3rk1/1pq2ppp/4bn2/1p2pN2/3pP1PP/3B1P2/rPPN4/R2QK2R w KQ - 0 18,Rxa2,-2,-7,-5,1
1n3rk1/1pq2ppp/4bn2/1p2pN2/3pP1PP/3B1P2/RPPN4/3QK2R b K - 0 18,Bxa2,1,5,4,1
1n3rk1/1pq2ppp/5n2/1p2pN2/3pP1PP/3B1P2/bPPN4/3QK2R w K - 0 19,b3,7,5,-2,1
1n3rk1/1pq2ppp/5n2/1p2pN2/3pP1PP/1P1B1P2/b1PN4/3QK2R b K - 0 19,Qa5,2,86,84,1
1n3rk1/1p3ppp/5n2/qp2pN2/3pP1PP/1P1B1P2/b1PN4/3QK2R w K - 1 20,Qc1,78,-76,-154,0
1n3rk1/1p3ppp/5n2/qp2pN2/3pP1PP/1P1B1P2/b1PN4/2Q1K2R b K - 2 20,Nc6,-37,-31,6,1
5rk1/1p3ppp/2n2n2/qp2pN2/3pP1PP/1P1B1P2/b1PN4/2Q1K2R w K - 3 21,Ke2,-18,-41,-23,1
5rk1/1p3ppp/2n2n2/qp2pN2/3pP1PP/1P1B1P2/b1PNK3/2Q4R b - - 4 21,Nb4,-74,15,89,1
5rk1/1p3ppp/5n2/qp2pN2/1n1pP1PP/1P1B1P2/b1PNK3/2Q4R w - - 5 22,Qb2,13,-51,-64,1
5rk1/1p3ppp/5n2/qp2pN2/1n1pP1PP/1P1B1P2/bQPNK3/7R b - - 6 22,Rc8,-37,264,301,1
2r3k1/1p3ppp/5n2/qp2pN2/1n1pP1PP/1P1B1P2/bQPNK3/7R w - - 7 23,Ne7+,289,287,-2,1
2r3k1/1p2Nppp/5n2/qp2p3/1n1pP1PP/1P1B1P2/bQPNK3/7R b - - 8 23,Kh8,298,315,17,1
2r4k/1p2Nppp/5n2/qp2p3/1n1pP1PP/1P1B1P2/bQPNK3/7R w - - 9 24,Nxc8,337,341,4,1
2N4k/1p3ppp/5n2/qp2p3/1n1pP1PP/1P1B1P2/bQPNK3/7R b - - 0 24,Nxd3,333,421,88,1
2N4k/1p3ppp/5n2/qp2p3/3pP1PP/1P1n1P2/bQPNK3/7R w - - 0 25,Kxd3,384,340,-44,1
2N4k/1p3ppp/5n2/qp2p3/3pP1PP/1P1K1P2/bQPN4/7R b - - 0 25,Qc7,352,419,67,1
2N4k/1pq2ppp/5n2/1p2p3/3pP1PP/1P1K1P2/bQPN4/7R w - - 1 26,Na7,411,372,-39,1
7k/Npq2ppp/5n2/1p2p3/3pP1PP/1P1K1P2/bQPN4/7R b - - 2 26,Qb6,377,406,29,1
7k/Np3ppp/1q3n2/1p2p3/3pP1PP/1P1K1P2/bQPN4/7R w - - 3 27,Qxa2,428,393,-35,1
7k/Np3ppp/1q3n2/1p2p3/3pP1PP/1P1K1P2/Q1PN4/7R b - - 0 27,Qc5,429,483,54,1
7k/Np3ppp/5n2/1pq1p3/3pP1PP/1P1K1P2/Q1PN4/7R w - - 1 28,Qa5,463,452,-11,1
7k/Np3ppp/5n2/Qpq1p3/3pP1PP/1P1K1P2/2PN4/7R b - - 2 28,h6,452,497,45,1
7k/Np3pp1/5n1p/Qpq1p3/3pP1PP/1P1K1P2/2PN4/7R w - - 0 29,Nb1,484,415,-69,1
7k/Np3pp1/5n1p/Qpq1p3/3pP1PP/1P1K1P2/2P5/1N5R b - - 1 29,b6,430,514,84,1
7k/N4pp1/1p3n1p/Qpq1p3/3pP1PP/1P1K1P2/2P5/1N5R w - - 0 30,Qa3,556,451,-105,0
7k/N4pp1/1p3n1p/1pq1p3/3pP1PP/QP1K1P2/2P5/1N5R b - - 1 30,b4,448,503,55,1
7k/N4pp1/1p3n1p/2q1p3/1p1pP1PP/QP1K1P2/2P5/1N5R w - - 0 31,Qa6,523,522,-1,1
7k/N4pp1/Qp3n1p/2q1p3/1p1pP1PP/1P1K1P2/2P5/1N5R b - - 1 31,Kh7,505,554,49,1
8/N4ppk/Qp3n1p/2q1p3/1p1pP1PP/1P1K1P2/2P5/1N5R w - - 2 32,Qb5,548,470,-78,1
8/N4ppk/1p3n1p/1Qq1p3/1p1pP1PP/1P1K1P2/2P5/1N5R b - - 3 32,Qd6,509,497,-12,1
8/N4ppk/1p1q1n1p/1Q2p3/1p1pP1PP/1P1K1P2/2P5/1N5R w - - 4 33,Qc6,504,524,20,1
8/N4ppk/1pQq1n1p/4p3/1p1pP1PP/1P1K1P2/2P5/1N5R b - - 5 33,Qe7,498,523,25,1
8/N3qppk/1pQ2n1p/4p3/1p1pP1PP/1P1K1P2/2P5/1N5R w - - 6 34,Nb5,503,454,-49,1
8/4qppk/1pQ2n1p/1N2p3/1p1pP1PP/1P1K1P2/2P5/1N5R b - - 7 34,Nd7,408,409,1,1
8/3nqppk/1pQ4p/1N2p3/1p1pP1PP/1P1K1P2/2P5/1N5R w - - 8 35,Qd6,451,435,-16,1
8/3nqppk/1p1Q3p/1N2p3/1p1pP1PP/1P1K1P2/2P5/1N5R b - - 9 35,Nc5+,476,492,16,1
8/4qppk/1p1Q3p/1Nn1p3/1p1pP1PP/1P1K1P2/2P5/1N5R w - - 10 36,Kd2,496,486,-10,1
8/4qppk/1p1Q3p/1Nn1p3/1p1pP1PP/1P3P2/2PK4/1N5R b - - 11 36,Qe8,460,549,89,1
4q3/5ppk/1p1Q3p/1Nn1p3/1p1pP1PP/1P3P2/2PK4/1N5R w - - 12 37,Nc7,557,467,-90,1
4q3/2N2ppk/1p1Q3p/2n1p3/1p1pP1PP/1P3P2/2PK4/1N5R b - - 13 37,Qc8,485,514,29,1
2q5/2N2ppk/1p1Q3p/2n1p3/1p1pP1PP/1P3P2/2PK4/1N5R w - - 14 38,Qxb6,536,549,13,1
2q5/2N2ppk/1Q5p/2n1p3/1p1pP1PP/1P3P2/2PK4/1N5R b - - 0 38,Nd7,560,541,-19,1
2q5/2Nn1ppk/1Q5p/4p3/1p1pP1PP/1P3P2/2PK4/1N5R w - - 1 39,Qc6,549,595,46,1
2q5/2Nn1ppk/2Q4p/4p3/1p1pP1PP/1P3P2/2PK4/1N5R b - - 2 39,Nb8,576,625,49,1
1nq5/2N2ppk/2Q4p/4p3/1p1pP1PP/1P3P2/2PK4/1N5R w - - 3 40,Qc4,615,615,0,1
1nq5/2N2ppk/7p/4p3/1pQpP1PP/1P3P2/2PK4/1N5R b - - 4 40,Nd7,597,636,39,1
2q5/2Nn1ppk/7p/4p3/1pQpP1PP/1P3P2/2PK4/1N5R w - - 5 41,Nd5,626,658,32,1
2q5/3n1ppk/7p/3Np3/1pQpP1PP/1P3P2/2PK4/1N5R b - - 6 41,Qb8,673,685,12,1
1q6/3n1ppk/7p/3Np3/1pQpP1PP/1P3P2/2PK4/1N5R w - - 7 42,Ne7,685,609,-76,1
1q6/3nNppk/7p/4p3/1pQpP1PP/1P3P2/2PK4/1N5R b - - 8 42,Qb6,647,820,173,1
8/3nNppk/1q5p/4p3/1pQpP1PP/1P3P2/2PK4/1N5R w - - 9 43,Qxf7,801,783,-18,1
8/3nNQpk/1q5p/4p3/1p1pP1PP/1P3P2/2PK4/1N5R b - - 0 43,Qb8,748,897,149,1
1q6/3nNQpk/7p/4p3/1p1pP1PP/1P3P2/2PK4/1N5R w - - 1 44,h5,897,693,-204,0
1q6/3nNQpk/7p/4p2P/1p1pP1P1/1P3P2/2PK4/1N5R b - - 0 44,Nc5,702,749,47,1
1q6/4NQpk/7p/2n1p2P/1p1pP1P1/1P3P2/2PK4/1N5R w - - 1 45,Qf5+,757,787,30,1
1q6/4N1pk/7p/2n1pQ1P/1p1pP1P1/1P3P2/2PK4/1N5R b - - 2 45,Kh8,735,774,39,1
1q5k/4N1p1/7p/2n1pQ1P/1p1pP1P1/1P3P2/2PK4/1N5R w - - 3 46,Ng6+,773,771,-2,1
1q5k/6p1/6Np/2n1pQ1P/1p1pP1P1/1P3P2/2PK4/1N5R b - - 4 46,Kg8,785,780,-5,1
1q4k1/6p1/6Np/2n1pQ1P/1p1pP1P1/1P3P2/2PK4/1N5R w - - 5 47,Nxe5,778,598,-180,0
1q4k1/6p1/7p/2n1NQ1P/1p1pP1P1/1P3P2/2PK4/1N5R b - - 0 47,Qb6,595,829,234,1
6k1/6p1/1q5p/2n1NQ1P/1p1pP1P1/1P3P2/2PK4/1N5R w - - 1 48,Qf7+,853,836,-17,1
6k1/5Qp1/1q5p/2n1N2P/1p1pP1P1/1P3P2/2PK4/1N5R b - - 2 48,Kh7,849,846,-3,1
8/5Qpk/1q5p/2n1N2P/1p1pP1P1/1P3P2/2PK4/1N5R w - - 3 49,Qg6+,854,846,-8,1
8/6pk/1q4Qp/2n1N2P/1p1pP1P1/1P3P2/2PK4/1N5R b - - 4 49,Kg8,845,1044,199,1
6k1/6p1/1q4Qp/2n1N2P/1p1pP1P1/1P3P2/2PK4/1N5R w - - 5 50,Qxb6,1107,1087,-20,1
rnbqkbnr/pppppppp/8/8/8/8/PPPPPPPP/RNBQKBNR w KQkq - 0 1,Nf3,40,19,-21,1
rnbqkbnr/pppppppp/8/8/8/5N2/PPPPPPPP/RNBQKB1R b KQkq - 1 1,d5,25,25,0,1
rnbqkbnr/ppp1pppp/8/3p4/8/5N2/PPPPPPPP/RNBQKB1R w KQkq - 0 2,d4,27,24,-3,1
rnbqkbnr/ppp1pppp/8/3p4/3P4/5N2/PPP1PPPP/RNBQKB1R b KQkq - 0 2,c5,27,29,2,1
rnbqkbnr/pp2pppp/8/2pp4/3P4/5N2/PPP1PPPP/RNBQKB1R w KQkq - 0 3,Bf4,37,15,-22,1
rnbqkbnr/pp2pppp/8/2pp4/3P1B2/5N2/PPP1PPPP/RN1QKB1R b KQkq - 1 3,e6,13,11,-2,1
rnbqkbnr/pp3ppp/4p3/2pp4/3P1B2/5N2/PPP1PPPP/RN1QKB1R w KQkq - 0 4,Bxb8,22,-48,-70,1
rBbqkbnr/pp3ppp/4p3/2pp4/3P4/5N2/PPP1PPPP/RN1QKB1R b KQkq - 0 4,Rxb8,-50,-52,-2,1
1rbqkbnr/pp3ppp/4p3/2pp4/3P4/5N2/PPP1PPPP/RN1QKB1R w KQk - 0 5,e3,-49,-61,-12,1
1rbqkbnr/pp3ppp/4p3/2pp4/3P4/4PN2/PPP2PPP/RN1QKB1R b KQk - 0 5,Nf6,-47,-48,-1,1
1rbqkb1r/pp3ppp/4pn2/2pp4/3P4/4PN2/PPP2PPP/RN1QKB1R w KQk - 1 6,Bb5+,-42,-45,-3,1
1rbqkb1r/pp3ppp/4pn2/1Bpp4/3P4/4PN2/PPP2PPP/RN1QK2R b KQk - 2 6,Bd7,-47,-41,6,1
1r1qkb1r/pp1b1ppp/4pn2/1Bpp4/3P4/4PN2/PPP2PPP/RN1QK2R w KQk - 3 7,Bxd7+,-37,-38,-1,1
1r1qkb1r/pp1B1ppp/4pn2/2pp4/3P4/4PN2/PPP2PPP/RN1QK2R b KQk - 0 7,Qxd7,-43,-43,0,1
1r2kb1r/pp1q1ppp/4pn2/2pp4/3P4/4PN2/PPP2PPP/RN1QK2R w KQk - 0 8,Nc3,-40,-81,-41,1
1r2kb1r/pp1q1ppp/4pn2/2pp4/3P4/2N1PN2/PPP2PPP/R2QK2R b KQk - 1 8,Bd6,-88,-77,11,1
1r2k2r/pp1q1ppp/3bpn2/2pp4/3P4/2N1PN2/PPP2PPP/R2QK2R w KQk - 2 9,Qe2,-63,-61,2,1
1r2k2r/pp1q1ppp/3bpn2/2pp4/3P4/2N1PN2/PPP1QPPP/R3K2R b KQk - 3 9,O-O,-145,-64,81,1
1r3rk1/pp1q1ppp/3bpn2/2pp4/3P4/2N1PN2/PPP1QPPP/R3K2R w KQ - 4 10,h3,-63,-188,-125,0
1r3rk1/pp1q1ppp/3bpn2/2pp4/3P4/2N1PN1P/PPP1QPP1/R3K2R b KQ - 0 10,c4,-187,-73,114,1
1r3rk1/pp1q1ppp/3bpn2/3p4/2pP4/2N1PN1P/PPP1QPP1/R3K2R w KQ - 0 11,g4,-71,-129,-58,1
1r3rk1/pp1q1ppp/3bpn2/3p4/2pP2P1/2N1PN1P/PPP1QP2/R3K2R b KQ - 0 11,b5,-141,-123,18,1
1r3rk1/p2q1ppp/3bpn2/1p1p4/2pP2P1/2N1PN1P/PPP1QP2/R3K2R w KQ - 0 12,g5,-129,-134,-5,1
1r3rk1/p2q1ppp/3bpn2/1p1p2P1/2pP4/2N1PN1P/PPP1QP2/R3K2R b KQ - 0 12,Ne8,-150,-117,33,1
1r2nrk1/p2q1ppp/3bp3/1p1p2P1/2pP4/2N1PN1P/PPP1QP2/R3K2R w KQ - 1 13,h4,-155,-196,-41,1
1r2nrk1/p2q1ppp/3bp3/1p1p2P1/2pP3P/2N1PN2/PPP1QP2/R3K2R b KQ - 0 13,f6,-200,-159,41,1
1r2nrk1/p2q2pp/3bpp2/1p1p2P1/2pP3P/2N1PN2/PPP1QP2/R3K2R w KQ - 0 14,gxf6,-153,-181,-28,1
1r2nrk1/p2q2pp/3bpP2/1p1p4/2pP3P/2N1PN2/PPP1QP2/R3K2R b KQ - 0 14,Rxf6,-184,-104,80,1
1r2n1k1/p2q2pp/3bpr2/1p1p4/2pP3P/2N1PN2/PPP1QP2/R3K2R w KQ - 0 15,Ng5,-105,-192,-87,1
1r2n1k1/p2q2pp/3bpr2/1p1p2N1/2pP3P/2N1P3/PPP1QP2/R3K2R b KQ - 1 15,Nc7,-241,-63,178,1
1r4k1/p1nq2pp/3bpr2/1p1p2N1/2pP3P/2N1P3/PPP1QP2/R3K2R w KQ - 2 16,Qh5,-70,-107,-37,1
1r4k1/p1nq2pp/3bpr2/1p1p2NQ/2pP3P/2N1P3/PPP2P2/R3K2R b KQ - 3 16,h6,-130,-112,18,1
1r4k1/p1nq2p1/3bpr1p/1p1p2NQ/2pP3P/2N1P3/PPP2P2/R3K2R w KQ - 0 17,Nh3,-131,-170,-39,1
1r4k1/p1nq2p1/3bpr1p/1p1p3Q/2pP3P/2N1P2N/PPP2P2/R3K2R b KQ - 1 17,Rbf8,-143,-123,20,1
5rk1/p1nq2p1/3bpr1p/1p1p3Q/2pP3P/2N1P2N/PPP2P2/R3K2R w KQ - 2 18,Rg1,-101,-177,-76,1
5rk1/p1nq2p1/3bpr1p/1p1p3Q/2pP3P/2N1P2N/PPP2P2/R3K1R1 b Q - 3 18,Bh2,-182,-97,85,1
5rk1/p1nq2p1/4pr1p/1p1p3Q/2pP3P/2N1P2N/PPP2P1b/R3K1R1 w Q - 4 19,Rg2,-101,-103,-2,1
5rk1/p1nq2p1/4pr1p/1p1p3Q/2pP3P/2N1P2N/PPP2PRb/R3K3 b Q - 5 19,Bd6,-59,-78,-19,1
5rk1/p1nq2p1/3bpr1p/1p1p3Q/2pP3P/2N1P2N/PPP2PR1/R3K3 w Q - 6 20,O-O-O,-53,-128,-75,1
5rk1/p1nq2p1/3bpr1p/1p1p3Q/2pP3P/2N1P2N/PPP2PR1/2KR4 b - - 7 20,Qf7,-105,-25,80,1
5rk1/p1n2qp1/3bpr1p/1p1p3Q/2pP3P/2N1P2N/PPP2PR1/2KR4 w - - 8 21,e4,-6,-512,-506,0
5rk1/p1n2qp1/3bpr1p/1p1p3Q/2pPP2P/2N4N/PPP2PR1/2KR4 b - - 0 21,Qxh5,-531,-544,-13,1
5rk1/p1n3p1/3bpr1p/1p1p3q/2pPP2P/2N4N/PPP2PR1/2KR4 w - - 0 22,e5,-541,-568,-27,1
5rk1/p1n3p1/3bpr1p/1p1pP2q/2pP3P/2N4N/PPP2PR1/2KR4 b - - 0 22,Bxe5,-536,-536,0,1
5rk1/p1n3p1/4pr1p/1p1pb2q/2pP3P/2N4N/PPP2PR1/2KR4 w - - 0 23,dxe5,-531,-598,-67,1
5rk1/p1n3p1/4pr1p/1p1pP2q/2p4P/2N4N/PPP2PR1/2KR4 b - - 0 23,Rxf2,-571,-386,185,1
5rk1/p1n3p1/4p2p/1p1pP2q/2p4P/2N4N/PPP2rR1/2KR4 w - - 0 24,Nxf2,-376,-405,-29,1
5rk1/p1n3p1/4p2p/1p1pP2q/2p4P/2N5/PPP2NR1/2KR4 b - - 0 24,Qxh4,-362,-364,-2,1
5rk1/p1n3p1/4p2p/1p1pP3/2p4q/2N5/PPP2NR1/2KR4 w - - 0 25,Rdg1,-381,-396,-15,1
5rk1/p1n3p1/4p2p/1p1pP3/2p4q/2N5/PPP2NR1/2K3R1 b - - 1 25,Rf7,-392,-338,54,1
6k1/p1n2rp1/4p2p/1p1pP3/2p4q/2N5/PPP2NR1/2K3R1 w - - 2 26,Ng4,-309,-357,-48,1
6k1/p1n2rp1/4p2p/1p1pP3/2p3Nq/2N5/PPP3R1/2K3R1 b - - 3 26,Qg5+,-380,-355,25,1
6k1/p1n2rp1/4p2p/1p1pP1q1/2p3N1/2N5/PPP3R1/2K3R1 w - - 4 27,Kb1,-402,-421,-19,1
6k1/p1n2rp1/4p2p/1p1pP1q1/2p3N1/2N5/PPP3R1/1K4R1 b - - 5 27,Qh5,-394,-6,388,1
6k1/p1n2rp1/4p2p/1p1pP2q/2p3N1/2N5/PPP3R1/1K4R1 w - - 6 28,Nf6+,-7,0,7,1
6k1/p1n2rp1/4pN1p/1p1pP2q/2p5/2N5/PPP3R1/1K4R1 b - - 7 28,Kh8,-2,592,594,1
7k/p1n2rp1/4pN1p/1p1pP2q/2p5/2N5/PPP3R1/1K4R1 w - - 8 29,Nxh5,608,621,13,1
rnbqkbnr/pppppppp/8/8/8/8/PPPPPPPP/RNBQKBNR w KQkq - 0 1,e4,45,34,-11,1
rnbqkbnr/pppppppp/8/8/4P3/8/PPPP1PPP/RNBQKBNR b KQkq - 0 1,e5,34,44,10,1
rnbqkbnr/pppp1ppp/8/4p3/4P3/8/PPPP1PPP/RNBQKBNR w KQkq - 0 2,Qh5,38,-37,-75,1
rnbqkbnr/pppp1ppp/8/4p2Q/4P3/8/PPPP1PPP/RNB1KBNR b KQkq - 1 2,Qf6,-30,14,44,1
rnb1kbnr/pppp1ppp/5q2/4p2Q/4P3/8/PPPP1PPP/RNB1KBNR w KQkq - 2 3,a3,27,-43,-70,1
rnb1kbnr/pppp1ppp/5q2/4p2Q/4P3/P7/1PPP1PPP/RNB1KBNR b KQkq - 0 3,Bc5,-33,-17,16,1
rnb1k1nr/pppp1ppp/5q2/2b1p2Q/4P3/P7/1PPP1PPP/RNB1KBNR w KQkq - 1 4,Qe2,-15,-82,-67,1
rnb1k1nr/pppp1ppp/5q2/2b1p3/4P3/P7/1PPPQPPP/RNB1KBNR b KQkq - 2 4,Nc6,-68,-65,3,1
r1b1k1nr/pppp1ppp/2n2q2/2b1p3/4P3/P7/1PPPQPPP/RNB1KBNR w KQkq - 3 5,c3,-62,-80,-18,1
r1b1k1nr/pppp1ppp/2n2q2/2b1p3/4P3/P1P5/1P1PQPPP/RNB1KBNR b KQkq - 0 5,d6,-64,-54,10,1
r1b1k1nr/ppp2ppp/2np1q2/2b1p3/4P3/P1P5/1P1PQPPP/RNB1KBNR w KQkq - 0 6,a4,-38,-81,-43,1
r1b1k1nr/ppp2ppp/2np1q2/2b1p3/P3P3/2P5/1P1PQPPP/RNB1KBNR b KQkq - 0 6,a6,-88,-68,20,1
r1b1k1nr/1pp2ppp/p1np1q2/2b1p3/P3P3/2P5/1P1PQPPP/RNB1KBNR w KQkq - 0 7,b4,-73,-68,5,1
r1b1k1nr/1pp2ppp/p1np1q2/2b1p3/PP2P3/2P5/3PQPPP/RNB1KBNR b KQkq - 0 7,Bb6,-72,-58,14,1
r1b1k1nr/1pp2ppp/pbnp1q2/4p3/PP2P3/2P5/3PQPPP/RNB1KBNR w KQkq - 1 8,h4,-58,-132,-74,1
r1b1k1nr/1pp2ppp/pbnp1q2/4p3/PP2P2P/2P5/3PQPP1/RNB1KBNR b KQkq - 0 8,Bg4,-125,-144,-19,1
r3k1nr/1pp2ppp/pbnp1q2/4p3/PP2P1bP/2P5/3PQPP1/RNB1KBNR w KQkq - 1 9,f3,-142,-146,-4,1
r3k1nr/1pp2ppp/pbnp1q2/4p3/PP2P1bP/2P2P2/3PQ1P1/RNB1KBNR b KQkq - 0 9,Bh5,-154,-7,147,1
r3k1nr/1pp2ppp/pbnp1q2/4p2b/PP2P2P/2P2P2/3PQ1P1/RNB1KBNR w KQkq - 1 10,g4,-9,-43,-34,1
r3k1nr/1pp2ppp/pbnp1q2/4p2b/PP2P1PP/2P2P2/3PQ3/RNB1KBNR b KQkq - 0 10,Bg6,3,342,339,1
r3k1nr/1pp2ppp/pbnp1qb1/4p3/PP2P1PP/2P2P2/3PQ3/RNB1KBNR w KQkq - 1 11,h5,333,312,-21,1
r3k1nr/1pp2ppp/pbnp1qb1/4p2P/PP2P1P1/2P2P2/3PQ3/RNB1KBNR b KQkq - 0 11,Nd4,307,412,105,1
r3k1nr/1pp2ppp/pb1p1qb1/4p2P/PP1nP1P1/2P2P2/3PQ3/RNB1KBNR w KQkq - 1 12,cxd4,429,440,11,1
r3k1nr/1pp2ppp/pb1p1qb1/4p2P/PP1PP1P1/5P2/3PQ3/RNB1KBNR b KQkq - 0 12,Bxd4,424,439,15,1
r3k1nr/1pp2ppp/p2p1qb1/4p2P/PP1bP1P1/5P2/3PQ3/RNB1KBNR w KQkq - 0 13,Nc3,438,430,-8,1
r3k1nr/1pp2ppp/p2p1qb1/4p2P/PP1bP1P1/2N2P2/3PQ3/R1B1KBNR b KQkq - 1 13,Bxe4,414,506,92,1
r3k1nr/1pp2ppp/p2p1q2/4p2P/PP1bb1P1/2N2P2/3PQ3/R1B1KBNR w KQkq - 0 14,Qxe4,487,412,-75,1
r3k1nr/1pp2ppp/p2p1q2/4p2P/PP1bQ1P1/2N2P2/3P4/R1B1KBNR b KQkq - 0 14,O-O-O,425,518,93,1
2kr2nr/1pp2ppp/p2p1q2/4p2P/PP1bQ1P1/2N2P2/3P4/R1B1KBNR w KQ - 1 15,b5,530,449,-81,1
2kr2nr/1pp2ppp/p2p1q2/1P2p2P/P2bQ1P1/2N2P2/3P4/R1B1KBNR b KQ - 0 15,Ne7,457,486,29,1
2kr3r/1pp1nppp/p2p1q2/1P2p2P/P2bQ1P1/2N2P2/3P4/R1B1KBNR w KQ - 1 16,Bh3,480,400,-80,1
2kr3r/1pp1nppp/p2p1q2/1P2p2P/P2bQ1P1/2N2P1B/3P4/R1B1K1NR b KQ - 2 16,Qh4+,364,412,48,1
2kr3r/1pp1nppp/p2p4/1P2p2P/P2bQ1Pq/2N2P1B/3P4/R1B1K1NR w KQ - 3 17,Kd1,424,398,-26,1
2kr3r/1pp1nppp/p2p4/1P2p2P/P2bQ1Pq/2N2P1B/3P4/R1BK2NR b - - 4 17,Bxg1,399,664,265,1
2kr3r/1pp1nppp/p2p4/1P2p2P/P3Q1Pq/2N2P1B/3P4/R1BK2bR w - - 0 18,bxa6,651,502,-149,0
2kr3r/1pp1nppp/P2p4/4p2P/P3Q1Pq/2N2P1B/3P4/R1BK2bR b - - 0 18,Qf2,525,672,147,1
2kr3r/1pp1nppp/P2p4/4p2P/P3Q1P1/2N2P1B/3P1q2/R1BK2bR w - - 1 19,g5+,681,657,-24,1
2kr3r/1pp1nppp/P2p4/4p1PP/P3Q3/2N2P1B/3P1q2/R1BK2bR b - - 0 19,Rd7,593,613,20,1
2k4r/1pprnppp/P2p4/4p1PP/P3Q3/2N2P1B/3P1q2/R1BK2bR w - - 1 20,Qxb7+,648,611,-37,1
2k4r/1Qprnppp/P2p4/4p1PP/P7/2N2P1B/3P1q2/R1BK2bR b - - 0 20,Kd8,646,690,44,1
3k3r/1Qprnppp/P2p4/4p1PP/P7/2N2P1B/3P1q2/R1BK2bR w - - 1 21,Qb8+,673,532,-141,0
1Q1k3r/2prnppp/P2p4/4p1PP/P7/2N2P1B/3P1q2/R1BK2bR b - - 2 21,Nc8,592,522,-70,1
1Qnk3r/2pr1ppp/P2p4/4p1PP/P7/2N2P1B/3P1q2/R1BK2bR w - - 3 22,Bxd7,592,487,-105,0
1Qnk3r/2pB1ppp/P2p4/4p1PP/P7/2N2P2/3P1q2/R1BK2bR b - - 0 22,Kxd7,496,504,8,1
1Qn4r/2pk1ppp/P2p4/4p1PP/P7/2N2P2/3P1q2/R1BK2bR w - - 0 23,a7,501,270,-231,0
1Qn4r/P1pk1ppp/3p4/4p1PP/P7/2N2P2/3P1q2/R1BK2bR b - - 0 23,Qxf3+,290,319,29,1
1Qn4r/P1pk1ppp/3p4/4p1PP/P7/2N2q2/3P4/R1BK2bR w - - 0 24,Kc2,336,322,-14,1
1Qn4r/P1pk1ppp/3p4/4p1PP/P7/2N2q2/2KP4/R1B3bR b - - 1 24,Bxa7,355,479,124,1
1Qn4r/b1pk1ppp/3p4/4p1PP/P7/2N2q2/2KP4/R1B4R w - - 0 25,Qb5+,475,454,-21,1
2n4r/b1pk1ppp/3p4/1Q2p1PP/P7/2N2q2/2KP4/R1B4R b - - 1 25,Ke7,454,519,65,1
2n4r/b1p1kppp/3p4/1Q2p1PP/P7/2N2q2/2KP4/R1B4R w - - 2 26,Rf1,504,475,-29,1
2n4r/b1p1kppp/3p4/1Q2p1PP/P7/2N2q2/2KP4/R1B2R2 b - - 3 26,Qxh5,458,428,-30,1
2n4r/b1p1kppp/3p4/1Q2p1Pq/P7/2N5/2KP4/R1B2R2 w - - 0 27,Nd5+,448,406,-42,1
2n4r/b1p1kppp/3p4/1Q1Np1Pq/P7/8/2KP4/R1B2R2 b - - 1 27,Kd8,466,523,57,1
2nk3r/b1p2ppp/3p4/1Q1Np1Pq/P7/8/2KP4/R1B2R2 w - - 2 28,Ra3,521,420,-101,0
2nk3r/b1p2ppp/3p4/1Q1Np1Pq/P7/R7/2KP4/2B2R2 b - - 3 28,Qg6+,421,463,42,1
2nk3r/b1p2ppp/3p2q1/1Q1Np1P1/P7/R7/2KP4/2B2R2 w - - 4 29,d3,471,475,4,1
2nk3r/b1p2ppp/3p2q1/1Q1Np1P1/P7/R2P4/2K5/2B2R2 b - - 0 29,Bc5,459,532,73,1
2nk3r/2p2ppp/3p2q1/1QbNp1P1/P7/R2P4/2K5/2B2R2 w - - 1 30,Rc3,612,474,-138,0
2nk3r/2p2ppp/3p2q1/1QbNp1P1/P7/2RP4/2K5/2B2R2 b - - 2 30,Qh5,488,558,70,1
2nk3r/2p2ppp/3p4/1QbNp1Pq/P7/2RP4/2K5/2B2R2 w - - 3 31,d4,565,358,-207,0
2nk3r/2p2ppp/3p4/1QbNp1Pq/P2P4/2R5/2K5/2B2R2 b - - 0 31,Qe2+,387,721,334,1
2nk3r/2p2ppp/3p4/1QbNp1P1/P2P4/2R5/2K1q3/2B2R2 w - - 1 32,Qxe2,770,729,-41,1
2nk3r/2p2ppp/3p4/2bNp1P1/P2P4/2R5/2K1Q3/2B2R2 b - - 0 32,Bxd4,785,795,10,1
2nk3r/2p2ppp/3p4/3Np1P1/P2b4/2R5/2K1Q3/2B2R2 w - - 0 33,Rxc7,831,837,6,1
2nk3r/2R2ppp/3p4/3Np1P1/P2b4/8/2K1Q3/2B2R2 b - - 0 33,Nb6,848,851,3,1
3k3r/2R2ppp/1n1p4/3Np1P1/P2b4/8/2K1Q3/2B2R2 w - - 1 34,Rfxf7,949,846,-103,0
3k3r/2R2Rpp/1n1p4/3Np1P1/P2b4/8/2K1Q3/2B5 b - - 0 34,Nxd5,879,9991,9112,1
3k3r/2R2Rpp/3p4/3np1P1/P2b4/8/2K1Q3/2B5 w - - 0 35,Ra7,9991,574,-9417,0
3k3r/R4Rpp/3p4/3np1P1/P2b4/8/2K1Q3/2B5 b - - 1 35,Bxa7,724,771,47,1
3k3r/b4Rpp/3p4/3np1P1/P7/8/2K1Q3/2B5 w - - 0 36,Rxa7,1005,616,-389,0
3k3r/R5pp/3p4/3np1P1/P7/8/2K1Q3/2B5 b - - 0 36,Nb4+,633,636,3,1
3k3r/R5pp/3p4/4p1P1/Pn6/8/2K1Q3/2B5 w - - 1 37,Kb3,676,545,-131,0
3k3r/R5pp/3p4/4p1P1/Pn6/1K6/4Q3/2B5 b - - 2 37,Rf8,537,750,213,1
3k1r2/R5pp/3p4/4p1P1/Pn6/1K6/4Q3/2B5 w - - 3 38,Ra8+,781,788,7,1
R2k1r2/6pp/3p4/4p1P1/Pn6/1K6/4Q3/2B5 b - - 4 38,Ke7,773,773,0,1
R4r2/4k1pp/3p4/4p1P1/Pn6/1K6/4Q3/2B5 w - - 5 39,Rxf8,762,775,13,1
5R2/4k1pp/3p4/4p1P1/Pn6/1K6/4Q3/2B5 b - - 0 39,Kxf8,794,798,4,1
5k2/6pp/3p4/4p1P1/Pn6/1K6/4Q3/2B5 w - - 0 40,Bd2,774,734,-40,1
5k2/6pp/3p4/4p1P1/Pn6/1K6/3BQ3/8 b - - 1 40,Nc6,729,810,81,1
5k2/6pp/2np4/4p1P1/P7/1K6/3BQ3/8 w - - 2 41,Qg2,798,626,-172,0
5k2/6pp/2np4/4p1P1/P7/1K6/3B2Q1/8 b - - 3 41,Nd4+,677,659,-18,1
5k2/6pp/3p4/4p1P1/P2n4/1K6/3B2Q1/8 w - - 4 42,Kb4,693,660,-33,1
5k2/6pp/3p4/4p1P1/PK1n4/8/3B2Q1/8 b - - 5 42,Ke7,686,729,43,1
8/4k1pp/3p4/4p1P1/PK1n4/8/3B2Q1/8 w - - 6 43,a5,731,742,11,1
8/4k1pp/3p4/P3p1P1/1K1n4/8/3B2Q1/8 b - - 0 43,Ke6,740,807,67,1
8/6pp/3pk3/P3p1P1/1K1n4/8/3B2Q1/8 w - - 1 44,a6,778,807,29,1
8/6pp/P2pk3/4p1P1/1K1n4/8/3B2Q1/8 b - - 0 44,g6,813,951,138,1
8/7p/P2pk1p1/4p1P1/1K1n4/8/3B2Q1/8 w - - 0 45,a7,965,905,-60,1
8/P6p/3pk1p1/4p1P1/1K1n4/8/3B2Q1/8 b - - 0 45,Nc6+,959,1090,131,1
8/P6p/2npk1p1/4p1P1/1K6/8/3B2Q1/8 w - - 1 46,Qxc6,9993,9995,2,1
rnbqkbnr/pppppppp/8/8/8/8/PPPPPPPP/RNBQKBNR w KQkq - 0 1,e4,51,33,-18,1
rnbqkbnr/pppppppp/8/8/4P3/8/PPPP1PPP/RNBQKBNR b KQkq - 0 1,e5,40,42,2,1
rnbqkbnr/pppp1ppp/8/4p3/4P3/8/PPPP1PPP/RNBQKBNR w KQkq - 0 2,Bc4,36,26,-10,1
rnbqkbnr/pppp1ppp/8/4p3/2B1P3/8/PPPP1PPP/RNBQK1NR b KQkq - 1 2,a6,16,80,64,1
rnbqkbnr/1ppp1ppp/p7/4p3/2B1P3/8/PPPP1PPP/RNBQK1NR w KQkq - 0 3,Qh5,70,36,-34,1
rnbqkbnr/1ppp1ppp/p7/4p2Q/2B1P3/8/PPPP1PPP/RNB1K1NR b KQkq - 1 3,g6,35,468,433,1
rnbqkbnr/1ppp1p1p/p5p1/4p2Q/2B1P3/8/PPPP1PPP/RNB1K1NR w KQkq - 0 4,Qxe5+,397,433,36,1
rnbqkbnr/1ppp1p1p/p5p1/4Q3/2B1P3/8/PPPP1PPP/RNB1K1NR b KQkq - 0 4,Qe7,425,432,7,1
rnb1kbnr/1pppqp1p/p5p1/4Q3/2B1P3/8/PPPP1PPP/RNB1K1NR w KQkq - 1 5,Qxh8,400,393,-7,1
rnb1kbnQ/1pppqp1p/p5p1/8/2B1P3/8/PPPP1PPP/RNB1K1NR b KQq - 0 5,Qxe4+,412,473,61,1
rnb1kbnQ/1ppp1p1p/p5p1/8/2B1q3/8/PPPP1PPP/RNB1K1NR w KQq - 0 6,Ne2,439,402,-37,1
rnb1kbnQ/1ppp1p1p/p5p1/8/2B1q3/8/PPPPNPPP/RNB1K2R b KQq - 1 6,Qxc4,382,421,39,1
rnb1kbnQ/1ppp1p1p/p5p1/8/2q5/8/PPPPNPPP/RNB1K2R w KQq - 0 7,Qxg8,393,424,31,1
rnb1kbQ1/1ppp1p1p/p5p1/8/2q5/8/PPPPNPPP/RNB1K2R b KQq - 0 7,Qh4,421,493,72,1
rnb1kbQ1/1ppp1p1p/p5p1/8/7q/8/PPPPNPPP/RNB1K2R w KQq - 1 8,g3,533,391,-142,0
rnb1kbQ1/1ppp1p1p/p5p1/8/7q/6P1/PPPPNP1P/RNB1K2R b KQq - 0 8,Qh5,450,450,0,1
rnb1kbQ1/1ppp1p1p/p5p1/7q/8/6P1/PPPPNP1P/RNB1K2R w KQq - 1 9,Qh8,462,370,-92,1
rnb1kb1Q/1ppp1p1p/p5p1/7q/8/6P1/PPPPNP1P/RNB1K2R b KQq - 2 9,Qd5,331,500,169,1
rnb1kb1Q/1ppp1p1p/p5p1/3q4/8/6P1/PPPPNP1P/RNB1K2R w KQq - 3 10,Rg1,491,401,-90,1
rnbqkbnr/pppppppp/8/8/8/8/PPPPPPPP/RNBQKBNR w KQkq - 0 1,d4,35,31,-4,1
rnbqkbnr/pppppppp/8/8/3P4/8/PPP1PPPP/RNBQKBNR b KQkq - 0 1,d5,27,35,8,1
rnbqkbnr/ppp1pppp/8/3p4/3P4/8/PPP1PPPP/RNBQKBNR w KQkq - 0 2,Nc3,38,-4,-42,1
rnbqkbnr/ppp1pppp/8/3p4/3P4/2N5/PPP1PPPP/R1BQKBNR b KQkq - 1 2,c6,-1,48,49,1
rnbqkbnr/pp2pppp/2p5/3p4/3P4/2N5/PPP1PPPP/R1BQKBNR w KQkq - 0 3,Nf3,32,-4,-36,1
rnbqkbnr/pp2pppp/2p5/3p4/3P4/2N2N2/PPP1PPPP/R1BQKB1R b KQkq - 1 3,Nf6,8,11,3,1
rnbqkb1r/pp2pppp/2p2n2/3p4/3P4/2N2N2/PPP1PPPP/R1BQKB1R w KQkq - 2 4,Bf4,11,14,3,1
rnbqkb1r/pp2pppp/2p2n2/3p4/3P1B2/2N2N2/PPP1PPPP/R2QKB1R b KQkq - 3 4,g6,13,35,22,1
rnbqkb1r/pp2pp1p/2p2np1/3p4/3P1B2/2N2N2/PPP1PPPP/R2QKB1R w KQkq - 0 5,e3,46,21,-25,1
rnbqkb1r/pp2pp1p/2p2np1/3p4/3P1B2/2N1PN2/PPP2PPP/R2QKB1R b KQkq - 0 5,b5,31,64,33,1
rnbqkb1r/p3pp1p/2p2np1/1p1p4/3P1B2/2N1PN2/PPP2PPP/R2QKB1R w KQkq - 0 6,Bd3,43,38,-5,1
rnbqkb1r/p3pp1p/2p2np1/1p1p4/3P1B2/2NBPN2/PPP2PPP/R2QK2R b KQkq - 1 6,Ba6,40,134,94,1
rn1qkb1r/p3pp1p/b1p2np1/1p1p4/3P1B2/2NBPN2/PPP2PPP/R2QK2R w KQkq - 2 7,e4,118,50,-68,1
rn1qkb1r/p3pp1p/b1p2np1/1p1p4/3PPB2/2NB1N2/PPP2PPP/R2QK2R b KQkq - 0 7,b4,29,30,1,1
rn1qkb1r/p3pp1p/b1p2np1/3p4/1p1PPB2/2NB1N2/PPP2PPP/R2QK2R w KQkq - 0 8,Na4,28,-53,-81,1
rn1qkb1r/p3pp1p/b1p2np1/3p4/Np1PPB2/3B1N2/PPP2PPP/R2QK2R b KQkq - 1 8,Bxd3,-60,58,118,1
rn1qkb1r/p3pp1p/2p2np1/3p4/Np1PPB2/3b1N2/PPP2PPP/R2QK2R w KQkq - 0 9,cxd3,68,44,-24,1
rn1qkb1r/p3pp1p/2p2np1/3p4/Np1PPB2/3P1N2/PP3PPP/R2QK2R b KQkq - 0 9,dxe4,35,48,13,1
rn1qkb1r/p3pp1p/2p2np1/8/Np1PpB2/3P1N2/PP3PPP/R2QK2R w KQkq - 0 10,dxe4,43,44,1,1
rn1qkb1r/p3pp1p/2p2np1/8/Np1PPB2/5N2/PP3PPP/R2QK2R b KQkq - 0 10,Nxe4,43,44,1,1
rn1qkb1r/p3pp1p/2p3p1/8/Np1PnB2/5N2/PP3PPP/R2QK2R w KQkq - 0 11,O-O,45,37,-8,1
rn1qkb1r/p3pp1p/2p3p1/8/Np1PnB2/5N2/PP3PPP/R2Q1RK1 b kq - 1 11,Bg7,44,62,18,1
rn1qk2r/p3ppbp/2p3p1/8/Np1PnB2/5N2/PP3PPP/R2Q1RK1 w kq - 2 12,Nc5,60,-196,-256,0
rn1qk2r/p3ppbp/2p3p1/2N5/1p1PnB2/5N2/PP3PPP/R2Q1RK1 b kq - 3 12,Nxc5,-203,-179,24,1
rn1qk2r/p3ppbp/2p3p1/2n5/1p1P1B2/5N2/PP3PPP/R2Q1RK1 w kq - 0 13,dxc5,-163,-157,6,1
rn1qk2r/p3ppbp/2p3p1/2P5/1p3B2/5N2/PP3PPP/R2Q1RK1 b kq - 0 13,Qxd1,-140,-142,-2,1
rn2k2r/p3ppbp/2p3p1/2P5/1p3B2/5N2/PP3PPP/R2q1RK1 w kq - 0 14,Raxd1,-141,-141,0,1
rn2k2r/p3ppbp/2p3p1/2P5/1p3B2/5N2/PP3PPP/3R1RK1 b kq - 0 14,Bxb2,-140,-156,-16,1
rn2k2r/p3pp1p/2p3p1/2P5/1p3B2/5N2/Pb3PPP/3R1RK1 w kq - 0 15,Bc7,-154,-247,-93,1
rn2k2r/p1B1pp1p/2p3p1/2P5/1p6/5N2/Pb3PPP/3R1RK1 b kq - 1 15,O-O,-236,-254,-18,1
rn3rk1/p1B1pp1p/2p3p1/2P5/1p6/5N2/Pb3PPP/3R1RK1 w - - 2 16,Rd2,-231,-279,-48,1
rn3rk1/p1B1pp1p/2p3p1/2P5/1p6/5N2/Pb1R1PPP/5RK1 b - - 3 16,Bg7,-267,-237,30,1
rn3rk1/p1B1ppbp/2p3p1/2P5/1p6/5N2/P2R1PPP/5RK1 w - - 4 17,Re1,-285,-317,-32,1
rn3rk1/p1B1ppbp/2p3p1/2P5/1p6/5N2/P2R1PPP/4R1K1 b - - 5 17,e6,-374,-217,157,1
rn3rk1/p1B2pbp/2p1p1p1/2P5/1p6/5N2/P2R1PPP/4R1K1 w - - 0 18,Bd6,-244,-291,-47,1
rn3rk1/p4pbp/2pBp1p1/2P5/1p6/5N2/P2R1PPP/4R1K1 b - - 1 18,Rd8,-286,-262,24,1
rn1r2k1/p4pbp/2pBp1p1/2P5/1p6/5N2/P2R1PPP/4R1K1 w - - 2 19,Ne5,-264,-306,-42,1
rn1r2k1/p4pbp/2pBp1p1/2P1N3/1p6/8/P2R1PPP/4R1K1 b - - 3 19,Na6,-270,-105,165,1
r2r2k1/p4pbp/n1pBp1p1/2P1N3/1p6/8/P2R1PPP/4R1K1 w - - 4 20,Nc4,-84,-347,-263,0
r2r2k1/p4pbp/n1pBp1p1/2P5/1pN5/8/P2R1PPP/4R1K1 b - - 5 20,Nxc5,-347,65,412,1
r2r2k1/p4pbp/2pBp1p1/2n5/1pN5/8/P2R1PPP/4R1K1 w - - 0 21,Rde2,75,-410,-485,0
r2r2k1/p4pbp/2pBp1p1/2n5/1pN5/8/P3RPPP/4R1K1 b - - 1 21,a5,-425,146,571,1
r2r2k1/5pbp/2pBp1p1/p1n5/1pN5/8/P3RPPP/4R1K1 w - - 0 22,Bc7,151,-409,-560,0
r2r2k1/2B2pbp/2p1p1p1/p1n5/1pN5/8/P3RPPP/4R1K1 b - - 1 22,Rdc8,-411,-282,129,1
r1r3k1/2B2pbp/2p1p1p1/p1n5/1pN5/8/P3RPPP/4R1K1 w - - 2 23,Bxa5,-337,-345,-8,1
r1r3k1/5pbp/2p1p1p1/B1n5/1pN5/8/P3RPPP/4R1K1 b - - 0 23,b3,-368,-311,57,1
r1r3k1/5pbp/2p1p1p1/B1n5/2N5/1p6/P3RPPP/4R1K1 w - - 0 24,axb3,-311,-349,-38,1
r1r3k1/5pbp/2p1p1p1/B1n5/2N5/1P6/4RPPP/4R1K1 b - - 0 24,Nxb3,-349,-356,-7,1
r1r3k1/5pbp/2p1p1p1/B7/2N5/1n6/4RPPP/4R1K1 w - - 0 25,Bb4,-360,-400,-40,1
r1r3k1/5pbp/2p1p1p1/8/1BN5/1n6/4RPPP/4R1K1 b - - 1 25,Ra4,-359,-40,319,1
2r3k1/5pbp/2p1p1p1/8/rBN5/1n6/4RPPP/4R1K1 w - - 2 26,Nd6,-64,-454,-390,0
2r3k1/5pbp/2pNp1p1/8/rB6/1n6/4RPPP/4R1K1 b - - 3 26,Rca8,-461,-445,16,1
r5k1/5pbp/2pNp1p1/8/rB6/1n6/4RPPP/4R1K1 w - - 4 27,Bd2,-439,-516,-77,1
r5k1/5pbp/2pNp1p1/8/r7/1n6/3BRPPP/4R1K1 b - - 5 27,Ra1,-481,-477,4,1
r5k1/5pbp/2pNp1p1/8/8/1n6/3BRPPP/r3R1K1 w - - 6 28,Bc1,-453,-537,-84,1
r5k1/5pbp/2pNp1p1/8/8/1n6/4RPPP/r1B1R1K1 b - - 7 28,Nxc1,-545,-575,-30,1
r5k1/5pbp/2pNp1p1/8/8/8/4RPPP/r1n1R1K1 w - - 0 29,Nc4,-623,-814,-191,0
r5k1/5pbp/2p1p1p1/8/2N5/8/4RPPP/r1n1R1K1 b - - 1 29,Nxe2+,-810,-815,-5,1
r5k1/5pbp/2p1p1p1/8/2N5/8/4nPPP/r3R1K1 w - - 0 30,Kf1,-800,-818,-18,1
r5k1/5pbp/2p1p1p1/8/2N5/8/4nPPP/r3RK2 b - - 1 30,Nd4,-799,-769,30,1
r5k1/5pbp/2p1p1p1/8/2Nn4/8/5PPP/r3RK2 w - - 2 31,Nb6,-755,-808,-53,1
r5k1/5pbp/1Np1p1p1/8/3n4/8/5PPP/r3RK2 b - - 3 31,R8a6,-794,-774,20,1
6k1/5pbp/rNp1p1p1/8/3n4/8/5PPP/r3RK2 w - - 4 32,Nd7,-775,-785,-10,1
6k1/3N1pbp/r1p1p1p1/8/3n4/8/5PPP/r3RK2 b - - 5 32,Nc2,-793,-753,40,1
6k1/3N1pbp/r1p1p1p1/8/8/8/2n2PPP/r3RK2 w - - 6 33,Rxa1,-772,-778,-6,1
6k1/3N1pbp/r1p1p1p1/8/8/8/2n2PPP/R4K2 b - - 0 33,Rxa1+,-792,-769,23,1
6k1/3N1pbp/2p1p1p1/8/8/8/2n2PPP/r4K2 w - - 0 34,Ke2,-771,-788,-17,1
6k1/3N1pbp/2p1p1p1/8/8/8/2n1KPPP/r7 b - - 1 34,Nd4+,-810,-796,14,1
6k1/3N1pbp/2p1p1p1/8/3n4/8/4KPPP/r7 w - - 2 35,Ke3,-779,-780,-1,1
6k1/3N1pbp/2p1p1p1/8/3n4/4K3/5PPP/r7 b - - 3 35,Rh1,-810,-726,84,1
6k1/3N1pbp/2p1p1p1/8/3n4/4K3/5PPP/7r w - - 4 36,h3,-744,-765,-21,1
6k1/3N1pbp/2p1p1p1/8/3n4/4K2P/5PP1/7r b - - 0 36,Rh2,-776,-754,22,1
6k1/3N1pbp/2p1p1p1/8/3n4/4K2P/5PPr/8 w - - 1 37,Nc5,-737,-779,-42,1
6k1/5pbp/2p1p1p1/2N5/3n4/4K2P/5PPr/8 b - - 2 37,Rxg2,-795,-772,23,1
6k1/5pbp/2p1p1p1/2N5/3n4/4K2P/5Pr1/8 w - - 0 38,Ne4,-782,-796,-14,1
6k1/5pbp/2p1p1p1/8/3nN3/4K2P/5Pr1/8 b - - 1 38,f5,-801,-768,33,1
6k1/6bp/2p1p1p1/5p2/3nN3/4K2P/5Pr1/8 w - - 0 39,Ng5,-777,-775,2,1
6k1/6bp/2p1p1p1/5pN1/3n4/4K2P/5Pr1/8 b - - 1 39,Bh6,-828,-773,55,1
6k1/7p/2p1p1pb/5pN1/3n4/4K2P/5Pr1/8 w - - 2 40,f4,-783,-834,-51,1
6k1/7p/2p1p1pb/5pN1/3n1P2/4K2P/6r1/8 b - - 0 40,Nc2+,-818,-853,-35,1
6k1/7p/2p1p1pb/5pN1/5P2/4K2P/2n3r1/8 w - - 1 41,Kf3,-854,-881,-27,1
6k1/7p/2p1p1pb/5pN1/5P2/5K1P/2n3r1/8 b - - 2 41,Rg1,-888,-718,170,1
6k1/7p/2p1p1pb/5pN1/5P2/5K1P/2n5/6r1 w - - 3 42,h4,-709,-785,-76,1
6k1/7p/2p1p1pb/5pN1/5P1P/5K2/2n5/6r1 b - - 0 42,Nd4+,-745,-766,-21,1
6k1/7p/2p1p1pb/5pN1/3n1P1P/5K2/8/6r1 w - - 1 43,Kf2,-767,-769,-2,1
6k1/7p/2p1p1pb/5pN1/3n1P1P/8/5K2/6r1 b - - 2 43,Rg4,-787,-793,-6,1
6k1/7p/2p1p1pb/5pN1/3n1PrP/8/5K2/8 w - - 3 44,Ke3,-800,-804,-4,1
6k1/7p/2p1p1pb/5pN1/3n1PrP/4K3/8/8 b - - 4 44,c5,-812,-805,7,1
6k1/7p/4p1pb/2p2pN1/3n1PrP/4K3/8/8 w - - 0 45,Nf3,-829,-837,-8,1
6k1/7p/4p1pb/2p2p2/3n1PrP/4KN2/8/8 b - - 1 45,Nc2+,-872,-772,100,1
6k1/7p/4p1pb/2p2p2/5PrP/4KN2/2n5/8 w - - 2 46,Kf2,-787,-819,-32,1
6k1/7p/4p1pb/2p2p2/5PrP/5N2/2n2K2/8 b - - 3 46,Bxf4,-825,-848,-23,1
6k1/7p/4p1p1/2p2p2/5brP/5N2/2n2K2/8 w - - 0 47,Ke2,-865,-881,-16,1
6k1/7p/4p1p1/2p2p2/5brP/5N2/2n1K3/8 b - - 1 47,Nd4+,-872,-878,-6,1
6k1/7p/4p1p1/2p2p2/3n1brP/5N2/4K3/8 w - - 2 48,Kd3,-898,-941,-43,1
6k1/7p/4p1p1/2p2p2/3n1brP/3K1N2/8/8 b - - 3 48,Nxf3,-957,-929,28,1
6k1/7p/4p1p1/2p2p2/5brP/3K1n2/8/8 w - - 0 49,Kc4,-940,-952,-12,1
6k1/7p/4p1p1/2p2p2/2K2brP/5n2/8/8 b - - 1 49,Be3+,-959,-961,-2,1
6k1/7p/4p1p1/2p2p2/2K3rP/4bn2/8/8 w - - 2 50,Kb5,-960,-957,3,1
6k1/7p/4p1p1/1Kp2p2/6rP/4bn2/8/8 b - - 3 50,e5,-977,-946,31,1
6k1/7p/6p1/1Kp1pp2/6rP/4bn2/8/8 w - - 0 51,h5,-1047,-1102,-55,1
6k1/7p/6p1/1Kp1pp1P/6r1/4bn2/8/8 b - - 0 51,Rb4+,-1098,-966,132,1
6k1/7p/6p1/1Kp1pp1P/1r6/4bn2/8/8 w - - 1 52,Kc6,-1052,-1084,-32,1
6k1/7p/2K3p1/2p1pp1P/1r6/4bn2/8/8 b - - 2 52,c4,-1091,-975,116,1
6k1/7p/2K3p1/4pp1P/1rp5/4bn2/8/8 w - - 0 53,hxg6,-1131,-1122,9,1
6k1/7p/2K3P1/4pp2/1rp5/4bn2/8/8 b - - 0 53,hxg6,-9989,-9992,-3,1
6k1/8/2K3p1/4pp2/1rp5/4bn2/8/8 w - - 0 54,Kd6,-9993,-9993,0,1
6k1/8/3K2p1/4pp2/1rp5/4bn2/8/8 b - - 1 54,c3,-9993,-9994,-1,1
6k1/8/3K2p1/4pp2/1r6/2p1bn2/8/8 w - - 0 55,Ke6,-9994,-9994,0,1
6k1/8/4K1p1/4pp2/1r6/2p1bn2/8/8 b - - 1 55,f4,-9994,-9994,0,1
6k1/8/4K1p1/4p3/1r3p2/2p1bn2/8/8 w - - 0 56,Kf6,-9993,-9993,0,1
6k1/8/5Kp1/4p3/1r3p2/2p1bn2/8/8 b - - 1 56,g5,-9993,-9991,2,1
6k1/8/5K2/4p1p1/1r3p2/2p1bn2/8/8 w - - 0 57,Kf5,-9991,-9991,0,1
6k1/8/8/4pKp1/1r3p2/2p1bn2/8/8 b - - 1 57,c2,-9991,-9992,-1,1
6k1/8/8/4pKp1/1r3p2/4bn2/2p5/8 w - - 0 58,Kg4,-9992,-9994,-2,1
6k1/8/8/4p1p1/1r3pK1/4bn2/2p5/8 b - - 1 58,Nh2+,-9994,-1268,8726,1
6k1/8/8/4p1p1/1r3pK1/4b3/2p4n/8 w - - 2 59,Kh3,-9993,-9997,-4,1
6k1/8/8/4p1p1/1r3p2/4b2K/2p4n/8 b - - 3 59,Nf1,-9997,-9992,5,1
6k1/8/8/4p1p1/1r3p2/4b2K/2p5/5n2 w - - 4 60,Kg2,-9991,-9996,-5,1
6k1/8/8/4p1p1/1r3p2/4b3/2p3K1/5n2 b - - 5 60,Nd2,-9996,-9993,3,1
6k1/8/8/4p1p1/1r3p2/4b3/2pn2K1/8 w - - 6 61,Kh3,-9993,-9993,0,1
6k1/8/8/4p1p1/1r3p2/4b2K/2pn4/8 b - - 7 61,c1=Q,-9995,-9996,-1,1
6k1/8/8/4p1p1/1r3p2/4b2K/3n4/2q5 w - - 0 62,Kg4,-9996,-9996,0,1
6k1/8/8/4p1p1/1r3pK1/4b3/3n4/2q5 b - - 1 62,f3+,-9996,-9997,-1,1
6k1/8/8/4p1p1/1r4K1/4bp2/3n4/2q5 w - - 0 63,Kf5,-9997,-9997,0,1
6k1/8/8/4pKp1/1r6/4bp2/3n4/2q5 b - - 1 63,Qc2+,-9997,-9996,1,1
6k1/8/8/4pKp1/1r6/4bp2/2qn4/8 w - - 2 64,Kxe5,-9996,-9998,-2,1
6k1/8/8/4K1p1/1r6/4bp2/2qn4/8 b - - 0 64,Qe4+,-9998,-9996,2,1
6k1/8/8/4K1p1/1r2q3/4bp2/3n4/8 w - - 1 65,Kf6,-9996,-9999,-3,1
6k1/8/5K2/6p1/1r2q3/4bp2/3n4/8 b - - 2 65,Qf4+,-9999,-9996,3,1
6k1/8/5K2/6p1/1r3q2/4bp2/3n4/8 w - - 3 66,Kg6,-9997,-9998,-1,1
6k1/8/6K1/6p1/1r3q2/4bp2/3n4/8 b - - 4 66,Rb6+,-9998,-9999,-1,1
6k1/8/1r4K1/6p1/5q2/4bp2/3n4/8 w - - 5 67,Kh5,-9999,-9999,0,1
6k1/8/1r6/6pK/5q2/4bp2/3n4/8 b - - 6 67,Qh4#,-9999,-10000,-1,1
rnbqkbnr/pppppppp/8/8/8/8/PPPPPPPP/RNBQKBNR w KQkq - 0 1,e4,44,40,-4,1
rnbqkbnr/pppppppp/8/8/4P3/8/PPPP1PPP/RNBQKBNR b KQkq - 0 1,e6,30,36,6,1
rnbqkbnr/pppp1ppp/4p3/8/4P3/8/PPPP1PPP/RNBQKBNR w KQkq - 0 2,Nf3,44,20,-24,1
rnbqkbnr/pppp1ppp/4p3/8/4P3/5N2/PPPP1PPP/RNBQKB1R b KQkq - 1 2,d5,23,16,-7,1
rnbqkbnr/ppp2ppp/4p3/3p4/4P3/5N2/PPPP1PPP/RNBQKB1R w KQkq - 0 3,exd5,25,23,-2,1
rnbqkbnr/ppp2ppp/4p3/3P4/8/5N2/PPPP1PPP/RNBQKB1R b KQkq - 0 3,exd5,20,20,0,1
rnbqkbnr/ppp2ppp/8/3p4/8/5N2/PPPP1PPP/RNBQKB1R w KQkq - 0 4,d4,23,17,-6,1
rnbqkbnr/ppp2ppp/8/3p4/3P4/5N2/PPP2PPP/RNBQKB1R b KQkq - 0 4,Nf6,21,25,4,1
rnbqkb1r/ppp2ppp/5n2/3p4/3P4/5N2/PPP2PPP/RNBQKB1R w KQkq - 1 5,Nc3,21,9,-12,1
rnbqkb1r/ppp2ppp/5n2/3p4/3P4/2N2N2/PPP2PPP/R1BQKB1R b KQkq - 2 5,Bd6,13,20,7,1
rnbqk2r/ppp2ppp/3b1n2/3p4/3P4/2N2N2/PPP2PPP/R1BQKB1R w KQkq - 3 6,Bd3,24,13,-11,1
rnbqk2r/ppp2ppp/3b1n2/3p4/3P4/2NB1N2/PPP2PPP/R1BQK2R b KQkq - 4 6,c6,10,27,17,1
rnbqk2r/pp3ppp/2pb1n2/3p4/3P4/2NB1N2/PPP2PPP/R1BQK2R w KQkq - 0 7,O-O,23,17,-6,1
rnbqk2r/pp3ppp/2pb1n2/3p4/3P4/2NB1N2/PPP2PPP/R1BQ1RK1 b kq - 1 7,O-O,14,18,4,1
rnbq1rk1/pp3ppp/2pb1n2/3p4/3P4/2NB1N2/PPP2PPP/R1BQ1RK1 w - - 2 8,Re1,20,-13,-33,1
rnbq1rk1/pp3ppp/2pb1n2/3p4/3P4/2NB1N2/PPP2PPP/R1BQR1K1 b - - 3 8,Bg4,-23,-38,-15,1
rn1q1rk1/pp3ppp/2pb1n2/3p4/3P2b1/2NB1N2/PPP2PPP/R1BQR1K1 w - - 4 9,h3,-35,-39,-4,1
rn1q1rk1/pp3ppp/2pb1n2/3p4/3P2b1/2NB1N1P/PPP2PP1/R1BQR1K1 b - - 0 9,Bh5,-39,-34,5,1
rn1q1rk1/pp3ppp/2pb1n2/3p3b/3P4/2NB1N1P/PPP2PP1/R1BQR1K1 w - - 1 10,g4,-27,-42,-15,1
rn1q1rk1/pp3ppp/2pb1n2/3p3b/3P2P1/2NB1N1P/PPP2P2/R1BQR1K1 b - - 0 10,Bg6,-47,-37,10,1
rn1q1rk1/pp3ppp/2pb1nb1/3p4/3P2P1/2NB1N1P/PPP2P2/R1BQR1K1 w - - 1 11,Nh4,-32,-38,-6,1
rn1q1rk1/pp3ppp/2pb1nb1/3p4/3P2PN/2NB3P/PPP2P2/R1BQR1K1 b - - 2 11,Nbd7,-43,-39,4,1
r2q1rk1/pp1n1ppp/2pb1nb1/3p4/3P2PN/2NB3P/PPP2P2/R1BQR1K1 w - - 3 12,Nxg6,-39,-110,-71,1
r2q1rk1/pp1n1ppp/2pb1nN1/3p4/3P2P1/2NB3P/PPP2P2/R1BQR1K1 b - - 0 12,fxg6,-101,-89,12,1
r2q1rk1/pp1n2pp/2pb1np1/3p4/3P2P1/2NB3P/PPP2P2/R1BQR1K1 w - - 0 13,Ne2,-96,-299,-203,0
r2q1rk1/pp1n2pp/2pb1np1/3p4/3P2P1/3B3P/PPP1NP2/R1BQR1K1 b - - 1 13,Qc7,-377,-63,314,1
r4rk1/ppqn2pp/2pb1np1/3p4/3P2P1/3B3P/PPP1NP2/R1BQR1K1 w - - 2 14,Nf4,-50,-488,-438,0
r4rk1/ppqn2pp/2pb1np1/3p4/3P1NP1/3B3P/PPP2P2/R1BQR1K1 b - - 3 14,Bxf4,-448,-471,-23,1
r4rk1/ppqn2pp/2p2np1/3p4/3P1bP1/3B3P/PPP2P2/R1BQR1K1 w - - 0 15,Re7,-469,-585,-116,0
r4rk1/ppqnR1pp/2p2np1/3p4/3P1bP1/3B3P/PPP2P2/R1BQ2K1 b - - 1 15,Bd6,-542,-620,-78,1
r4rk1/ppqnR1pp/2pb1np1/3p4/3P2P1/3B3P/PPP2P2/R1BQ2K1 w - - 2 16,Re6,-568,-565,3,1
r4rk1/ppqn2pp/2pbRnp1/3p4/3P2P1/3B3P/PPP2P2/R1BQ2K1 b - - 3 16,Rae8,-525,-523,2,1
4rrk1/ppqn2pp/2pbRnp1/3p4/3P2P1/3B3P/PPP2P2/R1BQ2K1 w - - 4 17,Rxe8,-531,-528,3,1
4Rrk1/ppqn2pp/2pb1np1/3p4/3P2P1/3B3P/PPP2P2/R1BQ2K1 b - - 0 17,Rxe8,-520,-541,-21,1
4r1k1/ppqn2pp/2pb1np1/3p4/3P2P1/3B3P/PPP2P2/R1BQ2K1 w - - 0 18,Be3,-517,-525,-8,1
4r1k1/ppqn2pp/2pb1np1/3p4/3P2P1/3BB2P/PPP2P2/R2Q2K1 b - - 1 18,Bf4,-601,-589,12,1
4r1k1/ppqn2pp/2p2np1/3p4/3P1bP1/3BB2P/PPP2P2/R2Q2K1 w - - 2 19,Qd2,-554,-638,-84,1
4r1k1/ppqn2pp/2p2np1/3p4/3P1bP1/3BB2P/PPPQ1P2/R5K1 b - - 3 19,Bxe3,-645,-586,59,1
4r1k1/ppqn2pp/2p2np1/3p4/3P2P1/3Bb2P/PPPQ1P2/R5K1 w - - 0 20,fxe3,-594,-577,17,1
4r1k1/ppqn2pp/2p2np1/3p4/3P2P1/3BP2P/PPPQ4/R5K1 b - - 0 20,Ne4,-591,-541,50,1
4r1k1/ppqn2pp/2p3p1/3p4/3Pn1P1/3BP2P/PPPQ4/R5K1 w - - 1 21,Rf1,-515,-867,-352,0
4r1k1/ppqn2pp/2p3p1/3p4/3Pn1P1/3BP2P/PPPQ4/5RK1 b - - 2 21,Qg3+,-933,-670,263,1
4r1k1/pp1n2pp/2p3p1/3p4/3Pn1P1/3BP1qP/PPPQ4/5RK1 w - - 3 22,Qg2,-566,-554,12,1
4r1k1/pp1n2pp/2p3p1/3p4/3Pn1P1/3BP1qP/PPP3Q1/5RK1 b - - 4 22,Ndf6,-570,-513,57,1
4r1k1/pp4pp/2p2np1/3p4/3Pn1P1/3BP1qP/PPP3Q1/5RK1 w - - 5 23,Bxe4,-529,-521,8,1
4r1k1/pp4pp/2p2np1/3p4/3PB1P1/4P1qP/PPP3Q1/5RK1 b - - 0 23,Nxe4,-523,-503,20,1
4r1k1/pp4pp/2p3p1/3p4/3Pn1P1/4P1qP/PPP3Q1/5RK1 w - - 0 24,Rf3,-523,-635,-112,0
4r1k1/pp4pp/2p3p1/3p4/3Pn1P1/4PRqP/PPP3Q1/6K1 b - - 1 24,Qxg2+,-600,-527,73,1
4r1k1/pp4pp/2p3p1/3p4/3Pn1P1/4PR1P/PPP3q1/6K1 w - - 0 25,Kxg2,-517,-523,-6,1
4r1k1/pp4pp/2p3p1/3p4/3Pn1P1/4PR1P/PPP3K1/8 b - - 0 25,Rf8,-515,-479,36,1
5rk1/pp4pp/2p3p1/3p4/3Pn1P1/4PR1P/PPP3K1/8 w - - 1 26,Rxf8+,-482,-482,0,1
5Rk1/pp4pp/2p3p1/3p4/3Pn1P1/4P2P/PPP3K1/8 b - - 0 26,Kxf8,-503,-483,20,1
5k2/pp4pp/2p3p1/3p4/3Pn1P1/4P2P/PPP3K1/8 w - - 0 27,b3,-480,-527,-47,1
5k2/pp4pp/2p3p1/3p4/3Pn1P1/1P2P2P/P1P3K1/8 b - - 0 27,Kf7,-528,-477,51,1
8/pp3kpp/2p3p1/3p4/3Pn1P1/1P2P2P/P1P3K1/8 w - - 1 28,c4,-493,-537,-44,1
8/pp3kpp/2p3p1/3p4/2PPn1P1/1P2P2P/P5K1/8 b - - 0 28,Kf6,-540,-460,80,1
8/pp4pp/2p2kp1/3p4/2PPn1P1/1P2P2P/P5K1/8 w - - 1 29,cxd5,-466,-535,-69,1
8/pp4pp/2p2kp1/3P4/3Pn1P1/1P2P2P/P5K1/8 b - - 0 29,cxd5,-527,-523,4,1
8/pp4pp/5kp1/3p4/3Pn1P1/1P2P2P/P5K1/8 w - - 0 30,b4,-536,-550,-14,1
8/pp4pp/5kp1/3p4/1P1Pn1P1/4P2P/P5K1/8 b - - 0 30,Kg5,-536,-507,29,1
8/pp4pp/6p1/3p2k1/1P1Pn1P1/4P2P/P5K1/8 w - - 1 31,a4,-518,-531,-13,1
8/pp4pp/6p1/3p2k1/PP1Pn1P1/4P2P/6K1/8 b - - 0 31,Kh4,-554,-495,59,1
8/pp4pp/6p1/3p4/PP1Pn1Pk/4P2P/6K1/8 w - - 1 32,b5,-532,-579,-47,1
8/pp4pp/6p1/1P1p4/P2Pn1Pk/4P2P/6K1/8 b - - 0 32,b6,-586,-548,38,1
8/p5pp/1p4p1/1P1p4/P2Pn1Pk/4P2P/6K1/8 w - - 0 33,Kf3,-558,-551,7,1
8/p5pp/1p4p1/1P1p4/P2Pn1Pk/4PK1P/8/8 b - - 1 33,g5,-549,-651,-102,0
8/p5pp/1p6/1P1p2p1/P2Pn1Pk/4PK1P/8/8 w - - 0 34,Kg2,-672,-709,-37,1
8/p5pp/1p6/1P1p2p1/P2Pn1Pk/4P2P/6K1/8 b - - 1 34,h5,-663,-714,-51,1
8/p5p1/1p6/1P1p2pp/P2Pn1Pk/4P2P/6K1/8 w - - 0 35,Kh2,-719,-719,0,1
8/p5p1/1p6/1P1p2pp/P2Pn1Pk/4P2P/7K/8 b - - 1 35,hxg4,-788,-824,-36,1
8/p5p1/1p6/1P1p2p1/P2Pn1pk/4P2P/7K/8 w - - 0 36,hxg4,-785,-825,-40,1
8/p5p1/1p6/1P1p2p1/P2Pn1Pk/4P3/7K/8 b - - 0 36,Kxg4,-839,-831,8,1
8/p5p1/1p6/1P1p2p1/P2Pn1k1/4P3/7K/8 w - - 0 37,Kg2,-870,-882,-12,1
8/p5p1/1p6/1P1p2p1/P2Pn1k1/4P3/6K1/8 b - - 1 37,Kf5,-862,-691,171,1
8/p5p1/1p6/1P1p1kp1/P2Pn3/4P3/6K1/8 w - - 2 38,Kf3,-728,-756,-28,1
8/p5p1/1p6/1P1p1kp1/P2Pn3/4PK2/8/8 b - - 3 38,g4+,-731,-677,54,1
8/p5p1/1p6/1P1p1k2/P2Pn1p1/4PK2/8/8 w - - 0 39,Kg2,-784,-910,-126,0
8/p5p1/1p6/1P1p1k2/P2Pn1p1/4P3/6K1/8 b - - 1 39,g5,-915,-689,226,1
8/p7/1p6/1P1p1kp1/P2Pn1p1/4P3/6K1/8 w - - 0 40,Kh2,-882,-882,0,1
8/p7/1p6/1P1p1kp1/P2Pn1p1/4P3/7K/8 b - - 1 40,g3+,-844,-921,-77,1
8/p7/1p6/1P1p1kp1/P2Pn3/4P1p1/7K/8 w - - 0 41,Kg2,-929,-954,-25,1
8/p7/1p6/1P1p1kp1/P2Pn3/4P1p1/6K1/8 b - - 1 41,g4,-919,-720,199,1
8/p7/1p6/1P1p1k2/P2Pn1p1/4P1p1/6K1/8 w - - 0 42,Kh1,-707,-686,21,1
8/p7/1p6/1P1p1k2/P2Pn1p1/4P1p1/8/7K b - - 1 42,Nd6,-712,-696,16,1
8/p7/1p1n4/1P1p1k2/P2P2p1/4P1p1/8/7K w - - 2 43,Kg2,-710,-667,43,1
8/p7/1p1n4/1P1p1k2/P2P2p1/4P1p1/6K1/8 b - - 3 43,Nc4,-713,-674,39,1
8/p7/1p6/1P1p1k2/P1nP2p1/4P1p1/6K1/8 w - - 4 44,e4+,-648,-737,-89,1
8/p7/1p6/1P1p1k2/P1nPP1p1/6p1/6K1/8 b - - 0 44,Kxe4,-688,-665,23,1
8/p7/1p6/1P1p4/P1nPk1p1/6p1/6K1/8 w - - 0 45,Kxg3,-737,-769,-32,1
8/p7/1p6/1P1p4/P1nPk1p1/6K1/8/8 b - - 0 45,Kxd4,-774,-651,123,1
8/p7/1p6/1P1p4/P1nk2p1/6K1/8/8 w - - 0 46,Kxg4,-734,-726,8,1
8/p7/1p6/1P1p4/P1nk2K1/8/8/8 b - - 0 46,Nb2,-785,-638,147,1
8/p7/1p6/1P1p4/P2k2K1/8/1n6/8 w - - 1 47,Kf5,-707,-731,-24,1
8/p7/1p6/1P1p1K2/P2k4/8/1n6/8 b - - 2 47,Nxa4,-747,-721,26,1
8/p7/1p6/1P1p1K2/n2k4/8/8/8 w - - 0 48,Ke6,-743,-767,-24,1
8/p7/1p2K3/1P1p4/n2k4/8/8/8 b - - 1 48,Nc3,-776,-734,42,1
8/p7/1p2K3/1P1p4/3k4/2n5/8/8 w - - 2 49,Kd6,-762,-764,-2,1
8/p7/1p1K4/1P1p4/3k4/2n5/8/8 b - - 3 49,Nxb5+,-745,-729,16,1
8/p7/1p1K4/1n1p4/3k4/8/8/8 w - - 0 50,Kc6,-768,-774,-6,1
8/p7/1pK5/1n1p4/3k4/8/8/8 b - - 1 50,Kc4,-786,-976,-190,0
8/p7/1pK5/1n1p4/2k5/8/8/8 w - - 2 51,Kb7,-984,-1010,-26,1
8/pK6/1p6/1n1p4/2k5/8/8/8 b - - 3 51,d4,-1002,-1087,-85,1
8/pK6/1p6/1n6/2kp4/8/8/8 w - - 0 52,Ka6,-1091,-1163,-72,1
8/p7/Kp6/1n6/2kp4/8/8/8 b - - 1 52,d3,-1175,-1186,-11,1
rnbqkbnr/pppppppp/8/8/8/8/PPPPPPPP/RNBQKBNR w KQkq - 0 1,d4,30,25,-5,1
rnbqkbnr/pppppppp/8/8/3P4/8/PPP1PPPP/RNBQKBNR b KQkq - 0 1,e6,24,40,16,1
rnbqkbnr/pppp1ppp/4p3/8/3P4/8/PPP1PPPP/RNBQKBNR w KQkq - 0 2,e3,35,3,-32,1
rnbqkbnr/pppp1ppp/4p3/8/3P4/4P3/PPP2PPP/RNBQKBNR b KQkq - 0 2,d5,6,8,2,1
rnbqkbnr/ppp2ppp/4p3/3p4/3P4/4P3/PPP2PPP/RNBQKBNR w KQkq - 0 3,Bd3,6,5,-1,1
rnbqkbnr/ppp2ppp/4p3/3p4/3P4/3BP3/PPP2PPP/RNBQK1NR b KQkq - 1 3,Nf6,20,10,-10,1
rnbqkb1r/ppp2ppp/4pn2/3p4/3P4/3BP3/PPP2PPP/RNBQK1NR w KQkq - 2 4,Nd2,24,18,-6,1
rnbqkb1r/ppp2ppp/4pn2/3p4/3P4/3BP3/PPPN1PPP/R1BQK1NR b KQkq - 3 4,Be7,12,24,12,1
rnbqk2r/ppp1bppp/4pn2/3p4/3P4/3BP3/PPPN1PPP/R1BQK1NR w KQkq - 4 5,f4,27,-11,-38,1
rnbqk2r/ppp1bppp/4pn2/3p4/3P1P2/3BP3/PPPN2PP/R1BQK1NR b KQkq - 0 5,O-O,-24,-17,7,1
rnbq1rk1/ppp1bppp/4pn2/3p4/3P1P2/3BP3/PPPN2PP/R1BQK1NR w KQ - 1 6,Ngf3,-21,-20,1,1
rnbq1rk1/ppp1bppp/4pn2/3p4/3P1P2/3BPN2/PPPN2PP/R1BQK2R b KQ - 2 6,c5,-23,-27,-4,1
rnbq1rk1/pp2bppp/4pn2/2pp4/3P1P2/3BPN2/PPPN2PP/R1BQK2R w KQ - 0 7,c3,-28,-26,2,1
rnbq1rk1/pp2bppp/4pn2/2pp4/3P1P2/2PBPN2/PP1N2PP/R1BQK2R b KQ - 0 7,c4,-35,-3,32,1
rnbq1rk1/pp2bppp/4pn2/3p4/2pP1P2/2PBPN2/PP1N2PP/R1BQK2R w KQ - 0 8,Bc2,15,8,-7,1
rnbq1rk1/pp2bppp/4pn2/3p4/2pP1P2/2P1PN2/PPBN2PP/R1BQK2R b KQ - 1 8,Nc6,11,38,27,1
r1bq1rk1/pp2bppp/2n1pn2/3p4/2pP1P2/2P1PN2/PPBN2PP/R1BQK2R w KQ - 2 9,O-O,47,42,-5,1
r1bq1rk1/pp2bppp/2n1pn2/3p4/2pP1P2/2P1PN2/PPBN2PP/R1BQ1RK1 b - - 3 9,b5,46,50,4,1
r1bq1rk1/p3bppp/2n1pn2/1p1p4/2pP1P2/2P1PN2/PPBN2PP/R1BQ1RK1 w - - 0 10,Ne5,45,15,-30,1
r1bq1rk1/p3bppp/2n1pn2/1p1pN3/2pP1P2/2P1P3/PPBN2PP/R1BQ1RK1 b - - 1 10,Nxe5,27,104,77,1
r1bq1rk1/p3bppp/4pn2/1p1pn3/2pP1P2/2P1P3/PPBN2PP/R1BQ1RK1 w - - 0 11,fxe5,87,78,-9,1
r1bq1rk1/p3bppp/4pn2/1p1pP3/2pP4/2P1P3/PPBN2PP/R1BQ1RK1 b - - 0 11,Nd7,88,157,69,1
r1bq1rk1/p2nbppp/4p3/1p1pP3/2pP4/2P1P3/PPBN2PP/R1BQ1RK1 w - - 1 12,Rf3,149,-22,-171,0
r1bq1rk1/p2nbppp/4p3/1p1pP3/2pP4/2P1PR2/PPBN2PP/R1BQ2K1 b - - 2 12,f5,0,53,53,1
r1bq1rk1/p2nb1pp/4p3/1p1pPp2/2pP4/2P1PR2/PPBN2PP/R1BQ2K1 w - f6 0 13,exf6,69,-35,-104,0
r1bq1rk1/p2nb1pp/4pP2/1p1p4/2pP4/2P1PR2/PPBN2PP/R1BQ2K1 b - - 0 13,Nxf6,-46,-34,12,1
r1bq1rk1/p3b1pp/4pn2/1p1p4/2pP4/2P1PR2/PPBN2PP/R1BQ2K1 w - - 0 14,Rf1,-38,-34,4,1
r1bq1rk1/p3b1pp/4pn2/1p1p4/2pP4/2P1P3/PPBN2PP/R1BQ1RK1 b - - 1 14,Bd6,-50,-44,6,1
r1bq1rk1/p5pp/3bpn2/1p1p4/2pP4/2P1P3/PPBN2PP/R1BQ1RK1 w - - 2 15,e4,-39,-68,-29,1
r1bq1rk1/p5pp/3bpn2/1p1p4/2pPP3/2P5/PPBN2PP/R1BQ1RK1 b - - 0 15,dxe4,-59,116,175,1
r1bq1rk1/p5pp/3bpn2/1p6/2pPp3/2P5/PPBN2PP/R1BQ1RK1 w - - 0 16,Nxe4,94,83,-11,1
r1bq1rk1/p5pp/3bpn2/1p6/2pPN3/2P5/PPB3PP/R1BQ1RK1 b - - 0 16,Nxe4,94,173,79,1
r1bq1rk1/p5pp/3bp3/1p6/2pPn3/2P5/PPB3PP/R1BQ1RK1 w - - 0 17,Bxe4,183,-93,-276,0
r1bq1rk1/p5pp/3bp3/1p6/2pPB3/2P5/PP4PP/R1BQ1RK1 b - - 0 17,Rxf1+,-93,15,108,1
r1bq2k1/p5pp/3bp3/1p6/2pPB3/2P5/PP4PP/R1BQ1rK1 w - - 0 18,Qxf1,17,-293,-310,0
r1bq2k1/p5pp/3bp3/1p6/2pPB3/2P5/PP4PP/R1B2QK1 b - - 0 18,Rb8,-288,101,389,1
1rbq2k1/p5pp/3bp3/1p6/2pPB3/2P5/PP4PP/R1B2QK1 w - - 1 19,Qe2,110,81,-29,1
1rbq2k1/p5pp/3bp3/1p6/2pPB3/2P5/PP2Q1PP/R1B3K1 b - - 2 19,Qh4,70,129,59,1
1rb3k1/p5pp/3bp3/1p6/2pPB2q/2P5/PP2Q1PP/R1B3K1 w - - 3 20,g3,88,131,43,1
1rb3k1/p5pp/3bp3/1p6/2pPB2q/2P3P1/PP2Q2P/R1B3K1 b - - 0 20,Bxg3,139,227,88,1
1rb3k1/p5pp/4p3/1p6/2pPB2q/2P3b1/PP2Q2P/R1B3K1 w - - 0 21,hxg3,256,260,4,1
1rb3k1/p5pp/4p3/1p6/2pPB2q/2P3P1/PP2Q3/R1B3K1 b - - 0 21,Qxg3+,257,256,-1,1
1rb3k1/p5pp/4p3/1p6/2pPB3/2P3q1/PP2Q3/R1B3K1 w - - 0 22,Qg2,232,0,-232,0
1rb3k1/p5pp/4p3/1p6/2pPB3/2P3q1/PP4Q1/R1B3K1 b - - 1 22,Qe1+,0,0,0,1
1rb3k1/p5pp/4p3/1p6/2pPB3/2P5/PP4Q1/R1B1q1K1 w - - 2 23,Kh2,0,0,0,1
1rb3k1/p5pp/4p3/1p6/2pPB3/2P5/PP4QK/R1B1q3 b - - 3 23,e5,0,202,202,1
1rb3k1/p5pp/8/1p2p3/2pPB3/2P5/PP4QK/R1B1q3 w - - 0 24,Bd5+,193,225,32,1
1rb3k1/p5pp/8/1p1Bp3/2pP4/2P5/PP4QK/R1B1q3 b - - 1 24,Kh8,236,223,-13,1
1rb4k/p5pp/8/1p1Bp3/2pP4/2P5/PP4QK/R1B1q3 w - - 2 25,dxe5,237,70,-167,0
1rb4k/p5pp/8/1p1BP3/2p5/2P5/PP4QK/R1B1q3 b - - 0 25,Rb6,52,149,97,1
2b4k/p5pp/1r6/1p1BP3/2p5/2P5/PP4QK/R1B1q3 w - - 1 26,e6,167,0,-167,0
2b4k/p5pp/1r2P3/1p1B4/2p5/2P5/PP4QK/R1B1q3 b - - 0 26,Bxe6,0,0,0,1
7k/p5pp/1r2b3/1p1B4/2p5/2P5/PP4QK/R1B1q3 w - - 0 27,Bxe6,0,0,0,1
7k/p5pp/1r2B3/1p6/2p5/2P5/PP4QK/R1B1q3 b - - 0 27,Rxe6,0,0,0,1
7k/p5pp/4r3/1p6/2p5/2P5/PP4QK/R1B1q3 w - - 0 28,Qa8+,0,-252,-252,0
Q6k/p5pp/4r3/1p6/2p5/2P5/PP5K/R1B1q3 b - - 1 28,Re8,-149,-131,18,1
Q3r2k/p5pp/8/1p6/2p5/2P5/PP5K/R1B1q3 w - - 2 29,Qf3,-132,-179,-47,1
4r2k/p5pp/8/1p6/2p5/2P2Q2/PP5K/R1B1q3 b - - 3 29,Qh4+,-163,-76,87,1
4r2k/p5pp/8/1p6/2p4q/2P2Q2/PP5K/R1B5 w - - 4 30,Qh3,-76,-9997,-9921,0
4r2k/p5pp/8/1p6/2p4q/2P4Q/PP5K/R1B5 b - - 5 30,Re2+,-9997,-9998,-1,1
7k/p5pp/8/1p6/2p4q/2P4Q/PP2r2K/R1B5 w - - 6 31,Kg1,-9998,-9998,0,1
rnbqkbnr/pppppppp/8/8/8/8/PPPPPPPP/RNBQKBNR w KQkq - 0 1,d4,32,24,-8,1
rnbqkbnr/pppppppp/8/8/3P4/8/PPP1PPPP/RNBQKBNR b KQkq - 0 1,c5,29,59,30,1
rnbqkbnr/pp1ppppp/8/2p5/3P4/8/PPP1PPPP/RNBQKBNR w KQkq - 0 2,c3,70,30,-40,1
rnbqkbnr/pp1ppppp/8/2p5/3P4/2P5/PP2PPPP/RNBQKBNR b KQkq - 0 2,cxd4,25,21,-4,1
rnbqkbnr/pp1ppppp/8/8/3p4/2P5/PP2PPPP/RNBQKBNR w KQkq - 0 3,cxd4,22,29,7,1
rnbqkbnr/pp1ppppp/8/8/3P4/8/PP2PPPP/RNBQKBNR b KQkq - 0 3,d5,30,27,-3,1
rnbqkbnr/pp2pppp/8/3p4/3P4/8/PP2PPPP/RNBQKBNR w KQkq - 0 4,Nf3,30,25,-5,1
rnbqkbnr/pp2pppp/8/3p4/3P4/5N2/PP2PPPP/RNBQKB1R b KQkq - 1 4,Nc6,25,29,4,1
r1bqkbnr/pp2pppp/2n5/3p4/3P4/5N2/PP2PPPP/RNBQKB1R w KQkq - 2 5,Nc3,26,22,-4,1
r1bqkbnr/pp2pppp/2n5/3p4/3P4/2N2N2/PP2PPPP/R1BQKB1R b KQkq - 3 5,e6,26,29,3,1
r1bqkbnr/pp3ppp/2n1p3/3p4/3P4/2N2N2/PP2PPPP/R1BQKB1R w KQkq - 0 6,Bf4,33,34,1,1
r1bqkbnr/pp3ppp/2n1p3/3p4/3P1B2/2N2N2/PP2PPPP/R2QKB1R b KQkq - 1 6,Nf6,21,30,9,1
r1bqkb1r/pp3ppp/2n1pn2/3p4/3P1B2/2N2N2/PP2PPPP/R2QKB1R w KQkq - 2 7,e3,34,33,-1,1
r1bqkb1r/pp3ppp/2n1pn2/3p4/3P1B2/2N1PN2/PP3PPP/R2QKB1R b KQkq - 0 7,Bd6,32,27,-5,1
r1bqk2r/pp3ppp/2nbpn2/3p4/3P1B2/2N1PN2/PP3PPP/R2QKB1R w KQkq - 1 8,Bg5,37,28,-9,1
r1bqk2r/pp3ppp/2nbpn2/3p2B1/3P4/2N1PN2/PP3PPP/R2QKB1R b KQkq - 2 8,Be7,34,37,3,1
r1bqk2r/pp2bppp/2n1pn2/3p2B1/3P4/2N1PN2/PP3PPP/R2QKB1R w KQkq - 3 9,Bd3,37,43,6,1
r1bqk2r/pp2bppp/2n1pn2/3p2B1/3P4/2NBPN2/PP3PPP/R2QK2R b KQkq - 4 9,O-O,39,43,4,1
r1bq1rk1/pp2bppp/2n1pn2/3p2B1/3P4/2NBPN2/PP3PPP/R2QK2R w KQ - 5 10,Qc2,47,-7,-54,1
r1bq1rk1/pp2bppp/2n1pn2/3p2B1/3P4/2NBPN2/PPQ2PPP/R3K2R b KQ - 6 10,h6,-7,-7,0,1
r1bq1rk1/pp2bpp1/2n1pn1p/3p2B1/3P4/2NBPN2/PPQ2PPP/R3K2R w KQ - 0 11,Bh4,-1,-10,-9,1
r1bq1rk1/pp2bpp1/2n1pn1p/3p4/3P3B/2NBPN2/PPQ2PPP/R3K2R b KQ - 1 11,Nb4,-13,-7,6,1
r1bq1rk1/pp2bpp1/4pn1p/3p4/1n1P3B/2NBPN2/PPQ2PPP/R3K2R w KQ - 2 12,Qd2,-11,-13,-2,1
r1bq1rk1/pp2bpp1/4pn1p/3p4/1n1P3B/2NBPN2/PP1Q1PPP/R3K2R b KQ - 3 12,Nxd3+,-20,-5,15,1
r1bq1rk1/pp2bpp1/4pn1p/3p4/3P3B/2NnPN2/PP1Q1PPP/R3K2R w KQ - 0 13,Qxd3,-6,-3,3,1
r1bq1rk1/pp2bpp1/4pn1p/3p4/3P3B/2NQPN2/PP3PPP/R3K2R b KQ - 0 13,Bd7,-12,-9,3,1
r2q1rk1/pp1bbpp1/4pn1p/3p4/3P3B/2NQPN2/PP3PPP/R3K2R w KQ - 1 14,h3,-4,-20,-16,1
r2q1rk1/pp1bbpp1/4pn1p/3p4/3P3B/2NQPN1P/PP3PP1/R3K2R b KQ - 0 14,a6,-19,10,29,1
r2q1rk1/1p1bbpp1/p3pn1p/3p4/3P3B/2NQPN1P/PP3PP1/R3K2R w KQ - 0 15,Bg3,7,-156,-163,0
r2q1rk1/1p1bbpp1/p3pn1p/3p4/3P4/2NQPNBP/PP3PP1/R3K2R b KQ - 1 15,b5,-105,-50,55,1
r2q1rk1/3bbpp1/p3pn1p/1p1p4/3P4/2NQPNBP/PP3PP1/R3K2R w KQ - 0 16,a3,-50,-72,-22,1
r2q1rk1/3bbpp1/p3pn1p/1p1p4/3P4/P1NQPNBP/1P3PP1/R3K2R b KQ - 0 16,Rb8,-77,279,356,1
1r1q1rk1/3bbpp1/p3pn1p/1p1p4/3P4/P1NQPNBP/1P3PP1/R3K2R w KQ - 1 17,Bxb8,277,256,-21,1
1B1q1rk1/3bbpp1/p3pn1p/1p1p4/3P4/P1NQPN1P/1P3PP1/R3K2R b KQ - 0 17,Qxb8,236,247,11,1
1q3rk1/3bbpp1/p3pn1p/1p1p4/3P4/P1NQPN1P/1P3PP1/R3K2R w KQ - 0 18,O-O,265,260,-5,1
1q3rk1/3bbpp1/p3pn1p/1p1p4/3P4/P1NQPN1P/1P3PP1/R4RK1 b - - 1 18,b4,251,321,70,1
1q3rk1/3bbpp1/p3pn1p/3p4/1p1P4/P1NQPN1P/1P3PP1/R4RK1 w - - 0 19,axb4,329,342,13,1
1q3rk1/3bbpp1/p3pn1p/3p4/1P1P4/2NQPN1P/1P3PP1/R4RK1 b - - 0 19,Bxb4,321,327,6,1
1q3rk1/3b1pp1/p3pn1p/3p4/1b1P4/2NQPN1P/1P3PP1/R4RK1 w - - 0 20,Rab1,324,258,-66,1
1q3rk1/3b1pp1/p3pn1p/3p4/1b1P4/2NQPN1P/1P3PP1/1R3RK1 b - - 1 20,Bb5,271,328,57,1
1q3rk1/5pp1/p3pn1p/1b1p4/1b1P4/2NQPN1P/1P3PP1/1R3RK1 w - - 2 21,Qd2,321,-119,-440,0
1q3rk1/5pp1/p3pn1p/1b1p4/1b1P4/2N1PN1P/1P1Q1PP1/1R3RK1 b - - 3 21,Bxf1,-145,-64,81,1
1q3rk1/5pp1/p3pn1p/3p4/1b1P4/2N1PN1P/1P1Q1PP1/1R3bK1 w - - 0 22,Rxf1,-65,-59,6,1
1q3rk1/5pp1/p3pn1p/3p4/1b1P4/2N1PN1P/1P1Q1PP1/5RK1 b - - 0 22,Ne4,-86,-64,22,1
1q3rk1/5pp1/p3p2p/3p4/1b1Pn3/2N1PN1P/1P1Q1PP1/5RK1 w - - 1 23,Qc2,-54,-137,-83,1
1q3rk1/5pp1/p3p2p/3p4/1b1Pn3/2N1PN1P/1PQ2PP1/5RK1 b - - 2 23,Rc8,-124,-118,6,1
1qr3k1/5pp1/p3p2p/3p4/1b1Pn3/2N1PN1P/1PQ2PP1/5RK1 w - - 3 24,Rc1,-81,-214,-133,0
1qr3k1/5pp1/p3p2p/3p4/1b1Pn3/2N1PN1P/1PQ2PP1/2R3K1 b - - 4 24,Qc7,-253,-75,178,1
2r3k1/2q2pp1/p3p2p/3p4/1b1Pn3/2N1PN1P/1PQ2PP1/2R3K1 w - - 5 25,Qb3,-58,-91,-33,1
2r3k1/2q2pp1/p3p2p/3p4/1b1Pn3/1QN1PN1P/1P3PP1/2R3K1 b - - 6 25,Nxc3,-99,-70,29,1
2r3k1/2q2pp1/p3p2p/3p4/1b1P4/1Qn1PN1P/1P3PP1/2R3K1 w - - 0 26,bxc3,-65,-78,-13,1
2r3k1/2q2pp1/p3p2p/3p4/1b1P4/1QP1PN1P/5PP1/2R3K1 b - - 0 26,Bxc3,-72,63,135,1
2r3k1/2q2pp1/p3p2p/3p4/3P4/1Qb1PN1P/5PP1/2R3K1 w - - 0 27,Ne5,60,81,21,1
2r3k1/2q2pp1/p3p2p/3pN3/3P4/1Qb1P2P/5PP1/2R3K1 b - - 1 27,Qa5,65,56,-9,1
2r3k1/5pp1/p3p2p/q2pN3/3P4/1Qb1P2P/5PP1/2R3K1 w - - 2 28,Nd3,78,63,-15,1
2r3k1/5pp1/p3p2p/q2p4/3P4/1QbNP2P/5PP1/2R3K1 b - - 3 28,Rc6,61,85,24,1
6k1/5pp1/p1r1p2p/q2p4/3P4/1QbNP2P/5PP1/2R3K1 w - - 4 29,Nb4,80,-36,-116,0
6k1/5pp1/p1r1p2p/q2p4/1N1P4/1Qb1P2P/5PP1/2R3K1 b - - 5 29,Rc8,-10,334,344,1
2r3k1/5pp1/p3p2p/q2p4/1N1P4/1Qb1P2P/5PP1/2R3K1 w - - 6 30,Nc2,314,-164,-478,0
rnbqkbnr/pppppppp/8/8/8/8/PPPPPPPP/RNBQKBNR w KQkq - 0 1,e4,46,32,-14,1
rnbqkbnr/pppppppp/8/8/4P3/8/PPPP1PPP/RNBQKBNR b KQkq - 0 1,d5,40,76,36,1
rnbqkbnr/ppp1pppp/8/3p4/4P3/8/PPPP1PPP/RNBQKBNR w KQkq - 0 2,e5,83,0,-83,1
rnbqkbnr/ppp1pppp/8/3pP3/8/8/PPPP1PPP/RNBQKBNR b KQkq - 0 2,Nc6,2,44,42,1
r1bqkbnr/ppp1pppp/2n5/3pP3/8/8/PPPP1PPP/RNBQKBNR w KQkq - 1 3,d4,58,50,-8,1
r1bqkbnr/ppp1pppp/2n5/3pP3/3P4/8/PPP2PPP/RNBQKBNR b KQkq - 0 3,f6,42,56,14,1
r1bqkbnr/ppp1p1pp/2n2p2/3pP3/3P4/8/PPP2PPP/RNBQKBNR w KQkq - 0 4,exf6,62,3,-59,1
r1bqkbnr/ppp1p1pp/2n2P2/3p4/3P4/8/PPP2PPP/RNBQKBNR b KQkq - 0 4,Nxf6,-16,2,18,1
r1bqkb1r/ppp1p1pp/2n2n2/3p4/3P4/8/PPP2PPP/RNBQKBNR w KQkq - 0 5,Bg5,6,-57,-63,1
r1bqkb1r/ppp1p1pp/2n2n2/3p2B1/3P4/8/PPP2PPP/RN1QKBNR b KQkq - 1 5,Qd6,-53,-11,42,1
r1b1kb1r/ppp1p1pp/2nq1n2/3p2B1/3P4/8/PPP2PPP/RN1QKBNR w KQkq - 2 6,Bxf6,1,-72,-73,1
r1b1kb1r/ppp1p1pp/2nq1B2/3p4/3P4/8/PPP2PPP/RN1QKBNR b KQkq - 0 6,Qxf6,-81,-66,15,1
r1b1kb1r/ppp1p1pp/2n2q2/3p4/3P4/8/PPP2PPP/RN1QKBNR w KQkq - 0 7,Bb5,-77,-98,-21,1
r1b1kb1r/ppp1p1pp/2n2q2/1B1p4/3P4/8/PPP2PPP/RN1QK1NR b KQkq - 1 7,a6,-98,-40,58,1
r1b1kb1r/1pp1p1pp/p1n2q2/1B1p4/3P4/8/PPP2PPP/RN1QK1NR w KQkq - 0 8,Bxc6+,-30,-47,-17,1
r1b1kb1r/1pp1p1pp/p1B2q2/3p4/3P4/8/PPP2PPP/RN1QK1NR b KQkq - 0 8,Qxc6,-48,-35,13,1
r1b1kb1r/1pp1p1pp/p1q5/3p4/3P4/8/PPP2PPP/RN1QK1NR w KQkq - 0 9,Ne2,-41,-61,-20,1
r1b1kb1r/1pp1p1pp/p1q5/3p4/3P4/8/PPP1NPPP/RN1QK2R b KQkq - 1 9,Qg6,-58,-33,25,1
r1b1kb1r/1pp1p1pp/p5q1/3p4/3P4/8/PPP1NPPP/RN1QK2R w KQkq - 2 10,Ng3,-26,-132,-106,0
r1b1kb1r/1pp1p1pp/p5q1/3p4/3P4/6N1/PPP2PPP/RN1QK2R b KQkq - 3 10,Bg4,-161,-106,55,1
r3kb1r/1pp1p1pp/p5q1/3p4/3P2b1/6N1/PPP2PPP/RN1QK2R w KQkq - 4 11,Qd3,-112,-94,18,1
r3kb1r/1pp1p1pp/p5q1/3p4/3P2b1/3Q2N1/PPP2PPP/RN2K2R b KQkq - 5 11,Qe6+,-92,-83,9,1
r3kb1r/1pp1p1pp/p3q3/3p4/3P2b1/3Q2N1/PPP2PPP/RN2K2R w KQkq - 6 12,Ne2,-79,-88,-9,1
r3kb1r/1pp1p1pp/p3q3/3p4/3P2b1/3Q4/PPP1NPPP/RN2K2R b KQkq - 7 12,g5,-79,-58,21,1
r3kb1r/1pp1p2p/p3q3/3p2p1/3P2b1/3Q4/PPP1NPPP/RN2K2R w KQkq - 0 13,Nc3,-57,-90,-33,1
r3kb1r/1pp1p2p/p3q3/3p2p1/3P2b1/2NQ4/PPP1NPPP/R3K2R b KQkq - 1 13,Bg7,-93,-73,20,1
r3k2r/1pp1p1bp/p3q3/3p2p1/3P2b1/2NQ4/PPP1NPPP/R3K2R w KQkq - 2 14,O-O,-73,-94,-21,1
r3k2r/1pp1p1bp/p3q3/3p2p1/3P2b1/2NQ4/PPP1NPPP/R4RK1 b kq - 3 14,h5,-105,3,108,1
r3k2r/1pp1p1b1/p3q3/3p2pp/3P2b1/2NQ4/PPP1NPPP/R4RK1 w kq - 0 15,Rfe1,7,-102,-109,0
r3k2r/1pp1p1b1/p3q3/3p2pp/3P2b1/2NQ4/PPP1NPPP/R3R1K1 b kq - 1 15,h4,-110,196,306,1
r3k2r/1pp1p1b1/p3q3/3p2p1/3P2bp/2NQ4/PPP1NPPP/R3R1K1 w kq - 0 16,Nf4,237,215,-22,1
r3k2r/1pp1p1b1/p3q3/3p2p1/3P1Nbp/2NQ4/PPP2PPP/R3R1K1 b kq - 1 16,gxf4,224,429,205,1
r3k2r/1pp1p1b1/p3q3/3p4/3P1pbp/2NQ4/PPP2PPP/R3R1K1 w kq - 0 17,Rxe6,456,349,-107,0
r3k2r/1pp1p1b1/p3R3/3p4/3P1pbp/2NQ4/PPP2PPP/R5K1 b kq - 0 17,h3,370,601,231,1
r3k2r/1pp1p1b1/p3R3/3p4/3P1pb1/2NQ3p/PPP2PPP/R5K1 w kq - 0 18,Qg6+,612,638,26,1
r3k2r/1pp1p1b1/p3R1Q1/3p4/3P1pb1/2N4p/PPP2PPP/R5K1 b kq - 1 18,Kd7,683,683,0,1
r6r/1ppkp1b1/p3R1Q1/3p4/3P1pb1/2N4p/PPP2PPP/R5K1 w - - 2 19,Qxg4,650,671,21,1
r6r/1ppkp1b1/p3R3/3p4/3P1pQ1/2N4p/PPP2PPP/R5K1 b - - 0 19,hxg2,654,917,263,1
r6r/1ppkp1b1/p3R3/3p4/3P1pQ1/2N5/PPP2PpP/R5K1 w - - 0 20,Rg6+,869,751,-118,0
r6r/1ppkp1b1/p5R1/3p4/3P1pQ1/2N5/PPP2PpP/R5K1 b - - 1 20,Kd8,739,842,103,1
r2k3r/1pp1p1b1/p5R1/3p4/3P1pQ1/2N5/PPP2PpP/R5K1 w - - 2 21,Rxg7,832,822,-10,1
r2k3r/1pp1p1R1/p7/3p4/3P1pQ1/2N5/PPP2PpP/R5K1 b - - 0 21,c6,855,886,31,1
r2k3r/1p2p1R1/p1p5/3p4/3P1pQ1/2N5/PPP2PpP/R5K1 w - - 0 22,Rg8+,934,788,-146,0
r2k2Rr/1p2p3/p1p5/3p4/3P1pQ1/2N5/PPP2PpP/R5K1 b - - 1 22,Kc7,798,862,64,1
r5Rr/1pk1p3/p1p5/3p4/3P1pQ1/2N5/PPP2PpP/R5K1 w - - 2 23,Qxf4+,867,904,37,1
r5Rr/1pk1p3/p1p5/3p4/3P1Q2/2N5/PPP2PpP/R5K1 b - - 0 23,Kb6,803,886,83,1
r5Rr/1p2p3/pkp5/3p4/3P1Q2/2N5/PPP2PpP/R5K1 w - - 1 24,Na4+,862,807,-55,1
r5Rr/1p2p3/pkp5/3p4/N2P1Q2/8/PPP2PpP/R5K1 b - - 2 24,Ka7,800,845,45,1
r5Rr/kp2p3/p1p5/3p4/N2P1Q2/8/PPP2PpP/R5K1 w - - 3 25,Rxa8+,864,830,-34,1
R6r/kp2p3/p1p5/3p4/N2P1Q2/8/PPP2PpP/R5K1 b - - 0 25,Rxa8,829,868,39,1
r7/kp2p3/p1p5/3p4/N2P1Q2/8/PPP2PpP/R5K1 w - - 0 26,Qg4,884,872,-12,1
r7/kp2p3/p1p5/3p4/N2P2Q1/8/PPP2PpP/R5K1 b - - 1 26,b5,880,9997,9117,1
r7/k3p3/p1p5/1p1p4/N2P2Q1/8/PPP2PpP/R5K1 w - - 0 27,Nc3,9997,871,-9126,0
r7/k3p3/p1p5/1p1p4/3P2Q1/2N5/PPP2PpP/R5K1 b - - 1 27,b4,850,886,36,1
r7/k3p3/p1p5/3p4/1p1P2Q1/2N5/PPP2PpP/R5K1 w - - 0 28,Ne2,955,855,-100,1
r7/k3p3/p1p5/3p4/1p1P2Q1/8/PPP1NPpP/R5K1 b - - 1 28,a5,858,875,17,1
r7/k3p3/2p5/p2p4/1p1P2Q1/8/PPP1NPpP/R5K1 w - - 0 29,Qxg2,851,840,-11,1
r7/k3p3/2p5/p2p4/1p1P4/8/PPP1NPQP/R5K1 b - - 0 29,a4,850,846,-4,1
r7/k3p3/2p5/3p4/pp1P4/8/PPP1NPQP/R5K1 w - - 0 30,Qg7,850,852,2,1
r7/k3p1Q1/2p5/3p4/pp1P4/8/PPP1NP1P/R5K1 b - - 1 30,Rb8,840,861,21,1
1r6/k3p1Q1/2p5/3p4/pp1P4/8/PPP1NP1P/R5K1 w - - 2 31,Qxe7+,886,859,-27,1
1r6/k3Q3/2p5/3p4/pp1P4/8/PPP1NP1P/R5K1 b - - 0 31,Rb7,858,842,-16,1
8/kr2Q3/2p5/3p4/pp1P4/8/PPP1NP1P/R5K1 w - - 1 32,Qc5+,866,883,17,1
8/kr6/2p5/2Qp4/pp1P4/8/PPP1NP1P/R5K1 b - - 2 32,Kb8,881,895,14,1
1k6/1r6/2p5/2Qp4/pp1P4/8/PPP1NP1P/R5K1 w - - 3 33,Qxc6,895,865,-30,1
1k6/1r6/2Q5/3p4/pp1P4/8/PPP1NP1P/R5K1 b - - 0 33,Ka8,883,907,24,1
k7/1r6/2Q5/3p4/pp1P4/8/PPP1NP1P/R5K1 w - - 1 34,Qxd5,907,872,-35,1
k7/1r6/8/3Q4/pp1P4/8/PPP1NP1P/R5K1 b - - 0 34,Kb8,911,914,3,1
1k6/1r6/8/3Q4/pp1P4/8/PPP1NP1P/R5K1 w - - 1 35,f4,924,839,-85,1
1k6/1r6/8/3Q4/pp1P1P2/8/PPP1N2P/R5K1 b - - 0 35,Ka8,852,908,56,1
k7/1r6/8/3Q4/pp1P1P2/8/PPP1N2P/R5K1 w - - 1 36,f5,902,854,-48,1
k7/1r6/8/3Q1P2/pp1P4/8/PPP1N2P/R5K1 b - - 0 36,Kb8,854,889,35,1
1k6/1r6/8/3Q1P2/pp1P4/8/PPP1N2P/R5K1 w - - 1 37,h4,899,848,-51,1
1k6/1r6/8/3Q1P2/pp1P3P/8/PPP1N3/R5K1 b - - 0 37,Ka8,843,897,54,1
k7/1r6/8/3Q1P2/pp1P3P/8/PPP1N3/R5K1 w - - 1 38,h5,888,886,-2,1
k7/1r6/8/3Q1P1P/pp1P4/8/PPP1N3/R5K1 b - - 0 38,Kb8,894,894,0,1
1k6/1r6/8/3Q1P1P/pp1P4/8/PPP1N3/R5K1 w - - 1 39,h6,887,877,-10,1
1k6/1r6/7P/3Q1P2/pp1P4/8/PPP1N3/R5K1 b - - 0 39,Ka8,906,9997,9091,1
k7/1r6/7P/3Q1P2/pp1P4/8/PPP1N3/R5K1 w - - 1 40,f6,9997,939,-9058,0
k7/1r6/5P1P/3Q4/pp1P4/8/PPP1N3/R5K1 b - - 0 40,Kb8,961,980,19,1
1k6/1r6/5P1P/3Q4/pp1P4/8/PPP1N3/R5K1 w - - 1 41,f7,948,1172,224,1
1k6/1r3P2/7P/3Q4/pp1P4/8/PPP1N3/R5K1 b - - 0 41,Ka7,9995,9998,3,1
8/kr3P2/7P/3Q4/pp1P4/8/PPP1N3/R5K1 w - - 1 42,f8=Q,9998,9997,-1,1
5Q2/kr6/7P/3Q4/pp1P4/8/PPP1N3/R5K1 b - - 0 42,Rb8,9997,9997,0,1
1r3Q2/k7/7P/3Q4/pp1P4/8/PPP1N3/R5K1 w - - 1 43,Qa5+,9997,9998,1,1
1r3Q2/k7/7P/Q7/pp1P4/8/PPP1N3/R5K1 b - - 2 43,Kb7,9998,9998,0,1
1r3Q2/1k6/7P/Q7/pp1P4/8/PPP1N3/R5K1 w - - 3 44,Qe7+,9998,9999,1,1
1r6/1k2Q3/7P/Q7/pp1P4/8/PPP1N3/R5K1 b - - 4 44,Kc8,9999,9999,0,1
1rk5/4Q3/7P/Q7/pp1P4/8/PPP1N3/R5K1 w - - 5 45,Qac5#,9999,10000,1,1
rnbqkbnr/pppppppp/8/8/8/8/PPPPPPPP/RNBQKBNR w KQkq - 0 1,d4,39,22,-17,1
rnbqkbnr/pppppppp/8/8/3P4/8/PPP1PPPP/RNBQKBNR b KQkq - 0 1,Nf6,24,29,5,1
rnbqkb1r/pppppppp/5n2/8/3P4/8/PPP1PPPP/RNBQKBNR w KQkq - 1 2,h3,30,-16,-46,1
rnbqkb1r/pppppppp/5n2/8/3P4/7P/PPP1PPP1/RNBQKBNR b KQkq - 0 2,b6,-13,11,24,1
rnbqkb1r/p1pppppp/1p3n2/8/3P4/7P/PPP1PPP1/RNBQKBNR w KQkq - 0 3,a3,21,8,-13,1
rnbqkb1r/p1pppppp/1p3n2/8/3P4/P6P/1PP1PPP1/RNBQKBNR b KQkq - 0 3,Bb7,6,4,-2,1
rn1qkb1r/pbpppppp/1p3n2/8/3P4/P6P/1PP1PPP1/RNBQKBNR w KQkq - 1 4,e3,5,-7,-12,1
rn1qkb1r/pbpppppp/1p3n2/8/3P4/P3P2P/1PP2PP1/RNBQKBNR b KQkq - 0 4,e6,-8,-9,-1,1
rn1qkb1r/pbpp1ppp/1p2pn2/8/3P4/P3P2P/1PP2PP1/RNBQKBNR w KQkq - 0 5,Nd2,-13,-18,-5,1
rn1qkb1r/pbpp1ppp/1p2pn2/8/3P4/P3P2P/1PPN1PP1/R1BQKBNR b KQkq - 1 5,c5,-13,-19,-6,1
rn1qkb1r/pb1p1ppp/1p2pn2/2p5/3P4/P3P2P/1PPN1PP1/R1BQKBNR w KQkq - 0 6,c3,-15,-38,-23,1
rn1qkb1r/pb1p1ppp/1p2pn2/2p5/3P4/P1P1P2P/1P1N1PP1/R1BQKBNR b KQkq - 0 6,Bd6,-44,-8,36,1
rn1qk2r/pb1p1ppp/1p1bpn2/2p5/3P4/P1P1P2P/1P1N1PP1/R1BQKBNR w KQkq - 1 7,Ngf3,-8,-7,1,1
rn1qk2r/pb1p1ppp/1p1bpn2/2p5/3P4/P1P1PN1P/1P1N1PP1/R1BQKB1R b KQkq - 2 7,Ne4,-24,68,92,1
rn1qk2r/pb1p1ppp/1p1bp3/2p5/3Pn3/P1P1PN1P/1P1N1PP1/R1BQKB1R w KQkq - 3 8,Be2,64,-4,-68,1
rn1qk2r/pb1p1ppp/1p1bp3/2p5/3Pn3/P1P1PN1P/1P1NBPP1/R1BQK2R b KQkq - 4 8,Nxd2,19,24,5,1
rn1qk2r/pb1p1ppp/1p1bp3/2p5/3P4/P1P1PN1P/1P1nBPP1/R1BQK2R w KQkq - 0 9,Qxd2,25,14,-11,1
rn1qk2r/pb1p1ppp/1p1bp3/2p5/3P4/P1P1PN1P/1P1QBPP1/R1B1K2R b KQkq - 0 9,Bc7,17,49,32,1
rn1qk2r/pbbp1ppp/1p2p3/2p5/3P4/P1P1PN1P/1P1QBPP1/R1B1K2R w KQkq - 1 10,O-O,35,27,-8,1
rn1qk2r/pbbp1ppp/1p2p3/2p5/3P4/P1P1PN1P/1P1QBPP1/R1B2RK1 b kq - 2 10,O-O,18,26,8,1
rn1q1rk1/pbbp1ppp/1p2p3/2p5/3P4/P1P1PN1P/1P1QBPP1/R1B2RK1 w - - 3 11,Qc2,20,18,-2,1
rn1q1rk1/pbbp1ppp/1p2p3/2p5/3P4/P1P1PN1P/1PQ1BPP1/R1B2RK1 b - - 4 11,d6,4,52,48,1
rn1q1rk1/pbb2ppp/1p1pp3/2p5/3P4/P1P1PN1P/1PQ1BPP1/R1B2RK1 w - - 0 12,e4,59,58,-1,1
rn1q1rk1/pbb2ppp/1p1pp3/2p5/3PP3/P1P2N1P/1PQ1BPP1/R1B2RK1 b - - 0 12,cxd4,61,58,-3,1
rn1q1rk1/pbb2ppp/1p1pp3/8/3pP3/P1P2N1P/1PQ1BPP1/R1B2RK1 w - - 0 13,cxd4,63,66,3,1
rn1q1rk1/pbb2ppp/1p1pp3/8/3PP3/P4N1P/1PQ1BPP1/R1B2RK1 b - - 0 13,Nd7,62,112,50,1
r2q1rk1/pbbn1ppp/1p1pp3/8/3PP3/P4N1P/1PQ1BPP1/R1B2RK1 w - - 1 14,b4,107,62,-45,1
r2q1rk1/pbbn1ppp/1p1pp3/8/1P1PP3/P4N1P/2Q1BPP1/R1B2RK1 b - - 0 14,Rc8,65,58,-7,1
2rq1rk1/pbbn1ppp/1p1pp3/8/1P1PP3/P4N1P/2Q1BPP1/R1B2RK1 w - - 1 15,Qb1,63,46,-17,1
2rq1rk1/pbbn1ppp/1p1pp3/8/1P1PP3/P4N1P/4BPP1/RQB2RK1 b - - 2 15,Nf6,58,33,-25,1
2rq1rk1/pbb2ppp/1p1ppn2/8/1P1PP3/P4N1P/4BPP1/RQB2RK1 w - - 3 16,e5,21,-109,-130,0
2rq1rk1/pbb2ppp/1p1ppn2/4P3/1P1P4/P4N1P/4BPP1/RQB2RK1 b - - 0 16,dxe5,-107,-101,6,1
2rq1rk1/pbb2ppp/1p2pn2/4p3/1P1P4/P4N1P/4BPP1/RQB2RK1 w - - 0 17,dxe5,-92,-94,-2,1
2rq1rk1/pbb2ppp/1p2pn2/4P3/1P6/P4N1P/4BPP1/RQB2RK1 b - - 0 17,Bxf3,-97,-92,5,1
2rq1rk1/p1b2ppp/1p2pn2/4P3/1P6/P4b1P/4BPP1/RQB2RK1 w - - 0 18,Bxf3,-87,-95,-8,1
2rq1rk1/p1b2ppp/1p2pn2/4P3/1P6/P4B1P/5PP1/RQB2RK1 b - - 0 18,Bxe5,-95,-93,2,1
2rq1rk1/p4ppp/1p2pn2/4b3/1P6/P4B1P/5PP1/RQB2RK1 w - - 0 19,Ra2,-92,-89,3,1
2rq1rk1/p4ppp/1p2pn2/4b3/1P6/P4B1P/R4PP1/1QB2RK1 b - - 1 19,Nd5,-91,-11,80,1
2rq1rk1/p4ppp/1p2p3/3nb3/1P6/P4B1P/R4PP1/1QB2RK1 w - - 2 20,Qb3,-35,-139,-104,0
2rq1rk1/p4ppp/1p2p3/3nb3/1P6/PQ3B1P/R4PP1/2B2RK1 b - - 3 20,Rc3,-140,-57,83,1
3q1rk1/p4ppp/1p2p3/3nb3/1P6/PQr2B1P/R4PP1/2B2RK1 w - - 4 21,Qa4,-77,-253,-176,0
3q1rk1/p4ppp/1p2p3/3nb3/QP6/P1r2B1P/R4PP1/2B2RK1 b - - 5 21,Rxf3,-246,-229,17,1
3q1rk1/p4ppp/1p2p3/3nb3/QP6/P4r1P/R4PP1/2B2RK1 w - - 0 22,gxf3,-238,-224,14,1
3q1rk1/p4ppp/1p2p3/3nb3/QP6/P4P1P/R4P2/2B2RK1 b - - 0 22,Qg5+,-249,501,750,1
5rk1/p4ppp/1p2p3/3nb1q1/QP6/P4P1P/R4P2/2B2RK1 w - - 1 23,Bxg5,518,512,-6,1
rnbqkbnr/pppppppp/8/8/8/8/PPPPPPPP/RNBQKBNR w KQkq - 0 1,e4,33,30,-3,1
rnbqkbnr/pppppppp/8/8/4P3/8/PPPP1PPP/RNBQKBNR b KQkq - 0 1,c6,34,38,4,1
rnbqkbnr/pp1ppppp/2p5/8/4P3/8/PPPP1PPP/RNBQKBNR w KQkq - 0 2,Nc3,51,26,-25,1
rnbqkbnr/pp1ppppp/2p5/8/4P3/2N5/PPPP1PPP/R1BQKBNR b KQkq - 1 2,d5,38,34,-4,1
rnbqkbnr/pp2pppp/2p5/3p4/4P3/2N5/PPPP1PPP/R1BQKBNR w KQkq - 0 3,exd5,31,1,-30,1
rnbqkbnr/pp2pppp/2p5/3P4/8/2N5/PPPP1PPP/R1BQKBNR b KQkq - 0 3,cxd5,-2,-7,-5,1
rnbqkbnr/pp2pppp/8/3p4/8/2N5/PPPP1PPP/R1BQKBNR w KQkq - 0 4,Nf3,4,-9,-13,1
rnbqkbnr/pp2pppp/8/3p4/8/2N2N2/PPPP1PPP/R1BQKB1R b KQkq - 1 4,Nc6,-5,-1,4,1
r1bqkbnr/pp2pppp/2n5/3p4/8/2N2N2/PPPP1PPP/R1BQKB1R w KQkq - 2 5,d4,1,0,-1,1
r1bqkbnr/pp2pppp/2n5/3p4/3P4/2N2N2/PPP2PPP/R1BQKB1R b KQkq - 0 5,Nf6,7,14,7,1
r1bqkb1r/pp2pppp/2n2n2/3p4/3P4/2N2N2/PPP2PPP/R1BQKB1R w KQkq - 1 6,Bb5,27,-7,-34,1
r1bqkb1r/pp2pppp/2n2n2/1B1p4/3P4/2N2N2/PPP2PPP/R1BQK2R b KQkq - 2 6,Bg4,-13,0,13,1
r2qkb1r/pp2pppp/2n2n2/1B1p4/3P2b1/2N2N2/PPP2PPP/R1BQK2R w KQkq - 3 7,h3,-3,-17,-14,1
r2qkb1r/pp2pppp/2n2n2/1B1p4/3P2b1/2N2N1P/PPP2PP1/R1BQK2R b KQkq - 0 7,Bh5,-19,145,164,1
r2qkb1r/pp2pppp/2n2n2/1B1p3b/3P4/2N2N1P/PPP2PP1/R1BQK2R w KQkq - 1 8,g4,137,131,-6,1
r2qkb1r/pp2pppp/2n2n2/1B1p3b/3P2P1/2N2N1P/PPP2P2/R1BQK2R b KQkq - 0 8,Bg6,143,138,-5,1
r2qkb1r/pp2pppp/2n2nb1/1B1p4/3P2P1/2N2N1P/PPP2P2/R1BQK2R w KQkq - 1 9,Bf4,150,30,-120,0
r2qkb1r/pp2pppp/2n2nb1/1B1p4/3P1BP1/2N2N1P/PPP2P2/R2QK2R b KQkq - 2 9,a6,24,42,18,1
r2qkb1r/1p2pppp/p1n2nb1/1B1p4/3P1BP1/2N2N1P/PPP2P2/R2QK2R w KQkq - 0 10,Ba4,39,-100,-139,0
r2qkb1r/1p2pppp/p1n2nb1/3p4/B2P1BP1/2N2N1P/PPP2P2/R2QK2R b KQkq - 1 10,b5,-101,-90,11,1
r2qkb1r/4pppp/p1n2nb1/1p1p4/B2P1BP1/2N2N1P/PPP2P2/R2QK2R w KQkq - 0 11,Bb3,-85,-97,-12,1
r2qkb1r/4pppp/p1n2nb1/1p1p4/3P1BP1/1BN2N1P/PPP2P2/R2QK2R b KQkq - 1 11,b4,-92,168,260,1
r2qkb1r/4pppp/p1n2nb1/3p4/1p1P1BP1/1BN2N1P/PPP2P2/R2QK2R w KQkq - 0 12,Na4,135,-86,-221,0
r2qkb1r/4pppp/p1n2nb1/3p4/Np1P1BP1/1B3N1P/PPP2P2/R2QK2R b KQkq - 1 12,Be4,-65,50,115,1
r2qkb1r/4pppp/p1n2n2/3p4/Np1PbBP1/1B3N1P/PPP2P2/R2QK2R w KQkq - 2 13,Nc5,89,88,-1,1
r2qkb1r/4pppp/p1n2n2/2Np4/1p1PbBP1/1B3N1P/PPP2P2/R2QK2R b KQkq - 3 13,Qb6,89,210,121,1
r3kb1r/4pppp/pqn2n2/2Np4/1p1PbBP1/1B3N1P/PPP2P2/R2QK2R w KQkq - 4 14,Qe2,226,-142,-368,0
r3kb1r/4pppp/pqn2n2/2Np4/1p1PbBP1/1B3N1P/PPP1QP2/R3K2R b KQkq - 5 14,e6,-154,25,179,1
r3kb1r/5ppp/pqn1pn2/2Np4/1p1PbBP1/1B3N1P/PPP1QP2/R3K2R w KQkq - 0 15,Nxe4,27,18,-9,1
r3kb1r/5ppp/pqn1pn2/3p4/1p1PNBP1/1B3N1P/PPP1QP2/R3K2R b KQkq - 0 15,Nxe4,16,21,5,1
r3kb1r/5ppp/pqn1p3/3p4/1p1PnBP1/1B3N1P/PPP1QP2/R3K2R w KQkq - 0 16,c3,27,-146,-173,0
r3kb1r/5ppp/pqn1p3/3p4/1p1PnBP1/1BP2N1P/PP2QP2/R3K2R b KQkq - 0 16,Be7,-170,81,251,1
r3k2r/4bppp/pqn1p3/3p4/1p1PnBP1/1BP2N1P/PP2QP2/R3K2R w KQkq - 1 17,Rc1,103,-45,-148,0
r3k2r/4bppp/pqn1p3/3p4/1p1PnBP1/1BP2N1P/PP2QP2/2R1K2R b Kkq - 2 17,Rc8,-28,22,50,1
2r1k2r/4bppp/pqn1p3/3p4/1p1PnBP1/1BP2N1P/PP2QP2/2R1K2R w Kk - 3 18,Ne5,-1,-154,-153,0
2r1k2r/4bppp/pqn1p3/3pN3/1p1PnBP1/1BP4P/PP2QP2/2R1K2R b Kk - 4 18,O-O,-135,-21,114,1
2r2rk1/4bppp/pqn1p3/3pN3/1p1PnBP1/1BP4P/PP2QP2/2R1K2R w K - 5 19,Nxc6,-6,-17,-11,1
2r2rk1/4bppp/pqN1p3/3p4/1p1PnBP1/1BP4P/PP2QP2/2R1K2R b K - 0 19,Rxc6,-21,29,50,1
5rk1/4bppp/pqr1p3/3p4/1p1PnBP1/1BP4P/PP2QP2/2R1K2R w K - 0 20,Bd2,31,-231,-262,0
5rk1/4bppp/pqr1p3/3p4/1p1Pn1P1/1BP4P/PP1BQP2/2R1K2R b K - 1 20,Nxd2,-249,-197,52,1
5rk1/4bppp/pqr1p3/3p4/1p1P2P1/1BP4P/PP1nQP2/2R1K2R w K - 0 21,Qxd2,-211,-200,11,1
5rk1/4bppp/pqr1p3/3p4/1p1P2P1/1BP4P/PP1Q1P2/2R1K2R b K - 0 21,Rfc8,-210,-175,35,1
2r3k1/4bppp/pqr1p3/3p4/1p1P2P1/1BP4P/PP1Q1P2/2R1K2R w K - 1 22,O-O,-165,-181,-16,1
2r3k1/4bppp/pqr1p3/3p4/1p1P2P1/1BP4P/PP1Q1P2/2R2RK1 b - - 2 22,a5,-172,-116,56,1
2r3k1/4bppp/1qr1p3/p2p4/1p1P2P1/1BP4P/PP1Q1P2/2R2RK1 w - - 0 23,Ba4,-100,-175,-75,1
2r3k1/4bppp/1qr1p3/p2p4/Bp1P2P1/2P4P/PP1Q1P2/2R2RK1 b - - 1 23,R6c7,-170,-112,58,1
2r3k1/2r1bppp/1q2p3/p2p4/Bp1P2P1/2P4P/PP1Q1P2/2R2RK1 w - - 2 24,f4,-110,-202,-92,1
2r3k1/2r1bppp/1q2p3/p2p4/Bp1P1PP1/2P4P/PP1Q4/2R2RK1 b - - 0 24,Bd6,-221,-85,136,1
2r3k1/2r2ppp/1q1bp3/p2p4/Bp1P1PP1/2P4P/PP1Q4/2R2RK1 w - - 1 25,Kg2,-86,-82,4,1
2r3k1/2r2ppp/1q1bp3/p2p4/Bp1P1PP1/2P4P/PP1Q2K1/2R2R2 b - - 2 25,bxc3,-86,-22,64,1
2r3k1/2r2ppp/1q1bp3/p2p4/B2P1PP1/2p4P/PP1Q2K1/2R2R2 w - - 0 26,bxc3,-79,-62,17,1
2r3k1/2r2ppp/1q1bp3/p2p4/B2P1PP1/2P4P/P2Q2K1/2R2R2 b - - 0 26,Rc4,-65,-61,4,1
2r3k1/5ppp/1q1bp3/p2p4/B1rP1PP1/2P4P/P2Q2K1/2R2R2 w - - 1 27,Bb3,-69,-61,8,1
2r3k1/5ppp/1q1bp3/p2p4/2rP1PP1/1BP4P/P2Q2K1/2R2R2 b - - 2 27,R4c7,-60,-69,-9,1
2r3k1/2r2ppp/1q1bp3/p2p4/3P1PP1/1BP4P/P2Q2K1/2R2R2 w - - 3 28,Rf3,-63,-71,-8,1
2r3k1/2r2ppp/1q1bp3/p2p4/3P1PP1/1BP2R1P/P2Q2K1/2R5 b - - 4 28,Qa6,-56,-56,0,1
2r3k1/2r2ppp/q2bp3/p2p4/3P1PP1/1BP2R1P/P2Q2K1/2R5 w - - 5 29,Qd3,-60,-247,-187,0
2r3k1/2r2ppp/q2bp3/p2p4/3P1PP1/1BPQ1R1P/P5K1/2R5 b - - 6 29,Qxd3,-245,-258,-13,1
2r3k1/2r2ppp/3bp3/p2p4/3P1PP1/1BPq1R1P/P5K1/2R5 w - - 0 30,Rxd3,-276,-276,0,1
2r3k1/2r2ppp/3bp3/p2p4/3P1PP1/1BPR3P/P5K1/2R5 b - - 0 30,Rc6,-260,-10,250,1
2r3k1/5ppp/2rbp3/p2p4/3P1PP1/1BPR3P/P5K1/2R5 w - - 1 31,Kf3,-4,-52,-48,1
2r3k1/5ppp/2rbp3/p2p4/3P1PP1/1BPR1K1P/P7/2R5 b - - 2 31,R6c7,-66,-15,51,1
2r3k1/2r2ppp/3bp3/p2p4/3P1PP1/1BPR1K1P/P7/2R5 w - - 3 32,f5,-20,-27,-7,1
2r3k1/2r2ppp/3bp3/p2p1P2/3P2P1/1BPR1K1P/P7/2R5 b - - 0 32,Kf8,-19,8,27,1
2r2k2/2r2ppp/3bp3/p2p1P2/3P2P1/1BPR1K1P/P7/2R5 w - - 1 33,fxe6,8,-6,-14,1
2r2k2/2r2ppp/3bP3/p2p4/3P2P1/1BPR1K1P/P7/2R5 b - - 0 33,fxe6,-20,-5,15,1
2r2k2/2r3pp/3bp3/p2p4/3P2P1/1BPR1K1P/P7/2R5 w - - 0 34,Ke2,-8,0,8,1
2r2k2/2r3pp/3bp3/p2p4/3P2P1/1BPR3P/P3K3/2R5 b - - 1 34,Rf7,-5,-5,0,1
2r2k2/5rpp/3bp3/p2p4/3P2P1/1BPR3P/P3K3/2R5 w - - 2 35,Rf3,3,0,-3,1
2r2k2/5rpp/3bp3/p2p4/3P2P1/1BP2R1P/P3K3/2R5 b - - 3 35,Rc7,1,19,18,1
5k2/2r2rpp/3bp3/p2p4/3P2P1/1BP2R1P/P3K3/2R5 w - - 4 36,Rxf7+,16,19,3,1
5k2/2r2Rpp/3bp3/p2p4/3P2P1/1BP4P/P3K3/2R5 b - - 0 36,Rxf7,17,17,0,1
5k2/5rpp/3bp3/p2p4/3P2P1/1BP4P/P3K3/2R5 w - - 0 37,Rf1,19,5,-14,1
5k2/5rpp/3bp3/p2p4/3P2P1/1BP4P/P3K3/5R2 b - - 1 37,Rxf1,4,7,3,1
5k2/6pp/3bp3/p2p4/3P2P1/1BP4P/P3K3/5r2 w - - 0 38,Kxf1,4,4,0,1
5k2/6pp/3bp3/p2p4/3P2P1/1BP4P/P7/5K2 b - - 0 38,Kf7,7,4,-3,1
8/5kpp/3bp3/p2p4/3P2P1/1BP4P/P7/5K2 w - - 1 39,Ke2,1,2,1,1
8/5kpp/3bp3/p2p4/3P2P1/1BP4P/P3K3/8 b - - 2 39,Kf6,1,0,-1,1
8/6pp/3bpk2/p2p4/3P2P1/1BP4P/P3K3/8 w - - 3 40,Kf3,0,3,3,1
8/6pp/3bpk2/p2p4/3P2P1/1BP2K1P/P7/8 b - - 4 40,Ba3,3,0,-3,1
8/6pp/4pk2/p2p4/3P2P1/bBP2K1P/P7/8 w - - 5 41,h4,0,-6,-6,1
8/6pp/4pk2/p2p4/3P2PP/bBP2K2/P7/8 b - - 0 41,Bb2,-4,0,4,1
8/6pp/4pk2/p2p4/3P2PP/1BP2K2/Pb6/8 w - - 1 42,c4,-1,3,4,1
8/6pp/4pk2/p2p4/2PP2PP/1B3K2/Pb6/8 b - - 0 42,dxc4,0,0,0,1
8/6pp/4pk2/p7/2pP2PP/1B3K2/Pb6/8 w - - 0 43,Bxc4,-3,0,3,1
8/6pp/4pk2/p7/2BP2PP/5K2/Pb6/8 b - - 0 43,Bxd4,0,-1,-1,1
8/6pp/4pk2/p7/2Bb2PP/5K2/P7/8 w - - 0 44,Ke4,-8,-11,-3,1
8/6pp/4pk2/p7/2BbK1PP/8/P7/8 b - - 1 44,g6,-10,636,646,1
8/7p/4pkp1/p7/2BbK1PP/8/P7/8 w - - 0 45,g5+,620,647,27,1
8/7p/4pkp1/p5P1/2BbK2P/8/P7/8 b - - 0 45,Ke7,662,646,-16,1
8/4k2p/4p1p1/p5P1/2BbK2P/8/P7/8 w - - 1 46,Kxd4,636,641,5,1
8/4k2p/4p1p1/p5P1/2BK3P/8/P7/8 b - - 0 46,Kd6,670,661,-9,1
8/7p/3kp1p1/p5P1/2BK3P/8/P7/8 w - - 1 47,Ke4,647,665,18,1
8/7p/3kp1p1/p5P1/2B1K2P/8/P7/8 b - - 2 47,Kc5,683,699,16,1
8/7p/4p1p1/p1k3P1/2B1K2P/8/P7/8 w - - 3 48,Bxe6,672,664,-8,1
8/7p/4B1p1/p1k3P1/4K2P/8/P7/8 b - - 0 48,Kb4,675,679,4,1
8/7p/4B1p1/p5P1/1k2K2P/8/P7/8 w - - 1 49,Ke5,671,671,0,1
8/7p/4B1p1/p3K1P1/1k5P/8/P7/8 b - - 2 49,Ka3,669,706,37,1
8/7p/4B1p1/p3K1P1/7P/k7/P7/8 w - - 3 50,Kf6,673,673,0,1
rnbqkbnr/pppppppp/8/8/8/8/PPPPPPPP/RNBQKBNR w KQkq - 0 1,e4,34,35,1,1
rnbqkbnr/pppppppp/8/8/4P3/8/PPPP1PPP/RNBQKBNR b KQkq - 0 1,e5,36,50,14,1
rnbqkbnr/pppp1ppp/8/4p3/4P3/8/PPPP1PPP/RNBQKBNR w KQkq - 0 2,Nf3,39,30,-9,1
rnbqkbnr/pppp1ppp/8/4p3/4P3/5N2/PPPP1PPP/RNBQKB1R b KQkq - 1 2,d6,34,65,31,1
rnbqkbnr/ppp2ppp/3p4/4p3/4P3/5N2/PPPP1PPP/RNBQKB1R w KQkq - 0 3,Bb5+,50,2,-48,1
rnbqkbnr/ppp2ppp/3p4/1B2p3/4P3/5N2/PPPP1PPP/RNBQK2R b KQkq - 1 3,Bd7,24,34,10,1
rn1qkbnr/pppb1ppp/3p4/1B2p3/4P3/5N2/PPPP1PPP/RNBQK2R w KQkq - 2 4,Nc3,28,36,8,1
rn1qkbnr/pppb1ppp/3p4/1B2p3/4P3/2N2N2/PPPP1PPP/R1BQK2R b KQkq - 3 4,c6,28,71,43,1
rn1qkbnr/pp1b1ppp/2pp4/1B2p3/4P3/2N2N2/PPPP1PPP/R1BQK2R w KQkq - 0 5,Ba4,64,39,-25,1
rn1qkbnr/pp1b1ppp/2pp4/4p3/B3P3/2N2N2/PPPP1PPP/R1BQK2R b KQkq - 1 5,b5,39,58,19,1
rn1qkbnr/p2b1ppp/2pp4/1p2p3/B3P3/2N2N2/PPPP1PPP/R1BQK2R w KQkq - 0 6,Bb3,37,45,8,1
rn1qkbnr/p2b1ppp/2pp4/1p2p3/4P3/1BN2N2/PPPP1PPP/R1BQK2R b KQkq - 1 6,a5,32,84,52,1
rn1qkbnr/3b1ppp/2pp4/pp2p3/4P3/1BN2N2/PPPP1PPP/R1BQK2R w KQkq - 0 7,a3,83,13,-70,1
rn1qkbnr/3b1ppp/2pp4/pp2p3/4P3/PBN2N2/1PPP1PPP/R1BQK2R b KQkq - 0 7,a4,15,67,52,1
rn1qkbnr/3b1ppp/2pp4/1p2p3/p3P3/PBN2N2/1PPP1PPP/R1BQK2R w KQkq - 0 8,Ba2,68,64,-4,1
rn1qkbnr/3b1ppp/2pp4/1p2p3/p3P3/P1N2N2/BPPP1PPP/R1BQK2R b KQkq - 1 8,Bg4,77,170,93,1
rn1qkbnr/5ppp/2pp4/1p2p3/p3P1b1/P1N2N2/BPPP1PPP/R1BQK2R w KQkq - 2 9,h3,166,145,-21,1
rn1qkbnr/5ppp/2pp4/1p2p3/p3P1b1/P1N2N1P/BPPP1PP1/R1BQK2R b KQkq - 0 9,Bxf3,156,129,-27,1
rn1qkbnr/5ppp/2pp4/1p2p3/p3P3/P1N2b1P/BPPP1PP1/R1BQK2R w KQkq - 0 10,Qxf3,134,128,-6,1
rn1qkbnr/5ppp/2pp4/1p2p3/p3P3/P1N2Q1P/BPPP1PP1/R1B1K2R b KQkq - 0 10,Nd7,131,9999,9868,1
r2qkbnr/3n1ppp/2pp4/1p2p3/p3P3/P1N2Q1P/BPPP1PP1/R1B1K2R w KQkq - 1 11,Qxf7#,9999,10000,1,1
rnbqkbnr/pppppppp/8/8/8/8/PPPPPPPP/RNBQKBNR w KQkq - 0 1,e4,29,24,-5,1
rnbqkbnr/pppppppp/8/8/4P3/8/PPPP1PPP/RNBQKBNR b KQkq - 0 1,e6,27,53,26,1
rnbqkbnr/pppp1ppp/4p3/8/4P3/8/PPPP1PPP/RNBQKBNR w KQkq - 0 2,f4,51,-26,-77,1
rnbqkbnr/pppp1ppp/4p3/8/4PP2/8/PPPP2PP/RNBQKBNR b KQkq - 0 2,d5,-10,-11,-1,1
rnbqkbnr/ppp2ppp/4p3/3p4/4PP2/8/PPPP2PP/RNBQKBNR w KQkq - 0 3,e5,-3,-22,-19,1
rnbqkbnr/ppp2ppp/4p3/3pP3/5P2/8/PPPP2PP/RNBQKBNR b KQkq - 0 3,c5,-31,-18,13,1
rnbqkbnr/pp3ppp/4p3/2ppP3/5P2/8/PPPP2PP/RNBQKBNR w KQkq - 0 4,Nf3,-15,-15,0,1
rnbqkbnr/pp3ppp/4p3/2ppP3/5P2/5N2/PPPP2PP/RNBQKB1R b KQkq - 1 4,Nc6,-15,-13,2,1
r1bqkbnr/pp3ppp/2n1p3/2ppP3/5P2/5N2/PPPP2PP/RNBQKB1R w KQkq - 2 5,c4,-14,-101,-87,1
r1bqkbnr/pp3ppp/2n1p3/2ppP3/2P2P2/5N2/PP1P2PP/RNBQKB1R b KQkq - 0 5,d4,-104,16,120,1
r1bqkbnr/pp3ppp/2n1p3/2p1P3/2Pp1P2/5N2/PP1P2PP/RNBQKB1R w KQkq - 0 6,Bd3,19,-105,-124,0
r1bqkbnr/pp3ppp/2n1p3/2p1P3/2Pp1P2/3B1N2/PP1P2PP/RNBQK2R b KQkq - 1 6,g6,-94,45,139,1
r1bqkbnr/pp3p1p/2n1p1p1/2p1P3/2Pp1P2/3B1N2/PP1P2PP/RNBQK2R w KQkq - 0 7,O-O,45,-43,-88,1
r1bqkbnr/pp3p1p/2n1p1p1/2p1P3/2Pp1P2/3B1N2/PP1P2PP/RNBQ1RK1 b kq - 1 7,Nb4,-46,21,67,1
r1bqkbnr/pp3p1p/4p1p1/2p1P3/1nPp1P2/3B1N2/PP1P2PP/RNBQ1RK1 w kq - 2 8,Be2,22,-342,-364,0
r1bqkbnr/pp3p1p/4p1p1/2p1P3/1nPp1P2/5N2/PP1PB1PP/RNBQ1RK1 b kq - 3 8,d3,-377,-366,11,1
rnbqkbnr/pppppppp/8/8/8/8/PPPPPPPP/RNBQKBNR w KQkq - 0 1,e4,30,34,4,1
rnbqkbnr/pppppppp/8/8/4P3/8/PPPP1PPP/RNBQKBNR b KQkq - 0 1,e5,29,37,8,1
rnbqkbnr/pppp1ppp/8/4p3/4P3/8/PPPP1PPP/RNBQKBNR w KQkq - 0 2,Nf3,43,42,-1,1
rnbqkbnr/pppp1ppp/8/4p3/4P3/5N2/PPPP1PPP/RNBQKB1R b KQkq - 1 2,f6,44,172,128,1
rnbqkbnr/pppp2pp/5p2/4p3/4P3/5N2/PPPP1PPP/RNBQKB1R w KQkq - 0 3,d4,183,156,-27,1
rnbqkbnr/pppp2pp/5p2/4p3/3PP3/5N2/PPP2PPP/RNBQKB1R b KQkq - 0 3,d6,149,196,47,1
rnbqkbnr/ppp3pp/3p1p2/4p3/3PP3/5N2/PPP2PPP/RNBQKB1R w KQkq - 0 4,Qe2,181,132,-49,1
rnbqkbnr/ppp3pp/3p1p2/4p3/3PP3/5N2/PPP1QPPP/RNB1KB1R b KQkq - 1 4,Nc6,137,121,-16,1
r1bqkbnr/ppp3pp/2np1p2/4p3/3PP3/5N2/PPP1QPPP/RNB1KB1R w KQkq - 2 5,Nc3,114,-61,-175,0
r1bqkbnr/ppp3pp/2np1p2/4p3/3PP3/2N2N2/PPP1QPPP/R1B1KB1R b KQkq - 3 5,exd4,-22,87,109,1
r1bqkbnr/ppp3pp/2np1p2/8/3pP3/2N2N2/PPP1QPPP/R1B1KB1R w KQkq - 0 6,Nd5,93,76,-17,1
r1bqkbnr/ppp3pp/2np1p2/3N4/3pP3/5N2/PPP1QPPP/R1B1KB1R b KQkq - 1 6,Nge7,90,81,-9,1
r1bqkb1r/ppp1n1pp/2np1p2/3N4/3pP3/5N2/PPP1QPPP/R1B1KB1R w KQkq - 2 7,c3,94,-1,-95,1
r1bqkb1r/ppp1n1pp/2np1p2/3N4/3pP3/2P2N2/PP2QPPP/R1B1KB1R b KQkq - 0 7,f5,-6,104,110,1
r1bqkb1r/ppp1n1pp/2np4/3N1p2/3pP3/2P2N2/PP2QPPP/R1B1KB1R w KQkq - 0 8,cxd4,109,33,-76,1
r1bqkb1r/ppp1n1pp/2np4/3N1p2/3PP3/5N2/PP2QPPP/R1B1KB1R b KQkq - 0 8,Nb4,28,441,413,1
r1bqkb1r/ppp1n1pp/3p4/3N1p2/1n1PP3/5N2/PP2QPPP/R1B1KB1R w KQkq - 1 9,Nxb4,434,439,5,1
r1bqkb1r/ppp1n1pp/3p4/5p2/1N1PP3/5N2/PP2QPPP/R1B1KB1R b KQkq - 0 9,b6,469,614,145,1
r1bqkb1r/p1p1n1pp/1p1p4/5p2/1N1PP3/5N2/PP2QPPP/R1B1KB1R w KQkq - 0 10,exf5,653,528,-125,0
r1bqkb1r/p1p1n1pp/1p1p4/5P2/1N1P4/5N2/PP2QPPP/R1B1KB1R b KQkq - 0 10,Bxf5,543,619,76,1
r2qkb1r/p1p1n1pp/1p1p4/5b2/1N1P4/5N2/PP2QPPP/R1B1KB1R w KQkq - 0 11,Bg5,602,514,-88,1
r2qkb1r/p1p1n1pp/1p1p4/5bB1/1N1P4/5N2/PP2QPPP/R3KB1R b KQkq - 1 11,h6,543,540,-3,1
r2qkb1r/p1p1n1p1/1p1p3p/5bB1/1N1P4/5N2/PP2QPPP/R3KB1R w KQkq - 0 12,Bxe7,556,557,1,1
r2qkb1r/p1p1B1p1/1p1p3p/5b2/1N1P4/5N2/PP2QPPP/R3KB1R b KQkq - 0 12,Bxe7,537,523,-14,1
r2qk2r/p1p1b1p1/1p1p3p/5b2/1N1P4/5N2/PP2QPPP/R3KB1R w KQkq - 0 13,Rc1,518,515,-3,1
r2qk2r/p1p1b1p1/1p1p3p/5b2/1N1P4/5N2/PP2QPPP/2R1KB1R b Kkq - 1 13,a5,543,549,6,1
r2qk2r/2p1b1p1/1p1p3p/p4b2/1N1P4/5N2/PP2QPPP/2R1KB1R w Kkq - 0 14,Qb5+,552,518,-34,1
r2qk2r/2p1b1p1/1p1p3p/pQ3b2/1N1P4/5N2/PP3PPP/2R1KB1R b Kkq - 1 14,c6,524,646,122,1
r2qk2r/4b1p1/1ppp3p/pQ3b2/1N1P4/5N2/PP3PPP/2R1KB1R w Kkq - 0 15,Qxc6+,589,534,-55,1
r2qk2r/4b1p1/1pQp3p/p4b2/1N1P4/5N2/PP3PPP/2R1KB1R b Kkq - 0 15,Qd7,503,656,153,1
r3k2r/3qb1p1/1pQp3p/p4b2/1N1P4/5N2/PP3PPP/2R1KB1R w Kkq - 1 16,Qxb6,691,322,-369,0
r3k2r/3qb1p1/1Q1p3p/p4b2/1N1P4/5N2/PP3PPP/2R1KB1R b Kkq - 0 16,axb4,308,508,200,1
r3k2r/3qb1p1/1Q1p3p/5b2/1p1P4/5N2/PP3PPP/2R1KB1R w Kkq - 0 17,Rc4,543,-172,-715,0
r3k2r/3qb1p1/1Q1p3p/5b2/1pRP4/5N2/PP3PPP/4KB1R b Kkq - 1 17,d5,-179,269,448,1
r3k2r/3qb1p1/1Q5p/3p1b2/1pRP4/5N2/PP3PPP/4KB1R w Kkq - 0 18,Rxb4,248,-201,-449,0
r3k2r/3qb1p1/1Q5p/3p1b2/1R1P4/5N2/PP3PPP/4KB1R b Kkq - 0 18,Bxb4+,-175,-176,-1,1
r3k2r/3q2p1/1Q5p/3p1b2/1b1P4/5N2/PP3PPP/4KB1R w Kkq - 0 19,Qxb4,-196,-215,-19,1
r3k2r/3q2p1/7p/3p1b2/1Q1P4/5N2/PP3PPP/4KB1R b Kkq - 0 19,Rxa2,-250,508,758,1
4k2r/3q2p1/7p/3p1b2/1Q1P4/5N2/rP3PPP/4KB1R w Kk - 0 20,Qb8+,537,-154,-691,0
1Q2k2r/3q2p1/7p/3p1b2/3P4/5N2/rP3PPP/4KB1R b Kk - 1 20,Qd8,-135,-49,86,1
1Q1qk2r/6p1/7p/3p1b2/3P4/5N2/rP3PPP/4KB1R w Kk - 2 21,Qb3,-42,-377,-335,0
3qk2r/6p1/7p/3p1b2/3P4/1Q3N2/rP3PPP/4KB1R b Kk - 3 21,Ra1+,-403,-392,11,1
3qk2r/6p1/7p/3p1b2/3P4/1Q3N2/1P3PPP/r3KB1R w Kk - 4 22,Ke2,-424,-430,-6,1
3qk2r/6p1/7p/3p1b2/3P4/1Q3N2/1P2KPPP/r4B1R b k - 5 22,Qc7,-468,-159,309,1
4k2r/2q3p1/7p/3p1b2/3P4/1Q3N2/1P2KPPP/r4B1R w k - 6 23,Ne1,-141,-519,-378,0
4k2r/2q3p1/7p/3p1b2/3P4/1Q6/1P2KPPP/r3NB1R b k - 7 23,Bg4+,-505,-557,-52,1
4k2r/2q3p1/7p/3p4/3P2b1/1Q6/1P2KPPP/r3NB1R w k - 8 24,f3,-503,-676,-173,0
4k2r/2q3p1/7p/3p4/3P2b1/1Q3P2/1P2K1PP/r3NB1R b k - 0 24,Bf5,-758,-202,556,1
4k2r/2q3p1/7p/3p1b2/3P4/1Q3P2/1P2K1PP/r3NB1R w k - 1 25,Qxd5,-150,-165,-15,1
4k2r/2q3p1/7p/3Q1b2/3P4/5P2/1P2K1PP/r3NB1R b k - 0 25,Rxe1+,-166,339,505,1
4k2r/2q3p1/7p/3Q1b2/3P4/5P2/1P2K1PP/4rB1R w k - 0 26,Kxe1,357,359,2,1
4k2r/2q3p1/7p/3Q1b2/3P4/5P2/1P4PP/4KB1R b k - 0 26,Qc1+,439,434,-5,1
4k2r/6p1/7p/3Q1b2/3P4/5P2/1P4PP/2q1KB1R w k - 1 27,Ke2,431,290,-141,0
4k2r/6p1/7p/3Q1b2/3P4/5P2/1P2K1PP/2q2B1R b k - 2 27,Qc2+,368,439,71,1
4k2r/6p1/7p/3Q1b2/3P4/5P2/1Pq1K1PP/5B1R w k - 3 28,Ke3,445,450,5,1
4k2r/6p1/7p/3Q1b2/3P4/4KP2/1Pq3PP/5B1R b k - 4 28,Qd3+,435,883,448,1
4k2r/6p1/7p/3Q1b2/3P4/3qKP2/1P4PP/5B1R w k - 5 29,Kf4,914,398,-516,0
4k2r/6p1/7p/3Q1b2/3P1K2/3q1P2/1P4PP/5B1R b k - 6 29,Qd2+,460,524,64,1
4k2r/6p1/7p/3Q1b2/3P1K2/5P2/1P1q2PP/5B1R w k - 7 30,Kxf5,492,516,24,1
4k2r/6p1/7p/3Q1K2/3P4/5P2/1P1q2PP/5B1R b k - 0 30,Rf8+,537,536,-1,1
4kr2/6p1/7p/3Q1K2/3P4/5P2/1P1q2PP/5B1R w - - 1 31,Ke5,543,-9998,-10541,0
4kr2/6p1/7p/3QK3/3P4/5P2/1P1q2PP/5B1R b - - 2 31,Qe3+,-9998,658,10656,1
4kr2/6p1/7p/3QK3/3P4/4qP2/1P4PP/5B1R w - - 3 32,Qe4,604,643,39,1
4kr2/6p1/7p/4K3/3PQ3/4qP2/1P4PP/5B1R b - - 4 32,Qf4+,647,859,212,1
4kr2/6p1/7p/4K3/3PQq2/5P2/1P4PP/5B1R w - - 5 33,Kd5+,865,677,-188,0
4kr2/6p1/7p/3K4/3PQq2/5P2/1P4PP/5B1R b - - 6 33,Kd7,664,660,-4,1
5r2/3k2p1/7p/3K4/3PQq2/5P2/1P4PP/5B1R w - - 7 34,g3,675,377,-298,0
5r2/3k2p1/7p/3K4/3PQq2/5PP1/1P5P/5B1R b - - 0 34,Qf5+,379,724,345,1
5r2/3k2p1/7p/3K1q2/3PQ3/5PP1/1P5P/5B1R w - - 1 35,Kc4,705,478,-227,0
5r2/3k2p1/7p/5q2/2KPQ3/5PP1/1P5P/5B1R b - - 2 35,Qe6+,501,618,117,1
5r2/3k2p1/4q2p/8/2KPQ3/5PP1/1P5P/5B1R w - - 3 36,Kd3,653,440,-213,0
5r2/3k2p1/4q2p/8/3PQ3/3K1PP1/1P5P/5B1R b - - 4 36,h5,425,591,166,1
5r2/3k2p1/4q3/7p/3PQ3/3K1PP1/1P5P/5B1R w - - 0 37,h3,639,335,-304,0
5r2/3k2p1/4q3/7p/3PQ3/3K1PPP/1P6/5B1R b - - 0 37,Qa6+,339,473,134,1
5r2/3k2p1/q7/7p/3PQ3/3K1PPP/1P6/5B1R w - - 1 38,Ke3,581,573,-8,1
5r2/3k2p1/q7/7p/3PQ3/4KPPP/1P6/5B1R b - - 2 38,Qa1,584,1076,492,1
5r2/3k2p1/8/7p/3PQ3/4KPPP/1P6/q4B1R w - - 3 39,Bg2,9992,485,-9507,0
5r2/3k2p1/8/7p/3PQ3/4KPPP/1P4B1/q6R b - - 4 39,Qxb2,420,433,13,1
5r2/3k2p1/8/7p/3PQ3/4KPPP/1q4B1/7R w - - 0 40,Qe5,485,-11,-496,0
5r2/3k2p1/8/4Q2p/3P4/4KPPP/1q4B1/7R b - - 1 40,Qxg2,-8,260,268,1
5r2/3k2p1/8/4Q2p/3P4/4KPPP/6q1/7R w - - 0 41,Qxh5,348,0,-348,0
5r2/3k2p1/8/7Q/3P4/4KPPP/6q1/7R b - - 0 41,Qxh1,0,0,0,1
5r2/3k2p1/8/7Q/3P4/4KPPP/8/7q w - - 0 42,Qh6,0,-863,-863,0
5r2/3k2p1/7Q/8/3P4/4KPPP/8/7q b - - 1 42,gxh6,-985,-786,199,1
5r2/3k4/7p/8/3P4/4KPPP/8/7q w - - 0 43,Kf2,-825,-9997,-9172,0
5r2/3k4/7p/8/3P4/5PPP/5K2/7q b - - 1 43,Rxf3+,-9997,-9998,-1,1
8/3k4/7p/8/3P4/5rPP/5K2/7q w - - 0 44,Ke2,-9998,-9998,0,1
8/3k4/7p/8/3P4/5rPP/4K3/7q b - - 1 44,Qg2+,-9998,-9999,-1,1
8/3k4/7p/8/3P4/5rPP/4K1q1/8 w - - 2 45,Ke1,-9999,-9999,0,1
8/3k4/7p/8/3P4/5rPP/6q1/4K3 b - - 3 45,Qf2+,-9999,-9997,2,1
8/3k4/7p/8/3P4/5rPP/5q2/4K3 w - - 4 46,Kd1,-9997,-9998,-1,1
8/3k4/7p/8/3P4/5rPP/5q2/3K4 b - - 5 46,Rd3+,-9998,-9995,3,1
8/3k4/7p/8/3P4/3r2PP/5q2/3K4 w - - 6 47,Kc1,-9995,-9995,0,1
8/3k4/7p/8/3P4/3r2PP/5q2/2K5 b - - 7 47,Qxg3,-9998,-9995,3,1
8/3k4/7p/8/3P4/3r2qP/8/2K5 w - - 0 48,Kc2,-9995,-9995,0,1
8/3k4/7p/8/3P4/3r2qP/2K5/8 b - - 1 48,Rxd4,-9995,-9995,0,1
8/3k4/7p/8/3r4/6qP/2K5/8 w - - 0 49,Kb2,-9995,-9998,-3,1
8/3k4/7p/8/3r4/6qP/1K6/8 b - - 1 49,Qxh3,-9998,-9997,1,1
8/3k4/7p/8/3r4/7q/1K6/8 w - - 0 50,Kc2,-9997,-9997,0,1
8/3k4/7p/8/3r4/7q/2K5/8 b - - 1 50,Qd3+,-9997,-9997,0,1
8/3k4/7p/8/3r4/3q4/2K5/8 w - - 2 51,Kb2,-9997,-9998,-1,1
8/3k4/7p/8/3r4/3q4/1K6/8 b - - 3 51,h5,-9998,-9997,1,1
8/3k4/8/7p/3r4/3q4/1K6/8 w - - 0 52,Ka2,-9997,-9998,-1,1
8/3k4/8/7p/3r4/3q4/K7/8 b - - 1 52,h4,-9998,-9998,0,1
8/3k4/8/8/3r3p/3q4/K7/8 w - - 0 53,Kb2,-9998,-9998,0,1
8/3k4/8/8/3r3p/3q4/1K6/8 b - - 1 53,h3,-9998,-9997,1,1
8/3k4/8/8/3r4/3q3p/1K6/8 w - - 0 54,Ka2,-9997,-9998,-1,1
8/3k4/8/8/3r4/3q3p/K7/8 b - - 1 54,h2,-9998,-9998,0,1
8/3k4/8/8/3r4/3q4/K6p/8 w - - 0 55,Kb2,-9998,-9998,0,1
8/3k4/8/8/3r4/3q4/1K5p/8 b - - 1 55,h1=R,-9998,-9998,0,1
8/3k4/8/8/3r4/3q4/1K6/7r w - - 0 56,Ka2,-9998,-9998,0,1
8/3k4/8/8/3r4/3q4/K7/7r b - - 1 56,Ra1+,-9998,-9997,1,1
8/3k4/8/8/3r4/3q4/K7/r7 w - - 2 57,Kb2,-9997,-9998,-1,1
8/3k4/8/8/3r4/3q4/1K6/r7 b - - 3 57,Rb4+,-9998,-9999,-1,1
8/3k4/8/8/1r6/3q4/1K6/r7 w - - 4 58,Kxa1,-9999,-9999,0,1
8/3k4/8/8/1r6/3q4/8/K7 b - - 0 58,Qc2,-9999,0,9999,1
rnbqkbnr/pppppppp/8/8/8/8/PPPPPPPP/RNBQKBNR w KQkq - 0 1,e4,30,31,1,1
rnbqkbnr/pppppppp/8/8/4P3/8/PPPP1PPP/RNBQKBNR b KQkq - 0 1,d5,28,76,48,1
rnbqkbnr/ppp1pppp/8/3p4/4P3/8/PPPP1PPP/RNBQKBNR w KQkq - 0 2,exd5,73,65,-8,1
rnbqkbnr/ppp1pppp/8/3P4/8/8/PPPP1PPP/RNBQKBNR b KQkq - 0 2,Qxd5,75,77,2,1
rnb1kbnr/ppp1pppp/8/3q4/8/8/PPPP1PPP/RNBQKBNR w KQkq - 0 3,Nc3,80,76,-4,1
rnb1kbnr/ppp1pppp/8/3q4/8/2N5/PPPP1PPP/R1BQKBNR b KQkq - 1 3,Qd8,78,76,-2,1
rnbqkbnr/ppp1pppp/8/8/8/2N5/PPPP1PPP/R1BQKBNR w KQkq - 2 4,h3,76,34,-42,1
rnbqkbnr/ppp1pppp/8/8/8/2N4P/PPPP1PP1/R1BQKBNR b KQkq - 0 4,e6,31,66,35,1
rnbqkbnr/ppp2ppp/4p3/8/8/2N4P/PPPP1PP1/R1BQKBNR w KQkq - 0 5,a3,66,24,-42,1
rnbqkbnr/ppp2ppp/4p3/8/8/P1N4P/1PPP1PP1/R1BQKBNR b KQkq - 0 5,Nf6,-17,38,55,1
rnbqkb1r/ppp2ppp/4pn2/8/8/P1N4P/1PPP1PP1/R1BQKBNR w KQkq - 1 6,Bc4,35,-26,-61,1
rnbqkb1r/ppp2ppp/4pn2/8/2B5/P1N4P/1PPP1PP1/R1BQK1NR b KQkq - 2 6,c6,-23,25,48,1
rnbqkb1r/pp3ppp/2p1pn2/8/2B5/P1N4P/1PPP1PP1/R1BQK1NR w KQkq - 0 7,Nf3,37,33,-4,1
rnbqkb1r/pp3ppp/2p1pn2/8/2B5/P1N2N1P/1PPP1PP1/R1BQK2R b KQkq - 1 7,Nbd7,32,72,40,1
r1bqkb1r/pp1n1ppp/2p1pn2/8/2B5/P1N2N1P/1PPP1PP1/R1BQK2R w KQkq - 2 8,O-O,35,28,-7,1
r1bqkb1r/pp1n1ppp/2p1pn2/8/2B5/P1N2N1P/1PPP1PP1/R1BQ1RK1 b kq - 3 8,h6,39,85,46,1
r1bqkb1r/pp1n1pp1/2p1pn1p/8/2B5/P1N2N1P/1PPP1PP1/R1BQ1RK1 w kq - 0 9,d4,80,90,10,1
r1bqkb1r/pp1n1pp1/2p1pn1p/8/2BP4/P1N2N1P/1PP2PP1/R1BQ1RK1 b kq - 0 9,Bd6,80,85,5,1
r1bqk2r/pp1n1pp1/2pbpn1p/8/2BP4/P1N2N1P/1PP2PP1/R1BQ1RK1 w kq - 1 10,Ba2,78,59,-19,1
r1bqk2r/pp1n1pp1/2pbpn1p/8/3P4/P1N2N1P/BPP2PP1/R1BQ1RK1 b kq - 2 10,O-O,48,56,8,1
r1bq1rk1/pp1n1pp1/2pbpn1p/8/3P4/P1N2N1P/BPP2PP1/R1BQ1RK1 w - - 3 11,Nd2,59,13,-46,1
r1bq1rk1/pp1n1pp1/2pbpn1p/8/3P4/P1N4P/BPPN1PP1/R1BQ1RK1 b - - 4 11,Nh7,0,49,49,1
r1bq1rk1/pp1n1ppn/2pbp2p/8/3P4/P1N4P/BPPN1PP1/R1BQ1RK1 w - - 5 12,Nde4,51,23,-28,1
r1bq1rk1/pp1n1ppn/2pbp2p/8/3PN3/P1N4P/BPP2PP1/R1BQ1RK1 b - - 6 12,Bc7,13,20,7,1
r1bq1rk1/ppbn1ppn/2p1p2p/8/3PN3/P1N4P/BPP2PP1/R1BQ1RK1 w - - 7 13,Ne2,34,-13,-47,1
r1bq1rk1/ppbn1ppn/2p1p2p/8/3PN3/P6P/BPP1NPP1/R1BQ1RK1 b - - 8 13,Kh8,-15,39,54,1
r1bq1r1k/ppbn1ppn/2p1p2p/8/3PN3/P6P/BPP1NPP1/R1BQ1RK1 w - - 9 14,c3,39,-5,-44,1
r1bq1r1k/ppbn1ppn/2p1p2p/8/3PN3/P1P4P/BP2NPP1/R1BQ1RK1 b - - 0 14,f5,-21,-10,11,1
r1bq1r1k/ppbn2pn/2p1p2p/5p2/3PN3/P1P4P/BP2NPP1/R1BQ1RK1 w - - 0 15,N4g3,97,-6,-103,0
r1bq1r1k/ppbn2pn/2p1p2p/5p2/3P4/P1P3NP/BP2NPP1/R1BQ1RK1 b - - 1 15,Ndf6,1,171,170,1
r1bq1r1k/ppb3pn/2p1pn1p/5p2/3P4/P1P3NP/BP2NPP1/R1BQ1RK1 w - - 2 16,Nf4,191,188,-3,1
r1bq1r1k/ppb3pn/2p1pn1p/5p2/3P1N2/P1P3NP/BP3PP1/R1BQ1RK1 b - - 3 16,Nd5,176,262,86,1
r1bq1r1k/ppb3pn/2p1p2p/3n1p2/3P1N2/P1P3NP/BP3PP1/R1BQ1RK1 w - - 4 17,Ng6+,249,240,-9,1
r1bq1r1k/ppb3pn/2p1p1Np/3n1p2/3P4/P1P3NP/BP3PP1/R1BQ1RK1 b - - 5 17,Kg8,254,271,17,1
r1bq1rk1/ppb3pn/2p1p1Np/3n1p2/3P4/P1P3NP/BP3PP1/R1BQ1RK1 w - - 6 18,Nxf8,246,236,-10,1
r1bq1Nk1/ppb3pn/2p1p2p/3n1p2/3P4/P1P3NP/BP3PP1/R1BQ1RK1 b - - 0 18,Nxf8,242,255,13,1
r1bq1nk1/ppb3p1/2p1p2p/3n1p2/3P4/P1P3NP/BP3PP1/R1BQ1RK1 w - - 0 19,Bxd5,242,176,-66,1
r1bq1nk1/ppb3p1/2p1p2p/3B1p2/3P4/P1P3NP/1P3PP1/R1BQ1RK1 b - - 0 19,exd5,180,148,-32,1
r1bq1nk1/ppb3p1/2p4p/3p1p2/3P4/P1P3NP/1P3PP1/R1BQ1RK1 w - - 0 20,Nh5,159,156,-3,1
r1bq1nk1/ppb3p1/2p4p/3p1p1N/3P4/P1P4P/1P3PP1/R1BQ1RK1 b - - 1 20,Qd6,157,321,164,1
r1b2nk1/ppb3p1/2pq3p/3p1p1N/3P4/P1P4P/1P3PP1/R1BQ1RK1 w - - 2 21,f4,334,127,-207,0
r1b2nk1/ppb3p1/2pq3p/3p1p1N/3P1P2/P1P4P/1P4P1/R1BQ1RK1 b - - 0 21,Qg6,123,141,18,1
r1b2nk1/ppb3p1/2p3qp/3p1p1N/3P1P2/P1P4P/1P4P1/R1BQ1RK1 w - - 1 22,Be3,124,118,-6,1
r1b2nk1/ppb3p1/2p3qp/3p1p1N/3P1P2/P1P1B2P/1P4P1/R2Q1RK1 b - - 2 22,Bd7,102,98,-4,1
r4nk1/ppbb2p1/2p3qp/3p1p1N/3P1P2/P1P1B2P/1P4P1/R2Q1RK1 w - - 3 23,Ng3,98,-490,-588,0
r4nk1/ppbb2p1/2p3qp/3p1p2/3P1P2/P1P1B1NP/1P4P1/R2Q1RK1 b - - 4 23,Qxg3,-467,-466,1,1
r4nk1/ppbb2p1/2p4p/3p1p2/3P1P2/P1P1B1qP/1P4P1/R2Q1RK1 w - - 0 24,Rf3,-491,-474,17,1
r4nk1/ppbb2p1/2p4p/3p1p2/3P1P2/P1P1BRqP/1P4P1/R2Q2K1 b - - 1 24,Qg6,-444,-469,-25,1
r4nk1/ppbb2p1/2p3qp/3p1p2/3P1P2/P1P1BR1P/1P4P1/R2Q2K1 w - - 2 25,Qe2,-461,-553,-92,1
r4nk1/ppbb2p1/2p3qp/3p1p2/3P1P2/P1P1BR1P/1P2Q1P1/R5K1 b - - 3 25,Re8,-566,-522,44,1
4rnk1/ppbb2p1/2p3qp/3p1p2/3P1P2/P1P1BR1P/1P2Q1P1/R5K1 w - - 4 26,Qf2,-522,-527,-5,1
4rnk1/ppbb2p1/2p3qp/3p1p2/3P1P2/P1P1BR1P/1P3QP1/R5K1 b - - 5 26,Re4,-551,-513,38,1
5nk1/ppbb2p1/2p3qp/3p1p2/3PrP2/P1P1BR1P/1P3QP1/R5K1 w - - 6 27,Rf1,-523,-543,-20,1
5nk1/ppbb2p1/2p3qp/3p1p2/3PrP2/P1P1BR1P/1P3QP1/5RK1 b - - 7 27,Qe6,-559,-534,25,1
5nk1/ppbb2p1/2p1q2p/3p1p2/3PrP2/P1P1BR1P/1P3QP1/5RK1 w - - 8 28,Qg3,-535,-550,-15,1
5nk1/ppbb2p1/2p1q2p/3p1p2/3PrP2/P1P1BRQP/1P4P1/5RK1 b - - 9 28,Ng6,-546,-501,45,1
6k1/ppbb2p1/2p1q1np/3p1p2/3PrP2/P1P1BRQP/1P4P1/5RK1 w - - 10 29,Qh2,-511,-627,-116,0
6k1/ppbb2p1/2p1q1np/3p1p2/3PrP2/P1P1BR1P/1P4PQ/5RK1 b - - 11 29,Rxe3,-649,-676,-27,1
6k1/ppbb2p1/2p1q1np/3p1p2/3P1P2/P1P1rR1P/1P4PQ/5RK1 w - - 0 30,Rxe3,-688,-666,22,1
6k1/ppbb2p1/2p1q1np/3p1p2/3P1P2/P1P1R2P/1P4PQ/5RK1 b - - 0 30,Qxe3+,-646,-652,-6,1
6k1/ppbb2p1/2p3np/3p1p2/3P1P2/P1P1q2P/1P4PQ/5RK1 w - - 0 31,Rf2,-681,-915,-234,0
6k1/ppbb2p1/2p3np/3p1p2/3P1P2/P1P1q2P/1P3RPQ/6K1 b - - 1 31,Nxf4,-930,-805,125,1
6k1/ppbb2p1/2p4p/3p1p2/3P1n2/P1P1q2P/1P3RPQ/6K1 w - - 0 32,g3,-801,-789,12,1
6k1/ppbb2p1/2p4p/3p1p2/3P1n2/P1P1q1PP/1P3R1Q/6K1 b - - 0 32,Nh5,-772,-738,34,1
rnbqkbnr/pppppppp/8/8/8/8/PPPPPPPP/RNBQKBNR w KQkq - 0 1,c3,24,-1,-25,1
rnbqkbnr/pppppppp/8/8/8/2P5/PP1PPPPP/RNBQKBNR b KQkq - 0 1,Nf6,-3,12,15,1
rnbqkb1r/pppppppp/5n2/8/8/2P5/PP1PPPPP/RNBQKBNR w KQkq - 1 2,d4,13,20,7,1
rnbqkb1r/pppppppp/5n2/8/3P4/2P5/PP2PPPP/RNBQKBNR b KQkq - 0 2,g6,12,26,14,1
rnbqkb1r/pppppp1p/5np1/8/3P4/2P5/PP2PPPP/RNBQKBNR w KQkq - 0 3,Bf4,31,13,-18,1
rnbqkb1r/pppppp1p/5np1/8/3P1B2/2P5/PP2PPPP/RN1QKBNR b KQkq - 1 3,Bg7,16,21,5,1
rnbqk2r/ppppppbp/5np1/8/3P1B2/2P5/PP2PPPP/RN1QKBNR w KQkq - 2 4,e3,18,14,-4,1
rnbqk2r/ppppppbp/5np1/8/3P1B2/2P1P3/PP3PPP/RN1QKBNR b KQkq - 0 4,d6,18,13,-5,1
rnbqk2r/ppp1ppbp/3p1np1/8/3P1B2/2P1P3/PP3PPP/RN1QKBNR w KQkq - 0 5,Bd3,17,-17,-34,1
rnbqk2r/ppp1ppbp/3p1np1/8/3P1B2/2PBP3/PP3PPP/RN1QK1NR b KQkq - 1 5,O-O,-7,-4,3,1
rnbq1rk1/ppp1ppbp/3p1np1/8/3P1B2/2PBP3/PP3PPP/RN1QK1NR w KQ - 2 6,h3,3,-12,-15,1
rnbq1rk1/ppp1ppbp/3p1np1/8/3P1B2/2PBP2P/PP3PP1/RN1QK1NR b KQ - 0 6,Nbd7,-20,23,43,1
r1bq1rk1/pppnppbp/3p1np1/8/3P1B2/2PBP2P/PP3PP1/RN1QK1NR w KQ - 1 7,Qc2,30,-37,-67,1
r1bq1rk1/pppnppbp/3p1np1/8/3P1B2/2PBP2P/PPQ2PP1/RN2K1NR b KQ - 2 7,c5,-43,-23,20,1
r1bq1rk1/pp1nppbp/3p1np1/2p5/3P1B2/2PBP2P/PPQ2PP1/RN2K1NR w KQ - 0 8,Nd2,-22,-65,-43,1
r1bq1rk1/pp1nppbp/3p1np1/2p5/3P1B2/2PBP2P/PPQN1PP1/R3K1NR b KQ - 1 8,a6,-49,-15,34,1
r1bq1rk1/1p1nppbp/p2p1np1/2p5/3P1B2/2PBP2P/PPQN1PP1/R3K1NR w KQ - 0 9,c4,-28,-109,-81,1
r1bq1rk1/1p1nppbp/p2p1np1/2p5/2PP1B2/3BP2P/PPQN1PP1/R3K1NR b KQ - 0 9,cxd4,-151,-111,40,1
r1bq1rk1/1p1nppbp/p2p1np1/8/2Pp1B2/3BP2P/PPQN1PP1/R3K1NR w KQ - 0 10,exd4,-108,-113,-5,1
r1bq1rk1/1p1nppbp/p2p1np1/8/2PP1B2/3B3P/PPQN1PP1/R3K1NR b KQ - 0 10,Nh5,-138,-117,21,1
r1bq1rk1/1p1nppbp/p2p2p1/7n/2PP1B2/3B3P/PPQN1PP1/R3K1NR w KQ - 1 11,Ne2,-126,-223,-97,1
r1bq1rk1/1p1nppbp/p2p2p1/7n/2PP1B2/3B3P/PPQNNPP1/R3K2R b KQ - 2 11,Nxf4,-220,-212,8,1
r1bq1rk1/1p1nppbp/p2p2p1/8/2PP1n2/3B3P/PPQNNPP1/R3K2R w KQ - 0 12,Nxf4,-227,-209,18,1
r1bq1rk1/1p1nppbp/p2p2p1/8/2PP1N2/3B3P/PPQN1PP1/R3K2R b KQ - 0 12,Bxd4,-217,-219,-2,1
r1bq1rk1/1p1npp1p/p2p2p1/8/2Pb1N2/3B3P/PPQN1PP1/R3K2R w KQ - 0 13,Nf3,-233,-244,-11,1
r1bq1rk1/1p1npp1p/p2p2p1/8/2Pb1N2/3B1N1P/PPQ2PP1/R3K2R b KQ - 1 13,Bg7,-237,-261,-24,1
r1bq1rk1/1p1nppbp/p2p2p1/8/2P2N2/3B1N1P/PPQ2PP1/R3K2R w KQ - 2 14,h4,-240,-261,-21,1
r1bq1rk1/1p1nppbp/p2p2p1/8/2P2N1P/3B1N2/PPQ2PP1/R3K2R b KQ - 0 14,e5,-265,-220,45,1
r1bq1rk1/1p1n1pbp/p2p2p1/4p3/2P2N1P/3B1N2/PPQ2PP1/R3K2R w KQ - 0 15,Nd5,-252,-259,-7,1
r1bq1rk1/1p1n1pbp/p2p2p1/3Np3/2P4P/3B1N2/PPQ2PP1/R3K2R b KQ - 1 15,Nc5,-277,-229,48,1
r1bq1rk1/1p3pbp/p2p2p1/2nNp3/2P4P/3B1N2/PPQ2PP1/R3K2R w KQ - 2 16,h5,-240,-369,-129,0
r1bq1rk1/1p3pbp/p2p2p1/2nNp2P/2P5/3B1N2/PPQ2PP1/R3K2R b KQ - 0 16,e4,-336,-383,-47,1
r1bq1rk1/1p3pbp/p2p2p1/2nN3P/2P1p3/3B1N2/PPQ2PP1/R3K2R w KQ - 0 17,Bxe4,-390,-411,-21,1
r1bq1rk1/1p3pbp/p2p2p1/2nN3P/2P1B3/5N2/PPQ2PP1/R3K2R b KQ - 0 17,Nxe4,-370,-402,-32,1
r1bq1rk1/1p3pbp/p2p2p1/3N3P/2P1n3/5N2/PPQ2PP1/R3K2R w KQ - 0 18,hxg6,-389,-414,-25,1
r1bq1rk1/1p3pbp/p2p2P1/3N4/2P1n3/5N2/PPQ2PP1/R3K2R b KQ - 0 18,fxg6,-402,-349,53,1
r1bq1rk1/1p4bp/p2p2p1/3N4/2P1n3/5N2/PPQ2PP1/R3K2R w KQ - 0 19,O-O-O,-373,-417,-44,1
r1bq1rk1/1p4bp/p2p2p1/3N4/2P1n3/5N2/PPQ2PP1/2KR3R b - - 1 19,Bf5,-418,-265,153,1
r2q1rk1/1p4bp/p2p2p1/3N1b2/2P1n3/5N2/PPQ2PP1/2KR3R w - - 2 20,Qa4,-292,-517,-225,0
r2q1rk1/1p4bp/p2p2p1/3N1b2/Q1P1n3/5N2/PP3PP1/2KR3R b - - 3 20,b5,-539,-511,28,1
r2q1rk1/6bp/p2p2p1/1p1N1b2/Q1P1n3/5N2/PP3PP1/2KR3R w - - 0 21,Qb4,-462,-575,-113,0
r2q1rk1/6bp/p2p2p1/1p1N1b2/1QP1n3/5N2/PP3PP1/2KR3R b - - 1 21,bxc4,-549,-450,99,1
rnbqkbnr/pppppppp/8/8/8/8/PPPPPPPP/RNBQKBNR w KQkq - 0 1,e4,40,30,-10,1
rnbqkbnr/pppppppp/8/8/4P3/8/PPPP1PPP/RNBQKBNR b KQkq - 0 1,b6,40,84,44,1
rnbqkbnr/p1pppppp/1p6/8/4P3/8/PPPP1PPP/RNBQKBNR w KQkq - 0 2,Nf3,97,70,-27,1
rnbqkbnr/p1pppppp/1p6/8/4P3/5N2/PPPP1PPP/RNBQKB1R b KQkq - 1 2,Bb7,69,53,-16,1
rn1qkbnr/pbpppppp/1p6/8/4P3/5N2/PPPP1PPP/RNBQKB1R w KQkq - 2 3,d4,57,-60,-117,0
rn1qkbnr/pbpppppp/1p6/8/3PP3/5N2/PPP2PPP/RNBQKB1R b KQkq - 0 3,Bxe4,-56,-43,13,1
rn1qkbnr/p1pppppp/1p6/8/3Pb3/5N2/PPP2PPP/RNBQKB1R w KQkq - 0 4,Qd3,-51,-488,-437,0
rn1qkbnr/p1pppppp/1p6/8/3Pb3/3Q1N2/PPP2PPP/RNB1KB1R b KQkq - 1 4,Bxd3,-498,-496,2,1
rn1qkbnr/p1pppppp/1p6/8/3P4/3b1N2/PPP2PPP/RNB1KB1R w KQkq - 0 5,Bh6,-508,-816,-308,0
rn1qkbnr/p1pppppp/1p5B/8/3P4/3b1N2/PPP2PPP/RN2KB1R b KQkq - 1 5,Nxh6,-767,-782,-15,1
rn1qkb1r/p1pppppp/1p5n/8/3P4/3b1N2/PPP2PPP/RN2KB1R w KQkq - 0 6,Ne5,-743,-871,-128,0
rn1qkb1r/p1pppppp/1p5n/4N3/3P4/3b4/PPP2PPP/RN2KB1R b KQkq - 1 6,Bxc2,-879,-891,-12,1
rn1qkb1r/p1pppppp/1p5n/4N3/3P4/8/PPb2PPP/RN2KB1R w KQkq - 0 7,Nxf7,-893,-957,-64,1
rn1qkb1r/p1pppNpp/1p5n/8/3P4/8/PPb2PPP/RN2KB1R b KQkq - 0 7,Nxf7,-941,-927,14,1
rn1qkb1r/p1pppnpp/1p6/8/3P4/8/PPb2PPP/RN2KB1R w KQkq - 0 8,Ba6,-938,-1037,-99,1
rn1qkb1r/p1pppnpp/Bp6/8/3P4/8/PPb2PPP/RN2K2R b KQkq - 1 8,Nxa6,-1036,-1034,2,1
r2qkb1r/p1pppnpp/np6/8/3P4/8/PPb2PPP/RN2K2R w KQkq - 0 9,Ke2,-1044,-1059,-15,1
r2qkb1r/p1pppnpp/np6/8/3P4/8/PPb1KPPP/RN5R b kq - 1 9,Bxb1,-1065,-1083,-18,1
r2qkb1r/p1pppnpp/np6/8/3P4/8/PP2KPPP/Rb5R w kq - 0 10,Rd1,-1096,-1121,-25,1
r2qkb1r/p1pppnpp/np6/8/3P4/8/PP2KPPP/Rb1R4 b kq - 1 10,Bg6,-1148,-1195,-47,1
r2qkb1r/p1pppnpp/np4b1/8/3P4/8/PP2KPPP/R2R4 w kq - 2 11,Rd3,-1199,-1224,-25,1
r2qkb1r/p1pppnpp/np4b1/8/3P4/3R4/PP2KPPP/R7 b kq - 3 11,Bxd3+,-1198,-1239,-41,1
r2qkb1r/p1pppnpp/np6/8/3P4/3b4/PP2KPPP/R7 w kq - 0 12,Ke3,-1252,-1299,-47,1
r2qkb1r/p1pppnpp/np6/8/3P4/3bK3/PP3PPP/R7 b kq - 1 12,g6,-1290,-1246,44,1
r2qkb1r/p1pppn1p/np4p1/8/3P4/3bK3/PP3PPP/R7 w kq - 0 13,Rb1,-1205,-1347,-142,0
r2qkb1r/p1pppn1p/np4p1/8/3P4/3bK3/PP3PPP/1R6 b kq - 1 13,Bg7,-1346,-1205,141,1
r2qk2r/p1pppnbp/np4p1/8/3P4/3bK3/PP3PPP/1R6 w kq - 2 14,f4,-1219,-1338,-119,0
r2qk2r/p1pppnbp/np4p1/8/3P1P2/3bK3/PP4PP/1R6 b kq - 0 14,Bxb1,-1346,-1352,-6,1
r2qk2r/p1pppnbp/np4p1/8/3P1P2/4K3/PP4PP/1b6 w kq - 0 15,g4,-1358,-1392,-34,1
r2qk2r/p1pppnbp/np4p1/8/3P1PP1/4K3/PP5P/1b6 b kq - 0 15,Bxa2,-1364,-1394,-30,1
r2qk2r/p1pppnbp/np4p1/8/3P1PP1/4K3/bP5P/8 w kq - 0 16,h4,-1402,-1426,-24,1
r2qk2r/p1pppnbp/np4p1/8/3P1PPP/4K3/bP6/8 b kq - 0 16,O-O,-1429,-1229,200,1
r2q1rk1/p1pppnbp/np4p1/8/3P1PPP/4K3/bP6/8 w - - 1 17,h5,-1237,-1258,-21,1
r2q1rk1/p1pppnbp/np4p1/7P/3P1PP1/4K3/bP6/8 b - - 0 17,Nd6,-1285,-1240,45,1
r2q1rk1/p1ppp1bp/np1n2p1/7P/3P1PP1/4K3/bP6/8 w - - 1 18,h6,-1234,-1313,-79,1
r2q1rk1/p1ppp1bp/np1n2pP/8/3P1PP1/4K3/bP6/8 b - - 0 18,Bxh6,-1311,-1321,-10,1
r2q1rk1/p1ppp2p/np1n2pb/8/3P1PP1/4K3/bP6/8 w - - 0 19,g5,-1329,-1352,-23,1
r2q1rk1/p1ppp2p/np1n2pb/6P1/3P1P2/4K3/bP6/8 b - - 0 19,Bxg5,-1375,-1332,43,1
r2q1rk1/p1ppp2p/np1n2p1/6b1/3P1P2/4K3/bP6/8 w - - 0 20,Kf2,-1338,-1373,-35,1
r2q1rk1/p1ppp2p/np1n2p1/6b1/3P1P2/8/bP3K2/8 b - - 1 20,Bxf4,-1374,-1350,24,1
r2q1rk1/p1ppp2p/np1n2p1/8/3P1b2/8/bP3K2/8 w - - 0 21,b3,-1353,-1359,-6,1
r2q1rk1/p1ppp2p/np1n2p1/8/3P1b2/1P6/b4K2/8 b - - 0 21,Nb4,-1376,-1384,-8,1
r2q1rk1/p1ppp2p/1p1n2p1/8/1n1P1b2/1P6/b4K2/8 w - - 1 22,d5,-1393,-1392,1,1
r2q1rk1/p1ppp2p/1p1n2p1/3P4/1n3b2/1P6/b4K2/8 b - - 0 22,Nxd5,-1407,-1351,56,1
r2q1rk1/p1ppp2p/1p1n2p1/3n4/5b2/1P6/b4K2/8 w - - 0 23,b4,-1372,-1385,-13,1
r2q1rk1/p1ppp2p/1p1n2p1/3n4/1P3b2/8/b4K2/8 b - - 0 23,Nxb4,-1401,-1363,38,1
r2q1rk1/p1ppp2p/1p1n2p1/8/1n3b2/8/b4K2/8 w - - 0 24,Ke2,-1353,-1370,-17,1
r2q1rk1/p1ppp2p/1p1n2p1/8/1n3b2/8/b3K3/8 b - - 1 24,Qc8,-1360,-1397,-37,1
r1q2rk1/p1ppp2p/1p1n2p1/8/1n3b2/8/b3K3/8 w - - 2 25,Kf3,-1432,-9991,-8559,0
r1q2rk1/p1ppp2p/1p1n2p1/8/1n3b2/5K2/b7/8 b - - 3 25,Qb7+,-9991,-1413,8578,1
r4rk1/pqppp2p/1p1n2p1/8/1n3b2/5K2/b7/8 w - - 4 26,Kg4,-9990,-9998,-8,1
r4rk1/pqppp2p/1p1n2p1/8/1n3bK1/8/b7/8 b - - 5 26,Qg2+,-9998,-9999,-1,1
r4rk1/p1ppp2p/1p1n2p1/8/1n3bK1/8/b5q1/8 w - - 6 27,Kh4,-9999,-9999,0,1
r4rk1/p1ppp2p/1p1n2p1/8/1n3b1K/8/b5q1/8 b - - 7 27,Qg3#,-9999,-10000,-1,1
rnbqkbnr/pppppppp/8/8/8/8/PPPPPPPP/RNBQKBNR w KQkq - 0 1,d4,40,29,-11,1
rnbqkbnr/pppppppp/8/8/3P4/8/PPP1PPPP/RNBQKBNR b KQkq - 0 1,c6,31,77,46,1
rnbqkbnr/pp1ppppp/2p5/8/3P4/8/PPP1PPPP/RNBQKBNR w KQkq - 0 2,e4,648,46,-602,0
rnbqkbnr/pp1ppppp/2p5/8/3PP3/8/PPP2PPP/RNBQKBNR b KQkq - 0 2,d5,37,42,5,1
rnbqkbnr/pp2pppp/2p5/3p4/3PP3/8/PPP2PPP/RNBQKBNR w KQkq - 0 3,e5,40,44,4,1
rnbqkbnr/pp2pppp/2p5/3pP3/3P4/8/PPP2PPP/RNBQKBNR b KQkq - 0 3,Bf5,28,36,8,1
rn1qkbnr/pp2pppp/2p5/3pPb2/3P4/8/PPP2PPP/RNBQKBNR w KQkq - 1 4,Bd3,37,16,-21,1
rn1qkbnr/pp2pppp/2p5/3pPb2/3P4/3B4/PPP2PPP/RNBQK1NR b KQkq - 2 4,Bxd3,18,20,2,1
rn1qkbnr/pp2pppp/2p5/3pP3/3P4/3b4/PPP2PPP/RNBQK1NR w KQkq - 0 5,Qxd3,21,15,-6,1
rn1qkbnr/pp2pppp/2p5/3pP3/3P4/3Q4/PPP2PPP/RNB1K1NR b KQkq - 0 5,e6,12,15,3,1
rn1qkbnr/pp3ppp/2p1p3/3pP3/3P4/3Q4/PPP2PPP/RNB1K1NR w KQkq - 0 6,f4,18,-15,-33,1
rn1qkbnr/pp3ppp/2p1p3/3pP3/3P1P2/3Q4/PPP3PP/RNB1K1NR b KQkq - 0 6,c5,-26,-17,9,1
rn1qkbnr/pp3ppp/4p3/2ppP3/3P1P2/3Q4/PPP3PP/RNB1K1NR w KQkq - 0 7,c3,-11,-38,-27,1
rn1qkbnr/pp3ppp/4p3/2ppP3/3P1P2/2PQ4/PP4PP/RNB1K1NR b KQkq - 0 7,c4,-30,36,66,1
rn1qkbnr/pp3ppp/4p3/3pP3/2pP1P2/2PQ4/PP4PP/RNB1K1NR w KQkq - 0 8,Qf3,35,37,2,1
rn1qkbnr/pp3ppp/4p3/3pP3/2pP1P2/2P2Q2/PP4PP/RNB1K1NR b KQkq - 1 8,Nc6,28,32,4,1
r2qkbnr/pp3ppp/2n1p3/3pP3/2pP1P2/2P2Q2/PP4PP/RNB1K1NR w KQkq - 2 9,Be3,38,-16,-54,1
r2qkbnr/pp3ppp/2n1p3/3pP3/2pP1P2/2P1BQ2/PP4PP/RN2K1NR b KQkq - 3 9,Nge7,-11,3,14,1
r2qkb1r/pp2nppp/2n1p3/3pP3/2pP1P2/2P1BQ2/PP4PP/RN2K1NR w KQkq - 4 10,Na3,13,-37,-50,1
r2qkb1r/pp2nppp/2n1p3/3pP3/2pP1P2/N1P1BQ2/PP4PP/R3K1NR b KQkq - 5 10,Qb6,-33,-12,21,1
r3kb1r/pp2nppp/1qn1p3/3pP3/2pP1P2/N1P1BQ2/PP4PP/R3K1NR w KQkq - 6 11,Rb1,-12,-58,-46,1
r3kb1r/pp2nppp/1qn1p3/3pP3/2pP1P2/N1P1BQ2/PP4PP/1R2K1NR b Kkq - 7 11,Nf5,-48,-6,42,1
r3kb1r/pp3ppp/1qn1p3/3pPn2/2pP1P2/N1P1BQ2/PP4PP/1R2K1NR w Kkq - 8 12,Nc2,4,6,2,1
r3kb1r/pp3ppp/1qn1p3/3pPn2/2pP1P2/2P1BQ2/PPN3PP/1R2K1NR b Kkq - 9 12,Nxe3,0,79,79,1
r3kb1r/pp3ppp/1qn1p3/3pP3/2pP1P2/2P1nQ2/PPN3PP/1R2K1NR w Kkq - 0 13,Nxe3,103,82,-21,1
r3kb1r/pp3ppp/1qn1p3/3pP3/2pP1P2/2P1NQ2/PP4PP/1R2K1NR b Kkq - 0 13,Ba3,72,102,30,1
r3k2r/pp3ppp/1qn1p3/3pP3/2pP1P2/b1P1NQ2/PP4PP/1R2K1NR w Kkq - 1 14,Ne2,112,105,-7,1
r3k2r/pp3ppp/1qn1p3/3pP3/2pP1P2/b1P1NQ2/PP2N1PP/1R2K2R b Kkq - 2 14,Be7,101,190,89,1
r3k2r/pp2bppp/1qn1p3/3pP3/2pP1P2/2P1NQ2/PP2N1PP/1R2K2R w Kkq - 3 15,O-O,188,90,-98,1
r3k2r/pp2bppp/1qn1p3/3pP3/2pP1P2/2P1NQ2/PP2N1PP/1R3RK1 b kq - 4 15,O-O-O,88,179,91,1
2kr3r/pp2bppp/1qn1p3/3pP3/2pP1P2/2P1NQ2/PP2N1PP/1R3RK1 w - - 5 16,f5,169,165,-4,1
2kr3r/pp2bppp/1qn1p3/3pPP2/2pP4/2P1NQ2/PP2N1PP/1R3RK1 b - - 0 16,Bg5,148,169,21,1
2kr3r/pp3ppp/1qn1p3/3pPPb1/2pP4/2P1NQ2/PP2N1PP/1R3RK1 w - - 1 17,fxe6,177,81,-96,1
2kr3r/pp3ppp/1qn1P3/3pP1b1/2pP4/2P1NQ2/PP2N1PP/1R3RK1 b - - 0 17,fxe6,83,156,73,1
2kr3r/pp4pp/1qn1p3/3pP1b1/2pP4/2P1NQ2/PP2N1PP/1R3RK1 w - - 0 18,Nxd5,167,-217,-384,0
2kr3r/pp4pp/1qn1p3/3NP1b1/2pP4/2P2Q2/PP2N1PP/1R3RK1 b - - 0 18,exd5,-192,362,554,1
2kr3r/pp4pp/1qn5/3pP1b1/2pP4/2P2Q2/PP2N1PP/1R3RK1 w - - 0 19,Qf5+,353,356,3,1
2kr3r/pp4pp/1qn5/3pPQb1/2pP4/2P5/PP2N1PP/1R3RK1 b - - 1 19,Kb8,358,355,-3,1
1k1r3r/pp4pp/1qn5/3pPQb1/2pP4/2P5/PP2N1PP/1R3RK1 w - - 2 20,Qxg5,365,336,-29,1
1k1r3r/pp4pp/1qn5/3pP1Q1/2pP4/2P5/PP2N1PP/1R3RK1 b - - 0 20,Rde8,365,376,11,1
1k2r2r/pp4pp/1qn5/3pP1Q1/2pP4/2P5/PP2N1PP/1R3RK1 w - - 1 21,Nf4,377,214,-163,0
1k2r2r/pp4pp/1qn5/3pP1Q1/2pP1N2/2P5/PP4PP/1R3RK1 b - - 2 21,g6,210,501,291,1
1k2r2r/pp5p/1qn3p1/3pP1Q1/2pP1N2/2P5/PP4PP/1R3RK1 w - - 0 22,Nxd5,472,446,-26,1
1k2r2r/pp5p/1qn3p1/3NP1Q1/2pP4/2P5/PP4PP/1R3RK1 b - - 0 22,Reg8,492,767,275,1
1k4rr/pp5p/1qn3p1/3NP1Q1/2pP4/2P5/PP4PP/1R3RK1 w - - 1 23,Nxb6,777,763,-14,1
1k4rr/pp5p/1Nn3p1/4P1Q1/2pP4/2P5/PP4PP/1R3RK1 b - - 0 23,axb6,772,759,-13,1
1k4rr/1p5p/1pn3p1/4P1Q1/2pP4/2P5/PP4PP/1R3RK1 w - - 0 24,d5,743,741,-2,1
1k4rr/1p5p/1pn3p1/3PP1Q1/2p5/2P5/PP4PP/1R3RK1 b - - 0 24,h6,774,792,18,1
1k4rr/1p6/1pn3pp/3PP1Q1/2p5/2P5/PP4PP/1R3RK1 w - - 0 25,Qf6,794,768,-26,1
1k4rr/1p6/1pn2Qpp/3PP3/2p5/2P5/PP4PP/1R3RK1 b - - 1 25,Nd8,747,839,92,1
1k1n2rr/1p6/1p3Qpp/3PP3/2p5/2P5/PP4PP/1R3RK1 w - - 2 26,Qxb6,825,820,-5,1
1k1n2rr/1p6/1Q4pp/3PP3/2p5/2P5/PP4PP/1R3RK1 b - - 0 26,g5,804,818,14,1
1k1n2rr/1p6/1Q5p/3PP1p1/2p5/2P5/PP4PP/1R3RK1 w - - 0 27,e6,823,849,26,1
1k1n2rr/1p6/1Q2P2p/3P2p1/2p5/2P5/PP4PP/1R3RK1 b - - 0 27,h5,853,898,45,1
1k1n2rr/1p6/1Q2P3/3P2pp/2p5/2P5/PP4PP/1R3RK1 w - - 0 28,e7,932,926,-6,1
1k1n2rr/1p2P3/1Q6/3P2pp/2p5/2P5/PP4PP/1R3RK1 b - - 0 28,Re8,911,909,-2,1
1k1nr2r/1p2P3/1Q6/3P2pp/2p5/2P5/PP4PP/1R3RK1 w - - 1 29,exd8=Q+,910,9997,9087,1
1k1Qr2r/1p6/1Q6/3P2pp/2p5/2P5/PP4PP/1R3RK1 b - - 0 29,Rxd8,9997,9997,0,1
1k1r3r/1p6/1Q6/3P2pp/2p5/2P5/PP4PP/1R3RK1 w - - 0 30,d6,9997,795,-9202,0
1k1r3r/1p6/1Q1P4/6pp/2p5/2P5/PP4PP/1R3RK1 b - - 0 30,g4,890,9997,9107,1
1k1r3r/1p6/1Q1P4/7p/2p3p1/2P5/PP4PP/1R3RK1 w - - 0 31,Rf7,9997,9998,1,1
rnbqkbnr/pppppppp/8/8/8/8/PPPPPPPP/RNBQKBNR w KQkq - 0 1,e4,33,21,-12,1
rnbqkbnr/pppppppp/8/8/4P3/8/PPPP1PPP/RNBQKBNR b KQkq - 0 1,b6,37,104,67,1
rnbqkbnr/p1pppppp/1p6/8/4P3/8/PPPP1PPP/RNBQKBNR w KQkq - 0 2,Bd3,89,1,-88,1
rnbqkbnr/p1pppppp/1p6/8/4P3/3B4/PPPP1PPP/RNBQK1NR b KQkq - 1 2,Bb7,-4,7,11,1
rn1qkbnr/pbpppppp/1p6/8/4P3/3B4/PPPP1PPP/RNBQK1NR w KQkq - 2 3,Nf3,26,24,-2,1
rn1qkbnr/pbpppppp/1p6/8/4P3/3B1N2/PPPP1PPP/RNBQK2R b KQkq - 3 3,Nc6,24,34,10,1
r2qkbnr/pbpppppp/1pn5/8/4P3/3B1N2/PPPP1PPP/RNBQK2R w KQkq - 4 4,Bb5,41,8,-33,1
r2qkbnr/pbpppppp/1pn5/1B6/4P3/5N2/PPPP1PPP/RNBQK2R b KQkq - 5 4,a6,-1,8,9,1
r2qkbnr/1bpppppp/ppn5/1B6/4P3/5N2/PPPP1PPP/RNBQK2R w KQkq - 0 5,Bxc6,1,1,0,1
r2qkbnr/1bpppppp/ppB5/8/4P3/5N2/PPPP1PPP/RNBQK2R b KQkq - 0 5,dxc6,-2,30,32,1
r2qkbnr/1bp1pppp/ppp5/8/4P3/5N2/PPPP1PPP/RNBQK2R w KQkq - 0 6,O-O,40,9,-31,1
r2qkbnr/1bp1pppp/ppp5/8/4P3/5N2/PPPP1PPP/RNBQ1RK1 b kq - 1 6,c5,6,-5,-11,1
r2qkbnr/1bp1pppp/pp6/2p5/4P3/5N2/PPPP1PPP/RNBQ1RK1 w kq - 0 7,d3,-14,-53,-39,1
r2qkbnr/1bp1pppp/pp6/2p5/4P3/3P1N2/PPP2PPP/RNBQ1RK1 b kq - 0 7,b5,-47,99,146,1
r2qkbnr/1bp1pppp/p7/1pp5/4P3/3P1N2/PPP2PPP/RNBQ1RK1 w kq - 0 8,c4,125,69,-56,1
r2qkbnr/1bp1pppp/p7/1pp5/2P1P3/3P1N2/PP3PPP/RNBQ1RK1 b kq - 0 8,bxc4,89,163,74,1
r2qkbnr/1bp1pppp/p7/2p5/2p1P3/3P1N2/PP3PPP/RNBQ1RK1 w kq - 0 9,dxc4,173,-22,-195,0
r2qkbnr/1bp1pppp/p7/2p5/2P1P3/5N2/PP3PPP/RNBQ1RK1 b kq - 0 9,Bxe4,-31,133,164,1
r2qkbnr/2p1pppp/p7/2p5/2P1b3/5N2/PP3PPP/RNBQ1RK1 w kq - 0 10,Qe2,142,-212,-354,0
r2qkbnr/2p1pppp/p7/2p5/2P1b3/5N2/PP2QPPP/RNB2RK1 b kq - 1 10,f5,-228,258,486,1
r2qkbnr/2p1p1pp/p7/2p2p2/2P1b3/5N2/PP2QPPP/RNB2RK1 w kq - 0 11,Nfd2,253,0,-253,0
r2qkbnr/2p1p1pp/p7/2p2p2/2P1b3/8/PP1NQPPP/RNB2RK1 b kq - 1 11,Qd3,31,29,-2,1
r3kbnr/2p1p1pp/p7/2p2p2/2P1b3/3q4/PP1NQPPP/RNB2RK1 w kq - 2 12,Qxd3,36,-17,-53,1
r3kbnr/2p1p1pp/p7/2p2p2/2P1b3/3Q4/PP1N1PPP/RNB2RK1 b kq - 0 12,Bxd3,-21,-27,-6,1
r3kbnr/2p1p1pp/p7/2p2p2/2P5/3b4/PP1N1PPP/RNB2RK1 w kq - 0 13,Re1,-24,-21,3,1
r3kbnr/2p1p1pp/p7/2p2p2/2P5/3b4/PP1N1PPP/RNB1R1K1 b kq - 1 13,e6,-24,42,66,1
r3kbnr/2p3pp/p3p3/2p2p2/2P5/3b4/PP1N1PPP/RNB1R1K1 w kq - 0 14,Na3,46,-32,-78,1
r3kbnr/2p3pp/p3p3/2p2p2/2P5/N2b4/PP1N1PPP/R1B1R1K1 b kq - 1 14,O-O-O,-35,-12,23,1
2kr1bnr/2p3pp/p3p3/2p2p2/2P5/N2b4/PP1N1PPP/R1B1R1K1 w - - 2 15,Rxe6,-6,-53,-47,1
2kr1bnr/2p3pp/p3R3/2p2p2/2P5/N2b4/PP1N1PPP/R1B3K1 b - - 0 15,Bxc4,-39,514,553,1
2kr1bnr/2p3pp/p3R3/2p2p2/2b5/N7/PP1N1PPP/R1B3K1 w - - 0 16,Naxc4,497,503,6,1
2kr1bnr/2p3pp/p3R3/2p2p2/2N5/8/PP1N1PPP/R1B3K1 b - - 0 16,Ne7,494,529,35,1
2kr1b1r/2p1n1pp/p3R3/2p2p2/2N5/8/PP1N1PPP/R1B3K1 w - - 1 17,Rxa6,512,508,-4,1
2kr1b1r/2p1n1pp/R7/2p2p2/2N5/8/PP1N1PPP/R1B3K1 b - - 0 17,Nd5,490,576,86,1
2kr1b1r/2p3pp/R7/2pn1p2/2N5/8/PP1N1PPP/R1B3K1 w - - 1 18,Ra8+,574,590,16,1
R1kr1b1r/2p3pp/8/2pn1p2/2N5/8/PP1N1PPP/R1B3K1 b - - 2 18,Kd7,600,599,-1,1
R2r1b1r/2pk2pp/8/2pn1p2/2N5/8/PP1N1PPP/R1B3K1 w - - 3 19,Rxd8+,546,550,4,1
3R1b1r/2pk2pp/8/2pn1p2/2N5/8/PP1N1PPP/R1B3K1 b - - 0 19,Kxd8,556,541,-15,1
3k1b1r/2p3pp/8/2pn1p2/2N5/8/PP1N1PPP/R1B3K1 w - - 0 20,Nf3,541,554,13,1
3k1b1r/2p3pp/8/2pn1p2/2N5/5N2/PP3PPP/R1B3K1 b - - 1 20,h6,552,589,37,1
3k1b1r/2p3p1/7p/2pn1p2/2N5/5N2/PP3PPP/R1B3K1 w - - 0 21,Ne3,599,500,-99,1
3k1b1r/2p3p1/7p/2pn1p2/8/4NN2/PP3PPP/R1B3K1 b - - 1 21,Bd6,534,616,82,1
3k3r/2p3p1/3b3p/2pn1p2/8/4NN2/PP3PPP/R1B3K1 w - - 2 22,Nxd5,620,627,7,1
3k3r/2p3p1/3b3p/2pN1p2/8/5N2/PP3PPP/R1B3K1 b - - 0 22,Re8,647,666,19,1
3kr3/2p3p1/3b3p/2pN1p2/8/5N2/PP3PPP/R1B3K1 w - - 1 23,Bf4,664,585,-79,1
3kr3/2p3p1/3b3p/2pN1p2/5B2/5N2/PP3PPP/R5K1 b - - 2 23,g5,637,661,24,1
3kr3/2p5/3b3p/2pN1pp1/5B2/5N2/PP3PPP/R5K1 w - - 0 24,Bxd6,660,654,-6,1
3kr3/2p5/3B3p/2pN1pp1/8/5N2/PP3PPP/R5K1 b - - 0 24,cxd6,662,671,9,1
3kr3/8/3p3p/2pN1pp1/8/5N2/PP3PPP/R5K1 w - - 0 25,Re1,674,623,-51,1
3kr3/8/3p3p/2pN1pp1/8/5N2/PP3PPP/4R1K1 b - - 1 25,Rxe1+,634,641,7,1
3k4/8/3p3p/2pN1pp1/8/5N2/PP3PPP/4r1K1 w - - 0 26,Nxe1,656,644,-12,1
3k4/8/3p3p/2pN1pp1/8/8/PP3PPP/4N1K1 b - - 0 26,Kd7,643,653,10,1
8/3k4/3p3p/2pN1pp1/8/8/PP3PPP/4N1K1 w - - 1 27,Nf6+,657,628,-29,1
8/3k4/3p1N1p/2p2pp1/8/8/PP3PPP/4N1K1 b - - 2 27,Ke6,647,647,0,1
8/8/3pkN1p/2p2pp1/8/8/PP3PPP/4N1K1 w - - 3 28,Ng8,596,573,-23,1
6N1/8/3pk2p/2p2pp1/8/8/PP3PPP/4N1K1 b - - 4 28,h5,582,587,5,1
6N1/8/3pk3/2p2ppp/8/8/PP3PPP/4N1K1 w - - 0 29,f3,585,536,-49,1
6N1/8/3pk3/2p2ppp/8/5P2/PP4PP/4N1K1 b - - 0 29,Kf7,574,596,22,1
6N1/5k2/3p4/2p2ppp/8/5P2/PP4PP/4N1K1 w - - 1 30,Nh6+,629,608,-21,1
8/5k2/3p3N/2p2ppp/8/5P2/PP4PP/4N1K1 b - - 2 30,Kg6,646,645,-1,1
8/8/3p2kN/2p2ppp/8/5P2/PP4PP/4N1K1 w - - 3 31,Ng8,652,637,-15,1
6N1/8/3p2k1/2p2ppp/8/5P2/PP4PP/4N1K1 b - - 4 31,Kf7,658,651,-7,1
6N1/5k2/3p4/2p2ppp/8/5P2/PP4PP/4N1K1 w - - 5 32,h4,662,565,-97,1
6N1/5k2/3p4/2p2ppp/7P/5P2/PP4P1/4N1K1 b - - 0 32,Kxg8,602,643,41,1
6k1/8/3p4/2p2ppp/7P/5P2/PP4P1/4N1K1 w - - 0 33,hxg5,635,610,-25,1
6k1/8/3p4/2p2pPp/8/5P2/PP4P1/4N1K1 b - - 0 33,d5,600,671,71,1
6k1/8/8/2pp1pPp/8/5P2/PP4P1/4N1K1 w - - 0 34,Nd3,684,580,-104,0
6k1/8/8/2pp1pPp/8/3N1P2/PP4P1/6K1 b - - 1 34,c4,591,618,27,1
6k1/8/8/3p1pPp/2p5/3N1P2/PP4P1/6K1 w - - 0 35,Ne5,649,654,5,1
6k1/8/8/3pNpPp/2p5/5P2/PP4P1/6K1 b - - 1 35,Kg7,638,694,56,1
8/6k1/8/3pNpPp/2p5/5P2/PP4P1/6K1 w - - 2 36,f4,687,703,16,1
rnbqkbnr/pppppppp/8/8/8/8/PPPPPPPP/RNBQKBNR w KQkq - 0 1,d4,38,31,-7,1
rnbqkbnr/pppppppp/8/8/3P4/8/PPP1PPPP/RNBQKBNR b KQkq - 0 1,d5,31,29,-2,1
rnbqkbnr/ppp1pppp/8/3p4/3P4/8/PPP1PPPP/RNBQKBNR w KQkq - 0 2,e3,30,16,-14,1
rnbqkbnr/ppp1pppp/8/3p4/3P4/4P3/PPP2PPP/RNBQKBNR b KQkq - 0 2,Nf6,13,18,5,1
rnbqkb1r/ppp1pppp/5n2/3p4/3P4/4P3/PPP2PPP/RNBQKBNR w KQkq - 1 3,Nc3,23,-27,-50,1
rnbqkb1r/ppp1pppp/5n2/3p4/3P4/2N1P3/PPP2PPP/R1BQKBNR b KQkq - 2 3,Bf5,-26,-26,0,1
rn1qkb1r/ppp1pppp/5n2/3p1b2/3P4/2N1P3/PPP2PPP/R1BQKBNR w KQkq - 3 4,Bd3,-22,-20,2,1
rn1qkb1r/ppp1pppp/5n2/3p1b2/3P4/2NBP3/PPP2PPP/R1BQK1NR b KQkq - 4 4,Bxd3,-19,24,43,1
rn1qkb1r/ppp1pppp/5n2/3p4/3P4/2NbP3/PPP2PPP/R1BQK1NR w KQkq - 0 5,Qxd3,25,15,-10,1
rn1qkb1r/ppp1pppp/5n2/3p4/3P4/2NQP3/PPP2PPP/R1B1K1NR b KQkq - 0 5,Qd6,16,29,13,1
rn2kb1r/ppp1pppp/3q1n2/3p4/3P4/2NQP3/PPP2PPP/R1B1K1NR w KQkq - 1 6,Nb5,28,-13,-41,1
rn2kb1r/ppp1pppp/3q1n2/1N1p4/3P4/3QP3/PPP2PPP/R1B1K1NR b KQkq - 2 6,Qd7,-21,2,23,1
rn2kb1r/pppqpppp/5n2/1N1p4/3P4/3QP3/PPP2PPP/R1B1K1NR w KQkq - 3 7,Qc3,12,-540,-552,0
rn2kb1r/pppqpppp/5n2/1N1p4/3P4/2Q1P3/PPP2PPP/R1B1K1NR b KQkq - 4 7,c6,-561,-127,434,1
rn2kb1r/pp1qpppp/2p2n2/1N1p4/3P4/2Q1P3/PPP2PPP/R1B1K1NR w KQkq - 0 8,Na3,-119,-123,-4,1
rn2kb1r/pp1qpppp/2p2n2/3p4/3P4/N1Q1P3/PPP2PPP/R1B1K1NR b KQkq - 1 8,Ne4,-141,-61,80,1
rn2kb1r/pp1qpppp/2p5/3p4/3Pn3/N1Q1P3/PPP2PPP/R1B1K1NR w KQkq - 2 9,Qb3,-55,-61,-6,1
rn2kb1r/pp1qpppp/2p5/3p4/3Pn3/NQ2P3/PPP2PPP/R1B1K1NR b KQkq - 3 9,Qf5,-48,30,78,1
rn2kb1r/pp2pppp/2p5/3p1q2/3Pn3/NQ2P3/PPP2PPP/R1B1K1NR w KQkq - 4 10,f3,27,21,-6,1
rn2kb1r/pp2pppp/2p5/3p1q2/3Pn3/NQ2PP2/PPP3PP/R1B1K1NR b KQkq - 0 10,Nd6,21,21,0,1
rn2kb1r/pp2pppp/2pn4/3p1q2/3P4/NQ2PP2/PPP3PP/R1B1K1NR w KQkq - 1 11,Bd2,22,-61,-83,1
rn2kb1r/pp2pppp/2pn4/3p1q2/3P4/NQ2PP2/PPPB2PP/R3K1NR b KQkq - 2 11,b5,-47,-24,23,1
rn2kb1r/p3pppp/2pn4/1p1p1q2/3P4/NQ2PP2/PPPB2PP/R3K1NR w KQkq - 0 12,Bb4,-38,-87,-49,1
rn2kb1r/p3pppp/2pn4/1p1p1q2/1B1P4/NQ2PP2/PPP3PP/R3K1NR b KQkq - 1 12,Nc4,-84,34,118,1
rn2kb1r/p3pppp/2p5/1p1p1q2/1BnP4/NQ2PP2/PPP3PP/R3K1NR w KQkq - 2 13,Ne2,39,-105,-144,0
rn2kb1r/p3pppp/2p5/1p1p1q2/1BnP4/NQ2PP2/PPP1N1PP/R3K2R b KQkq - 3 13,Na6,-87,-71,16,1
r3kb1r/p3pppp/n1p5/1p1p1q2/1BnP4/NQ2PP2/PPP1N1PP/R3K2R w KQkq - 4 14,Ng3,-30,-73,-43,1
r3kb1r/p3pppp/n1p5/1p1p1q2/1BnP4/NQ2PPN1/PPP3PP/R3K2R b KQkq - 5 14,Qg5,-84,10,94,1
r3kb1r/p3pppp/n1p5/1p1p2q1/1BnP4/NQ2PPN1/PPP3PP/R3K2R w KQkq - 6 15,f4,-8,-11,-3,1
r3kb1r/p3pppp/n1p5/1p1p2q1/1BnP1P2/NQ2P1N1/PPP3PP/R3K2R b KQkq - 0 15,Qg4,-8,-25,-17,1
r3kb1r/p3pppp/n1p5/1p1p4/1BnP1Pq1/NQ2P1N1/PPP3PP/R3K2R w KQkq - 1 16,Bc3,-16,-228,-212,0
r3kb1r/p3pppp/n1p5/1p1p4/2nP1Pq1/NQB1P1N1/PPP3PP/R3K2R b KQkq - 2 16,Nxe3,-215,-256,-41,1
r3kb1r/p3pppp/n1p5/1p1p4/3P1Pq1/NQB1n1N1/PPP3PP/R3K2R w KQkq - 0 17,Nxb5,-274,-247,27,1
r3kb1r/p3pppp/n1p5/1N1p4/3P1Pq1/1QB1n1N1/PPP3PP/R3K2R b KQkq - 0 17,cxb5,-269,-206,63,1
r3kb1r/p3pppp/n7/1p1p4/3P1Pq1/1QB1n1N1/PPP3PP/R3K2R w KQkq - 0 18,Qxb5+,-182,-227,-45,1
r3kb1r/p3pppp/n7/1Q1p4/3P1Pq1/2B1n1N1/PPP3PP/R3K2R b KQkq - 0 18,Qd7,-231,-227,4,1
r3kb1r/p2qpppp/n7/1Q1p4/3P1P2/2B1n1N1/PPP3PP/R3K2R w KQkq - 1 19,Qxd7+,-232,-482,-250,0
r3kb1r/p2Qpppp/n7/3p4/3P1P2/2B1n1N1/PPP3PP/R3K2R b KQkq - 0 19,Kxd7,-463,-485,-22,1
r4b1r/p2kpppp/n7/3p4/3P1P2/2B1n1N1/PPP3PP/R3K2R w KQ - 0 20,Rc1,-481,-508,-27,1
r4b1r/p2kpppp/n7/3p4/3P1P2/2B1n1N1/PPP3PP/2R1K2R b K - 1 20,Nxg2+,-497,-499,-2,1
r4b1r/p2kpppp/n7/3p4/3P1P2/2B3N1/PPP3nP/2R1K2R w K - 0 21,Kf2,-487,-486,1,1
r4b1r/p2kpppp/n7/3p4/3P1P2/2B3N1/PPP2KnP/2R4R b - - 1 21,Nxf4,-481,-476,5,1
r4b1r/p2kpppp/n7/3p4/3P1n2/2B3N1/PPP2K1P/2R4R w - - 0 22,h4,-487,-508,-21,1
r4b1r/p2kpppp/n7/3p4/3P1n1P/2B3N1/PPP2K2/2R4R b - - 0 22,e6,-486,-472,14,1
r4b1r/p2k1ppp/n3p3/3p4/3P1n1P/2B3N1/PPP2K2/2R4R w - - 0 23,Bd2,-453,-469,-16,1
r4b1r/p2k1ppp/n3p3/3p4/3P1n1P/6N1/PPPB1K2/2R4R b - - 1 23,Bd6,-527,-489,38,1
r6r/p2k1ppp/n2bp3/3p4/3P1n1P/6N1/PPPB1K2/2R4R w - - 2 24,Kf3,-509,-500,9,1
r6r/p2k1ppp/n2bp3/3p4/3P1n1P/5KN1/PPPB4/2R4R b - - 3 24,Ng6,-519,-489,30,1
r6r/p2k1ppp/n2bp1n1/3p4/3P3P/5KN1/PPPB4/2R4R w - - 4 25,Nh5,-485,-532,-47,1
r6r/p2k1ppp/n2bp1n1/3p3N/3P3P/5K2/PPPB4/2R4R b - - 5 25,Rhg8,-541,-494,47,1
r5r1/p2k1ppp/n2bp1n1/3p3N/3P3P/5K2/PPPB4/2R4R w - - 6 26,c4,-494,-490,4,1
r5r1/p2k1ppp/n2bp1n1/3p3N/2PP3P/5K2/PP1B4/2R4R b - - 0 26,dxc4,-520,-495,25,1
r5r1/p2k1ppp/n2bp1n1/7N/2pP3P/5K2/PP1B4/2R4R w - - 0 27,Rxc4,-505,-507,-2,1
r5r1/p2k1ppp/n2bp1n1/7N/2RP3P/5K2/PP1B4/7R b - - 0 27,Be7,-517,-453,64,1
r5r1/p2kbppp/n3p1n1/7N/2RP3P/5K2/PP1B4/7R w - - 1 28,Bg5,-463,-485,-22,1
r5r1/p2kbppp/n3p1n1/6BN/2RP3P/5K2/PP6/7R b - - 2 28,Bxg5,-489,-449,40,1
r5r1/p2k1ppp/n3p1n1/6bN/2RP3P/5K2/PP6/7R w - - 0 29,hxg5,-415,-394,21,1
r5r1/p2k1ppp/n3p1n1/6PN/2RP4/5K2/PP6/7R b - - 0 29,Rac8,-410,-384,26,1
2r3r1/p2k1ppp/n3p1n1/6PN/2RP4/5K2/PP6/7R w - - 1 30,Ra4,-403,-407,-4,1
2r3r1/p2k1ppp/n3p1n1/6PN/R2P4/5K2/PP6/7R b - - 2 30,Rc6,-418,-341,77,1
6r1/p2k1ppp/n1r1p1n1/6PN/R2P4/5K2/PP6/7R w - - 3 31,Rd1,-397,-439,-42,1
6r1/p2k1ppp/n1r1p1n1/6PN/R2P4/5K2/PP6/3R4 b - - 4 31,e5,-445,-359,86,1
6r1/p2k1ppp/n1r3n1/4p1PN/R2P4/5K2/PP6/3R4 w - - 0 32,dxe5+,-308,-425,-117,0
6r1/p2k1ppp/n1r3n1/4P1PN/R7/5K2/PP6/3R4 b - - 0 32,Ke6,-421,-339,82,1
6r1/p4ppp/n1r1k1n1/4P1PN/R7/5K2/PP6/3R4 w - - 1 33,Ke4,-319,-626,-307,0
6r1/p4ppp/n1r1k1n1/4P1PN/R3K3/8/PP6/3R4 b - - 2 33,Nc5+,-653,-677,-24,1
6r1/p4ppp/2r1k1n1/2n1P1PN/R3K3/8/PP6/3R4 w - - 3 34,Ke3,-651,-673,-22,1
6r1/p4ppp/2r1k1n1/2n1P1PN/R7/4K3/PP6/3R4 b - - 4 34,Nxa4,-681,-655,26,1
6r1/p4ppp/2r1k1n1/4P1PN/n7/4K3/PP6/3R4 w - - 0 35,b3,-637,-658,-21,1
6r1/p4ppp/2r1k1n1/4P1PN/n7/1P2K3/P7/3R4 b - - 0 35,Nc3,-642,-694,-52,1
6r1/p4ppp/2r1k1n1/4P1PN/8/1Pn1K3/P7/3R4 w - - 1 36,Rd2,-680,-688,-8,1
6r1/p4ppp/2r1k1n1/4P1PN/8/1Pn1K3/P2R4/8 b - - 2 36,Nxa2,-700,-479,221,1
6r1/p4ppp/2r1k1n1/4P1PN/8/1P2K3/n2R4/8 w - - 0 37,Rxa2,-476,-525,-49,1
6r1/p4ppp/2r1k1n1/4P1PN/8/1P2K3/R7/8 b - - 0 37,Rc3+,-479,-464,15,1
6r1/p4ppp/4k1n1/4P1PN/8/1Pr1K3/R7/8 w - - 1 38,Kd2,-480,-528,-48,1
6r1/p4ppp/4k1n1/4P1PN/8/1Pr5/R2K4/8 b - - 2 38,Rxb3,-543,-573,-30,1
6r1/p4ppp/4k1n1/4P1PN/8/1r6/R2K4/8 w - - 0 39,Rxa7,-554,-566,-12,1
6r1/R4ppp/4k1n1/4P1PN/8/1r6/3K4/8 b - - 0 39,Rd8+,-514,-480,34,1
3r4/R4ppp/4k1n1/4P1PN/8/1r6/3K4/8 w - - 1 40,Kc2,-502,-482,20,1
3r4/R4ppp/4k1n1/4P1PN/8/1r6/2K5/8 b - - 2 40,Rb5,-471,-490,-19,1
3r4/R4ppp/4k1n1/1r2P1PN/8/8/2K5/8 w - - 3 41,Ra6+,-477,-610,-133,0
3r4/5ppp/R3k1n1/1r2P1PN/8/8/2K5/8 b - - 4 41,Kxe5,-603,-575,28,1
3r4/5ppp/R5n1/1r2k1PN/8/8/2K5/8 w - - 0 42,Nxg7,-589,-595,-6,1
3r4/5pNp/R5n1/1r2k1P1/8/8/2K5/8 b - - 0 42,Rc5+,-582,-513,69,1
3r4/5pNp/R5n1/2r1k1P1/8/8/2K5/8 w - - 1 43,Kb3,-557,-554,3,1
3r4/5pNp/R5n1/2r1k1P1/8/1K6/8/8 b - - 2 43,Rb5+,-601,-522,79,1
3r4/5pNp/R5n1/1r2k1P1/8/1K6/8/8 w - - 3 44,Kc4,-542,-582,-40,1
3r4/5pNp/R5n1/1r2k1P1/2K5/8/8/8 b - - 4 44,Rb1,-578,-584,-6,1
3r4/5pNp/R5n1/4k1P1/2K5/8/8/1r6 w - - 5 45,Ra5+,-558,-598,-40,1
3r4/5pNp/6n1/R3k1P1/2K5/8/8/1r6 b - - 6 45,Kf4,-619,-462,157,1
3r4/5pNp/6n1/R5P1/2K2k2/8/8/1r6 w - - 7 46,Nh5+,-509,-511,-2,1
3r4/5p1p/6n1/R5PN/2K2k2/8/8/1r6 b - - 8 46,Kg4,-545,-518,27,1
3r4/5p1p/6n1/R5PN/2K3k1/8/8/1r6 w - - 9 47,Nf6+,-499,-536,-37,1
3r4/5p1p/5Nn1/R5P1/2K3k1/8/8/1r6 b - - 10 47,Kf4,-522,-545,-23,1
3r4/5p1p/5Nn1/R5P1/2K2k2/8/8/1r6 w - - 11 48,Nd5+,-472,-548,-76,1
3r4/5p1p/6n1/R2N2P1/2K2k2/8/8/1r6 b - - 12 48,Kg4,-516,-518,-2,1
3r4/5p1p/6n1/R2N2P1/2K3k1/8/8/1r6 w - - 13 49,Nc3,-527,-547,-20,1
3r4/5p1p/6n1/R5P1/2K3k1/2N5/8/1r6 b - - 14 49,Rc8+,-576,-654,-78,1
2r5/5p1p/6n1/R5P1/2K3k1/2N5/8/1r6 w - - 15 50,Kd3,-616,-701,-85,1
2r5/5p1p/6n1/R5P1/6k1/2NK4/8/1r6 b - - 16 50,Rb3,-707,-734,-27,1
2r5/5p1p/6n1/R5P1/6k1/1rNK4/8/8 w - - 17 51,Ra4+,-746,-734,12,1
2r5/5p1p/6n1/6P1/R5k1/1rNK4/8/8 b - - 18 51,Kxg5,-734,-620,114,1
2r5/5p1p/6n1/6k1/R7/1rNK4/8/8 w - - 0 52,Rc4,-626,-649,-23,1
2r5/5p1p/6n1/6k1/2R5/1rNK4/8/8 b - - 1 52,Rd8+,-651,-555,96,1
3r4/5p1p/6n1/6k1/2R5/1rNK4/8/8 w - - 2 53,Kc2,-513,-540,-27,1
3r4/5p1p/6n1/6k1/2R5/1rN5/2K5/8 b - - 3 53,Rbb8,-519,-544,-25,1
1r1r4/5p1p/6n1/6k1/2R5/2N5/2K5/8 w - - 4 54,Ne4+,-580,-601,-21,1
1r1r4/5p1p/6n1/6k1/2R1N3/8/2K5/8 b - - 5 54,Kf5,-586,-539,47,1
1r1r4/5p1p/6n1/5k2/2R1N3/8/2K5/8 w - - 6 55,Ng3+,-562,-564,-2,1
1r1r4/5p1p/6n1/5k2/2R5/6N1/2K5/8 b - - 7 55,Kg5,-567,-531,36,1
1r1r4/5p1p/6n1/6k1/2R5/6N1/2K5/8 w - - 8 56,Rc5+,-566,-596,-30,1
1r1r4/5p1p/6n1/2R3k1/8/6N1/2K5/8 b - - 9 56,Kg4,-598,-608,-10,1
1r1r4/5p1p/6n1/2R5/6k1/6N1/2K5/8 w - - 10 57,Rc3,-618,-628,-10,1
1r1r4/5p1p/6n1/8/6k1/2R3N1/2K5/8 b - - 11 57,Ne5,-636,-552,84,1
1r1r4/5p1p/8/4n3/6k1/2R3N1/2K5/8 w - - 12 58,Ne4,-603,-591,12,1
1r1r4/5p1p/8/4n3/4N1k1/2R5/2K5/8 b - - 13 58,h5,-606,-603,3,1
1r1r4/5p2/8/4n2p/4N1k1/2R5/2K5/8 w - - 0 59,Nf2+,-605,-656,-51,1
1r1r4/5p2/8/4n2p/6k1/2R5/2K2N2/8 b - - 1 59,Kg5,-653,-560,93,1
1r1r4/5p2/8/4n1kp/8/2R5/2K2N2/8 w - - 2 60,Rc5,-630,-673,-43,1
1r1r4/5p2/8/2R1n1kp/8/8/2K2N2/8 b - - 3 60,Kf5,-657,-622,35,1
1r1r4/5p2/8/2R1nk1p/8/8/2K2N2/8 w - - 4 61,Kc3,-639,-684,-45,1
1r1r4/5p2/8/2R1nk1p/8/2K5/5N2/8 b - - 5 61,Rbc8,-674,-696,-22,1
2rr4/5p2/8/2R1nk1p/8/2K5/5N2/8 w - - 6 62,Nd3,-680,-997,-317,0
2rr4/5p2/8/2R1nk1p/8/2KN4/8/8 b - - 7 62,Rxc5+,-1066,-754,312,1
3r4/5p2/8/2r1nk1p/8/2KN4/8/8 w - - 0 63,Nxc5,-781,-782,-1,1
3r4/5p2/8/2N1nk1p/8/2K5/8/8 b - - 0 63,Rc8,-777,-727,50,1
2r5/5p2/8/2N1nk1p/8/2K5/8/8 w - - 1 64,Kc2,-730,-827,-97,1
2r5/5p2/8/2N1nk1p/8/8/2K5/8 b - - 2 64,Rxc5+,-863,-908,-45,1
rnbqkbnr/pppppppp/8/8/8/8/PPPPPPPP/RNBQKBNR w KQkq - 0 1,e4,38,35,-3,1
rnbqkbnr/pppppppp/8/8/4P3/8/PPPP1PPP/RNBQKBNR b KQkq - 0 1,e5,28,44,16,1
rnbqkbnr/pppp1ppp/8/4p3/4P3/8/PPPP1PPP/RNBQKBNR w KQkq - 0 2,Nf3,31,33,2,1
rnbqkbnr/pppp1ppp/8/4p3/4P3/5N2/PPPP1PPP/RNBQKB1R b KQkq - 1 2,c6,30,134,104,1
rnbqkbnr/pp1p1ppp/2p5/4p3/4P3/5N2/PPPP1PPP/RNBQKB1R w KQkq - 0 3,Nc3,138,39,-99,1
rnbqkbnr/pp1p1ppp/2p5/4p3/4P3/2N2N2/PPPP1PPP/R1BQKB1R b KQkq - 1 3,d5,44,158,114,1
rnbqkbnr/pp3ppp/2p5/3pp3/4P3/2N2N2/PPPP1PPP/R1BQKB1R w KQkq - 0 4,d3,151,-25,-176,0
rnbqkbnr/pp3ppp/2p5/3pp3/4P3/2NP1N2/PPP2PPP/R1BQKB1R b KQkq - 0 4,dxe4,-37,111,148,1
rnbqkbnr/pp3ppp/2p5/4p3/4p3/2NP1N2/PPP2PPP/R1BQKB1R w KQkq - 0 5,dxe4,109,29,-80,1
rnbqkbnr/pp3ppp/2p5/4p3/4P3/2N2N2/PPP2PPP/R1BQKB1R b KQkq - 0 5,Qxd1+,3,29,26,1
rnb1kbnr/pp3ppp/2p5/4p3/4P3/2N2N2/PPP2PPP/R1BqKB1R w KQkq - 0 6,Nxd1,38,34,-4,1
rnb1kbnr/pp3ppp/2p5/4p3/4P3/5N2/PPP2PPP/R1BNKB1R b KQkq - 0 6,f6,33,29,-4,1
rnb1kbnr/pp4pp/2p2p2/4p3/4P3/5N2/PPP2PPP/R1BNKB1R w KQkq - 0 7,Bc4,33,23,-10,1
rnb1kbnr/pp4pp/2p2p2/4p3/2B1P3/5N2/PPP2PPP/R1BNK2R b KQkq - 1 7,Ne7,19,43,24,1
rnb1kb1r/pp2n1pp/2p2p2/4p3/2B1P3/5N2/PPP2PPP/R1BNK2R w KQkq - 2 8,O-O,35,28,-7,1
rnb1kb1r/pp2n1pp/2p2p2/4p3/2B1P3/5N2/PPP2PPP/R1BN1RK1 b kq - 3 8,Bg4,27,272,245,1
rn2kb1r/pp2n1pp/2p2p2/4p3/2B1P1b1/5N2/PPP2PPP/R1BN1RK1 w kq - 4 9,Be2,30,-15,-45,1
rn2kb1r/pp2n1pp/2p2p2/4p3/4P1b1/5N2/PPP1BPPP/R1BN1RK1 b kq - 5 9,Bxf3,-19,37,56,1
rn2kb1r/pp2n1pp/2p2p2/4p3/4P3/5b2/PPP1BPPP/R1BN1RK1 w kq - 0 10,Bxf3,35,27,-8,1
rn2kb1r/pp2n1pp/2p2p2/4p3/4P3/5B2/PPP2PPP/R1BN1RK1 b kq - 0 10,Nd7,34,34,0,1
r3kb1r/pp1nn1pp/2p2p2/4p3/4P3/5B2/PPP2PPP/R1BN1RK1 w kq - 1 11,Nc3,33,19,-14,1
r3kb1r/pp1nn1pp/2p2p2/4p3/4P3/2N2B2/PPP2PPP/R1B2RK1 b kq - 2 11,O-O-O,25,42,17,1
2kr1b1r/pp1nn1pp/2p2p2/4p3/4P3/2N2B2/PPP2PPP/R1B2RK1 w - - 3 12,Bg4,42,10,-32,1
2kr1b1r/pp1nn1pp/2p2p2/4p3/4P1B1/2N5/PPP2PPP/R1B2RK1 b - - 4 12,Kb8,8,57,49,1
1k1r1b1r/pp1nn1pp/2p2p2/4p3/4P1B1/2N5/PPP2PPP/R1B2RK1 w - - 5 13,Rd1,48,34,-14,1
1k1r1b1r/pp1nn1pp/2p2p2/4p3/4P1B1/2N5/PPP2PPP/R1BR2K1 b - - 6 13,Kc7,32,34,2,1
3r1b1r/ppknn1pp/2p2p2/4p3/4P1B1/2N5/PPP2PPP/R1BR2K1 w - - 7 14,b3,45,16,-29,1
3r1b1r/ppknn1pp/2p2p2/4p3/4P1B1/1PN5/P1P2PPP/R1BR2K1 b - - 0 14,g6,16,28,12,1
3r1b1r/ppknn2p/2p2pp1/4p3/4P1B1/1PN5/P1P2PPP/R1BR2K1 w - - 0 15,Ba3,31,-23,-54,1
3r1b1r/ppknn2p/2p2pp1/4p3/4P1B1/BPN5/P1P2PPP/R2R2K1 b - - 1 15,c5,-9,352,361,1
3r1b1r/ppknn2p/5pp1/2p1p3/4P1B1/BPN5/P1P2PPP/R2R2K1 w - - 0 16,Rd3,393,133,-260,0
3r1b1r/ppknn2p/5pp1/2p1p3/4P1B1/BPNR4/P1P2PPP/R5K1 b - - 1 16,Nb6,180,585,405,1
3r1b1r/ppk1n2p/1n3pp1/2p1p3/4P1B1/BPNR4/P1P2PPP/R5K1 w - - 2 17,Nb5+,536,545,9,1
3r1b1r/ppk1n2p/1n3pp1/1Np1p3/4P1B1/BP1R4/P1P2PPP/R5K1 b - - 3 17,Kc6,561,558,-3,1
3r1b1r/pp2n2p/1nk2pp1/1Np1p3/4P1B1/BP1R4/P1P2PPP/R5K1 w - - 4 18,Rxd8,574,500,-74,1
3R1b1r/pp2n2p/1nk2pp1/1Np1p3/4P1B1/BP6/P1P2PPP/R5K1 b - - 0 18,Kxb5,484,546,62,1
3R1b1r/pp2n2p/1n3pp1/1kp1p3/4P1B1/BP6/P1P2PPP/R5K1 w - - 0 19,Bd7+,529,466,-63,1
3R1b1r/pp1Bn2p/1n3pp1/1kp1p3/4P3/BP6/P1P2PPP/R5K1 b - - 1 19,Nxd7,476,497,21,1
3R1b1r/pp1nn2p/5pp1/1kp1p3/4P3/BP6/P1P2PPP/R5K1 w - - 0 20,Rxd7,497,498,1,1
5b1r/pp1Rn2p/5pp1/1kp1p3/4P3/BP6/P1P2PPP/R5K1 b - - 0 20,Nc6,484,555,71,1
5b1r/pp1R3p/2n2pp1/1kp1p3/4P3/BP6/P1P2PPP/R5K1 w - - 1 21,Rxb7+,549,557,8,1
5b1r/pR5p/2n2pp1/1kp1p3/4P3/BP6/P1P2PPP/R5K1 b - - 0 21,Ka6,554,557,3,1
5b1r/pR5p/k1n2pp1/2p1p3/4P3/BP6/P1P2PPP/R5K1 w - - 1 22,Rd7,560,496,-64,1
5b1r/p2R3p/k1n2pp1/2p1p3/4P3/BP6/P1P2PPP/R5K1 b - - 2 22,Kb6,496,506,10,1
5b1r/p2R3p/1kn2pp1/2p1p3/4P3/BP6/P1P2PPP/R5K1 w - - 3 23,Rd5,523,399,-124,0
5b1r/p6p/1kn2pp1/2pRp3/4P3/BP6/P1P2PPP/R5K1 b - - 4 23,Be7,384,486,102,1
7r/p3b2p/1kn2pp1/2pRp3/4P3/BP6/P1P2PPP/R5K1 w - - 5 24,c3,478,471,-7,1
7r/p3b2p/1kn2pp1/2pRp3/4P3/BPP5/P4PPP/R5K1 b - - 0 24,Rd8,472,500,28,1
3r4/p3b2p/1kn2pp1/2pRp3/4P3/BPP5/P4PPP/R5K1 w - - 1 25,Rxd8,499,478,-21,1
3R4/p3b2p/1kn2pp1/2p1p3/4P3/BPP5/P4PPP/R5K1 b - - 0 25,Nxd8,490,475,-15,1
3n4/p3b2p/1k3pp1/2p1p3/4P3/BPP5/P4PPP/R5K1 w - - 0 26,b4,472,426,-46,1
3n4/p3b2p/1k3pp1/2p1p3/1P2P3/B1P5/P4PPP/R5K1 b - - 0 26,cxb4,439,445,6,1
3n4/p3b2p/1k3pp1/4p3/1p2P3/B1P5/P4PPP/R5K1 w - - 0 27,Bxb4,456,429,-27,1
3n4/p3b2p/1k3pp1/4p3/1B2P3/2P5/P4PPP/R5K1 b - - 0 27,Bxb4,458,484,26,1
3n4/p6p/1k3pp1/4p3/1b2P3/2P5/P4PPP/R5K1 w - - 0 28,cxb4,474,481,7,1
3n4/p6p/1k3pp1/4p3/1P2P3/8/P4PPP/R5K1 b - - 0 28,Nc6,491,465,-26,1
8/p6p/1kn2pp1/4p3/1P2P3/8/P4PPP/R5K1 w - - 1 29,a3,453,459,6,1
8/p6p/1kn2pp1/4p3/1P2P3/P7/5PPP/R5K1 b - - 0 29,f5,460,538,78,1
8/p6p/1kn3p1/4pp2/1P2P3/P7/5PPP/R5K1 w - - 0 30,exf5,540,502,-38,1
8/p6p/1kn3p1/4pP2/1P6/P7/5PPP/R5K1 b - - 0 30,gxf5,527,539,12,1
8/p6p/1kn5/4pp2/1P6/P7/5PPP/R5K1 w - - 0 31,Re1,564,517,-47,1
8/p6p/1kn5/4pp2/1P6/P7/5PPP/4R1K1 b - - 1 31,Kb5,503,549,46,1
8/p6p/2n5/1k2pp2/1P6/P7/5PPP/4R1K1 w - - 2 32,f3,552,499,-53,1
8/p6p/2n5/1k2pp2/1P6/P4P2/6PP/4R1K1 b - - 0 32,Ka4,509,525,16,1
8/p6p/2n5/4pp2/kP6/P4P2/6PP/4R1K1 w - - 1 33,Rc1,528,499,-29,1
8/p6p/2n5/4pp2/kP6/P4P2/6PP/2R3K1 b - - 2 33,Nd4,457,455,-2,1
8/p6p/8/4pp2/kP1n4/P4P2/6PP/2R3K1 w - - 3 34,Rc7,441,462,21,1
8/p1R4p/8/4pp2/kP1n4/P4P2/6PP/6K1 b - - 4 34,Kxa3,475,487,12,1
8/p1R4p/8/4pp2/1P1n4/k4P2/6PP/6K1 w - - 0 35,Rxa7+,475,487,12,1
8/R6p/8/4pp2/1P1n4/k4P2/6PP/6K1 b - - 0 35,Kxb4,488,493,5,1
8/R6p/8/4pp2/1k1n4/5P2/6PP/6K1 w - - 0 36,Rxh7,464,454,-10,1
8/7R/8/4pp2/1k1n4/5P2/6PP/6K1 b - - 0 36,Kc4,467,505,38,1
8/7R/8/4pp2/2kn4/5P2/6PP/6K1 w - - 1 37,Rh4,507,417,-90,1
8/8/8/4pp2/2kn3R/5P2/6PP/6K1 b - - 2 37,Kd5,423,479,56,1
8/8/8/3kpp2/3n3R/5P2/6PP/6K1 w - - 3 38,g4,447,-430,-877,0
8/8/8/3kpp2/3n2PR/5P2/7P/6K1 b - - 0 38,Nxf3+,-434,-410,24,1
8/8/8/3kpp2/6PR/5n2/7P/6K1 w - - 0 39,Kg2,-426,-446,-20,1
8/8/8/3kpp2/6PR/5n2/6KP/8 b - - 1 39,Nxh4+,-454,-419,35,1
8/8/8/3kpp2/6Pn/8/6KP/8 w - - 0 40,Kh3,-470,-446,24,1
8/8/8/3kpp2/6Pn/7K/7P/8 b - - 1 40,Nf3,-479,-469,10,1
8/8/8/3kpp2/6P1/5n1K/7P/8 w - - 2 41,gxf5,-502,-538,-36,1
8/8/8/3kpP2/8/5n1K/7P/8 b - - 0 41,Ke4,-501,-431,70,1
8/8/8/4pP2/4k3/5n1K/7P/8 w - - 1 42,f6,-435,-465,-30,1
8/8/5P2/4p3/4k3/5n1K/7P/8 b - - 0 42,Ng5+,-506,-367,139,1
8/8/5P2/4p1n1/4k3/7K/7P/8 w - - 1 43,Kg4,-402,-464,-62,1
8/8/5P2/4p1n1/4k1K1/8/7P/8 b - - 2 43,Nf7,-505,-506,-1,1
8/5n2/5P2/4p3/4k1K1/8/7P/8 w - - 3 44,h4,-494,-508,-14,1
8/5n2/5P2/4p3/4k1KP/8/8/8 b - - 0 44,Kd5,-516,-536,-20,1
8/5n2/5P2/3kp3/6KP/8/8/8 w - - 1 45,h5,-523,-503,20,1
8/5n2/5P2/3kp2P/6K1/8/8/8 b - - 0 45,e4,-503,-413,90,1
8/5n2/5P2/3k3P/4p1K1/8/8/8 w - - 0 46,Kf5,-500,-603,-103,0
8/5n2/5P2/3k1K1P/4p3/8/8/8 b - - 1 46,e3,-633,-645,-12,1
8/5n2/5P2/3k1K1P/8/4p3/8/8 w - - 0 47,Kg6,-648,-695,-47,1
8/5n2/5PK1/3k3P/8/4p3/8/8 b - - 1 47,e2,-760,-533,227,1
8/5n2/5PK1/3k3P/8/8/4p3/8 w - - 0 48,Kxf7,-517,-603,-86,1
8/5K2/5P2/3k3P/8/8/4p3/8 b - - 0 48,e1=Q,-614,-638,-24,1
8/5K2/5P2/3k3P/8/8/8/4q3 w - - 0 49,Kg7,-773,-9993,-9220,0
8/6K1/5P2/3k3P/8/8/8/4q3 b - - 1 49,Qg1+,-9994,-731,9263,1
8/6K1/5P2/3k3P/8/8/8/6q1 w - - 2 50,Kf7,-9984,-9984,0,1
8/5K2/5P2/3k3P/8/8/8/6q1 b - - 3 50,Qa7+,-9984,-581,9403,1
8/q4K2/5P2/3k3P/8/8/8/8 w - - 4 51,Kg6,-551,-581,-30,1
8/q7/5PK1/3k3P/8/8/8/8 b - - 5 51,Qg1+,-562,-554,8,1
8/8/5PK1/3k3P/8/8/8/6q1 w - - 6 52,Kf7,-570,-9984,-9414,0
8/5K2/5P2/3k3P/8/8/8/6q1 b - - 7 52,Qa7+,-9984,-568,9416,1
8/q4K2/5P2/3k3P/8/8/8/8 w - - 8 53,Kg6,-573,-596,-23,1
8/q7/5PK1/3k3P/8/8/8/8 b - - 9 53,Ke6,-567,-541,26,1
8/q7/4kPK1/7P/8/8/8/8 w - - 10 54,h6,-554,-9995,-9441,0
8/q7/4kPKP/8/8/8/8/8 b - - 0 54,Qg1+,-9994,-9996,-2,1
8/8/4kPKP/8/8/8/8/6q1 w - - 1 55,Kh7,-9997,-9998,-1,1
8/7K/4kP1P/8/8/8/8/6q1 b - - 2 55,Kxf6,-9998,-9998,0,1
8/7K/5k1P/8/8/8/8/6q1 w - - 0 56,Kh8,-9998,-9998,0,1
7K/8/5k1P/8/8/8/8/6q1 b - - 1 56,Qa7,-9998,-9998,0,1
7K/q7/5k1P/8/8/8/8/8 w - - 2 57,Kg8,-9998,-9998,0,1
6K1/q7/5k1P/8/8/8/8/8 b - - 3 57,Qf7+,-9998,-9998,0,1
6K1/5q2/5k1P/8/8/8/8/8 w - - 4 58,Kh8,-9998,-9998,0,1
7K/5q2/5k1P/8/8/8/8/8 b - - 5 58,Qf8+,-9998,-9997,1,1
5q1K/8/5k1P/8/8/8/8/8 w - - 6 59,Kh7,-9997,-9997,0,1
5q2/7K/5k1P/8/8/8/8/8 b - - 7 59,Qe7+,-9997,-9998,-1,1
8/4q2K/5k1P/8/8/8/8/8 w - - 8 60,Kg8,-9998,-9998,0,1
6K1/4q3/5k1P/8/8/8/8/8 b - - 9 60,Qe8+,-9998,-9997,1,1
4q1K1/8/5k1P/8/8/8/8/8 w - - 10 61,Kh7,-9997,-9997,0,1
4q3/7K/5k1P/8/8/8/8/8 b - - 11 61,Kg5,-9997,-9996,1,1
4q3/7K/7P/6k1/8/8/8/8 w - - 12 62,Kg7,-9997,-9997,0,1
4q3/6K1/7P/6k1/8/8/8/8 b - - 13 62,Qe7+,-9997,-9998,-1,1
8/4q1K1/7P/6k1/8/8/8/8 w - - 14 63,Kh8,-9998,-9998,0,1
7K/4q3/7P/6k1/8/8/8/8 b - - 15 63,Qf6+,-9998,-9997,1,1
7K/8/5q1P/6k1/8/8/8/8 w - - 16 64,Kh7,-9997,-9997,0,1
8/7K/5q1P/6k1/8/8/8/8 b - - 17 64,Qxh6+,-9997,-9996,1,1
rnbqkbnr/pppppppp/8/8/8/8/PPPPPPPP/RNBQKBNR w KQkq - 0 1,Nf3,31,21,-10,1
rnbqkbnr/pppppppp/8/8/8/5N2/PPPPPPPP/RNBQKB1R b KQkq - 1 1,d5,19,11,-8,1
rnbqkbnr/ppp1pppp/8/3p4/8/5N2/PPPPPPPP/RNBQKB1R w KQkq - 0 2,d4,17,24,7,1
rnbqkbnr/ppp1pppp/8/3p4/3P4/5N2/PPP1PPPP/RNBQKB1R b KQkq - 0 2,e6,18,17,-1,1
rnbqkbnr/ppp2ppp/4p3/3p4/3P4/5N2/PPP1PPPP/RNBQKB1R w KQkq - 0 3,e3,20,10,-10,1
rnbqkbnr/ppp2ppp/4p3/3p4/3P4/4PN2/PPP2PPP/RNBQKB1R b KQkq - 0 3,Bd7,10,35,25,1
rn1qkbnr/pppb1ppp/4p3/3p4/3P4/4PN2/PPP2PPP/RNBQKB1R w KQkq - 1 4,c4,55,50,-5,1
rn1qkbnr/pppb1ppp/4p3/3p4/2PP4/4PN2/PP3PPP/RNBQKB1R b KQkq - 0 4,dxc4,43,71,28,1
rn1qkbnr/pppb1ppp/4p3/8/2pP4/4PN2/PP3PPP/RNBQKB1R w KQkq - 0 5,Bxc4,75,81,6,1
rn1qkbnr/pppb1ppp/4p3/8/2BP4/4PN2/PP3PPP/RNBQK2R b KQkq - 0 5,Nf6,70,75,5,1
rn1qkb1r/pppb1ppp/4pn2/8/2BP4/4PN2/PP3PPP/RNBQK2R w KQkq - 1 6,O-O,69,79,10,1
rn1qkb1r/pppb1ppp/4pn2/8/2BP4/4PN2/PP3PPP/RNBQ1RK1 b kq - 2 6,Nc6,69,99,30,1
r2qkb1r/pppb1ppp/2n1pn2/8/2BP4/4PN2/PP3PPP/RNBQ1RK1 w kq - 3 7,Nbd2,97,98,1,1
r2qkb1r/pppb1ppp/2n1pn2/8/2BP4/4PN2/PP1N1PPP/R1BQ1RK1 b kq - 4 7,Bd6,89,95,6,1
r2qk2r/pppb1ppp/2nbpn2/8/2BP4/4PN2/PP1N1PPP/R1BQ1RK1 w kq - 5 8,a3,90,72,-18,1
r2qk2r/pppb1ppp/2nbpn2/8/2BP4/P3PN2/1P1N1PPP/R1BQ1RK1 b kq - 0 8,O-O,71,100,29,1
r2q1rk1/pppb1ppp/2nbpn2/8/2BP4/P3PN2/1P1N1PPP/R1BQ1RK1 w - - 1 9,b4,78,99,21,1
r2q1rk1/pppb1ppp/2nbpn2/8/1PBP4/P3PN2/3N1PPP/R1BQ1RK1 b - - 0 9,a6,77,101,24,1
r2q1rk1/1ppb1ppp/p1nbpn2/8/1PBP4/P3PN2/3N1PPP/R1BQ1RK1 w - - 0 10,e4,97,91,-6,1
r2q1rk1/1ppb1ppp/p1nbpn2/8/1PBPP3/P4N2/3N1PPP/R1BQ1RK1 b - - 0 10,Be7,105,116,11,1
r2q1rk1/1ppbbppp/p1n1pn2/8/1PBPP3/P4N2/3N1PPP/R1BQ1RK1 w - - 1 11,Rb1,135,83,-52,1
r2q1rk1/1ppbbppp/p1n1pn2/8/1PBPP3/P4N2/3N1PPP/1RBQ1RK1 b - - 2 11,b5,94,83,-11,1
r2q1rk1/2pbbppp/p1n1pn2/1p6/1PBPP3/P4N2/3N1PPP/1RBQ1RK1 w - - 0 12,Be2,83,66,-17,1
r2q1rk1/2pbbppp/p1n1pn2/1p6/1P1PP3/P4N2/3NBPPP/1RBQ1RK1 b - - 1 12,Re8,46,97,51,1
r2qr1k1/2pbbppp/p1n1pn2/1p6/1P1PP3/P4N2/3NBPPP/1RBQ1RK1 w - - 2 13,Nb3,106,30,-76,1
r2qr1k1/2pbbppp/p1n1pn2/1p6/1P1PP3/PN3N2/4BPPP/1RBQ1RK1 b - - 3 13,Nxe4,25,33,8,1
r2qr1k1/2pbbppp/p1n1p3/1p6/1P1Pn3/PN3N2/4BPPP/1RBQ1RK1 w - - 0 14,Nc5,38,-262,-300,0
r2qr1k1/2pbbppp/p1n1p3/1pN5/1P1Pn3/P4N2/4BPPP/1RBQ1RK1 b - - 1 14,Nxc5,-260,-146,114,1
r2qr1k1/2pbbppp/p1n1p3/1pn5/1P1P4/P4N2/4BPPP/1RBQ1RK1 w - - 0 15,dxc5,-154,-178,-24,1
r2qr1k1/2pbbppp/p1n1p3/1pP5/1P6/P4N2/4BPPP/1RBQ1RK1 b - - 0 15,e5,-186,-191,-5,1
r2qr1k1/2pbbppp/p1n5/1pP1p3/1P6/P4N2/4BPPP/1RBQ1RK1 w - - 0 16,Bb2,-183,-221,-38,1
r2qr1k1/2pbbppp/p1n5/1pP1p3/1P6/P4N2/1B2BPPP/1R1Q1RK1 b - - 1 16,Bf6,-207,-173,34,1
r2qr1k1/2pb1ppp/p1n2b2/1pP1p3/1P6/P4N2/1B2BPPP/1R1Q1RK1 w - - 2 17,Qc2,-163,-238,-75,1
r2qr1k1/2pb1ppp/p1n2b2/1pP1p3/1P6/P4N2/1BQ1BPPP/1R3RK1 b - - 3 17,Nd4,-237,-40,197,1
r2qr1k1/2pb1ppp/p4b2/1pP1p3/1P1n4/P4N2/1BQ1BPPP/1R3RK1 w - - 4 18,Bxd4,-102,-154,-52,1
r2qr1k1/2pb1ppp/p4b2/1pP1p3/1P1B4/P4N2/2Q1BPPP/1R3RK1 b - - 0 18,exd4,-155,-139,16,1
r2qr1k1/2pb1ppp/p4b2/1pP5/1P1p4/P4N2/2Q1BPPP/1R3RK1 w - - 0 19,Rfd1,-151,-181,-30,1
r2qr1k1/2pb1ppp/p4b2/1pP5/1P1p4/P4N2/2Q1BPPP/1R1R2K1 b - - 1 19,Qe7,-184,-70,114,1
r3r1k1/2pbqppp/p4b2/1pP5/1P1p4/P4N2/2Q1BPPP/1R1R2K1 w - - 2 20,Nxd4,-90,-272,-182,0
r3r1k1/2pbqppp/p4b2/1pP5/1P1N4/P7/2Q1BPPP/1R1R2K1 b - - 0 20,c6,-286,-35,251,1
r3r1k1/3bqppp/p1p2b2/1pP5/1P1N4/P7/2Q1BPPP/1R1R2K1 w - - 0 21,Bf3,-38,-303,-265,0
r3r1k1/3bqppp/p1p2b2/1pP5/1P1N4/P4B2/2Q2PPP/1R1R2K1 b - - 1 21,Rad8,-286,155,441,1
3rr1k1/3bqppp/p1p2b2/1pP5/1P1N4/P4B2/2Q2PPP/1R1R2K1 w - - 2 22,h3,133,-206,-339,0
3rr1k1/3bqppp/p1p2b2/1pP5/1P1N4/P4B1P/2Q2PP1/1R1R2K1 b - - 0 22,g6,-183,140,323,1
3rr1k1/3bqp1p/p1p2bp1/1pP5/1P1N4/P4B1P/2Q2PP1/1R1R2K1 w - - 0 23,Bxc6,172,-421,-593,0
3rr1k1/3bqp1p/p1B2bp1/1pP5/1P1N4/P6P/2Q2PP1/1R1R2K1 b - - 0 23,Bxd4,-402,-404,-2,1
3rr1k1/3bqp1p/p1B3p1/1pP5/1P1b4/P6P/2Q2PP1/1R1R2K1 w - - 0 24,Bxd7,-369,-420,-51,1
3rr1k1/3Bqp1p/p5p1/1pP5/1P1b4/P6P/2Q2PP1/1R1R2K1 b - - 0 24,Rxd7,-391,-391,0,1
4r1k1/3rqp1p/p5p1/1pP5/1P1b4/P6P/2Q2PP1/1R1R2K1 w - - 0 25,c6,-372,-448,-76,1
4r1k1/3rqp1p/p1P3p1/1p6/1P1b4/P6P/2Q2PP1/1R1R2K1 b - - 0 25,Rd6,-442,-460,-18,1
4r1k1/4qp1p/p1Pr2p1/1p6/1P1b4/P6P/2Q2PP1/1R1R2K1 w - - 1 26,c7,-427,-462,-35,1
4r1k1/2P1qp1p/p2r2p1/1p6/1P1b4/P6P/2Q2PP1/1R1R2K1 b - - 0 26,Rc8,-420,-487,-67,1
2r3k1/2P1qp1p/p2r2p1/1p6/1P1b4/P6P/2Q2PP1/1R1R2K1 w - - 1 27,Re1,-482,-476,6,1
2r3k1/2P1qp1p/p2r2p1/1p6/1P1b4/P6P/2Q2PP1/1R2R1K1 b - - 2 27,Qxc7,-510,18,528,1
2r3k1/2q2p1p/p2r2p1/1p6/1P1b4/P6P/2Q2PP1/1R2R1K1 w - - 0 28,Qxc7,0,-458,-458,0
2r3k1/2Q2p1p/p2r2p1/1p6/1P1b4/P6P/5PP1/1R2R1K1 b - - 0 28,Rxc7,-535,-532,3,1
6k1/2r2p1p/p2r2p1/1p6/1P1b4/P6P/5PP1/1R2R1K1 w - - 0 29,Re8+,-525,-546,-21,1
4R1k1/2r2p1p/p2r2p1/1p6/1P1b4/P6P/5PP1/1R4K1 b - - 1 29,Kg7,-537,-533,4,1
4R3/2r2pkp/p2r2p1/1p6/1P1b4/P6P/5PP1/1R4K1 w - - 2 30,Rbe1,-552,-578,-26,1
4R3/2r2pkp/p2r2p1/1p6/1P1b4/P6P/5PP1/4R1K1 b - - 3 30,Bb2,-546,-518,28,1
4R3/2r2pkp/p2r2p1/1p6/1P6/P6P/1b3PP1/4R1K1 w - - 4 31,a4,-519,-506,13,1
4R3/2r2pkp/p2r2p1/1p6/PP6/7P/1b3PP1/4R1K1 b - - 0 31,bxa4,-526,-468,58,1
4R3/2r2pkp/p2r2p1/8/pP6/7P/1b3PP1/4R1K1 w - - 0 32,Ra8,-496,-553,-57,1
R7/2r2pkp/p2r2p1/8/pP6/7P/1b3PP1/4R1K1 b - - 1 32,a3,-521,-533,-12,1
R7/2r2pkp/p2r2p1/8/1P6/p6P/1b3PP1/4R1K1 w - - 0 33,Ree8,-596,-681,-85,1
R3R3/2r2pkp/p2r2p1/8/1P6/p6P/1b3PP1/6K1 b - - 1 33,a2,-688,-701,-13,1
R3R3/2r2pkp/p2r2p1/8/1P6/7P/pb3PP1/6K1 w - - 0 34,Rg8+,-709,-719,-10,1
R5R1/2r2pkp/p2r2p1/8/1P6/7P/pb3PP1/6K1 b - - 1 34,Kh6,-779,-765,14,1
rnbqkbnr/pppppppp/8/8/8/8/PPPPPPPP/RNBQKBNR w KQkq - 0 1,d4,29,23,-6,1
rnbqkbnr/pppppppp/8/8/3P4/8/PPP1PPPP/RNBQKBNR b KQkq - 0 1,d5,17,25,8,1
rnbqkbnr/ppp1pppp/8/3p4/3P4/8/PPP1PPPP/RNBQKBNR w KQkq - 0 2,f4,27,-47,-74,1
rnbqkbnr/ppp1pppp/8/3p4/3P1P2/8/PPP1P1PP/RNBQKBNR b KQkq - 0 2,Nc6,-42,26,68,1
r1bqkbnr/ppp1pppp/2n5/3p4/3P1P2/8/PPP1P1PP/RNBQKBNR w KQkq - 1 3,e3,50,-12,-62,1
r1bqkbnr/ppp1pppp/2n5/3p4/3P1P2/4P3/PPP3PP/RNBQKBNR b KQkq - 0 3,e5,-15,100,115,1
r1bqkbnr/ppp2ppp/2n5/3pp3/3P1P2/4P3/PPP3PP/RNBQKBNR w KQkq - 0 4,Bb5,109,-91,-200,0
r1bqkbnr/ppp2ppp/2n5/1B1pp3/3P1P2/4P3/PPP3PP/RNBQK1NR b KQkq - 1 4,Ne7,-94,131,225,1
r1bqkb1r/ppp1nppp/2n5/1B1pp3/3P1P2/4P3/PPP3PP/RNBQK1NR w KQkq - 2 5,Bxc6+,146,-26,-172,0
r1bqkb1r/ppp1nppp/2B5/3pp3/3P1P2/4P3/PPP3PP/RNBQK1NR b KQkq - 0 5,Nxc6,-48,-44,4,1
r1bqkb1r/ppp2ppp/2n5/3pp3/3P1P2/4P3/PPP3PP/RNBQK1NR w KQkq - 0 6,fxe5,-54,-103,-49,1
r1bqkb1r/ppp2ppp/2n5/3pP3/3P4/4P3/PPP3PP/RNBQK1NR b KQkq - 0 6,Bb4+,-103,-25,78,1
r1bqk2r/ppp2ppp/2n5/3pP3/1b1P4/4P3/PPP3PP/RNBQK1NR w KQkq - 1 7,Bd2,-13,-48,-35,1
r1bqk2r/ppp2ppp/2n5/3pP3/1b1P4/4P3/PPPB2PP/RN1QK1NR b KQkq - 2 7,O-O,-52,37,89,1
r1bq1rk1/ppp2ppp/2n5/3pP3/1b1P4/4P3/PPPB2PP/RN1QK1NR w KQ - 3 8,h3,41,-127,-168,0
r1bq1rk1/ppp2ppp/2n5/3pP3/1b1P4/4P2P/PPPB2P1/RN1QK1NR b KQ - 0 8,Qh4+,-127,-126,1,1
r1b2rk1/ppp2ppp/2n5/3pP3/1b1P3q/4P2P/PPPB2P1/RN1QK1NR w KQ - 1 9,Ke2,-142,-180,-38,1
r1b2rk1/ppp2ppp/2n5/3pP3/1b1P3q/4P2P/PPPBK1P1/RN1Q2NR b - - 2 9,Bf5,-168,-102,66,1
r4rk1/ppp2ppp/2n5/3pPb2/1b1P3q/4P2P/PPPBK1P1/RN1Q2NR w - - 3 10,Bxb4,-118,-199,-81,1
r4rk1/ppp2ppp/2n5/3pPb2/1B1P3q/4P2P/PPP1K1P1/RN1Q2NR b - - 0 10,Nxb4,-195,-174,21,1
r4rk1/ppp2ppp/8/3pPb2/1n1P3q/4P2P/PPP1K1P1/RN1Q2NR w - - 0 11,c3,-169,-411,-242,0
r4rk1/ppp2ppp/8/3pPb2/1n1P3q/2P1P2P/PP2K1P1/RN1Q2NR b - - 0 11,Bc2,-414,-211,203,1
r4rk1/ppp2ppp/8/3pP3/1n1P3q/2P1P2P/PPb1K1P1/RN1Q2NR w - - 1 12,Qe1,-233,-262,-29,1
r4rk1/ppp2ppp/8/3pP3/1n1P3q/2P1P2P/PPb1K1P1/RN2Q1NR b - - 2 12,Nd3,-311,550,861,1
r4rk1/ppp2ppp/8/3pP3/3P3q/2PnP2P/PPb1K1P1/RN2Q1NR w - - 3 13,Qxh4,544,568,24,1
r4rk1/ppp2ppp/8/3pP3/3P3Q/2PnP2P/PPb1K1P1/RN4NR b - - 0 13,h6,552,735,183,1
r4rk1/ppp2pp1/7p/3pP3/3P3Q/2PnP2P/PPb1K1P1/RN4NR w - - 0 14,Nd2,767,499,-268,0
r4rk1/ppp2pp1/7p/3pP3/3P3Q/2PnP2P/PPbNK1P1/R5NR b - - 1 14,g5,536,588,52,1
r4rk1/ppp2p2/7p/3pP1p1/3P3Q/2PnP2P/PPbNK1P1/R5NR w - - 0 15,Qg3,641,531,-110,0
r4rk1/ppp2p2/7p/3pP1p1/3P4/2PnP1QP/PPbNK1P1/R5NR b - - 1 15,c5,554,631,77,1
r4rk1/pp3p2/7p/2ppP1p1/3P4/2PnP1QP/PPbNK1P1/R5NR w - - 0 16,Nb3,617,559,-58,1
r4rk1/pp3p2/7p/2ppP1p1/3P4/1NPnP1QP/PPb1K1P1/R5NR b - - 1 16,cxd4,521,688,167,1
r4rk1/pp3p2/7p/3pP1p1/3p4/1NPnP1QP/PPb1K1P1/R5NR w - - 0 17,cxd4,708,505,-203,0
r4rk1/pp3p2/7p/3pP1p1/3P4/1N1nP1QP/PPb1K1P1/R5NR b - - 0 17,Rac8,544,526,-18,1
2r2rk1/pp3p2/7p/3pP1p1/3P4/1N1nP1QP/PPb1K1P1/R5NR w - - 1 18,Nf3,518,501,-17,1
2r2rk1/pp3p2/7p/3pP1p1/3P4/1N1nPNQP/PPb1K1P1/R6R b - - 2 18,f5,525,537,12,1
2r2rk1/pp6/7p/3pPpp1/3P4/1N1nPNQP/PPb1K1P1/R6R w - f6 0 19,exf6,547,530,-17,1
2r2rk1/pp6/5P1p/3p2p1/3P4/1N1nPNQP/PPb1K1P1/R6R b - - 0 19,Rxf6,546,564,18,1
2r3k1/pp6/5r1p/3p2p1/3P4/1N1nPNQP/PPb1K1P1/R6R w - - 0 20,Ne1,541,540,-1,1
2r3k1/pp6/5r1p/3p2p1/3P4/1N1nP1QP/PPb1K1P1/R3N2R b - - 1 20,Rf2+,505,660,155,1
2r3k1/pp6/7p/3p2p1/3P4/1N1nP1QP/PPb1KrP1/R3N2R w - - 2 21,Qxf2,680,676,-4,1
2r3k1/pp6/7p/3p2p1/3P4/1N1nP2P/PPb1KQP1/R3N2R b - - 0 21,Nxf2,692,669,-23,1
2r3k1/pp6/7p/3p2p1/3P4/1N2P2P/PPb1KnP1/R3N2R w - - 0 22,Kxf2,682,622,-60,1
2r3k1/pp6/7p/3p2p1/3P4/1N2P2P/PPb2KP1/R3N2R b - - 0 22,Rf8+,656,698,42,1
5rk1/pp6/7p/3p2p1/3P4/1N2P2P/PPb2KP1/R3N2R w - - 1 23,Ke2,718,701,-17,1
5rk1/pp6/7p/3p2p1/3P4/1N2P2P/PPb1K1P1/R3N2R b - - 2 23,b6,686,881,195,1
5rk1/p7/1p5p/3p2p1/3P4/1N2P2P/PPb1K1P1/R3N2R w - - 0 24,Nxc2,883,880,-3,1
5rk1/p7/1p5p/3p2p1/3P4/1N2P2P/PPN1K1P1/R6R b - - 0 24,a5,901,885,-16,1
5rk1/8/1p5p/p2p2p1/3P4/1N2P2P/PPN1K1P1/R6R w - - 0 25,a4,896,906,10,1
5rk1/8/1p5p/p2p2p1/P2P4/1N2P2P/1PN1K1P1/R6R b - - 0 25,h5,887,919,32,1
5rk1/8/1p6/p2p2pp/P2P4/1N2P2P/1PN1K1P1/R6R w - - 0 26,Rhf1,899,904,5,1
5rk1/8/1p6/p2p2pp/P2P4/1N2P2P/1PN1K1P1/R4R2 b - - 1 26,g4,918,912,-6,1
5rk1/8/1p6/p2p3p/P2P2p1/1N2P2P/1PN1K1P1/R4R2 w - - 0 27,Rxf8+,915,915,0,1
5Rk1/8/1p6/p2p3p/P2P2p1/1N2P2P/1PN1K1P1/R7 b - - 0 27,Kxf8,908,920,12,1
5k2/8/1p6/p2p3p/P2P2p1/1N2P2P/1PN1K1P1/R7 w - - 0 28,hxg4,915,901,-14,1
5k2/8/1p6/p2p3p/P2P2P1/1N2P3/1PN1K1P1/R7 b - - 0 28,hxg4,914,909,-5,1
5k2/8/1p6/p2p4/P2P2p1/1N2P3/1PN1K1P1/R7 w - - 0 29,g3,908,851,-57,1
5k2/8/1p6/p2p4/P2P2p1/1N2P1P1/1PN1K3/R7 b - - 0 29,b5,874,876,2,1
5k2/8/8/pp1p4/P2P2p1/1N2P1P1/1PN1K3/R7 w - - 0 30,axb5,875,902,27,1
5k2/8/8/pP1p4/3P2p1/1N2P1P1/1PN1K3/R7 b - - 0 30,a4,954,973,19,1
5k2/8/8/1P1p4/p2P2p1/1N2P1P1/1PN1K3/R7 w - - 0 31,Rxa4,970,910,-60,1
5k2/8/8/1P1p4/R2P2p1/1N2P1P1/1PN1K3/8 b - - 0 31,Ke8,849,1061,212,1
4k3/8/8/1P1p4/R2P2p1/1N2P1P1/1PN1K3/8 w - - 1 32,b6,1234,9990,8756,1
4k3/8/1P6/3p4/R2P2p1/1N2P1P1/1PN1K3/8 b - - 0 32,Kd8,9991,9990,-1,1
3k4/8/1P6/3p4/R2P2p1/1N2P1P1/1PN1K3/8 w - - 1 33,b7,9991,9992,1,1
3k4/1P6/8/3p4/R2P2p1/1N2P1P1/1PN1K3/8 b - - 0 33,Kc7,9992,9992,0,1
8/1Pk5/8/3p4/R2P2p1/1N2P1P1/1PN1K3/8 w - - 1 34,Ra7,9992,9996,4,1
8/RPk5/8/3p4/3P2p1/1N2P1P1/1PN1K3/8 b - - 2 34,Kb8,9996,9996,0,1
1k6/RP6/8/3p4/3P2p1/1N2P1P1/1PN1K3/8 w - - 3 35,Ra5,9996,891,-9105,0
1k6/1P6/8/R2p4/3P2p1/1N2P1P1/1PN1K3/8 b - - 4 35,Kxb7,898,888,-10,1
8/1k6/8/R2p4/3P2p1/1N2P1P1/1PN1K3/8 w - - 0 36,Rxd5,899,929,30,1
8/1k6/8/3R4/3P2p1/1N2P1P1/1PN1K3/8 b - - 0 36,Kc6,976,1237,261,1
8/8/2k5/3R4/3P2p1/1N2P1P1/1PN1K3/8 w - - 1 37,Rg5,1072,881,-191,0
8/8/2k5/6R1/3P2p1/1N2P1P1/1PN1K3/8 b - - 2 37,Kd6,883,915,32,1
8/8/3k4/6R1/3P2p1/1N2P1P1/1PN1K3/8 w - - 3 38,Rxg4,915,899,-16,1
8/8/3k4/8/3P2R1/1N2P1P1/1PN1K3/8 b - - 0 38,Kd5,950,940,-10,1
8/8/8/3k4/3P2R1/1N2P1P1/1PN1K3/8 w - - 1 39,Rf4,972,1049,77,1
8/8/8/3k4/3P1R2/1N2P1P1/1PN1K3/8 b - - 2 39,Kc4,1166,1360,194,1
8/8/8/8/2kP1R2/1N2P1P1/1PN1K3/8 w - - 3 40,Nba1,1351,1071,-280,0
8/8/8/8/2kP1R2/4P1P1/1PN1K3/N7 b - - 4 40,Kd5,1199,1219,20,1
8/8/8/3k4/3P1R2/4P1P1/1PN1K3/N7 w - - 5 41,g4,1298,1383,85,1
8/8/8/3k4/3P1RP1/4P3/1PN1K3/N7 b - - 0 41,Ke6,1311,9987,8676,1
8/8/4k3/8/3P1RP1/4P3/1PN1K3/N7 w - - 1 42,g5,9988,9988,0,1
8/8/4k3/6P1/3P1R2/4P3/1PN1K3/N7 b - - 0 42,Ke7,9988,9989,1,1
8/4k3/8/6P1/3P1R2/4P3/1PN1K3/N7 w - - 1 43,g6,9989,9990,1,1
8/4k3/6P1/8/3P1R2/4P3/1PN1K3/N7 b - - 0 43,Ke8,9990,9990,0,1
4k3/8/6P1/8/3P1R2/4P3/1PN1K3/N7 w - - 1 44,g7,9990,9991,1,1
4k3/6P1/8/8/3P1R2/4P3/1PN1K3/N7 b - - 0 44,Ke7,9991,9991,0,1
8/4k1P1/8/8/3P1R2/4P3/1PN1K3/N7 w - - 1 45,g8=Q,9991,9992,1,1
6Q1/4k3/8/8/3P1R2/4P3/1PN1K3/N7 b - - 0 45,Kd6,9996,9997,1,1
6Q1/8/3k4/8/3P1R2/4P3/1PN1K3/N7 w - - 1 46,Rf5,9997,9991,-6,1
6Q1/8/3k4/5R2/3P4/4P3/1PN1K3/N7 b - - 2 46,Ke7,9991,9996,5,1
6Q1/4k3/8/5R2/3P4/4P3/1PN1K3/N7 w - - 3 47,Re5+,9996,9996,0,1
6Q1/4k3/8/4R3/3P4/4P3/1PN1K3/N7 b - - 4 47,Kf6,9996,9998,2,1
6Q1/8/5k2/4R3/3P4/4P3/1PN1K3/N7 w - - 5 48,Qf8+,9998,9995,-3,1
5Q2/8/5k2/4R3/3P4/4P3/1PN1K3/N7 b - - 6 48,Kg6,9995,9995,0,1
5Q2/8/6k1/4R3/3P4/4P3/1PN1K3/N7 w - - 7 49,Re4,9996,9996,0,1
5Q2/8/6k1/8/3PR3/4P3/1PN1K3/N7 b - - 8 49,Kg5,9996,9997,1,1
5Q2/8/8/6k1/3PR3/4P3/1PN1K3/N7 w - - 9 50,Qg8+,9997,9998,1,1
6Q1/8/8/6k1/3PR3/4P3/1PN1K3/N7 b - - 10 50,Kf5,9998,9999,1,1
6Q1/8/8/5k2/3PR3/4P3/1PN1K3/N7 w - - 11 51,Re5+,9999,9998,-1,1
6Q1/8/8/4Rk2/3P4/4P3/1PN1K3/N7 b - - 12 51,Kf6,9998,9998,0,1
6Q1/8/5k2/4R3/3P4/4P3/1PN1K3/N7 w - - 13 52,Qf8+,9998,9997,-1,1
5Q2/8/5k2/4R3/3P4/4P3/1PN1K3/N7 b - - 14 52,Kg6,9997,9997,0,1
5Q2/8/6k1/4R3/3P4/4P3/1PN1K3/N7 w - - 15 53,Qg8+,9997,9997,0,1
6Q1/8/6k1/4R3/3P4/4P3/1PN1K3/N7 b - - 16 53,Kf6,9997,9998,1,1
6Q1/8/5k2/4R3/3P4/4P3/1PN1K3/N7 w - - 17 54,Qf8+,9998,9997,-1,1
5Q2/8/5k2/4R3/3P4/4P3/1PN1K3/N7 b - - 18 54,Kg6,9997,9997,0,1
5Q2/8/6k1/4R3/3P4/4P3/1PN1K3/N7 w - - 19 55,Re6+,9997,9998,1,1
5Q2/8/4R1k1/8/3P4/4P3/1PN1K3/N7 b - - 20 55,Kg5,9998,9998,0,1
5Q2/8/4R3/6k1/3P4/4P3/1PN1K3/N7 w - - 21 56,Re7,9998,9997,-1,1
5Q2/4R3/8/6k1/3P4/4P3/1PN1K3/N7 b - - 22 56,Kg6,9997,9997,0,1
5Q2/4R3/6k1/8/3P4/4P3/1PN1K3/N7 w - - 23 57,Rg7+,9997,9999,2,1
5Q2/6R1/6k1/8/3P4/4P3/1PN1K3/N7 b - - 24 57,Kh5,9999,9999,0,1
5Q2/6R1/8/7k/3P4/4P3/1PN1K3/N7 w - - 25 58,Qh8#,9999,10000,1,1
rnbqkbnr/pppppppp/8/8/8/8/PPPPPPPP/RNBQKBNR w KQkq - 0 1,e4,32,22,-10,1
rnbqkbnr/pppppppp/8/8/4P3/8/PPPP1PPP/RNBQKBNR b KQkq - 0 1,e5,19,29,10,1
rnbqkbnr/pppp1ppp/8/4p3/4P3/8/PPPP1PPP/RNBQKBNR w KQkq - 0 2,f4,44,-40,-84,1
rnbqkbnr/pppp1ppp/8/4p3/4PP2/8/PPPP2PP/RNBQKBNR b KQkq - 0 2,Nc6,-42,47,89,1
r1bqkbnr/pppp1ppp/2n5/4p3/4PP2/8/PPPP2PP/RNBQKBNR w KQkq - 1 3,fxe5,38,-330,-368,0
r1bqkbnr/pppp1ppp/2n5/4P3/4P3/8/PPPP2PP/RNBQKBNR b KQkq - 0 3,Nxe5,-396,63,459,1
r1bqkbnr/pppp1ppp/8/4n3/4P3/8/PPPP2PP/RNBQKBNR w KQkq - 0 4,Nf3,34,19,-15,1
r1bqkbnr/pppp1ppp/8/4n3/4P3/5N2/PPPP2PP/RNBQKB1R b KQkq - 1 4,d6,3,56,53,1
r1bqkbnr/ppp2ppp/3p4/4n3/4P3/5N2/PPPP2PP/RNBQKB1R w KQkq - 0 5,d4,96,64,-32,1
r1bqkbnr/ppp2ppp/3p4/4n3/3PP3/5N2/PPP3PP/RNBQKB1R b KQkq - 0 5,Ng6,82,82,0,1
r1bqkbnr/ppp2ppp/3p2n1/8/3PP3/5N2/PPP3PP/RNBQKB1R w KQkq - 1 6,Bc4,86,55,-31,1
r1bqkbnr/ppp2ppp/3p2n1/8/2BPP3/5N2/PPP3PP/RNBQK2R b KQkq - 2 6,Nf6,66,59,-7,1
r1bqkb1r/ppp2ppp/3p1nn1/8/2BPP3/5N2/PPP3PP/RNBQK2R w KQkq - 3 7,Bg5,75,8,-67,1
r1bqkb1r/ppp2ppp/3p1nn1/6B1/2BPP3/5N2/PPP3PP/RN1QK2R b KQkq - 4 7,Be7,17,25,8,1
r1bqk2r/ppp1bppp/3p1nn1/6B1/2BPP3/5N2/PPP3PP/RN1QK2R w KQkq - 5 8,Bxf6,33,-16,-49,1
r1bqk2r/ppp1bppp/3p1Bn1/8/2BPP3/5N2/PPP3PP/RN1QK2R b KQkq - 0 8,Bxf6,-27,-8,19,1
r1bqk2r/ppp2ppp/3p1bn1/8/2BPP3/5N2/PPP3PP/RN1QK2R w KQkq - 0 9,h4,-18,-163,-145,0
r1bqk2r/ppp2ppp/3p1bn1/8/2BPP2P/5N2/PPP3P1/RN1QK2R b KQkq - 0 9,O-O,-152,-154,-2,1
r1bq1rk1/ppp2ppp/3p1bn1/8/2BPP2P/5N2/PPP3P1/RN1QK2R w KQ - 1 10,Nc3,-161,-179,-18,1
r1bq1rk1/ppp2ppp/3p1bn1/8/2BPP2P/2N2N2/PPP3P1/R2QK2R b KQ - 2 10,Re8,-153,-23,130,1
r1bqr1k1/ppp2ppp/3p1bn1/8/2BPP2P/2N2N2/PPP3P1/R2QK2R w KQ - 3 11,Qd2,-13,-58,-45,1
r1bqr1k1/ppp2ppp/3p1bn1/8/2BPP2P/2N2N2/PPPQ2P1/R3K2R b KQ - 4 11,Nxh4,-39,-25,14,1
r1bqr1k1/ppp2ppp/3p1b2/8/2BPP2n/2N2N2/PPPQ2P1/R3K2R w KQ - 0 12,Nxh4,-16,-257,-241,0
r1bqr1k1/ppp2ppp/3p1b2/8/2BPP2N/2N5/PPPQ2P1/R3K2R b KQ - 0 12,Bxh4+,-254,-236,18,1
r1bqr1k1/ppp2ppp/3p4/8/2BPP2b/2N5/PPPQ2P1/R3K2R w KQ - 0 13,Kd1,-225,-330,-105,0
r1bqr1k1/ppp2ppp/3p4/8/2BPP2b/2N5/PPPQ2P1/R2K3R b - - 1 13,Bg5,-337,-296,41,1
r1bqr1k1/ppp2ppp/3p4/6b1/2BPP3/2N5/PPPQ2P1/R2K3R w - - 2 14,Qf2,-308,-295,13,1
r1bqr1k1/ppp2ppp/3p4/6b1/2BPP3/2N5/PPP2QP1/R2K3R b - - 3 14,Bg4+,-320,-313,7,1
r2qr1k1/ppp2ppp/3p4/6b1/2BPP1b1/2N5/PPP2QP1/R2K3R w - - 4 15,Be2,-299,-308,-9,1
r2qr1k1/ppp2ppp/3p4/6b1/3PP1b1/2N5/PPP1BQP1/R2K3R b - - 5 15,Bxe2+,-315,-263,52,1
r2qr1k1/ppp2ppp/3p4/6b1/3PP3/2N5/PPP1bQP1/R2K3R w - - 0 16,Qxe2,-290,-341,-51,1
r2qr1k1/ppp2ppp/3p4/6b1/3PP3/2N5/PPP1Q1P1/R2K3R b - - 0 16,c5,-343,-322,21,1
r2qr1k1/pp3ppp/3p4/2p3b1/3PP3/2N5/PPP1Q1P1/R2K3R w - - 0 17,d5,-326,-386,-60,1
r2qr1k1/pp3ppp/3p4/2pP2b1/4P3/2N5/PPP1Q1P1/R2K3R b - - 0 17,b5,-386,-297,89,1
r2qr1k1/p4ppp/3p4/1ppP2b1/4P3/2N5/PPP1Q1P1/R2K3R w - - 0 18,Qh5,-324,-420,-96,1
r2qr1k1/p4ppp/3p4/1ppP2bQ/4P3/2N5/PPP3P1/R2K3R b - - 1 18,h6,-408,-426,-18,1
r2qr1k1/p4pp1/3p3p/1ppP2bQ/4P3/2N5/PPP3P1/R2K3R w - - 0 19,Qg4,-414,-493,-79,1
r2qr1k1/p4pp1/3p3p/1ppP2b1/4P1Q1/2N5/PPP3P1/R2K3R b - - 1 19,b4,-501,-445,56,1
r2qr1k1/p4pp1/3p3p/2pP2b1/1p2P1Q1/2N5/PPP3P1/R2K3R w - - 0 20,Ne2,-487,-475,12,1
r2qr1k1/p4pp1/3p3p/2pP2b1/1p2P1Q1/8/PPP1N1P1/R2K3R b - - 1 20,Qf6,-448,-463,-15,1
r3r1k1/p4pp1/3p1q1p/2pP2b1/1p2P1Q1/8/PPP1N1P1/R2K3R w - - 2 21,Rb1,-439,-524,-85,1
r3r1k1/p4pp1/3p1q1p/2pP2b1/1p2P1Q1/8/PPP1N1P1/1R1K3R b - - 3 21,c4,-478,-368,110,1
r3r1k1/p4pp1/3p1q1p/3P2b1/1pp1P1Q1/8/PPP1N1P1/1R1K3R w - - 0 22,Ng3,-385,-476,-91,1
r3r1k1/p4pp1/3p1q1p/3P2b1/1pp1P1Q1/6N1/PPP3P1/1R1K3R b - - 1 22,Qd4+,-449,-451,-2,1
r3r1k1/p4pp1/3p3p/3P2b1/1ppqP1Q1/6N1/PPP3P1/1R1K3R w - - 2 23,Ke1,-429,-556,-127,0
r3r1k1/p4pp1/3p3p/3P2b1/1ppqP1Q1/6N1/PPP3P1/1R2K2R b - - 3 23,Qxd5,-496,-455,41,1
r3r1k1/p4pp1/3p3p/3q2b1/1pp1P1Q1/6N1/PPP3P1/1R2K2R w - - 0 24,Kf1,-425,-454,-29,1
r3r1k1/p4pp1/3p3p/3q2b1/1pp1P1Q1/6N1/PPP3P1/1R3K1R b - - 1 24,Qb5,-454,-391,63,1
r3r1k1/p4pp1/3p3p/1q4b1/1pp1P1Q1/6N1/PPP3P1/1R3K1R w - - 2 25,Nf5,-408,-389,19,1
r3r1k1/p4pp1/3p3p/1q3Nb1/1pp1P1Q1/8/PPP3P1/1R3K1R b - - 3 25,c3+,-461,-453,8,1
r3r1k1/p4pp1/3p3p/1q3Nb1/1p2P1Q1/2p5/PPP3P1/1R3K1R w - - 0 26,Kg1,-471,-494,-23,1
r3r1k1/p4pp1/3p3p/1q3Nb1/1p2P1Q1/2p5/PPP3P1/1R4KR b - - 1 26,Qc5+,-499,-524,-25,1
r3r1k1/p4pp1/3p3p/2q2Nb1/1p2P1Q1/2p5/PPP3P1/1R4KR w - - 2 27,Kh2,-480,-482,-2,1
r3r1k1/p4pp1/3p3p/2q2Nb1/1p2P1Q1/2p5/PPP3PK/1R5R b - - 3 27,Qe5+,-542,-462,80,1
r3r1k1/p4pp1/3p3p/4qNb1/1p2P1Q1/2p5/PPP3PK/1R5R w - - 4 28,g3,-503,-510,-7,1
r3r1k1/p4pp1/3p3p/4qNb1/1p2P1Q1/2p3P1/PPP4K/1R5R b - - 0 28,Qxe4,-501,-372,129,1
r3r1k1/p4pp1/3p3p/5Nb1/1p2q1Q1/2p3P1/PPP4K/1R5R w - - 0 29,Qxe4,-413,-430,-17,1
r3r1k1/p4pp1/3p3p/5Nb1/1p2Q3/2p3P1/PPP4K/1R5R b - - 0 29,Rxe4,-422,-460,-38,1
r5k1/p4pp1/3p3p/5Nb1/1p2r3/2p3P1/PPP4K/1R5R w - - 0 30,Nxd6,-445,-554,-109,0
r5k1/p4pp1/3N3p/6b1/1p2r3/2p3P1/PPP4K/1R5R b - - 0 30,Re2+,-521,-520,1,1
r5k1/p4pp1/3N3p/6b1/1p6/2p3P1/PPP1r2K/1R5R w - - 1 31,Kh3,-490,-513,-23,1
r5k1/p4pp1/3N3p/6b1/1p6/2p3PK/PPP1r3/1R5R b - - 2 31,Rxc2,-492,-453,39,1
r5k1/p4pp1/3N3p/6b1/1p6/2p3PK/PPr5/1R5R w - - 0 32,Rhf1,-416,-542,-126,0
r5k1/p4pp1/3N3p/6b1/1p6/2p3PK/PPr5/1R3R2 b - - 1 32,cxb2,-592,-488,104,1
r5k1/p4pp1/3N3p/6b1/1p6/6PK/Ppr5/1R3R2 w - - 0 33,Nxf7,-517,-548,-31,1
r5k1/p4Np1/7p/6b1/1p6/6PK/Ppr5/1R3R2 b - - 0 33,Bf6,-518,-416,102,1
r5k1/p4Np1/5b1p/8/1p6/6PK/Ppr5/1R3R2 w - - 1 34,Nd6,-452,-537,-85,1
r5k1/p5p1/3N1b1p/8/1p6/6PK/Ppr5/1R3R2 b - - 2 34,a5,-556,-529,27,1
r5k1/6p1/3N1b1p/p7/1p6/6PK/Ppr5/1R3R2 w - - 0 35,Ne4,-561,-556,5,1
r5k1/6p1/5b1p/p7/1p2N3/6PK/Ppr5/1R3R2 b - - 1 35,a4,-561,-480,81,1
r5k1/6p1/5b1p/8/pp2N3/6PK/Ppr5/1R3R2 w - - 0 36,Nxf6+,-468,-479,-11,1
r5k1/6p1/5N1p/8/pp6/6PK/Ppr5/1R3R2 b - - 0 36,gxf6,-477,-481,-4,1
r5k1/8/5p1p/8/pp6/6PK/Ppr5/1R3R2 w - - 0 37,Rxf6,-488,-534,-46,1
r5k1/8/5R1p/8/pp6/6PK/Ppr5/1R6 b - - 0 37,a3,-506,-524,-18,1
r5k1/8/5R1p/8/1p6/p5PK/Ppr5/1R6 w - - 0 38,Rff1,-483,-587,-104,0
r5k1/8/7p/8/1p6/p5PK/Ppr5/1R3R2 b - - 1 38,Rac8,-612,-554,58,1
rnbqkbnr/pppppppp/8/8/8/8/PPPPPPPP/RNBQKBNR w KQkq - 0 1,e4,18,24,6,1
rnbqkbnr/pppppppp/8/8/4P3/8/PPPP1PPP/RNBQKBNR b KQkq - 0 1,e5,28,42,14,1
rnbqkbnr/pppp1ppp/8/4p3/4P3/8/PPPP1PPP/RNBQKBNR w KQkq - 0 2,d3,34,-16,-50,1
rnbqkbnr/pppp1ppp/8/4p3/4P3/3P4/PPP2PPP/RNBQKBNR b KQkq - 0 2,Nc6,-21,-15,6,1
r1bqkbnr/pppp1ppp/2n5/4p3/4P3/3P4/PPP2PPP/RNBQKBNR w KQkq - 1 3,Nf3,-21,-21,0,1
r1bqkbnr/pppp1ppp/2n5/4p3/4P3/3P1N2/PPP2PPP/RNBQKB1R b KQkq - 2 3,Nf6,-19,-8,11,1
r1bqkb1r/pppp1ppp/2n2n2/4p3/4P3/3P1N2/PPP2PPP/RNBQKB1R w KQkq - 3 4,Nc3,-3,-25,-22,1
r1bqkb1r/pppp1ppp/2n2n2/4p3/4P3/2NP1N2/PPP2PPP/R1BQKB1R b KQkq - 4 4,d5,-30,-32,-2,1
r1bqkb1r/ppp2ppp/2n2n2/3pp3/4P3/2NP1N2/PPP2PPP/R1BQKB1R w KQkq - 0 5,Bg5,-30,-43,-13,1
r1bqkb1r/ppp2ppp/2n2n2/3pp1B1/4P3/2NP1N2/PPP2PPP/R2QKB1R b KQkq - 1 5,dxe4,-33,14,47,1
r1bqkb1r/ppp2ppp/2n2n2/4p1B1/4p3/2NP1N2/PPP2PPP/R2QKB1R w KQkq - 0 6,Bxf6,-6,-47,-41,1
r1bqkb1r/ppp2ppp/2n2B2/4p3/4p3/2NP1N2/PPP2PPP/R2QKB1R b KQkq - 0 6,Be7,-48,469,517,1
r1bqk2r/ppp1bppp/2n2B2/4p3/4p3/2NP1N2/PPP2PPP/R2QKB1R w KQkq - 1 7,Bxe7,412,431,19,1
r1bqk2r/ppp1Bppp/2n5/4p3/4p3/2NP1N2/PPP2PPP/R2QKB1R b KQkq - 0 7,Qxe7,444,434,-10,1
r1b1k2r/ppp1qppp/2n5/4p3/4p3/2NP1N2/PPP2PPP/R2QKB1R w KQkq - 0 8,Nxe4,466,281,-185,0
r1b1k2r/ppp1qppp/2n5/4p3/4N3/3P1N2/PPP2PPP/R2QKB1R b KQkq - 0 8,f5,317,344,27,1
r1b1k2r/ppp1q1pp/2n5/4pp2/4N3/3P1N2/PPP2PPP/R2QKB1R w KQkq - 0 9,Ned2,341,169,-172,0
r1b1k2r/ppp1q1pp/2n5/4pp2/8/3P1N2/PPPN1PPP/R2QKB1R b KQkq - 1 9,O-O,169,340,171,1
r1b2rk1/ppp1q1pp/2n5/4pp2/8/3P1N2/PPPN1PPP/R2QKB1R w KQ - 2 10,Be2,283,270,-13,1
r1b2rk1/ppp1q1pp/2n5/4pp2/8/3P1N2/PPPNBPPP/R2QK2R b KQ - 3 10,e4,259,241,-18,1
r1b2rk1/ppp1q1pp/2n5/5p2/4p3/3P1N2/PPPNBPPP/R2QK2R w KQ - 0 11,dxe4,261,165,-96,1
r1b2rk1/ppp1q1pp/2n5/5p2/4P3/5N2/PPPNBPPP/R2QK2R b KQ - 0 11,fxe4,160,150,-10,1
r1b2rk1/ppp1q1pp/2n5/8/4p3/5N2/PPPNBPPP/R2QK2R w KQ - 0 12,Ng1,169,94,-75,1
r1b2rk1/ppp1q1pp/2n5/8/4p3/8/PPPNBPPP/R2QK1NR b KQ - 1 12,Qc5,98,305,207,1
r1b2rk1/ppp3pp/2n5/2q5/4p3/8/PPPNBPPP/R2QK1NR w KQ - 2 13,c3,287,-9999,-10286,0
r1b2rk1/ppp3pp/2n5/2q5/4p3/2P5/PP1NBPPP/R2QK1NR b KQ - 0 13,Qxf2#,-9999,-10000,-1,1
rnbqkbnr/pppppppp/8/8/8/8/PPPPPPPP/RNBQKBNR w KQkq - 0 1,e4,28,24,-4,1
rnbqkbnr/pppppppp/8/8/4P3/8/PPPP1PPP/RNBQKBNR b KQkq - 0 1,d6,26,52,26,1
rnbqkbnr/ppp1pppp/3p4/8/4P3/8/PPPP1PPP/RNBQKBNR w KQkq - 0 2,d4,53,45,-8,1
rnbqkbnr/ppp1pppp/3p4/8/3PP3/8/PPP2PPP/RNBQKBNR b KQkq - 0 2,e5,49,47,-2,1
rnbqkbnr/ppp2ppp/3p4/4p3/3PP3/8/PPP2PPP/RNBQKBNR w KQkq - 0 3,d5,53,46,-7,1
rnbqkbnr/ppp2ppp/3p4/3Pp3/4P3/8/PPP2PPP/RNBQKBNR b KQkq - 0 3,Nf6,36,31,-5,1
rnbqkb1r/ppp2ppp/3p1n2/3Pp3/4P3/8/PPP2PPP/RNBQKBNR w KQkq - 1 4,Nc3,35,29,-6,1
rnbqkb1r/ppp2ppp/3p1n2/3Pp3/4P3/2N5/PPP2PPP/R1BQKBNR b KQkq - 2 4,Be7,23,25,2,1
rnbqk2r/ppp1bppp/3p1n2/3Pp3/4P3/2N5/PPP2PPP/R1BQKBNR w KQkq - 3 5,Nf3,26,4,-22,1
rnbqk2r/ppp1bppp/3p1n2/3Pp3/4P3/2N2N2/PPP2PPP/R1BQKB1R b KQkq - 4 5,O-O,16,19,3,1
rnbq1rk1/ppp1bppp/3p1n2/3Pp3/4P3/2N2N2/PPP2PPP/R1BQKB1R w KQ - 5 6,Bc4,13,-13,-26,1
rnbq1rk1/ppp1bppp/3p1n2/3Pp3/2B1P3/2N2N2/PPP2PPP/R1BQK2R b KQ - 6 6,c6,-27,-30,-3,1
rnbq1rk1/pp2bppp/2pp1n2/3Pp3/2B1P3/2N2N2/PPP2PPP/R1BQK2R w KQ - 0 7,Qd2,-24,-141,-117,0
rnbq1rk1/pp2bppp/2pp1n2/3Pp3/2B1P3/2N2N2/PPPQ1PPP/R1B1K2R b KQ - 1 7,cxd5,-134,-30,104,1
rnbq1rk1/pp2bppp/3p1n2/3pp3/2B1P3/2N2N2/PPPQ1PPP/R1B1K2R w KQ - 0 8,Nxd5,-29,-94,-65,1
rnbq1rk1/pp2bppp/3p1n2/3Np3/2B1P3/5N2/PPPQ1PPP/R1B1K2R b KQ - 0 8,Nc6,-87,27,114,1
r1bq1rk1/pp2bppp/2np1n2/3Np3/2B1P3/5N2/PPPQ1PPP/R1B1K2R w KQ - 1 9,Nxf6+,27,20,-7,1
r1bq1rk1/pp2bppp/2np1N2/4p3/2B1P3/5N2/PPPQ1PPP/R1B1K2R b KQ - 0 9,Bxf6,15,21,6,1
r1bq1rk1/pp3ppp/2np1b2/4p3/2B1P3/5N2/PPPQ1PPP/R1B1K2R w KQ - 0 10,Ng5,18,-95,-113,0
r1bq1rk1/pp3ppp/2np1b2/4p1N1/2B1P3/8/PPPQ1PPP/R1B1K2R b KQ - 1 10,Bxg5,-104,2,106,1
r1bq1rk1/pp3ppp/2np4/4p1b1/2B1P3/8/PPPQ1PPP/R1B1K2R w KQ - 0 11,Qxg5,2,2,0,1
r1bq1rk1/pp3ppp/2np4/4p1Q1/2B1P3/8/PPP2PPP/R1B1K2R b KQ - 0 11,g6,-23,146,169,1
r1bq1rk1/pp3p1p/2np2p1/4p1Q1/2B1P3/8/PPP2PPP/R1B1K2R w KQ - 0 12,h4,141,85,-56,1
r1bq1rk1/pp3p1p/2np2p1/4p1Q1/2B1P2P/8/PPP2PP1/R1B1K2R b KQ - 0 12,Qxg5,97,130,33,1
r1b2rk1/pp3p1p/2np2p1/4p1q1/2B1P2P/8/PPP2PP1/R1B1K2R w KQ - 0 13,Bxg5,157,174,17,1
r1b2rk1/pp3p1p/2np2p1/4p1B1/2B1P2P/8/PPP2PP1/R3K2R b KQ - 0 13,Nd4,175,184,9,1
r1b2rk1/pp3p1p/3p2p1/4p1B1/2BnP2P/8/PPP2PP1/R3K2R w KQ - 1 14,Rd1,187,17,-170,0
r1b2rk1/pp3p1p/3p2p1/4p1B1/2BnP2P/8/PPP2PP1/3RK2R b K - 2 14,Nxc2+,2,9,7,1
r1b2rk1/pp3p1p/3p2p1/4p1B1/2B1P2P/8/PPn2PP1/3RK2R w K - 0 15,Kd2,11,0,-11,1
r1b2rk1/pp3p1p/3p2p1/4p1B1/2B1P2P/8/PPnK1PP1/3R3R b - - 1 15,Nd4,0,0,0,1
r1b2rk1/pp3p1p/3p2p1/4p1B1/2BnP2P/8/PP1K1PP1/3R3R w - - 2 16,Kc1,0,-154,-154,0
r1b2rk1/pp3p1p/3p2p1/4p1B1/2BnP2P/8/PP3PP1/2KR3R b - - 3 16,Bg4,-224,-203,21,1
r4rk1/pp3p1p/3p2p1/4p1B1/2BnP1bP/8/PP3PP1/2KR3R w - - 4 17,Rd2,-208,-401,-193,0
r4rk1/pp3p1p/3p2p1/4p1B1/2BnP1bP/8/PP1R1PP1/2K4R b - - 5 17,Ne2+,-360,467,827,1
r4rk1/pp3p1p/3p2p1/4p1B1/2B1P1bP/8/PP1RnPP1/2K4R w - - 6 18,Kb1,430,51,-379,0
r4rk1/pp3p1p/3p2p1/4p1B1/2B1P1bP/8/PP1RnPP1/1K5R b - - 7 18,Rac8,45,436,391,1
2r2rk1/pp3p1p/3p2p1/4p1B1/2B1P1bP/8/PP1RnPP1/1K5R w - - 8 19,Bb3,445,25,-420,0
2r2rk1/pp3p1p/3p2p1/4p1B1/4P1bP/1B6/PP1RnPP1/1K5R b - - 9 19,Nd4,0,-2,-2,1
2r2rk1/pp3p1p/3p2p1/4p1B1/3nP1bP/1B6/PP1R1PP1/1K5R w - - 10 20,h5,-3,-44,-41,1
2r2rk1/pp3p1p/3p2p1/4p1BP/3nP1b1/1B6/PP1R1PP1/1K5R b - - 0 20,Nxb3,-43,-53,-10,1
2r2rk1/pp3p1p/3p2p1/4p1BP/4P1b1/1n6/PP1R1PP1/1K5R w - - 0 21,Rxd6,-78,-341,-263,0
2r2rk1/pp3p1p/3R2p1/4p1BP/4P1b1/1n6/PP3PP1/1K5R b - - 0 21,Bxh5,-372,-28,344,1
2r2rk1/pp3p1p/3R2p1/4p1Bb/4P3/1n6/PP3PP1/1K5R w - - 0 22,Be7,-16,-338,-322,0
2r2rk1/pp2Bp1p/3R2p1/4p2b/4P3/1n6/PP3PP1/1K5R b - - 1 22,Rfe8,-379,-385,-6,1
rnbqkbnr/pppppppp/8/8/8/8/PPPPPPPP/RNBQKBNR w KQkq - 0 1,e4,42,30,-12,1
rnbqkbnr/pppppppp/8/8/4P3/8/PPPP1PPP/RNBQKBNR b KQkq - 0 1,e5,30,37,7,1
rnbqkbnr/pppp1ppp/8/4p3/4P3/8/PPPP1PPP/RNBQKBNR w KQkq - 0 2,Nf3,42,36,-6,1
rnbqkbnr/pppp1ppp/8/4p3/4P3/5N2/PPPP1PPP/RNBQKB1R b KQkq - 1 2,d6,35,40,5,1
rnbqkbnr/ppp2ppp/3p4/4p3/4P3/5N2/PPPP1PPP/RNBQKB1R w KQkq - 0 3,Bc4,55,34,-21,1
rnbqkbnr/ppp2ppp/3p4/4p3/2B1P3/5N2/PPPP1PPP/RNBQK2R b KQkq - 1 3,Be7,20,29,9,1
rnbqk1nr/ppp1bppp/3p4/4p3/2B1P3/5N2/PPPP1PPP/RNBQK2R w KQkq - 2 4,d4,30,28,-2,1
rnbqk1nr/ppp1bppp/3p4/4p3/2BPP3/5N2/PPP2PPP/RNBQK2R b KQkq - 0 4,exd4,26,31,5,1
rnbqk1nr/ppp1bppp/3p4/8/2BpP3/5N2/PPP2PPP/RNBQK2R w KQkq - 0 5,Nxd4,32,26,-6,1
rnbqk1nr/ppp1bppp/3p4/8/2BNP3/8/PPP2PPP/RNBQK2R b KQkq - 0 5,Nf6,17,21,4,1
rnbqk2r/ppp1bppp/3p1n2/8/2BNP3/8/PPP2PPP/RNBQK2R w KQkq - 1 6,Nc3,43,32,-11,1
rnbqk2r/ppp1bppp/3p1n2/8/2BNP3/2N5/PPP2PPP/R1BQK2R b KQkq - 2 6,a6,22,47,25,1
rnbqk2r/1pp1bppp/p2p1n2/8/2BNP3/2N5/PPP2PPP/R1BQK2R w KQkq - 0 7,O-O,43,45,2,1
rnbqk2r/1pp1bppp/p2p1n2/8/2BNP3/2N5/PPP2PPP/R1BQ1RK1 b kq - 1 7,b5,52,146,94,1
rnbqk2r/2p1bppp/p2p1n2/1p6/2BNP3/2N5/PPP2PPP/R1BQ1RK1 w kq - 0 8,Bb3,103,-26,-129,0
rnbqk2r/2p1bppp/p2p1n2/1p6/3NP3/1BN5/PPP2PPP/R1BQ1RK1 b kq - 1 8,c5,-29,-16,13,1
rnbqk2r/4bppp/p2p1n2/1pp5/3NP3/1BN5/PPP2PPP/R1BQ1RK1 w kq - 0 9,Bxf7+,-32,-287,-255,0
rnbqk2r/4bBpp/p2p1n2/1pp5/3NP3/2N5/PPP2PPP/R1BQ1RK1 b kq - 0 9,Kxf7,-289,-293,-4,1
rnbq3r/4bkpp/p2p1n2/1pp5/3NP3/2N5/PPP2PPP/R1BQ1RK1 w - - 0 10,Nf5,-267,-251,16,1
rnbq3r/4bkpp/p2p1n2/1pp2N2/4P3/2N5/PPP2PPP/R1BQ1RK1 b - - 1 10,Bxf5,-253,-230,23,1
rn1q3r/4bkpp/p2p1n2/1pp2b2/4P3/2N5/PPP2PPP/R1BQ1RK1 w - - 0 11,exf5,-251,-251,0,1
rn1q3r/4bkpp/p2p1n2/1pp2P2/8/2N5/PPP2PPP/R1BQ1RK1 b - - 0 11,Rf8,-247,-157,90,1
rn1q1r2/4bkpp/p2p1n2/1pp2P2/8/2N5/PPP2PPP/R1BQ1RK1 w - - 1 12,Nd5,-156,-157,-1,1
rn1q1r2/4bkpp/p2p1n2/1ppN1P2/8/8/PPP2PPP/R1BQ1RK1 b - - 2 12,Kg8,-179,198,377,1
rn1q1rk1/4b1pp/p2p1n2/1ppN1P2/8/8/PPP2PPP/R1BQ1RK1 w - - 3 13,Nxf6+,193,172,-21,1
rn1q1rk1/4b1pp/p2p1N2/1pp2P2/8/8/PPP2PPP/R1BQ1RK1 b - - 0 13,Bxf6,201,377,176,1
rn1q1rk1/6pp/p2p1b2/1pp2P2/8/8/PPP2PPP/R1BQ1RK1 w - - 0 14,Qd5+,354,382,28,1
rn1q1rk1/6pp/p2p1b2/1ppQ1P2/8/8/PPP2PPP/R1B2RK1 b - - 1 14,Kh8,373,366,-7,1
rn1q1r1k/6pp/p2p1b2/1ppQ1P2/8/8/PPP2PPP/R1B2RK1 w - - 2 15,Qxa8,348,350,2,1
Qn1q1r1k/6pp/p2p1b2/1pp2P2/8/8/PPP2PPP/R1B2RK1 b - - 0 15,Nd7,341,452,111,1
Q2q1r1k/3n2pp/p2p1b2/1pp2P2/8/8/PPP2PPP/R1B2RK1 w - - 1 16,Qf3,424,349,-75,1
3q1r1k/3n2pp/p2p1b2/1pp2P2/8/5Q2/PPP2PPP/R1B2RK1 b - - 2 16,Ne5,358,350,-8,1
3q1r1k/6pp/p2p1b2/1pp1nP2/8/5Q2/PPP2PPP/R1B2RK1 w - - 3 17,Qg3,354,315,-39,1
3q1r1k/6pp/p2p1b2/1pp1nP2/8/6Q1/PPP2PPP/R1B2RK1 b - - 4 17,c4,312,379,67,1
3q1r1k/6pp/p2p1b2/1p2nP2/2p5/6Q1/PPP2PPP/R1B2RK1 w - - 0 18,Bf4,377,350,-27,1
3q1r1k/6pp/p2p1b2/1p2nP2/2p2B2/6Q1/PPP2PPP/R4RK1 b - - 1 18,Ng6,374,508,134,1
3q1r1k/6pp/p2p1bn1/1p3P2/2p2B2/6Q1/PPP2PPP/R4RK1 w - - 2 19,Bxd6,574,420,-154,0
3q1r1k/6pp/p2B1bn1/1p3P2/2p5/6Q1/PPP2PPP/R4RK1 b - - 0 19,Re8,470,542,72,1
3qr2k/6pp/p2B1bn1/1p3P2/2p5/6Q1/PPP2PPP/R4RK1 w - - 1 20,fxg6,579,549,-30,1
3qr2k/6pp/p2B1bP1/1p6/2p5/6Q1/PPP2PPP/R4RK1 b - - 0 20,hxg6,584,581,-3,1
3qr2k/6p1/p2B1bp1/1p6/2p5/6Q1/PPP2PPP/R4RK1 w - - 0 21,Rad1,594,575,-19,1
3qr2k/6p1/p2B1bp1/1p6/2p5/6Q1/PPP2PPP/3R1RK1 b - - 1 21,Qa5,569,668,99,1
4r2k/6p1/p2B1bp1/qp6/2p5/6Q1/PPP2PPP/3R1RK1 w - - 2 22,c3,685,569,-116,0
4r2k/6p1/p2B1bp1/qp6/2p5/2P3Q1/PP3PPP/3R1RK1 b - - 0 22,Qxa2,531,657,126,1
4r2k/6p1/p2B1bp1/1p6/2p5/2P3Q1/qP3PPP/3R1RK1 w - - 0 23,Ba3,708,567,-141,0
4r2k/6p1/p4bp1/1p6/2p5/B1P3Q1/qP3PPP/3R1RK1 b - - 1 23,Qb3,586,714,128,1
4r2k/6p1/p4bp1/1p6/2p5/BqP3Q1/1P3PPP/3R1RK1 w - - 2 24,Rfe1,724,550,-174,0
4r2k/6p1/p4bp1/1p6/2p5/BqP3Q1/1P3PPP/3RR1K1 b - - 3 24,Rc8,596,971,375,1
2r4k/6p1/p4bp1/1p6/2p5/BqP3Q1/1P3PPP/3RR1K1 w - - 4 25,Rd7,9993,636,-9357,0
2r4k/3R2p1/p4bp1/1p6/2p5/BqP3Q1/1P3PPP/4R1K1 b - - 5 25,Qc2,654,622,-32,1
2r4k/3R2p1/p4bp1/1p6/2p5/B1P3Q1/1Pq2PPP/4R1K1 w - - 6 26,Ra7,628,497,-131,0
2r4k/R5p1/p4bp1/1p6/2p5/B1P3Q1/1Pq2PPP/4R1K1 b - - 7 26,Qd2,556,747,191,1
2r4k/R5p1/p4bp1/1p6/2p5/B1P3Q1/1P1q1PPP/4R1K1 w - - 8 27,Qh3+,784,733,-51,1
2r4k/R5p1/p4bp1/1p6/2p5/B1P4Q/1P1q1PPP/4R1K1 b - - 9 27,Kg8,731,838,107,1
2r3k1/R5p1/p4bp1/1p6/2p5/B1P4Q/1P1q1PPP/4R1K1 w - - 10 28,Qxc8+,839,832,-7,1
2Q3k1/R5p1/p4bp1/1p6/2p5/B1P5/1P1q1PPP/4R1K1 b - - 0 28,Kh7,844,846,2,1
2Q5/R5pk/p4bp1/1p6/2p5/B1P5/1P1q1PPP/4R1K1 w - - 1 29,Qh3+,848,847,-1,1
8/R5pk/p4bp1/1p6/2p5/B1P4Q/1P1q1PPP/4R1K1 b - - 2 29,Kg8,841,9999,9158,1
6k1/R5p1/p4bp1/1p6/2p5/B1P4Q/1P1q1PPP/4R1K1 w - - 3 30,Re8#,9999,10000,1,1
rnbqkbnr/pppppppp/8/8/8/8/PPPPPPPP/RNBQKBNR w KQkq - 0 1,d4,25,12,-13,1
rnbqkbnr/pppppppp/8/8/3P4/8/PPP1PPPP/RNBQKBNR b KQkq - 0 1,d5,18,38,20,1
rnbqkbnr/ppp1pppp/8/3p4/3P4/8/PPP1PPPP/RNBQKBNR w KQkq - 0 2,c4,24,16,-8,1
rnbqkbnr/ppp1pppp/8/3p4/2PP4/8/PP2PPPP/RNBQKBNR b KQkq - 0 2,e6,21,14,-7,1
rnbqkbnr/ppp2ppp/4p3/3p4/2PP4/8/PP2PPPP/RNBQKBNR w KQkq - 0 3,Nf3,18,20,2,1
rnbqkbnr/ppp2ppp/4p3/3p4/2PP4/5N2/PP2PPPP/RNBQKB1R b KQkq - 1 3,c5,22,43,21,1
rnbqkbnr/pp3ppp/4p3/2pp4/2PP4/5N2/PP2PPPP/RNBQKB1R w KQkq - 0 4,e3,43,12,-31,1
rnbqkbnr/pp3ppp/4p3/2pp4/2PP4/4PN2/PP3PPP/RNBQKB1R b KQkq - 0 4,Nc6,20,31,11,1
r1bqkbnr/pp3ppp/2n1p3/2pp4/2PP4/4PN2/PP3PPP/RNBQKB1R w KQkq - 1 5,Nc3,22,8,-14,1
r1bqkbnr/pp3ppp/2n1p3/2pp4/2PP4/2N1PN2/PP3PPP/R1BQKB1R b KQkq - 2 5,Nf6,10,9,-1,1
r1bqkb1r/pp3ppp/2n1pn2/2pp4/2PP4/2N1PN2/PP3PPP/R1BQKB1R w KQkq - 3 6,Bd3,24,-20,-44,1
r1bqkb1r/pp3ppp/2n1pn2/2pp4/2PP4/2NBPN2/PP3PPP/R1BQK2R b KQkq - 4 6,Be7,-19,16,35,1
r1bqk2r/pp2bppp/2n1pn2/2pp4/2PP4/2NBPN2/PP3PPP/R1BQK2R w KQkq - 5 7,O-O,16,17,1,1
r1bqk2r/pp2bppp/2n1pn2/2pp4/2PP4/2NBPN2/PP3PPP/R1BQ1RK1 b kq - 6 7,O-O,15,20,5,1
r1bq1rk1/pp2bppp/2n1pn2/2pp4/2PP4/2NBPN2/PP3PPP/R1BQ1RK1 w - - 7 8,a3,18,-6,-24,1
r1bq1rk1/pp2bppp/2n1pn2/2pp4/2PP4/P1NBPN2/1P3PPP/R1BQ1RK1 b - - 0 8,Re8,-18,41,59,1
r1bqr1k1/pp2bppp/2n1pn2/2pp4/2PP4/P1NBPN2/1P3PPP/R1BQ1RK1 w - - 1 9,dxc5,37,34,-3,1
r1bqr1k1/pp2bppp/2n1pn2/2Pp4/2P5/P1NBPN2/1P3PPP/R1BQ1RK1 b - - 0 9,Bxc5,41,32,-9,1
r1bqr1k1/pp3ppp/2n1pn2/2bp4/2P5/P1NBPN2/1P3PPP/R1BQ1RK1 w - - 0 10,b4,47,32,-15,1
r1bqr1k1/pp3ppp/2n1pn2/2bp4/1PP5/P1NBPN2/5PPP/R1BQ1RK1 b - - 0 10,Bb6,30,94,64,1
r1bqr1k1/pp3ppp/1bn1pn2/3p4/1PP5/P1NBPN2/5PPP/R1BQ1RK1 w - - 1 11,c5,89,26,-63,1
r1bqr1k1/pp3ppp/1bn1pn2/2Pp4/1P6/P1NBPN2/5PPP/R1BQ1RK1 b - - 0 11,Bc7,36,48,12,1
r1bqr1k1/ppb2ppp/2n1pn2/2Pp4/1P6/P1NBPN2/5PPP/R1BQ1RK1 w - - 1 12,Bc2,32,6,-26,1
r1bqr1k1/ppb2ppp/2n1pn2/2Pp4/1P6/P1N1PN2/2B2PPP/R1BQ1RK1 b - - 2 12,e5,-11,-2,9,1
r1bqr1k1/ppb2ppp/2n2n2/2Ppp3/1P6/P1N1PN2/2B2PPP/R1BQ1RK1 w - - 0 13,Bb2,26,-117,-143,0
r1bqr1k1/ppb2ppp/2n2n2/2Ppp3/1P6/P1N1PN2/1BB2PPP/R2Q1RK1 b - - 1 13,Bg4,-169,-27,142,1
r2qr1k1/ppb2ppp/2n2n2/2Ppp3/1P4b1/P1N1PN2/1BB2PPP/R2Q1RK1 w - - 2 14,Qb1,28,-162,-190,0
r2qr1k1/ppb2ppp/2n2n2/2Ppp3/1P4b1/P1N1PN2/1BB2PPP/RQ3RK1 b - - 3 14,Bxf3,-166,-148,18,1
r2qr1k1/ppb2ppp/2n2n2/2Ppp3/1P6/P1N1Pb2/1BB2PPP/RQ3RK1 w - - 0 15,gxf3,-67,-75,-8,1
r2qr1k1/ppb2ppp/2n2n2/2Ppp3/1P6/P1N1PP2/1BB2P1P/RQ3RK1 b - - 0 15,g6,-72,-30,42,1
r2qr1k1/ppb2p1p/2n2np1/2Ppp3/1P6/P1N1PP2/1BB2P1P/RQ3RK1 w - - 0 16,e4,2,-134,-136,0
r2qr1k1/ppb2p1p/2n2np1/2Ppp3/1P2P3/P1N2P2/1BB2P1P/RQ3RK1 b - - 0 16,d4,-123,-99,24,1
r2qr1k1/ppb2p1p/2n2np1/2P1p3/1P1pP3/P1N2P2/1BB2P1P/RQ3RK1 w - - 0 17,Nb5,-117,-259,-142,0
r2qr1k1/ppb2p1p/2n2np1/1NP1p3/1P1pP3/P4P2/1BB2P1P/RQ3RK1 b - - 1 17,a6,-299,-152,147,1
r2qr1k1/1pb2p1p/p1n2np1/1NP1p3/1P1pP3/P4P2/1BB2P1P/RQ3RK1 w - - 0 18,Nxc7,-149,-156,-7,1
r2qr1k1/1pN2p1p/p1n2np1/2P1p3/1P1pP3/P4P2/1BB2P1P/RQ3RK1 b - - 0 18,Qxc7,-145,-160,-15,1
r3r1k1/1pq2p1p/p1n2np1/2P1p3/1P1pP3/P4P2/1BB2P1P/RQ3RK1 w - - 0 19,Bd3,-144,-184,-40,1
r3r1k1/1pq2p1p/p1n2np1/2P1p3/1P1pP3/P2B1P2/1B3P1P/RQ3RK1 b - - 1 19,Qd7,-195,-159,36,1
r3r1k1/1p1q1p1p/p1n2np1/2P1p3/1P1pP3/P2B1P2/1B3P1P/RQ3RK1 w - - 2 20,Qd1,-167,-209,-42,1
r3r1k1/1p1q1p1p/p1n2np1/2P1p3/1P1pP3/P2B1P2/1B3P1P/R2Q1RK1 b - - 3 20,Qh3,-203,-180,23,1
r3r1k1/1p3p1p/p1n2np1/2P1p3/1P1pP3/P2B1P1q/1B3P1P/R2Q1RK1 w - - 4 21,Kh1,-170,-152,18,1
r3r1k1/1p3p1p/p1n2np1/2P1p3/1P1pP3/P2B1P1q/1B3P1P/R2Q1R1K b - - 5 21,Nh5,-165,-142,23,1
r3r1k1/1p3p1p/p1n3p1/2P1p2n/1P1pP3/P2B1P1q/1B3P1P/R2Q1R1K w - - 6 22,Rg1,-151,-152,-1,1
r3r1k1/1p3p1p/p1n3p1/2P1p2n/1P1pP3/P2B1P1q/1B3P1P/R2Q2RK b - - 7 22,Nf4,-135,-143,-8,1
r3r1k1/1p3p1p/p1n3p1/2P1p3/1P1pPn2/P2B1P1q/1B3P1P/R2Q2RK w - - 8 23,Rg3,-133,-170,-37,1
r3r1k1/1p3p1p/p1n3p1/2P1p3/1P1pPn2/P2B1PRq/1B3P1P/R2Q3K b - - 9 23,Qh5,-171,-150,21,1
r3r1k1/1p3p1p/p1n3p1/2P1p2q/1P1pPn2/P2B1PR1/1B3P1P/R2Q3K w - - 10 24,Bc1,-147,-162,-15,1
r3r1k1/1p3p1p/p1n3p1/2P1p2q/1P1pPn2/P2B1PR1/5P1P/R1BQ3K b - - 11 24,Nxd3,-150,-33,117,1
r3r1k1/1p3p1p/p1n3p1/2P1p2q/1P1pP3/P2n1PR1/5P1P/R1BQ3K w - - 0 25,Qxd3,-16,-33,-17,1
r3r1k1/1p3p1p/p1n3p1/2P1p2q/1P1pP3/P2Q1PR1/5P1P/R1B4K b - - 0 25,Kg7,-33,0,33,1
r3r3/1p3pkp/p1n3p1/2P1p2q/1P1pP3/P2Q1PR1/5P1P/R1B4K w - - 1 26,Bd2,11,0,-11,1
r3r3/1p3pkp/p1n3p1/2P1p2q/1P1pP3/P2Q1PR1/3B1P1P/R6K b - - 2 26,h6,0,22,22,1
r3r3/1p3pk1/p1n3pp/2P1p2q/1P1pP3/P2Q1PR1/3B1P1P/R6K w - - 0 27,Rag1,43,-5,-48,1
r3r3/1p3pk1/p1n3pp/2P1p2q/1P1pP3/P2Q1PR1/3B1P1P/6RK b - - 1 27,g5,-17,379,396,1
r3r3/1p3pk1/p1n4p/2P1p1pq/1P1pP3/P2Q1PR1/3B1P1P/6RK w - - 0 28,Bxg5,370,401,31,1
rnbqkbnr/pppppppp/8/8/8/8/PPPPPPPP/RNBQKBNR w KQkq - 0 1,e4,36,31,-5,1
rnbqkbnr/pppppppp/8/8/4P3/8/PPPP1PPP/RNBQKBNR b KQkq - 0 1,c5,24,36,12,1
rnbqkbnr/pp1ppppp/8/2p5/4P3/8/PPPP1PPP/RNBQKBNR w KQkq - 0 2,Nc3,35,21,-14,1
rnbqkbnr/pp1ppppp/8/2p5/4P3/2N5/PPPP1PPP/R1BQKBNR b KQkq - 1 2,e5,20,67,47,1
rnbqkbnr/pp1p1ppp/8/2p1p3/4P3/2N5/PPPP1PPP/R1BQKBNR w KQkq - 0 3,Nf3,66,30,-36,1
rnbqkbnr/pp1p1ppp/8/2p1p3/4P3/2N2N2/PPPP1PPP/R1BQKB1R b KQkq - 1 3,d6,42,40,-2,1
rnbqkbnr/pp3ppp/3p4/2p1p3/4P3/2N2N2/PPPP1PPP/R1BQKB1R w KQkq - 0 4,Bc4,32,31,-1,1
rnbqkbnr/pp3ppp/3p4/2p1p3/2B1P3/2N2N2/PPPP1PPP/R1BQK2R b KQkq - 1 4,h6,32,36,4,1
rnbqkbnr/pp3pp1/3p3p/2p1p3/2B1P3/2N2N2/PPPP1PPP/R1BQK2R w KQkq - 0 5,h3,40,34,-6,1
rnbqkbnr/pp3pp1/3p3p/2p1p3/2B1P3/2N2N1P/PPPP1PP1/R1BQK2R b KQkq - 0 5,Nc6,30,43,13,1
r1bqkbnr/pp3pp1/2np3p/2p1p3/2B1P3/2N2N1P/PPPP1PP1/R1BQK2R w KQkq - 1 6,O-O,45,41,-4,1
r1bqkbnr/pp3pp1/2np3p/2p1p3/2B1P3/2N2N1P/PPPP1PP1/R1BQ1RK1 b kq - 2 6,Be6,37,75,38,1
r2qkbnr/pp3pp1/2npb2p/2p1p3/2B1P3/2N2N1P/PPPP1PP1/R1BQ1RK1 w kq - 3 7,d3,71,56,-15,1
r2qkbnr/pp3pp1/2npb2p/2p1p3/2B1P3/2NP1N1P/PPP2PP1/R1BQ1RK1 b kq - 0 7,Nf6,58,54,-4,1
r2qkb1r/pp3pp1/2npbn1p/2p1p3/2B1P3/2NP1N1P/PPP2PP1/R1BQ1RK1 w kq - 1 8,Nd5,62,59,-3,1
r2qkb1r/pp3pp1/2npbn1p/2pNp3/2B1P3/3P1N1P/PPP2PP1/R1BQ1RK1 b kq - 2 8,a6,64,72,8,1
r2qkb1r/1p3pp1/p1npbn1p/2pNp3/2B1P3/3P1N1P/PPP2PP1/R1BQ1RK1 w kq - 0 9,a4,75,71,-4,1
r2qkb1r/1p3pp1/p1npbn1p/2pNp3/P1B1P3/3P1N1P/1PP2PP1/R1BQ1RK1 b kq - 0 9,Be7,68,71,3,1
r2qk2r/1p2bpp1/p1npbn1p/2pNp3/P1B1P3/3P1N1P/1PP2PP1/R1BQ1RK1 w kq - 1 10,Bd2,65,60,-5,1
r2qk2r/1p2bpp1/p1npbn1p/2pNp3/P1B1P3/3P1N1P/1PPB1PP1/R2Q1RK1 b kq - 2 10,Bxd5,54,58,4,1
r2qk2r/1p2bpp1/p1np1n1p/2pbp3/P1B1P3/3P1N1P/1PPB1PP1/R2Q1RK1 w kq - 0 11,exd5,55,50,-5,1
r2qk2r/1p2bpp1/p1np1n1p/2pPp3/P1B5/3P1N1P/1PPB1PP1/R2Q1RK1 b kq - 0 11,Nd4,51,48,-3,1
r2qk2r/1p2bpp1/p2p1n1p/2pPp3/P1Bn4/3P1N1P/1PPB1PP1/R2Q1RK1 w kq - 1 12,c3,61,21,-40,1
r2qk2r/1p2bpp1/p2p1n1p/2pPp3/P1Bn4/2PP1N1P/1P1B1PP1/R2Q1RK1 b kq - 0 12,Nf5,19,318,299,1
r2qk2r/1p2bpp1/p2p1n1p/2pPpn2/P1B5/2PP1N1P/1P1B1PP1/R2Q1RK1 w kq - 1 13,g4,254,311,57,1
r2qk2r/1p2bpp1/p2p1n1p/2pPpn2/P1B3P1/2PP1N1P/1P1B1P2/R2Q1RK1 b kq - 0 13,g6,300,335,35,1
r2qk2r/1p2bp2/p2p1npp/2pPpn2/P1B3P1/2PP1N1P/1P1B1P2/R2Q1RK1 w kq - 0 14,gxf5,334,316,-18,1
r2qk2r/1p2bp2/p2p1npp/2pPpP2/P1B5/2PP1N1P/1P1B1P2/R2Q1RK1 b kq - 0 14,gxf5,329,329,0,1
r2qk2r/1p2bp2/p2p1n1p/2pPpp2/P1B5/2PP1N1P/1P1B1P2/R2Q1RK1 w kq - 0 15,Kh2,307,314,7,1
r2qk2r/1p2bp2/p2p1n1p/2pPpp2/P1B5/2PP1N1P/1P1B1P1K/R2Q1R2 b kq - 1 15,h5,316,320,4,1
r2qk2r/1p2bp2/p2p1n2/2pPpp1p/P1B5/2PP1N1P/1P1B1P1K/R2Q1R2 w kq - 0 16,Rg1,340,305,-35,1
r2qk2r/1p2bp2/p2p1n2/2pPpp1p/P1B5/2PP1N1P/1P1B1P1K/R2Q2R1 b kq - 1 16,Ng4+,308,336,28,1
r2qk2r/1p2bp2/p2p4/2pPpp1p/P1B3n1/2PP1N1P/1P1B1P1K/R2Q2R1 w kq - 2 17,hxg4,297,234,-63,1
r2qk2r/1p2bp2/p2p4/2pPpp1p/P1B3P1/2PP1N2/1P1B1P1K/R2Q2R1 b kq - 0 17,hxg4+,239,237,-2,1
r2qk2r/1p2bp2/p2p4/2pPpp2/P1B3p1/2PP1N2/1P1B1P1K/R2Q2R1 w kq - 0 18,Kg2,247,231,-16,1
r2qk2r/1p2bp2/p2p4/2pPpp2/P1B3p1/2PP1N2/1P1B1PK1/R2Q2R1 b kq - 1 18,Rh3,228,327,99,1
r2qk3/1p2bp2/p2p4/2pPpp2/P1B3p1/2PP1N1r/1P1B1PK1/R2Q2R1 w q - 2 19,Ne1,297,219,-78,1
r2qk3/1p2bp2/p2p4/2pPpp2/P1B3p1/2PP3r/1P1B1PK1/R2QN1R1 b q - 3 19,Bh4,182,207,25,1
r2qk3/1p3p2/p2p4/2pPpp2/P1B3pb/2PP3r/1P1B1PK1/R2QN1R1 w q - 4 20,Kf1,210,216,6,1
r2qk3/1p3p2/p2p4/2pPpp2/P1B3pb/2PP3r/1P1B1P2/R2QNKR1 b q - 5 20,Rh2,211,222,11,1
r2qk3/1p3p2/p2p4/2pPpp2/P1B3pb/2PP4/1P1B1P1r/R2QNKR1 w q - 6 21,Ng2,220,213,-7,1
r2qk3/1p3p2/p2p4/2pPpp2/P1B3pb/2PP4/1P1B1PNr/R2Q1KR1 b q - 7 21,Qf6,255,237,-18,1
r3k3/1p3p2/p2p1q2/2pPpp2/P1B3pb/2PP4/1P1B1PNr/R2Q1KR1 w q - 8 22,Qe2,243,238,-5,1
r3k3/1p3p2/p2p1q2/2pPpp2/P1B3pb/2PP4/1P1BQPNr/R4KR1 b q - 9 22,O-O-O,235,235,0,1
2kr4/1p3p2/p2p1q2/2pPpp2/P1B3pb/2PP4/1P1BQPNr/R4KR1 w - - 10 23,Ke1,252,238,-14,1
2kr4/1p3p2/p2p1q2/2pPpp2/P1B3pb/2PP4/1P1BQPNr/R3K1R1 b - - 11 23,g3,246,260,14,1
2kr4/1p3p2/p2p1q2/2pPpp2/P1B4b/2PP2p1/1P1BQPNr/R3K1R1 w - - 0 24,f3,342,264,-78,1
2kr4/1p3p2/p2p1q2/2pPpp2/P1B4b/2PP1Pp1/1P1BQ1Nr/R3K1R1 b - - 0 24,e4,259,328,69,1
2kr4/1p3p2/p2p1q2/2pP1p2/P1B1p2b/2PP1Pp1/1P1BQ1Nr/R3K1R1 w - - 0 25,dxe4,322,326,4,1
2kr4/1p3p2/p2p1q2/2pP1p2/P1B1P2b/2P2Pp1/1P1BQ1Nr/R3K1R1 b - - 0 25,fxe4,327,343,16,1
2kr4/1p3p2/p2p1q2/2pP4/P1B1p2b/2P2Pp1/1P1BQ1Nr/R3K1R1 w - - 0 26,Qxe4,340,400,60,1
2kr4/1p3p2/p2p1q2/2pP4/P1B1Q2b/2P2Pp1/1P1B2Nr/R3K1R1 b - - 0 26,Rd7,375,450,75,1
2k5/1p1r1p2/p2p1q2/2pP4/P1B1Q2b/2P2Pp1/1P1B2Nr/R3K1R1 w - - 1 27,Kd1,435,450,15,1
2k5/1p1r1p2/p2p1q2/2pP4/P1B1Q2b/2P2Pp1/1P1B2Nr/R2K2R1 b - - 2 27,Re7,439,497,58,1
2k5/1p2rp2/p2p1q2/2pP4/P1B1Q2b/2P2Pp1/1P1B2Nr/R2K2R1 w - - 3 28,Qg4+,507,521,14,1
2k5/1p2rp2/p2p1q2/2pP4/P1B3Qb/2P2Pp1/1P1B2Nr/R2K2R1 b - - 4 28,Kc7,501,497,-4,1
8/1pk1rp2/p2p1q2/2pP4/P1B3Qb/2P2Pp1/1P1B2Nr/R2K2R1 w - - 5 29,Kc2,531,440,-91,1
8/1pk1rp2/p2p1q2/2pP4/P1B3Qb/2P2Pp1/1PKB2Nr/R5R1 b - - 6 29,b5,458,561,103,1
8/2k1rp2/p2p1q2/1ppP4/P1B3Qb/2P2Pp1/1PKB2Nr/R5R1 w - - 0 30,axb5,540,575,35,1
8/2k1rp2/p2p1q2/1PpP4/2B3Qb/2P2Pp1/1PKB2Nr/R5R1 b - - 0 30,axb5,587,631,44,1
8/2k1rp2/3p1q2/1ppP4/2B3Qb/2P2Pp1/1PKB2Nr/R5R1 w - - 0 31,Ra7+,628,574,-54,1
8/R1k1rp2/3p1q2/1ppP4/2B3Qb/2P2Pp1/1PKB2Nr/6R1 b - - 1 31,Kb6,779,766,-13,1
8/R3rp2/1k1p1q2/1ppP4/2B3Qb/2P2Pp1/1PKB2Nr/6R1 w - - 2 32,Qc8,760,770,10,1
2Q5/R3rp2/1k1p1q2/1ppP4/2B4b/2P2Pp1/1PKB2Nr/6R1 b - - 3 32,Rxa7,812,9998,9186,1
2Q5/r4p2/1k1p1q2/1ppP4/2B4b/2P2Pp1/1PKB2Nr/6R1 w - - 0 33,Qc6+,9998,9999,1,1
8/r4p2/1kQp1q2/1ppP4/2B4b/2P2Pp1/1PKB2Nr/6R1 b - - 1 33,Ka5,9999,9999,0,1
8/r4p2/2Qp1q2/kppP4/2B4b/2P2Pp1/1PKB2Nr/6R1 w - - 2 34,Ra1#,9999,10000,1,1
rnbqkbnr/pppppppp/8/8/8/8/PPPPPPPP/RNBQKBNR w KQkq - 0 1,e4,33,34,1,1
rnbqkbnr/pppppppp/8/8/4P3/8/PPPP1PPP/RNBQKBNR b KQkq - 0 1,e5,32,45,13,1
rnbqkbnr/pppp1ppp/8/4p3/4P3/8/PPPP1PPP/RNBQKBNR w KQkq - 0 2,d4,39,4,-35,1
rnbqkbnr/pppp1ppp/8/4p3/3PP3/8/PPP2PPP/RNBQKBNR b KQkq - 0 2,exd4,4,18,14,1
rnbqkbnr/pppp1ppp/8/8/3pP3/8/PPP2PPP/RNBQKBNR w KQkq - 0 3,c3,23,-63,-86,1
rnbqkbnr/pppp1ppp/8/8/3pP3/2P5/PP3PPP/RNBQKBNR b KQkq - 0 3,dxc3,-82,23,105,1
rnbqkbnr/pppp1ppp/8/8/4P3/2p5/PP3PPP/RNBQKBNR w KQkq - 0 4,Bc4,11,-86,-97,1
rnbqkbnr/pppp1ppp/8/8/2B1P3/2p5/PP3PPP/RNBQK1NR b KQkq - 1 4,cxb2,-89,-77,12,1
rnbqkbnr/pppp1ppp/8/8/2B1P3/8/Pp3PPP/RNBQK1NR w KQkq - 0 5,Bxb2,-72,-84,-12,1
rnbqkbnr/pppp1ppp/8/8/2B1P3/8/PB3PPP/RN1QK1NR b KQkq - 0 5,d5,-75,-62,13,1
rnbqkbnr/ppp2ppp/8/3p4/2B1P3/8/PB3PPP/RN1QK1NR w KQkq - 0 6,Bxd5,-61,-73,-12,1
rnbqkbnr/ppp2ppp/8/3B4/4P3/8/PB3PPP/RN1QK1NR b KQkq - 0 6,Nf6,-76,-58,18,1
rnbqkb1r/ppp2ppp/5n2/3B4/4P3/8/PB3PPP/RN1QK1NR w KQkq - 1 7,Bxf7+,-55,-357,-302,0
rnbqkb1r/ppp2Bpp/5n2/8/4P3/8/PB3PPP/RN1QK1NR b KQkq - 0 7,Kxf7,-324,-328,-4,1
rnbq1b1r/ppp2kpp/5n2/8/4P3/8/PB3PPP/RN1QK1NR w KQ - 0 8,Qxd8,-339,-510,-171,0
rnbQ1b1r/ppp2kpp/5n2/8/4P3/8/PB3PPP/RN2K1NR b KQ - 0 8,Bb4+,-10,-2,8,1
rnbQ3r/ppp2kpp/5n2/8/1b2P3/8/PB3PPP/RN2K1NR w KQ - 1 9,Qd2,10,-15,-25,1
rnb4r/ppp2kpp/5n2/8/1b2P3/8/PB1Q1PPP/RN2K1NR b KQ - 2 9,Bxd2+,-16,0,16,1
rnb4r/ppp2kpp/5n2/8/4P3/8/PB1b1PPP/RN2K1NR w KQ - 0 10,Nxd2,-4,-5,-1,1
rnb4r/ppp2kpp/5n2/8/4P3/8/PB1N1PPP/R3K1NR b KQ - 0 10,Nc6,0,13,13,1
r1b4r/ppp2kpp/2n2n2/8/4P3/8/PB1N1PPP/R3K1NR w KQ - 1 11,Bxf6,22,-73,-95,1
r1b4r/ppp2kpp/2n2B2/8/4P3/8/P2N1PPP/R3K1NR b KQ - 0 11,gxf6,-69,-80,-11,1
r1b4r/ppp2k1p/2n2p2/8/4P3/8/P2N1PPP/R3K1NR w KQ - 0 12,Ngf3,-89,-102,-13,1
r1b4r/ppp2k1p/2n2p2/8/4P3/5N2/P2N1PPP/R3K2R b KQ - 1 12,Re8,-103,-31,72,1
r1b1r3/ppp2k1p/2n2p2/8/4P3/5N2/P2N1PPP/R3K2R w KQ - 2 13,O-O,-40,-38,2,1
r1b1r3/ppp2k1p/2n2p2/8/4P3/5N2/P2N1PPP/R4RK1 b - - 3 13,Be6,-44,-40,4,1
r3r3/ppp2k1p/2n1bp2/8/4P3/5N2/P2N1PPP/R4RK1 w - - 4 14,Rac1,-34,-248,-214,0
r3r3/ppp2k1p/2n1bp2/8/4P3/5N2/P2N1PPP/2R2RK1 b - - 5 14,Rad8,-239,-80,159,1
3rr3/ppp2k1p/2n1bp2/8/4P3/5N2/P2N1PPP/2R2RK1 w - - 6 15,a3,-86,-115,-29,1
3rr3/ppp2k1p/2n1bp2/8/4P3/P4N2/3N1PPP/2R2RK1 b - - 0 15,Rd3,-107,-101,6,1
4r3/ppp2k1p/2n1bp2/8/4P3/P2r1N2/3N1PPP/2R2RK1 w - - 1 16,Nc4,-96,-180,-84,1
4r3/ppp2k1p/2n1bp2/8/2N1P3/P2r1N2/5PPP/2R2RK1 b - - 2 16,Bxc4,-195,-130,65,1
4r3/ppp2k1p/2n2p2/8/2b1P3/P2r1N2/5PPP/2R2RK1 w - - 0 17,Rxc4,-174,-149,25,1
4r3/ppp2k1p/2n2p2/8/2R1P3/P2r1N2/5PPP/5RK1 b - - 0 17,Rxa3,-156,-152,4,1
4r3/ppp2k1p/2n2p2/8/2R1P3/r4N2/5PPP/5RK1 w - - 0 18,Rb1,-175,-190,-15,1
4r3/ppp2k1p/2n2p2/8/2R1P3/r4N2/5PPP/1R4K1 b - - 1 18,Ne5,-204,218,422,1
4r3/ppp2k1p/5p2/4n3/2R1P3/r4N2/5PPP/1R4K1 w - - 2 19,Rxc7+,218,213,-5,1
4r3/ppR2k1p/5p2/4n3/4P3/r4N2/5PPP/1R4K1 b - - 0 19,Re7,223,210,-13,1
8/ppR1rk1p/5p2/4n3/4P3/r4N2/5PPP/1R4K1 w - - 1 20,Rxe7+,216,199,-17,1
8/pp2Rk1p/5p2/4n3/4P3/r4N2/5PPP/1R4K1 b - - 0 20,Kxe7,266,282,16,1
8/pp2k2p/5p2/4n3/4P3/r4N2/5PPP/1R4K1 w - - 0 21,Rxb7+,301,33,-268,0
8/pR2k2p/5p2/4n3/4P3/r4N2/5PPP/6K1 b - - 0 21,Kd6,25,29,4,1
8/pR5p/3k1p2/4n3/4P3/r4N2/5PPP/6K1 w - - 1 22,Rb1,26,-4,-30,1
8/p6p/3k1p2/4n3/4P3/r4N2/5PPP/1R4K1 b - - 2 22,Nxf3+,7,11,4,1
8/p6p/3k1p2/8/4P3/r4n2/5PPP/1R4K1 w - - 0 23,gxf3,11,3,-8,1
8/p6p/3k1p2/8/4P3/r4P2/5P1P/1R4K1 b - - 0 23,Rxf3,11,8,-3,1
8/p6p/3k1p2/8/4P3/5r2/5P1P/1R4K1 w - - 0 24,Ra1,2,9,7,1
8/p6p/3k1p2/8/4P3/5r2/5P1P/R5K1 b - - 1 24,Rf4,5,5,0,1
8/p6p/3k1p2/8/4Pr2/8/5P1P/R5K1 w - - 2 25,Rxa7,3,1,-2,1
8/R6p/3k1p2/8/4Pr2/8/5P1P/6K1 b - - 0 25,Rxe4,3,2,-1,1
8/R6p/3k1p2/8/4r3/8/5P1P/6K1 w - - 0 26,Rxh7,1,1,0,1
8/7R/3k1p2/8/4r3/8/5P1P/6K1 b - - 0 26,Ke5,-3,398,401,1
8/7R/5p2/4k3/4r3/8/5P1P/6K1 w - - 1 27,Kg2,465,13,-452,0
8/7R/5p2/4k3/4r3/8/5PKP/8 b - - 2 27,f5,6,490,484,1
8/7R/8/4kp2/4r3/8/5PKP/8 w - - 0 28,f3,606,16,-590,0
8/7R/8/4kp2/4r3/5P2/6KP/8 b - - 0 28,Re2+,15,14,-1,1
8/7R/8/4kp2/8/5P2/4r1KP/8 w - - 1 29,Kg3,18,16,-2,1
8/7R/8/4kp2/8/5PK1/4r2P/8 b - - 2 29,Rb2,13,13,0,1
8/7R/8/4kp2/8/5PK1/1r5P/8 w - - 3 30,Re7+,17,10,-7,1
8/4R3/8/4kp2/8/5PK1/1r5P/8 b - - 4 30,Kf6,10,9,-1,1
8/4R3/5k2/5p2/8/5PK1/1r5P/8 w - - 5 31,Re8,11,18,7,1
4R3/8/5k2/5p2/8/5PK1/1r5P/8 b - - 6 31,Rb3,14,20,6,1
4R3/8/5k2/5p2/8/1r3PK1/7P/8 w - - 7 32,h4,12,0,-12,1
4R3/8/5k2/5p2/7P/1r3PK1/8/8 b - - 0 32,Kg6,13,22,9,1
4R3/8/6k1/5p2/7P/1r3PK1/8/8 w - - 1 33,Rg8+,21,19,-2,1
6R1/8/6k1/5p2/7P/1r3PK1/8/8 b - - 2 33,Kf6,21,56,35,1
6R1/8/5k2/5p2/7P/1r3PK1/8/8 w - - 3 34,Ra8,23,14,-9,1
R7/8/5k2/5p2/7P/1r3PK1/8/8 b - - 4 34,Rb4,17,25,8,1
R7/8/5k2/5p2/1r5P/5PK1/8/8 w - - 5 35,Rg8,26,8,-18,1
6R1/8/5k2/5p2/1r5P/5PK1/8/8 b - - 6 35,Rc4,15,34,19,1
6R1/8/5k2/5p2/2r4P/5PK1/8/8 w - - 7 36,h5,17,16,-1,1
6R1/8/5k2/5p1P/2r5/5PK1/8/8 b - - 0 36,Ra4,24,27,3,1
6R1/8/5k2/5p1P/r7/5PK1/8/8 w - - 1 37,Rg6+,20,27,7,1
rnbqkbnr/pppppppp/8/8/8/8/PPPPPPPP/RNBQKBNR w KQkq - 0 1,d4,36,23,-13,1
rnbqkbnr/pppppppp/8/8/3P4/8/PPP1PPPP/RNBQKBNR b KQkq - 0 1,d6,27,48,21,1
rnbqkbnr/ppp1pppp/3p4/8/3P4/8/PPP1PPPP/RNBQKBNR w KQkq - 0 2,e3,47,27,-20,1
rnbqkbnr/ppp1pppp/3p4/8/3P4/4P3/PPP2PPP/RNBQKBNR b KQkq - 0 2,g6,33,39,6,1
rnbqkbnr/ppp1pp1p/3p2p1/8/3P4/4P3/PPP2PPP/RNBQKBNR w KQkq - 0 3,Bd3,42,21,-21,1
rnbqkbnr/ppp1pp1p/3p2p1/8/3P4/3BP3/PPP2PPP/RNBQK1NR b KQkq - 1 3,Bg7,28,32,4,1
rnbqk1nr/ppp1ppbp/3p2p1/8/3P4/3BP3/PPP2PPP/RNBQK1NR w KQkq - 2 4,Nd2,35,-16,-51,1
rnbqk1nr/ppp1ppbp/3p2p1/8/3P4/3BP3/PPPN1PPP/R1BQK1NR b KQkq - 3 4,Nf6,1,2,1,1
rnbqk2r/ppp1ppbp/3p1np1/8/3P4/3BP3/PPPN1PPP/R1BQK1NR w KQkq - 4 5,c3,-9,-17,-8,1
rnbqk2r/ppp1ppbp/3p1np1/8/3P4/2PBP3/PP1N1PPP/R1BQK1NR b KQkq - 0 5,e5,-13,-3,10,1
rnbqk2r/ppp2pbp/3p1np1/4p3/3P4/2PBP3/PP1N1PPP/R1BQK1NR w KQkq - 0 6,f4,-6,-104,-98,1
rnbqk2r/ppp2pbp/3p1np1/4p3/3P1P2/2PBP3/PP1N2PP/R1BQK1NR b KQkq - 0 6,e4,-91,107,198,1
rnbqk2r/ppp2pbp/3p1np1/8/3PpP2/2PBP3/PP1N2PP/R1BQK1NR w KQkq - 0 7,Nxe4,107,119,12,1
rnbqk2r/ppp2pbp/3p1np1/8/3PNP2/2PBP3/PP4PP/R1BQK1NR b KQkq - 0 7,Nxe4,107,119,12,1
rnbqk2r/ppp2pbp/3p2p1/8/3PnP2/2PBP3/PP4PP/R1BQK1NR w KQkq - 0 8,Bxe4,108,96,-12,1
rnbqk2r/ppp2pbp/3p2p1/8/3PBP2/2P1P3/PP4PP/R1BQK1NR b KQkq - 0 8,O-O,114,104,-10,1
rnbq1rk1/ppp2pbp/3p2p1/8/3PBP2/2P1P3/PP4PP/R1BQK1NR w KQ - 1 9,Nf3,95,90,-5,1
rnbq1rk1/ppp2pbp/3p2p1/8/3PBP2/2P1PN2/PP4PP/R1BQK2R b KQ - 2 9,Nd7,74,82,8,1
r1bq1rk1/pppn1pbp/3p2p1/8/3PBP2/2P1PN2/PP4PP/R1BQK2R w KQ - 3 10,O-O,84,70,-14,1
r1bq1rk1/pppn1pbp/3p2p1/8/3PBP2/2P1PN2/PP4PP/R1BQ1RK1 b - - 4 10,c6,82,144,62,1
r1bq1rk1/pp1n1pbp/2pp2p1/8/3PBP2/2P1PN2/PP4PP/R1BQ1RK1 w - - 0 11,Bc2,149,140,-9,1
r1bq1rk1/pp1n1pbp/2pp2p1/8/3P1P2/2P1PN2/PPB3PP/R1BQ1RK1 b - - 1 11,Nf6,141,229,88,1
r1bq1rk1/pp3pbp/2pp1np1/8/3P1P2/2P1PN2/PPB3PP/R1BQ1RK1 w - - 2 12,Bd2,232,76,-156,0
r1bq1rk1/pp3pbp/2pp1np1/8/3P1P2/2P1PN2/PPBB2PP/R2Q1RK1 b - - 3 12,Qb6,62,168,106,1
r1b2rk1/pp3pbp/1qpp1np1/8/3P1P2/2P1PN2/PPBB2PP/R2Q1RK1 w - - 4 13,b4,173,67,-106,0
r1b2rk1/pp3pbp/1qpp1np1/8/1P1P1P2/2P1PN2/P1BB2PP/R2Q1RK1 b - - 0 13,a5,96,139,43,1
r1b2rk1/1p3pbp/1qpp1np1/p7/1P1P1P2/2P1PN2/P1BB2PP/R2Q1RK1 w - - 0 14,a3,140,79,-61,1
r1b2rk1/1p3pbp/1qpp1np1/p7/1P1P1P2/P1P1PN2/2BB2PP/R2Q1RK1 b - - 0 14,Qb5,85,177,92,1
r1b2rk1/1p3pbp/2pp1np1/pq6/1P1P1P2/P1P1PN2/2BB2PP/R2Q1RK1 w - - 1 15,a4,154,112,-42,1
r1b2rk1/1p3pbp/2pp1np1/pq6/PP1P1P2/2P1PN2/2BB2PP/R2Q1RK1 b - - 0 15,Qh5,126,193,67,1
r1b2rk1/1p3pbp/2pp1np1/p6q/PP1P1P2/2P1PN2/2BB2PP/R2Q1RK1 w - - 1 16,h3,214,83,-131,0
r1b2rk1/1p3pbp/2pp1np1/p6q/PP1P1P2/2P1PN1P/2BB2P1/R2Q1RK1 b - - 0 16,Bf5,92,132,40,1
r4rk1/1p3pbp/2pp1np1/p4b1q/PP1P1P2/2P1PN1P/2BB2P1/R2Q1RK1 w - - 1 17,Qb1,119,34,-85,1
r4rk1/1p3pbp/2pp1np1/p4b1q/PP1P1P2/2P1PN1P/2BB2P1/RQ3RK1 b - - 2 17,Bxh3,53,347,294,1
r4rk1/1p3pbp/2pp1np1/p6q/PP1P1P2/2P1PN1b/2BB2P1/RQ3RK1 w - - 0 18,Bd1,295,-208,-503,0
r4rk1/1p3pbp/2pp1np1/p6q/PP1P1P2/2P1PN1b/3B2P1/RQ1B1RK1 b - - 1 18,Bf5,-178,-89,89,1
r4rk1/1p3pbp/2pp1np1/p4b1q/PP1P1P2/2P1PN2/3B2P1/RQ1B1RK1 w - - 2 19,Qc1,-91,-163,-72,1
r4rk1/1p3pbp/2pp1np1/p4b1q/PP1P1P2/2P1PN2/3B2P1/R1QB1RK1 b - - 3 19,Ng4,-180,-190,-10,1
r4rk1/1p3pbp/2pp2p1/p4b1q/PP1P1Pn1/2P1PN2/3B2P1/R1QB1RK1 w - - 4 20,Be2,-192,-273,-81,1
r4rk1/1p3pbp/2pp2p1/p4b1q/PP1P1Pn1/2P1PN2/3BB1P1/R1Q2RK1 b - - 5 20,Be4,-270,-284,-14,1
r4rk1/1p3pbp/2pp2p1/p6q/PP1PbPn1/2P1PN2/3BB1P1/R1Q2RK1 w - - 6 21,Rf2,-256,-326,-70,1
r4rk1/1p3pbp/2pp2p1/p6q/PP1PbPn1/2P1PN2/3BBRP1/R1Q3K1 b - - 7 21,Nxf2,-344,-319,25,1
r4rk1/1p3pbp/2pp2p1/p6q/PP1PbP2/2P1PN2/3BBnP1/R1Q3K1 w - - 0 22,Kxf2,-297,-304,-7,1
r4rk1/1p3pbp/2pp2p1/p6q/PP1PbP2/2P1PN2/3BBKP1/R1Q5 b - - 0 22,Bxf3,-304,-189,115,1
r4rk1/1p3pbp/2pp2p1/p6q/PP1P1P2/2P1Pb2/3BBKP1/R1Q5 w - - 0 23,Bxf3,-174,-169,5,1
r4rk1/1p3pbp/2pp2p1/p6q/PP1P1P2/2P1PB2/3B1KP1/R1Q5 b - - 0 23,Qf5,-192,-164,28,1
r4rk1/1p3pbp/2pp2p1/p4q2/PP1P1P2/2P1PB2/3B1KP1/R1Q5 w - - 1 24,e4,-156,-192,-36,1
r4rk1/1p3pbp/2pp2p1/p4q2/PP1PPP2/2P2B2/3B1KP1/R1Q5 b - - 0 24,Qd7,-191,-189,2,1
r4rk1/1p1q1pbp/2pp2p1/p7/PP1PPP2/2P2B2/3B1KP1/R1Q5 w - - 1 25,e5,-186,-277,-91,1
r4rk1/1p1q1pbp/2pp2p1/p3P3/PP1P1P2/2P2B2/3B1KP1/R1Q5 b - - 0 25,dxe5,-255,-287,-32,1
r4rk1/1p1q1pbp/2p3p1/p3p3/PP1P1P2/2P2B2/3B1KP1/R1Q5 w - - 0 26,fxe5,-288,-309,-21,1
r4rk1/1p1q1pbp/2p3p1/p3P3/PP1P4/2P2B2/3B1KP1/R1Q5 b - - 0 26,f6,-330,-238,92,1
r4rk1/1p1q2bp/2p2pp1/p3P3/PP1P4/2P2B2/3B1KP1/R1Q5 w - - 0 27,exf6,-252,-278,-26,1
r4rk1/1p1q2bp/2p2Pp1/p7/PP1P4/2P2B2/3B1KP1/R1Q5 b - - 0 27,Rxf6,-264,-252,12,1
r5k1/1p1q2bp/2p2rp1/p7/PP1P4/2P2B2/3B1KP1/R1Q5 w - - 0 28,Bg5,-255,-341,-86,1
r5k1/1p1q2bp/2p2rp1/p5B1/PP1P4/2P2B2/5KP1/R1Q5 b - - 1 28,Rf5,-286,-298,-12,1
r5k1/1p1q2bp/2p3p1/p4rB1/PP1P4/2P2B2/5KP1/R1Q5 w - - 2 29,Kg1,-307,-384,-77,1
r5k1/1p1q2bp/2p3p1/p4rB1/PP1P4/2P2B2/6P1/R1Q3K1 b - - 3 29,Re8,-412,-283,129,1
4r1k1/1p1q2bp/2p3p1/p4rB1/PP1P4/2P2B2/6P1/R1Q3K1 w - - 4 30,Bg4,-292,-353,-61,1
4r1k1/1p1q2bp/2p3p1/p4rB1/PP1P2B1/2P5/6P1/R1Q3K1 b - - 5 30,Bxd4+,-305,-241,64,1
4r1k1/1p1q3p/2p3p1/p4rB1/PP1b2B1/2P5/6P1/R1Q3K1 w - - 0 31,Kh1,-327,-332,-5,1
4r1k1/1p1q3p/2p3p1/p4rB1/PP1b2B1/2P5/6P1/R1Q4K b - - 1 31,Be3,-349,294,643,1
4r1k1/1p1q3p/2p3p1/p4rB1/PP4B1/2P1b3/6P1/R1Q4K w - - 2 32,Bxe3,317,334,17,1
4r1k1/1p1q3p/2p3p1/p4r2/PP4B1/2P1B3/6P1/R1Q4K b - - 0 32,Rxe3,361,469,108,1
6k1/1p1q3p/2p3p1/p4r2/PP4B1/2P1r3/6P1/R1Q4K w - - 0 33,Qxe3,498,551,53,1
6k1/1p1q3p/2p3p1/p4r2/PP4B1/2P1Q3/6P1/R6K b - - 0 33,Re5,511,572,61,1
6k1/1p1q3p/2p3p1/p3r3/PP4B1/2P1Q3/6P1/R6K w - - 1 34,Qxe5,595,561,-34,1
6k1/1p1q3p/2p3p1/p3Q3/PP4B1/2P5/6P1/R6K b - - 0 34,Qxg4,603,610,7,1
6k1/1p5p/2p3p1/p3Q3/PP4q1/2P5/6P1/R6K w - - 0 35,Re1,605,544,-61,1
6k1/1p5p/2p3p1/p3Q3/PP4q1/2P5/6P1/4R2K b - - 1 35,Qh5+,576,705,129,1
6k1/1p5p/2p3p1/p3Q2q/PP6/2P5/6P1/4R2K w - - 2 36,Qxh5,753,729,-24,1
rnbqkbnr/pppppppp/8/8/8/8/PPPPPPPP/RNBQKBNR w KQkq - 0 1,e4,28,29,1,1
rnbqkbnr/pppppppp/8/8/4P3/8/PPPP1PPP/RNBQKBNR b KQkq - 0 1,e6,32,45,13,1
rnbqkbnr/pppp1ppp/4p3/8/4P3/8/PPPP1PPP/RNBQKBNR w KQkq - 0 2,Nf3,70,33,-37,1
rnbqkbnr/pppp1ppp/4p3/8/4P3/5N2/PPPP1PPP/RNBQKB1R b KQkq - 1 2,b6,30,77,47,1
rnbqkbnr/p1pp1ppp/1p2p3/8/4P3/5N2/PPPP1PPP/RNBQKB1R w KQkq - 0 3,b3,80,12,-68,1
rnbqkbnr/p1pp1ppp/1p2p3/8/4P3/1P3N2/P1PP1PPP/RNBQKB1R b KQkq - 0 3,Bb7,27,25,-2,1
rn1qkbnr/pbpp1ppp/1p2p3/8/4P3/1P3N2/P1PP1PPP/RNBQKB1R w KQkq - 1 4,Bd3,25,-18,-43,1
rn1qkbnr/pbpp1ppp/1p2p3/8/4P3/1P1B1N2/P1PP1PPP/RNBQK2R b KQkq - 2 4,g6,-24,-17,7,1
rn1qkbnr/pbpp1p1p/1p2p1p1/8/4P3/1P1B1N2/P1PP1PPP/RNBQK2R w KQkq - 0 5,Bb2,-21,-26,-5,1
rn1qkbnr/pbpp1p1p/1p2p1p1/8/4P3/1P1B1N2/PBPP1PPP/RN1QK2R b KQkq - 1 5,Nf6,-25,-23,2,1
rn1qkb1r/pbpp1p1p/1p2pnp1/8/4P3/1P1B1N2/PBPP1PPP/RN1QK2R w KQkq - 2 6,e5,-25,-38,-13,1
rn1qkb1r/pbpp1p1p/1p2pnp1/4P3/8/1P1B1N2/PBPP1PPP/RN1QK2R b KQkq - 0 6,Nd5,-36,66,102,1
rn1qkb1r/pbpp1p1p/1p2p1p1/3nP3/8/1P1B1N2/PBPP1PPP/RN1QK2R w KQkq - 1 7,Be4,66,60,-6,1
rn1qkb1r/pbpp1p1p/1p2p1p1/3nP3/4B3/1P3N2/PBPP1PPP/RN1QK2R b KQkq - 2 7,c6,57,82,25,1
rn1qkb1r/pb1p1p1p/1pp1p1p1/3nP3/4B3/1P3N2/PBPP1PPP/RN1QK2R w KQkq - 0 8,O-O,112,34,-78,1
rn1qkb1r/pb1p1p1p/1pp1p1p1/3nP3/4B3/1P3N2/PBPP1PPP/RN1Q1RK1 b kq - 1 8,Bg7,45,82,37,1
rn1qk2r/pb1p1pbp/1pp1p1p1/3nP3/4B3/1P3N2/PBPP1PPP/RN1Q1RK1 w kq - 2 9,c4,82,82,0,1
rn1qk2r/pb1p1pbp/1pp1p1p1/3nP3/2P1B3/1P3N2/PB1P1PPP/RN1Q1RK1 b kq - 0 9,Ne7,77,119,42,1
rn1qk2r/pb1pnpbp/1pp1p1p1/4P3/2P1B3/1P3N2/PB1P1PPP/RN1Q1RK1 w kq - 1 10,d4,112,106,-6,1
rn1qk2r/pb1pnpbp/1pp1p1p1/4P3/2PPB3/1P3N2/PB3PPP/RN1Q1RK1 b kq - 0 10,Nf5,88,197,109,1
rn1qk2r/pb1p1pbp/1pp1p1p1/4Pn2/2PPB3/1P3N2/PB3PPP/RN1Q1RK1 w kq - 1 11,d5,216,89,-127,0
rn1qk2r/pb1p1pbp/1pp1p1p1/3PPn2/2P1B3/1P3N2/PB3PPP/RN1Q1RK1 b kq - 0 11,cxd5,96,123,27,1
rn1qk2r/pb1p1pbp/1p2p1p1/3pPn2/2P1B3/1P3N2/PB3PPP/RN1Q1RK1 w kq - 0 12,cxd5,92,81,-11,1
rn1qk2r/pb1p1pbp/1p2p1p1/3PPn2/4B3/1P3N2/PB3PPP/RN1Q1RK1 b kq - 0 12,exd5,66,253,187,1
rn1qk2r/pb1p1pbp/1p4p1/3pPn2/4B3/1P3N2/PB3PPP/RN1Q1RK1 w kq - 0 13,Bxd5,260,152,-108,0
rn1qk2r/pb1p1pbp/1p4p1/3BPn2/8/1P3N2/PB3PPP/RN1Q1RK1 b kq - 0 13,Bxd5,196,203,7,1
rn1qk2r/p2p1pbp/1p4p1/3bPn2/8/1P3N2/PB3PPP/RN1Q1RK1 w kq - 0 14,Qxd5,202,168,-34,1
rn1qk2r/p2p1pbp/1p4p1/3QPn2/8/1P3N2/PB3PPP/RN3RK1 b kq - 0 14,Nc6,168,214,46,1
r2qk2r/p2p1pbp/1pn3p1/3QPn2/8/1P3N2/PB3PPP/RN3RK1 w kq - 1 15,Rd1,209,172,-37,1
r2qk2r/p2p1pbp/1pn3p1/3QPn2/8/1P3N2/PB3PPP/RN1R2K1 b kq - 2 15,O-O,171,154,-17,1
r2q1rk1/p2p1pbp/1pn3p1/3QPn2/8/1P3N2/PB3PPP/RN1R2K1 w - - 3 16,Qxd7,167,34,-133,0
r2q1rk1/p2Q1pbp/1pn3p1/4Pn2/8/1P3N2/PB3PPP/RN1R2K1 b - - 0 16,Qxd7,36,39,3,1
r4rk1/p2q1pbp/1pn3p1/4Pn2/8/1P3N2/PB3PPP/RN1R2K1 w - - 0 17,Rxd7,45,27,-18,1
r4rk1/p2R1pbp/1pn3p1/4Pn2/8/1P3N2/PB3PPP/RN4K1 b - - 0 17,Rfe8,32,31,-1,1
r3r1k1/p2R1pbp/1pn3p1/4Pn2/8/1P3N2/PB3PPP/RN4K1 w - - 1 18,Rd5,33,23,-10,1
r3r1k1/p4pbp/1pn3p1/3RPn2/8/1P3N2/PB3PPP/RN4K1 b - - 2 18,Nb4,20,11,-9,1
r3r1k1/p4pbp/1p4p1/3RPn2/1n6/1P3N2/PB3PPP/RN4K1 w - - 3 19,Rd2,18,14,-4,1
r3r1k1/p4pbp/1p4p1/4Pn2/1n6/1P3N2/PB1R1PPP/RN4K1 b - - 4 19,Rad8,21,49,28,1
3rr1k1/p4pbp/1p4p1/4Pn2/1n6/1P3N2/PB1R1PPP/RN4K1 w - - 5 20,a3,35,-168,-203,0
3rr1k1/p4pbp/1p4p1/4Pn2/1n6/PP3N2/1B1R1PPP/RN4K1 b - - 0 20,Rxd2,-207,32,239,1
4r1k1/p4pbp/1p4p1/4Pn2/1n6/PP3N2/1B1r1PPP/RN4K1 w - - 0 21,Nbxd2,31,22,-9,1
4r1k1/p4pbp/1p4p1/4Pn2/1n6/PP3N2/1B1N1PPP/R5K1 b - - 0 21,Nc2,18,292,274,1
4r1k1/p4pbp/1p4p1/4Pn2/8/PP3N2/1BnN1PPP/R5K1 w - - 1 22,Rc1,360,374,14,1
4r1k1/p4pbp/1p4p1/4Pn2/8/PP3N2/1BnN1PPP/2R3K1 b - - 2 22,Rc8,335,387,52,1
2r3k1/p4pbp/1p4p1/4Pn2/8/PP3N2/1BnN1PPP/2R3K1 w - - 3 23,Ne1,382,314,-68,1
2r3k1/p4pbp/1p4p1/4Pn2/8/PP6/1BnN1PPP/2R1N1K1 b - - 4 23,Bh6,289,275,-14,1
2r3k1/p4p1p/1p4pb/4Pn2/8/PP6/1BnN1PPP/2R1N1K1 w - - 5 24,Rxc2,245,247,2,1
2r3k1/p4p1p/1p4pb/4Pn2/8/PP6/1BRN1PPP/4N1K1 b - - 0 24,Rxc2,249,263,14,1
6k1/p4p1p/1p4pb/4Pn2/8/PP6/1BrN1PPP/4N1K1 w - - 0 25,Nxc2,280,257,-23,1
6k1/p4p1p/1p4pb/4Pn2/8/PP6/1BNN1PPP/6K1 b - - 0 25,Bxd2,264,265,1,1
6k1/p4p1p/1p4p1/4Pn2/8/PP6/1BNb1PPP/6K1 w - - 0 26,Nd4,266,60,-206,0
6k1/p4p1p/1p4p1/4Pn2/3N4/PP6/1B1b1PPP/6K1 b - - 1 26,Nxd4,35,113,78,1
6k1/p4p1p/1p4p1/4P3/3n4/PP6/1B1b1PPP/6K1 w - - 0 27,Bxd4,120,137,17,1
6k1/p4p1p/1p4p1/4P3/3B4/PP6/3b1PPP/6K1 b - - 0 27,Kf8,109,114,5,1
5k2/p4p1p/1p4p1/4P3/3B4/PP6/3b1PPP/6K1 w - - 1 28,Kf1,109,119,10,1
5k2/p4p1p/1p4p1/4P3/3B4/PP6/3b1PPP/5K2 b - - 2 28,Ke7,116,100,-16,1
8/p3kp1p/1p4p1/4P3/3B4/PP6/3b1PPP/5K2 w - - 3 29,Ke2,107,90,-17,1
8/p3kp1p/1p4p1/4P3/3B4/PP6/3bKPPP/8 b - - 4 29,Bh6,103,245,142,1
8/p3kp1p/1p4pb/4P3/3B4/PP6/4KPPP/8 w - - 5 30,Kd3,248,251,3,1
8/p3kp1p/1p4pb/4P3/3B4/PP1K4/5PPP/8 b - - 6 30,Ke6,252,266,14,1
8/p4p1p/1p2k1pb/4P3/3B4/PP1K4/5PPP/8 w - - 7 31,g3,270,62,-208,0
8/p4p1p/1p2k1pb/4P3/3B4/PP1K2P1/5P1P/8 b - - 0 31,Kd5,53,57,4,1
8/p4p1p/1p4pb/3kP3/3B4/PP1K2P1/5P1P/8 w - - 1 32,Bb2,64,36,-28,1
8/p4p1p/1p4pb/3kP3/8/PP1K2P1/1B3P1P/8 b - - 2 32,Bg5,32,38,6,1
8/p4p1p/1p4p1/3kP1b1/8/PP1K2P1/1B3P1P/8 w - - 3 33,f4,45,18,-27,1
8/p4p1p/1p4p1/3kP1b1/5P2/PP1K2P1/1B5P/8 b - - 0 33,Be7,23,18,-5,1
8/p3bp1p/1p4p1/3kP3/5P2/PP1K2P1/1B5P/8 w - - 1 34,g4,22,21,-1,1
8/p3bp1p/1p4p1/3kP3/5PP1/PP1K4/1B5P/8 b - - 0 34,h6,20,49,29,1
8/p3bp2/1p4pp/3kP3/5PP1/PP1K4/1B5P/8 w - - 0 35,f5,30,21,-9,1
8/p3bp2/1p4pp/3kPP2/6P1/PP1K4/1B5P/8 b - - 0 35,gxf5,24,41,17,1
8/p3bp2/1p5p/3kPp2/6P1/PP1K4/1B5P/8 w - - 0 36,gxf5,24,26,2,1
8/p3bp2/1p5p/3kPP2/8/PP1K4/1B5P/8 b - - 0 36,Bc5,13,149,136,1
8/p4p2/1p5p/2bkPP2/8/PP1K4/1B5P/8 w - - 1 37,h4,49,-70,-119,0
8/p4p2/1p5p/2bkPP2/7P/PP1K4/1B6/8 b - - 0 37,h5,-22,-16,6,1
8/p4p2/1p6/2bkPP1p/7P/PP1K4/1B6/8 w - - 0 38,e6,-7,0,7,1
8/p4p2/1p2P3/2bk1P1p/7P/PP1K4/1B6/8 b - - 0 38,fxe6,0,0,0,1
8/p7/1p2p3/2bk1P1p/7P/PP1K4/1B6/8 w - - 0 39,fxe6,0,-231,-231,0
8/p7/1p2P3/2bk3p/7P/PP1K4/1B6/8 b - - 0 39,Kxe6,-265,-259,6,1
8/p7/1p2k3/2b4p/7P/PP1K4/1B6/8 w - - 0 40,Ke4,-266,-252,14,1
8/p7/1p2k3/2b4p/4K2P/PP6/1B6/8 b - - 1 40,Bf2,-231,-247,-16,1
8/p7/1p2k3/7p/4K2P/PP6/1B3b2/8 w - - 2 41,Bd4,-259,-478,-219,0
8/p7/1p2k3/7p/3BK2P/PP6/5b2/8 b - - 3 41,Bxh4,-350,-278,72,1
8/p7/1p2k3/7p/3BK2b/PP6/8/8 w - - 0 42,a4,-282,-291,-9,1
8/p7/1p2k3/7p/P2BK2b/1P6/8/8 b - - 0 42,Bg3,-305,-126,179,1
8/p7/1p2k3/7p/P2BK3/1P4b1/8/8 w - - 1 43,a5,-158,-177,-19,1
8/p7/1p2k3/P6p/3BK3/1P4b1/8/8 b - - 0 43,h4,-166,-34,132,1
8/p7/1p2k3/P7/3BK2p/1P4b1/8/8 w - - 0 44,axb6,-19,-21,-2,1
8/p7/1P2k3/8/3BK2p/1P4b1/8/8 b - - 0 44,axb6,-33,-18,15,1
8/8/1p2k3/8/3BK2p/1P4b1/8/8 w - - 0 45,Bxb6,-17,-18,-1,1
8/8/1B2k3/8/4K2p/1P4b1/8/8 b - - 0 45,h3,-17,-14,3,1
8/8/1B2k3/8/4K3/1P4bp/8/8 w - - 0 46,Kf3,-16,-14,2,1
8/8/1B2k3/8/8/1P3Kbp/8/8 b - - 1 46,Bd6,-15,-14,1,1
8/8/1B1bk3/8/8/1P3K1p/8/8 w - - 2 47,Bc5,-15,-25,-10,1
rnbqkbnr/pppppppp/8/8/8/8/PPPPPPPP/RNBQKBNR w KQkq - 0 1,d4,20,13,-7,1
rnbqkbnr/pppppppp/8/8/3P4/8/PPP1PPPP/RNBQKBNR b KQkq - 0 1,d5,17,28,11,1
rnbqkbnr/ppp1pppp/8/3p4/3P4/8/PPP1PPPP/RNBQKBNR w KQkq - 0 2,c4,27,29,2,1
rnbqkbnr/ppp1pppp/8/3p4/2PP4/8/PP2PPPP/RNBQKBNR b KQkq - 0 2,dxc4,20,60,40,1
rnbqkbnr/ppp1pppp/8/8/2pP4/8/PP2PPPP/RNBQKBNR w KQkq - 0 3,e4,36,28,-8,1
rnbqkbnr/ppp1pppp/8/8/2pPP3/8/PP3PPP/RNBQKBNR b KQkq - 0 3,e6,32,63,31,1
rnbqkbnr/ppp2ppp/4p3/8/2pPP3/8/PP3PPP/RNBQKBNR w KQkq - 0 4,Bxc4,47,43,-4,1
rnbqkbnr/ppp2ppp/4p3/8/2BPP3/8/PP3PPP/RNBQK1NR b KQkq - 0 4,Bb4+,44,101,57,1
rnbqk1nr/ppp2ppp/4p3/8/1bBPP3/8/PP3PPP/RNBQK1NR w KQkq - 1 5,Nc3,90,78,-12,1
rnbqk1nr/ppp2ppp/4p3/8/1bBPP3/2N5/PP3PPP/R1BQK1NR b KQkq - 2 5,Bxc3+,81,155,74,1
rnbqk1nr/ppp2ppp/4p3/8/2BPP3/2b5/PP3PPP/R1BQK1NR w KQkq - 0 6,bxc3,157,153,-4,1
rnbqk1nr/ppp2ppp/4p3/8/2BPP3/2P5/P4PPP/R1BQK1NR b KQkq - 0 6,Nf6,159,258,99,1
rnbqk2r/ppp2ppp/4pn2/8/2BPP3/2P5/P4PPP/R1BQK1NR w KQkq - 1 7,e5,241,223,-18,1
rnbqk2r/ppp2ppp/4pn2/4P3/2BP4/2P5/P4PPP/R1BQK1NR b KQkq - 0 7,Ne4,243,338,95,1
rnbqk2r/ppp2ppp/4p3/4P3/2BPn3/2P5/P4PPP/R1BQK1NR w KQkq - 1 8,Bd2,315,53,-262,0
rnbqk2r/ppp2ppp/4p3/4P3/2BPn3/2P5/P2B1PPP/R2QK1NR b KQkq - 2 8,Qf6,44,745,701,1
rnb1k2r/ppp2ppp/4pq2/4P3/2BPn3/2P5/P2B1PPP/R2QK1NR w KQkq - 3 9,Nf3,776,151,-625,0
rnb1k2r/ppp2ppp/4pq2/4P3/2BPn3/2P2N2/P2B1PPP/R2QK2R b KQkq - 4 9,Qf5,156,240,84,1
rnb1k2r/ppp2ppp/4p3/4Pq2/2BPn3/2P2N2/P2B1PPP/R2QK2R w KQkq - 5 10,O-O,233,216,-17,1
rnb1k2r/ppp2ppp/4p3/4Pq2/2BPn3/2P2N2/P2B1PPP/R2Q1RK1 b kq - 6 10,a6,232,575,343,1
rnb1k2r/1pp2ppp/p3p3/4Pq2/2BPn3/2P2N2/P2B1PPP/R2Q1RK1 w kq - 0 11,Bd3,473,275,-198,0
rnb1k2r/1pp2ppp/p3p3/4Pq2/3Pn3/2PB1N2/P2B1PPP/R2Q1RK1 b kq - 1 11,Bd7,292,513,221,1
rn2k2r/1ppb1ppp/p3p3/4Pq2/3Pn3/2PB1N2/P2B1PPP/R2Q1RK1 w kq - 2 12,Re1,570,280,-290,0
rn2k2r/1ppb1ppp/p3p3/4Pq2/3Pn3/2PB1N2/P2B1PPP/R2QR1K1 b kq - 3 12,Bc6,320,529,209,1
rn2k2r/1pp2ppp/p1b1p3/4Pq2/3Pn3/2PB1N2/P2B1PPP/R2QR1K1 w kq - 4 13,Qc2,531,524,-7,1
rn2k2r/1pp2ppp/p1b1p3/4Pq2/3Pn3/2PB1N2/P1QB1PPP/R3R1K1 b kq - 5 13,Qg6,540,632,92,1
rn2k2r/1pp2ppp/p1b1p1q1/4P3/3Pn3/2PB1N2/P1QB1PPP/R3R1K1 w kq - 6 14,Bxe4,633,582,-51,1
rn2k2r/1pp2ppp/p1b1p1q1/4P3/3PB3/2P2N2/P1QB1PPP/R3R1K1 b kq - 0 14,Bxe4,583,588,5,1
rn2k2r/1pp2ppp/p3p1q1/4P3/3Pb3/2P2N2/P1QB1PPP/R3R1K1 w kq - 0 15,Qxe4,592,583,-9,1
rn2k2r/1pp2ppp/p3p1q1/4P3/3PQ3/2P2N2/P2B1PPP/R3R1K1 b kq - 0 15,c6,580,678,98,1
rn2k2r/1p3ppp/p1p1p1q1/4P3/3PQ3/2P2N2/P2B1PPP/R3R1K1 w kq - 0 16,Rab1,657,566,-91,1
rn2k2r/1p3ppp/p1p1p1q1/4P3/3PQ3/2P2N2/P2B1PPP/1R2R1K1 b kq - 1 16,f5,577,660,83,1
rn2k2r/1p4pp/p1p1p1q1/4Pp2/3PQ3/2P2N2/P2B1PPP/1R2R1K1 w kq f6 0 17,exf6,652,655,3,1
rn2k2r/1p4pp/p1p1pPq1/8/3PQ3/2P2N2/P2B1PPP/1R2R1K1 b kq - 0 17,Qxe4,721,648,-73,1
rn2k2r/1p4pp/p1p1pP2/8/3Pq3/2P2N2/P2B1PPP/1R2R1K1 w kq - 0 18,Rxe4,653,665,12,1
rn2k2r/1p4pp/p1p1pP2/8/3PR3/2P2N2/P2B1PPP/1R4K1 b kq - 0 18,gxf6,689,726,37,1
rn2k2r/1p5p/p1p1pp2/8/3PR3/2P2N2/P2B1PPP/1R4K1 w kq - 0 19,Rxe6+,719,637,-82,1
rn2k2r/1p5p/p1p1Rp2/8/3P4/2P2N2/P2B1PPP/1R4K1 b kq - 0 19,Kf7,631,645,14,1
rn5r/1p3k1p/p1p1Rp2/8/3P4/2P2N2/P2B1PPP/1R4K1 w - - 1 20,Rbe1,646,610,-36,1
rn5r/1p3k1p/p1p1Rp2/8/3P4/2P2N2/P2B1PPP/4R1K1 b - - 2 20,Kg6,681,9994,9313,1
rn5r/1p5p/p1p1Rpk1/8/3P4/2P2N2/P2B1PPP/4R1K1 w - - 3 21,Ne5+,9994,727,-9267,0
rn5r/1p5p/p1p1Rpk1/4N3/3P4/2P5/P2B1PPP/4R1K1 b - - 4 21,Kf5,716,801,85,1
rn5r/1p5p/p1p1Rp2/4Nk2/3P4/2P5/P2B1PPP/4R1K1 w - - 5 22,Nf3,933,771,-162,0
rn5r/1p5p/p1p1Rp2/5k2/3P4/2P2N2/P2B1PPP/4R1K1 b - - 6 22,Nd7,823,818,-5,1
r6r/1p1n3p/p1p1Rp2/5k2/3P4/2P2N2/P2B1PPP/4R1K1 w - - 7 23,Nh4+,879,754,-125,0
r6r/1p1n3p/p1p1Rp2/5k2/3P3N/2P5/P2B1PPP/4R1K1 b - - 8 23,Kg4,741,842,101,1
r6r/1p1n3p/p1p1Rp2/8/3P2kN/2P5/P2B1PPP/4R1K1 w - - 9 24,R6e4+,837,738,-99,1
r6r/1p1n3p/p1p2p2/8/3PR1kN/2P5/P2B1PPP/4R1K1 b - - 10 24,Kh5,782,793,11,1
r6r/1p1n3p/p1p2p2/7k/3PR2N/2P5/P2B1PPP/4R1K1 w - - 11 25,Nf5,762,715,-47,1
r6r/1p1n3p/p1p2p2/5N1k/3PR3/2P5/P2B1PPP/4R1K1 b - - 12 25,Kg6,669,753,84,1
r6r/1p1n3p/p1p2pk1/5N2/3PR3/2P5/P2B1PPP/4R1K1 w - - 13 26,Ne7+,758,678,-80,1
r6r/1p1nN2p/p1p2pk1/8/3PR3/2P5/P2B1PPP/4R1K1 b - - 14 26,Kf7,673,709,36,1
r6r/1p1nNk1p/p1p2p2/8/3PR3/2P5/P2B1PPP/4R1K1 w - - 15 27,f4,737,550,-187,0
r6r/1p1nNk1p/p1p2p2/8/3PRP2/2P5/P2B2PP/4R1K1 b - - 0 27,Rhe8,544,571,27,1
r3r3/1p1nNk1p/p1p2p2/8/3PRP2/2P5/P2B2PP/4R1K1 w - - 1 28,f5,566,481,-85,1
r3r3/1p1nNk1p/p1p2p2/5P2/3PR3/2P5/P2B2PP/4R1K1 b - - 0 28,Nb6,503,489,-14,1
r3r3/1p2Nk1p/pnp2p2/5P2/3PR3/2P5/P2B2PP/4R1K1 w - - 1 29,Bc1,503,479,-24,1
r3r3/1p2Nk1p/pnp2p2/5P2/3PR3/2P5/P5PP/2B1R1K1 b - - 2 29,Nc4,456,562,106,1
r3r3/1p2Nk1p/p1p2p2/5P2/2nPR3/2P5/P5PP/2B1R1K1 w - - 3 30,d5,553,417,-136,0
r3r3/1p2Nk1p/p1p2p2/3P1P2/2n1R3/2P5/P5PP/2B1R1K1 b - - 0 30,Nd6,420,504,84,1
r3r3/1p2Nk1p/p1pn1p2/3P1P2/4R3/2P5/P5PP/2B1R1K1 w - - 1 31,R4e2,541,477,-64,1
r3r3/1p2Nk1p/p1pn1p2/3P1P2/8/2P5/P3R1PP/2B1R1K1 b - - 2 31,c5,506,489,-17,1
r3r3/1p2Nk1p/p2n1p2/2pP1P2/8/2P5/P3R1PP/2B1R1K1 w - - 0 32,Bf4,512,561,49,1
r3r3/1p2Nk1p/p2n1p2/2pP1P2/5B2/2P5/P3R1PP/4R1K1 b - - 1 32,Nb5,536,552,16,1
r3r3/1p2Nk1p/p4p2/1npP1P2/5B2/2P5/P3R1PP/4R1K1 w - - 2 33,d6,566,547,-19,1
r3r3/1p2Nk1p/p2P1p2/1np2P2/5B2/2P5/P3R1PP/4R1K1 b - - 0 33,Rad8,604,594,-10,1
3rr3/1p2Nk1p/p2P1p2/1np2P2/5B2/2P5/P3R1PP/4R1K1 w - - 1 34,Nd5,595,601,6,1
3rr3/1p3k1p/p2P1p2/1npN1P2/5B2/2P5/P3R1PP/4R1K1 b - - 2 34,Rxe2,531,568,37,1
3r4/1p3k1p/p2P1p2/1npN1P2/5B2/2P5/P3r1PP/4R1K1 w - - 0 35,Rxe2,592,598,6,1
3r4/1p3k1p/p2P1p2/1npN1P2/5B2/2P5/P3R1PP/6K1 b - - 0 35,Nxd6,626,627,1,1
3r4/1p3k1p/p2n1p2/2pN1P2/5B2/2P5/P3R1PP/6K1 w - - 0 36,Re7+,623,598,-25,1
3r4/1p2Rk1p/p2n1p2/2pN1P2/5B2/2P5/P5PP/6K1 b - - 1 36,Kf8,594,9997,9403,1
3r1k2/1p2R2p/p2n1p2/2pN1P2/5B2/2P5/P5PP/6K1 w - - 2 37,Bh6+,9997,9998,1,1
3r1k2/1p2R2p/p2n1p1B/2pN1P2/8/2P5/P5PP/6K1 b - - 3 37,Kg8,9998,9998,0,1
3r2k1/1p2R2p/p2n1p1B/2pN1P2/8/2P5/P5PP/6K1 w - - 4 38,Nxf6+,9998,9999,1,1
3r2k1/1p2R2p/p2n1N1B/2p2P2/8/2P5/P5PP/6K1 b - - 0 38,Kh8,9999,9999,0,1
3r3k/1p2R2p/p2n1N1B/2p2P2/8/2P5/P5PP/6K1 w - - 1 39,Bg7#,9999,10000,1,1
rnbqkbnr/pppppppp/8/8/8/8/PPPPPPPP/RNBQKBNR w KQkq - 0 1,e4,29,27,-2,1
rnbqkbnr/pppppppp/8/8/4P3/8/PPPP1PPP/RNBQKBNR b KQkq - 0 1,e6,29,41,12,1
rnbqkbnr/pppp1ppp/4p3/8/4P3/8/PPPP1PPP/RNBQKBNR w KQkq - 0 2,e5,71,-15,-86,1
rnbqkbnr/pppp1ppp/4p3/4P3/8/8/PPPP1PPP/RNBQKBNR b KQkq - 0 2,d5,-23,34,57,1
rnbqkbnr/ppp2ppp/4p3/3pP3/8/8/PPPP1PPP/RNBQKBNR w KQkq d6 0 3,d4,19,16,-3,1
rnbqkbnr/ppp2ppp/4p3/3pP3/3P4/8/PPP2PPP/RNBQKBNR b KQkq - 0 3,c5,11,16,5,1
rnbqkbnr/pp3ppp/4p3/2ppP3/3P4/8/PPP2PPP/RNBQKBNR w KQkq - 0 4,c3,15,15,0,1
rnbqkbnr/pp3ppp/4p3/2ppP3/3P4/2P5/PP3PPP/RNBQKBNR b KQkq - 0 4,Nc6,27,26,-1,1
r1bqkbnr/pp3ppp/2n1p3/2ppP3/3P4/2P5/PP3PPP/RNBQKBNR w KQkq - 1 5,f4,25,-75,-100,1
r1bqkbnr/pp3ppp/2n1p3/2ppP3/3P1P2/2P5/PP4PP/RNBQKBNR b KQkq - 0 5,Qb6,-74,-81,-7,1
r1b1kbnr/pp3ppp/1qn1p3/2ppP3/3P1P2/2P5/PP4PP/RNBQKBNR w KQkq - 1 6,Be3,-76,-237,-161,0
r1b1kbnr/pp3ppp/1qn1p3/2ppP3/3P1P2/2P1B3/PP4PP/RN1QKBNR b KQkq - 2 6,Qxb2,-255,-262,-7,1
r1b1kbnr/pp3ppp/2n1p3/2ppP3/3P1P2/2P1B3/Pq4PP/RN1QKBNR w KQkq - 0 7,Nd2,-238,-306,-68,1
r1b1kbnr/pp3ppp/2n1p3/2ppP3/3P1P2/2P1B3/Pq1N2PP/R2QKBNR b KQkq - 1 7,Qxc3,-316,-315,1,1
r1b1kbnr/pp3ppp/2n1p3/2ppP3/3P1P2/2q1B3/P2N2PP/R2QKBNR w KQkq - 0 8,dxc5,-328,-622,-294,0
r1b1kbnr/pp3ppp/2n1p3/2PpP3/5P2/2q1B3/P2N2PP/R2QKBNR b KQkq - 0 8,Qa5,-596,-130,466,1
r1b1kbnr/pp3ppp/2n1p3/q1PpP3/5P2/4B3/P2N2PP/R2QKBNR w KQkq - 1 9,Be2,-134,-214,-80,1
r1b1kbnr/pp3ppp/2n1p3/q1PpP3/5P2/4B3/P2NB1PP/R2QK1NR b KQkq - 2 9,Bxc5,-231,-198,33,1
r1b1k1nr/pp3ppp/2n1p3/q1bpP3/5P2/4B3/P2NB1PP/R2QK1NR w KQkq - 0 10,Bf2,-202,-314,-112,0
r1b1k1nr/pp3ppp/2n1p3/q1bpP3/5P2/8/P2NBBPP/R2QK1NR b KQkq - 1 10,Bxf2+,-316,-315,1,1
r1b1k1nr/pp3ppp/2n1p3/q2pP3/5P2/8/P2NBbPP/R2QK1NR w KQkq - 0 11,Kxf2,-350,-343,7,1
r1b1k1nr/pp3ppp/2n1p3/q2pP3/5P2/8/P2NBKPP/R2Q2NR b kq - 0 11,Nge7,-334,-330,4,1
r1b1k2r/pp2nppp/2n1p3/q2pP3/5P2/8/P2NBKPP/R2Q2NR w kq - 1 12,Ngf3,-294,-277,17,1
r1b1k2r/pp2nppp/2n1p3/q2pP3/5P2/5N2/P2NBKPP/R2Q3R b kq - 2 12,O-O,-295,-278,17,1
r1b2rk1/pp2nppp/2n1p3/q2pP3/5P2/5N2/P2NBKPP/R2Q3R w - - 3 13,Rf1,-278,-382,-104,0
r1b2rk1/pp2nppp/2n1p3/q2pP3/5P2/5N2/P2NBKPP/R2Q1R2 b - - 4 13,Bd7,-358,-238,120,1
r4rk1/pp1bnppp/2n1p3/q2pP3/5P2/5N2/P2NBKPP/R2Q1R2 w - - 5 14,Kg1,-242,-251,-9,1
r4rk1/pp1bnppp/2n1p3/q2pP3/5P2/5N2/P2NB1PP/R2Q1RK1 b - - 6 14,Nb4,-237,-220,17,1
r4rk1/pp1bnppp/4p3/q2pP3/1n3P2/5N2/P2NB1PP/R2Q1RK1 w - - 7 15,Rb1,-193,-277,-84,1
r4rk1/pp1bnppp/4p3/q2pP3/1n3P2/5N2/P2NB1PP/1R1Q1RK1 b - - 8 15,Qc5+,-270,-226,44,1
r4rk1/pp1bnppp/4p3/2qpP3/1n3P2/5N2/P2NB1PP/1R1Q1RK1 w - - 9 16,Kh1,-199,-207,-8,1
r4rk1/pp1bnppp/4p3/2qpP3/1n3P2/5N2/P2NB1PP/1R1Q1R1K b - - 10 16,a5,-221,-135,86,1
r4rk1/1p1bnppp/4p3/p1qpP3/1n3P2/5N2/P2NB1PP/1R1Q1R1K w - - 0 17,Nb3,-140,-152,-12,1
r4rk1/1p1bnppp/4p3/p1qpP3/1n3P2/1N3N2/P3B1PP/1R1Q1R1K b - - 1 17,Qa7,-170,-159,11,1
r4rk1/qp1bnppp/4p3/p2pP3/1n3P2/1N3N2/P3B1PP/1R1Q1R1K w - - 2 18,a3,-154,-164,-10,1
r4rk1/qp1bnppp/4p3/p2pP3/1n3P2/PN3N2/4B1PP/1R1Q1R1K b - - 0 18,Nbc6,-136,-133,3,1
r4rk1/qp1bnppp/2n1p3/p2pP3/5P2/PN3N2/4B1PP/1R1Q1R1K w - - 1 19,Bd3,-138,-140,-2,1
r4rk1/qp1bnppp/2n1p3/p2pP3/5P2/PN1B1N2/6PP/1R1Q1R1K b - - 2 19,a4,-128,85,213,1
r4rk1/qp1bnppp/2n1p3/3pP3/p4P2/PN1B1N2/6PP/1R1Q1R1K w - - 0 20,Na1,61,-168,-229,0
r4rk1/qp1bnppp/2n1p3/3pP3/p4P2/P2B1N2/6PP/NR1Q1R1K b - - 1 20,Na5,-179,157,336,1
r4rk1/qp1bnppp/4p3/n2pP3/p4P2/P2B1N2/6PP/NR1Q1R1K w - - 2 21,Ng5,117,-90,-207,0
r4rk1/qp1bnppp/4p3/n2pP1N1/p4P2/P2B4/6PP/NR1Q1R1K b - - 3 21,h6,-111,-55,56,1
r4rk1/qp1bnpp1/4p2p/n2pP1N1/p4P2/P2B4/6PP/NR1Q1R1K w - - 0 22,Nh7,-77,-64,13,1
r4rk1/qp1bnppN/4p2p/n2pP3/p4P2/P2B4/6PP/NR1Q1R1K b - - 1 22,Ng6,-69,-49,20,1
r4rk1/qp1b1ppN/4p1np/n2pP3/p4P2/P2B4/6PP/NR1Q1R1K w - - 2 23,Nxf8,-37,-37,0,1
r4Nk1/qp1b1pp1/4p1np/n2pP3/p4P2/P2B4/6PP/NR1Q1R1K b - - 0 23,Kxf8,-49,92,141,1
r4k2/qp1b1pp1/4p1np/n2pP3/p4P2/P2B4/6PP/NR1Q1R1K w - - 0 24,Bxg6,1,-12,-13,1
r4k2/qp1b1pp1/4p1Bp/n2pP3/p4P2/P7/6PP/NR1Q1R1K b - - 0 24,fxg6,-11,0,11,1
r4k2/qp1b2p1/4p1pp/n2pP3/p4P2/P7/6PP/NR1Q1R1K w - - 0 25,Nc2,0,-29,-29,1
r4k2/qp1b2p1/4p1pp/n2pP3/p4P2/P7/2N3PP/1R1Q1R1K b - - 1 25,Bb5,-26,445,471,1
r4k2/qp4p1/4p1pp/nb1pP3/p4P2/P7/2N3PP/1R1Q1R1K w - - 2 26,Rf3,423,-87,-510,0
r4k2/qp4p1/4p1pp/nb1pP3/p4P2/P4R2/2N3PP/1R1Q3K b - - 3 26,Nc4,-86,441,527,1
r4k2/qp4p1/4p1pp/1b1pP3/p1n2P2/P4R2/2N3PP/1R1Q3K w - - 4 27,Nd4,440,259,-181,0
r4k2/qp4p1/4p1pp/1b1pP3/p1nN1P2/P4R2/6PP/1R1Q3K b - - 5 27,Qb6,228,465,237,1
r4k2/1p4p1/1q2p1pp/1b1pP3/p1nN1P2/P4R2/6PP/1R1Q3K w - - 6 28,Nxb5,462,457,-5,1
rnbqkbnr/pppppppp/8/8/8/8/PPPPPPPP/RNBQKBNR w KQkq - 0 1,e4,23,24,1,1
rnbqkbnr/pppppppp/8/8/4P3/8/PPPP1PPP/RNBQKBNR b KQkq - 0 1,e5,23,45,22,1
rnbqkbnr/pppp1ppp/8/4p3/4P3/8/PPPP1PPP/RNBQKBNR w KQkq - 0 2,Nc3,48,35,-13,1
rnbqkbnr/pppp1ppp/8/4p3/4P3/2N5/PPPP1PPP/R1BQKBNR b KQkq - 1 2,Nf6,22,20,-2,1
rnbqkb1r/pppp1ppp/5n2/4p3/4P3/2N5/PPPP1PPP/R1BQKBNR w KQkq - 2 3,d3,24,-41,-65,1
rnbqkb1r/pppp1ppp/5n2/4p3/4P3/2NP4/PPP2PPP/R1BQKBNR b KQkq - 0 3,Bc5,-31,13,44,1
rnbqk2r/pppp1ppp/5n2/2b1p3/4P3/2NP4/PPP2PPP/R1BQKBNR w KQkq - 1 4,Be3,-1,-25,-24,1
rnbqk2r/pppp1ppp/5n2/2b1p3/4P3/2NPB3/PPP2PPP/R2QKBNR b KQkq - 2 4,Bxe3,-29,-14,15,1
rnbqk2r/pppp1ppp/5n2/4p3/4P3/2NPb3/PPP2PPP/R2QKBNR w KQkq - 0 5,fxe3,-16,-11,5,1
rnbqk2r/pppp1ppp/5n2/4p3/4P3/2NPP3/PPP3PP/R2QKBNR b KQkq - 0 5,d6,-19,-10,9,1
rnbqk2r/ppp2ppp/3p1n2/4p3/4P3/2NPP3/PPP3PP/R2QKBNR w KQkq - 0 6,Nf3,-4,-6,-2,1
rnbqk2r/ppp2ppp/3p1n2/4p3/4P3/2NPPN2/PPP3PP/R2QKB1R b KQkq - 1 6,Bg4,-1,72,73,1
rn1qk2r/ppp2ppp/3p1n2/4p3/4P1b1/2NPPN2/PPP3PP/R2QKB1R w KQkq - 2 7,Be2,72,16,-56,1
rn1qk2r/ppp2ppp/3p1n2/4p3/4P1b1/2NPPN2/PPP1B1PP/R2QK2R b KQkq - 3 7,Nc6,42,55,13,1
r2qk2r/ppp2ppp/2np1n2/4p3/4P1b1/2NPPN2/PPP1B1PP/R2QK2R w KQkq - 4 8,Ng5,36,18,-18,1
r2qk2r/ppp2ppp/2np1n2/4p1N1/4P1b1/2NPP3/PPP1B1PP/R2QK2R b KQkq - 5 8,Bxe2,4,11,7,1
r2qk2r/ppp2ppp/2np1n2/4p1N1/4P3/2NPP3/PPP1b1PP/R2QK2R w KQkq - 0 9,Nxe2,-4,-236,-232,0
r2qk2r/ppp2ppp/2np1n2/4p1N1/4P3/3PP3/PPP1N1PP/R2QK2R b KQkq - 0 9,h6,-248,-38,210,1
r2qk2r/ppp2pp1/2np1n1p/4p1N1/4P3/3PP3/PPP1N1PP/R2QK2R w KQkq - 0 10,Nf3,-35,-44,-9,1
r2qk2r/ppp2pp1/2np1n1p/4p3/4P3/3PPN2/PPP1N1PP/R2QK2R b KQkq - 1 10,O-O,-37,24,61,1
r2q1rk1/ppp2pp1/2np1n1p/4p3/4P3/3PPN2/PPP1N1PP/R2QK2R w KQ - 2 11,O-O,37,-17,-54,1
r2q1rk1/ppp2pp1/2np1n1p/4p3/4P3/3PPN2/PPP1N1PP/R2Q1RK1 b - - 3 11,Ne7,-18,36,54,1
r2q1rk1/ppp1npp1/3p1n1p/4p3/4P3/3PPN2/PPP1N1PP/R2Q1RK1 w - - 4 12,d4,38,-86,-124,0
r2q1rk1/ppp1npp1/3p1n1p/4p3/3PP3/4PN2/PPP1N1PP/R2Q1RK1 b - - 0 12,Nxe4,-88,-36,52,1
r2q1rk1/ppp1npp1/3p3p/4p3/3Pn3/4PN2/PPP1N1PP/R2Q1RK1 w - - 0 13,dxe5,-102,-140,-38,1
r2q1rk1/ppp1npp1/3p3p/4P3/4n3/4PN2/PPP1N1PP/R2Q1RK1 b - - 0 13,dxe5,-133,-99,34,1
r2q1rk1/ppp1npp1/7p/4p3/4n3/4PN2/PPP1N1PP/R2Q1RK1 w - - 0 14,Nxe5,-114,-118,-4,1
r2q1rk1/ppp1npp1/7p/4N3/4n3/4P3/PPP1N1PP/R2Q1RK1 b - - 0 14,Nd2,-116,75,191,1
r2q1rk1/ppp1npp1/7p/4N3/8/4P3/PPPnN1PP/R2Q1RK1 w - - 1 15,Qe1,70,-374,-444,0
r2q1rk1/ppp1npp1/7p/4N3/8/4P3/PPPnN1PP/R3QRK1 b - - 2 15,Nxf1,-414,-384,30,1
r2q1rk1/ppp1npp1/7p/4N3/8/4P3/PPP1N1PP/R3QnK1 w - - 0 16,Qxf1,-394,-457,-63,1
r2q1rk1/ppp1npp1/7p/4N3/8/4P3/PPP1N1PP/R4QK1 b - - 0 16,f6,-414,-320,94,1
r2q1rk1/ppp1n1p1/5p1p/4N3/8/4P3/PPP1N1PP/R4QK1 w - - 0 17,Ng4,-333,-314,19,1
r2q1rk1/ppp1n1p1/5p1p/8/6N1/4P3/PPP1N1PP/R4QK1 b - - 1 17,f5,-356,-370,-14,1
r2q1rk1/ppp1n1p1/7p/5p2/6N1/4P3/PPP1N1PP/R4QK1 w - - 0 18,Nf4,-373,-417,-44,1
r2q1rk1/ppp1n1p1/7p/5p2/5NN1/4P3/PPP3PP/R4QK1 b - - 1 18,fxg4,-418,-386,32,1
r2q1rk1/ppp1n1p1/7p/8/5Np1/4P3/PPP3PP/R4QK1 w - - 0 19,Ne6,-453,-683,-230,0
r2q1rk1/ppp1n1p1/4N2p/8/6p1/4P3/PPP3PP/R4QK1 b - - 1 19,Rxf1+,-643,-702,-59,1
r2q2k1/ppp1n1p1/4N2p/8/6p1/4P3/PPP3PP/R4rK1 w - - 0 20,Kxf1,-699,-743,-44,1
r2q2k1/ppp1n1p1/4N2p/8/6p1/4P3/PPP3PP/R4K2 b - - 0 20,Qd6,-698,-752,-54,1
r5k1/ppp1n1p1/3qN2p/8/6p1/4P3/PPP3PP/R4K2 w - - 1 21,Ng5,-725,-826,-101,0
rnbqkbnr/pppppppp/8/8/8/8/PPPPPPPP/RNBQKBNR w KQkq - 0 1,Nf3,24,-10,-34,1
rnbqkbnr/pppppppp/8/8/8/5N2/PPPPPPPP/RNBQKB1R b KQkq - 1 1,c5,12,27,15,1
rnbqkbnr/pp1ppppp/8/2p5/8/5N2/PPPPPPPP/RNBQKB1R w KQkq - 0 2,c4,32,19,-13,1
rnbqkbnr/pp1ppppp/8/2p5/2P5/5N2/PP1PPPPP/RNBQKB1R b KQkq - 0 2,g6,21,41,20,1
rnbqkbnr/pp1ppp1p/6p1/2p5/2P5/5N2/PP1PPPPP/RNBQKB1R w KQkq - 0 3,Nc3,24,14,-10,1
rnbqkbnr/pp1ppp1p/6p1/2p5/2P5/2N2N2/PP1PPPPP/R1BQKB1R b KQkq - 1 3,Bg7,11,16,5,1
rnbqk1nr/pp1pppbp/6p1/2p5/2P5/2N2N2/PP1PPPPP/R1BQKB1R w KQkq - 2 4,g3,14,-12,-26,1
rnbqk1nr/pp1pppbp/6p1/2p5/2P5/2N2NP1/PP1PPP1P/R1BQKB1R b KQkq - 0 4,b6,-3,48,51,1
rnbqk1nr/p2pppbp/1p4p1/2p5/2P5/2N2NP1/PP1PPP1P/R1BQKB1R w KQkq - 0 5,Bg2,41,17,-24,1
rnbqk1nr/p2pppbp/1p4p1/2p5/2P5/2N2NP1/PP1PPPBP/R1BQK2R b KQkq - 1 5,Bb7,15,15,0,1
rn1qk1nr/pb1pppbp/1p4p1/2p5/2P5/2N2NP1/PP1PPPBP/R1BQK2R w KQkq - 2 6,O-O,28,6,-22,1
rn1qk1nr/pb1pppbp/1p4p1/2p5/2P5/2N2NP1/PP1PPPBP/R1BQ1RK1 b kq - 3 6,Nc6,20,36,16,1
r2qk1nr/pb1pppbp/1pn3p1/2p5/2P5/2N2NP1/PP1PPPBP/R1BQ1RK1 w kq - 4 7,d3,28,4,-24,1
r2qk1nr/pb1pppbp/1pn3p1/2p5/2P5/2NP1NP1/PP2PPBP/R1BQ1RK1 b kq - 0 7,Nf6,6,10,4,1
r2qk2r/pb1pppbp/1pn2np1/2p5/2P5/2NP1NP1/PP2PPBP/R1BQ1RK1 w kq - 1 8,Bg5,11,-7,-18,1
r2qk2r/pb1pppbp/1pn2np1/2p3B1/2P5/2NP1NP1/PP2PPBP/R2Q1RK1 b kq - 2 8,O-O,0,15,15,1
r2q1rk1/pb1pppbp/1pn2np1/2p3B1/2P5/2NP1NP1/PP2PPBP/R2Q1RK1 w - - 3 9,Qd2,19,13,-6,1
r2q1rk1/pb1pppbp/1pn2np1/2p3B1/2P5/2NP1NP1/PP1QPPBP/R4RK1 b - - 4 9,d5,-4,32,36,1
r2q1rk1/pb2ppbp/1pn2np1/2pp2B1/2P5/2NP1NP1/PP1QPPBP/R4RK1 w - - 0 10,Bxf6,36,37,1,1
r2q1rk1/pb2ppbp/1pn2Bp1/2pp4/2P5/2NP1NP1/PP1QPPBP/R4RK1 b - - 0 10,Bxf6,42,73,31,1
r2q1rk1/pb2pp1p/1pn2bp1/2pp4/2P5/2NP1NP1/PP1QPPBP/R4RK1 w - - 0 11,Nxd5,80,34,-46,1
r2q1rk1/pb2pp1p/1pn2bp1/2pN4/2P5/3P1NP1/PP1QPPBP/R4RK1 b - - 0 11,Bg7,32,30,-2,1
r2q1rk1/pb2ppbp/1pn3p1/2pN4/2P5/3P1NP1/PP1QPPBP/R4RK1 w - - 1 12,Rab1,36,36,0,1
r2q1rk1/pb2ppbp/1pn3p1/2pN4/2P5/3P1NP1/PP1QPPBP/1R3RK1 b - - 2 12,Ne5,23,130,107,1
r2q1rk1/pb2ppbp/1p4p1/2pNn3/2P5/3P1NP1/PP1QPPBP/1R3RK1 w - - 3 13,Nxe5,140,133,-7,1
r2q1rk1/pb2ppbp/1p4p1/2pNN3/2P5/3P2P1/PP1QPPBP/1R3RK1 b - - 0 13,Bxe5,134,129,-5,1
r2q1rk1/pb2pp1p/1p4p1/2pNb3/2P5/3P2P1/PP1QPPBP/1R3RK1 w - - 0 14,b4,137,125,-12,1
r2q1rk1/pb2pp1p/1p4p1/2pNb3/1PP5/3P2P1/P2QPPBP/1R3RK1 b - - 0 14,Rc8,131,122,-9,1
2rq1rk1/pb2pp1p/1p4p1/2pNb3/1PP5/3P2P1/P2QPPBP/1R3RK1 w - - 1 15,bxc5,124,138,14,1
2rq1rk1/pb2pp1p/1p4p1/2PNb3/2P5/3P2P1/P2QPPBP/1R3RK1 b - - 0 15,Rxc5,102,311,209,1
3q1rk1/pb2pp1p/1p4p1/2rNb3/2P5/3P2P1/P2QPPBP/1R3RK1 w - - 0 16,d4,292,331,39,1
3q1rk1/pb2pp1p/1p4p1/2rNb3/2PP4/6P1/P2QPPBP/1R3RK1 b - - 0 16,Rxc4,301,468,167,1
3q1rk1/pb2pp1p/1p4p1/3Nb3/2rP4/6P1/P2QPPBP/1R3RK1 w - - 0 17,dxe5,491,447,-44,1
3q1rk1/pb2pp1p/1p4p1/3NP3/2r5/6P1/P2QPPBP/1R3RK1 b - - 0 17,e6,432,590,158,1
3q1rk1/pb3p1p/1p2p1p1/3NP3/2r5/6P1/P2QPPBP/1R3RK1 w - - 0 18,Nf6+,615,601,-14,1
3q1rk1/pb3p1p/1p2pNp1/4P3/2r5/6P1/P2QPPBP/1R3RK1 b - - 1 18,Kg7,608,593,-15,1
3q1r2/pb3pkp/1p2pNp1/4P3/2r5/6P1/P2QPPBP/1R3RK1 w - - 2 19,Qxd8,563,585,22,1
3Q1r2/pb3pkp/1p2pNp1/4P3/2r5/6P1/P3PPBP/1R3RK1 b - - 0 19,Rxd8,577,590,13,1
3r4/pb3pkp/1p2pNp1/4P3/2r5/6P1/P3PPBP/1R3RK1 w - - 0 20,Bxb7,584,576,-8,1
3r4/pB3pkp/1p2pNp1/4P3/2r5/6P1/P3PP1P/1R3RK1 b - - 0 20,Rd2,576,593,17,1
8/pB3pkp/1p2pNp1/4P3/2r5/6P1/P2rPP1P/1R3RK1 w - - 1 21,Rfd1,582,528,-54,1
8/pB3pkp/1p2pNp1/4P3/2r5/6P1/P2rPP1P/1R1R2K1 b - - 2 21,Rxe2,517,576,59,1
8/pB3pkp/1p2pNp1/4P3/2r5/6P1/P3rP1P/1R1R2K1 w - - 0 22,Rbc1,539,479,-60,1
8/pB3pkp/1p2pNp1/4P3/2r5/6P1/P3rP1P/2RR2K1 b - - 1 22,Rxc1,477,514,37,1
8/pB3pkp/1p2pNp1/4P3/8/6P1/P3rP1P/2rR2K1 w - - 0 23,Rxc1,482,457,-25,1
8/pB3pkp/1p2pNp1/4P3/8/6P1/P3rP1P/2R3K1 b - - 0 23,Rxa2,509,500,-9,1
rnbqkbnr/pppppppp/8/8/8/8/PPPPPPPP/RNBQKBNR w KQkq - 0 1,d4,24,23,-1,1
rnbqkbnr/pppppppp/8/8/3P4/8/PPP1PPPP/RNBQKBNR b KQkq - 0 1,Nf6,23,25,2,1
rnbqkb1r/pppppppp/5n2/8/3P4/8/PPP1PPPP/RNBQKBNR w KQkq - 1 2,c4,26,25,-1,1
rnbqkb1r/pppppppp/5n2/8/2PP4/8/PP2PPPP/RNBQKBNR b KQkq - 0 2,g6,18,47,29,1
rnbqkb1r/pppppp1p/5np1/8/2PP4/8/PP2PPPP/RNBQKBNR w KQkq - 0 3,Nc3,40,32,-8,1
rnbqkb1r/pppppp1p/5np1/8/2PP4/2N5/PP2PPPP/R1BQKBNR b KQkq - 1 3,Bg7,23,58,35,1
rnbqk2r/ppppppbp/5np1/8/2PP4/2N5/PP2PPPP/R1BQKBNR w KQkq - 2 4,e4,39,46,7,1
rnbqk2r/ppppppbp/5np1/8/2PPP3/2N5/PP3PPP/R1BQKBNR b KQkq - 0 4,d6,49,45,-4,1
rnbqk2r/ppp1ppbp/3p1np1/8/2PPP3/2N5/PP3PPP/R1BQKBNR w KQkq - 0 5,f3,53,48,-5,1
rnbqk2r/ppp1ppbp/3p1np1/8/2PPP3/2N2P2/PP4PP/R1BQKBNR b KQkq - 0 5,O-O,43,46,3,1
rnbq1rk1/ppp1ppbp/3p1np1/8/2PPP3/2N2P2/PP4PP/R1BQKBNR w KQ - 1 6,Be3,66,38,-28,1
rnbq1rk1/ppp1ppbp/3p1np1/8/2PPP3/2N1BP2/PP4PP/R2QKBNR b KQ - 2 6,Nc6,24,104,80,1
r1bq1rk1/ppp1ppbp/2np1np1/8/2PPP3/2N1BP2/PP4PP/R2QKBNR w KQ - 3 7,Qd2,93,95,2,1
r1bq1rk1/ppp1ppbp/2np1np1/8/2PPP3/2N1BP2/PP1Q2PP/R3KBNR b KQ - 4 7,e5,67,99,32,1
r1bq1rk1/ppp2pbp/2np1np1/4p3/2PPP3/2N1BP2/PP1Q2PP/R3KBNR w KQ - 0 8,d5,100,101,1,1
r1bq1rk1/ppp2pbp/2np1np1/3Pp3/2P1P3/2N1BP2/PP1Q2PP/R3KBNR b KQ - 0 8,Ne7,81,118,37,1
r1bq1rk1/ppp1npbp/3p1np1/3Pp3/2P1P3/2N1BP2/PP1Q2PP/R3KBNR w KQ - 1 9,Bd3,117,125,8,1
r1bq1rk1/ppp1npbp/3p1np1/3Pp3/2P1P3/2NBBP2/PP1Q2PP/R3K1NR b KQ - 2 9,Nh5,103,131,28,1
r1bq1rk1/ppp1npbp/3p2p1/3Pp2n/2P1P3/2NBBP2/PP1Q2PP/R3K1NR w KQ - 3 10,Nge2,116,120,4,1
r1bq1rk1/ppp1npbp/3p2p1/3Pp2n/2P1P3/2NBBP2/PP1QN1PP/R3K2R b KQ - 4 10,f5,130,134,4,1
r1bq1rk1/ppp1n1bp/3p2p1/3Ppp1n/2P1P3/2NBBP2/PP1QN1PP/R3K2R w KQ - 0 11,O-O-O,134,130,-4,1
r1bq1rk1/ppp1n1bp/3p2p1/3Ppp1n/2P1P3/2NBBP2/PP1QN1PP/2KR3R b - - 1 11,f4,143,143,0,1
r1bq1rk1/ppp1n1bp/3p2p1/3Pp2n/2P1Pp2/2NBBP2/PP1QN1PP/2KR3R w - - 0 12,Bf2,148,152,4,1
r1bq1rk1/ppp1n1bp/3p2p1/3Pp2n/2P1Pp2/2NB1P2/PP1QNBPP/2KR3R b - - 1 12,Nf6,148,159,11,1
r1bq1rk1/ppp1n1bp/3p1np1/3Pp3/2P1Pp2/2NB1P2/PP1QNBPP/2KR3R w - - 2 13,g3,155,100,-55,1
r1bq1rk1/ppp1n1bp/3p1np1/3Pp3/2P1Pp2/2NB1PP1/PP1QNB1P/2KR3R b - - 0 13,g5,89,141,52,1
r1bq1rk1/ppp1n1bp/3p1n2/3Pp1p1/2P1Pp2/2NB1PP1/PP1QNB1P/2KR3R w - - 0 14,gxf4,143,134,-9,1
r1bq1rk1/ppp1n1bp/3p1n2/3Pp1p1/2P1PP2/2NB1P2/PP1QNB1P/2KR3R b - - 0 14,gxf4,141,140,-1,1
r1bq1rk1/ppp1n1bp/3p1n2/3Pp3/2P1Pp2/2NB1P2/PP1QNB1P/2KR3R w - - 0 15,Rdg1,130,126,-4,1
r1bq1rk1/ppp1n1bp/3p1n2/3Pp3/2P1Pp2/2NB1P2/PP1QNB1P/2K3RR b - - 1 15,Kh8,110,119,9,1
r1bq1r1k/ppp1n1bp/3p1n2/3Pp3/2P1Pp2/2NB1P2/PP1QNB1P/2K3RR w - - 2 16,h4,135,124,-11,1
r1bq1r1k/ppp1n1bp/3p1n2/3Pp3/2P1Pp1P/2NB1P2/PP1QNB2/2K3RR b - - 0 16,Rg8,131,128,-3,1
r1bq2rk/ppp1n1bp/3p1n2/3Pp3/2P1Pp1P/2NB1P2/PP1QNB2/2K3RR w - - 1 17,Rg2,124,80,-44,1
r1bq2rk/ppp1n1bp/3p1n2/3Pp3/2P1Pp1P/2NB1P2/PP1QNBR1/2K4R b - - 2 17,Nh5,81,128,47,1
r1bq2rk/ppp1n1bp/3p4/3Pp2n/2P1Pp1P/2NB1P2/PP1QNBR1/2K4R w - - 3 18,Rhg1,143,44,-99,1
r1bq2rk/ppp1n1bp/3p4/3Pp2n/2P1Pp1P/2NB1P2/PP1QNBR1/2K3R1 b - - 4 18,Bd7,55,53,-2,1
r2q2rk/pppbn1bp/3p4/3Pp2n/2P1Pp1P/2NB1P2/PP1QNBR1/2K3R1 w - - 5 19,Rg5,42,31,-11,1
r2q2rk/pppbn1bp/3p4/3Pp1Rn/2P1Pp1P/2NB1P2/PP1QNB2/2K3R1 b - - 6 19,Nf6,29,123,94,1
r2q2rk/pppbn1bp/3p1n2/3Pp1R1/2P1Pp1P/2NB1P2/PP1QNB2/2K3R1 w - - 7 20,h5,108,38,-70,1
r2q2rk/pppbn1bp/3p1n2/3Pp1RP/2P1Pp2/2NB1P2/PP1QNB2/2K3R1 b - - 0 20,Bh6,41,37,-4,1
r2q2rk/pppbn2p/3p1n1b/3Pp1RP/2P1Pp2/2NB1P2/PP1QNB2/2K3R1 w - - 1 21,Rxg8+,27,36,9,1
r2q2Rk/pppbn2p/3p1n1b/3Pp2P/2P1Pp2/2NB1P2/PP1QNB2/2K3R1 b - - 0 21,Nexg8,43,38,-5,1
r2q2nk/pppb3p/3p1n1b/3Pp2P/2P1Pp2/2NB1P2/PP1QNB2/2K3R1 w - - 0 22,Bh4,41,24,-17,1
r2q2nk/pppb3p/3p1n1b/3Pp2P/2P1Pp1B/2NB1P2/PP1QN3/2K3R1 b - - 1 22,Qe8,8,11,3,1
r3q1nk/pppb3p/3p1n1b/3Pp2P/2P1Pp1B/2NB1P2/PP1QN3/2K3R1 w - - 2 23,Bg5,30,-250,-280,0
r3q1nk/pppb3p/3p1n1b/3Pp1BP/2P1Pp2/2NB1P2/PP1QN3/2K3R1 b - - 3 23,Qxh5,-218,-244,-26,1
r5nk/pppb3p/3p1n1b/3Pp1Bq/2P1Pp2/2NB1P2/PP1QN3/2K3R1 w - - 0 24,Bxh6,-237,-259,-22,1
r5nk/pppb3p/3p1n1B/3Pp2q/2P1Pp2/2NB1P2/PP1QN3/2K3R1 b - - 0 24,Nxh6,-234,-225,9,1
r6k/pppb3p/3p1n1n/3Pp2q/2P1Pp2/2NB1P2/PP1QN3/2K3R1 w - - 0 25,Rf1,-216,-239,-23,1
r6k/pppb3p/3p1n1n/3Pp2q/2P1Pp2/2NB1P2/PP1QN3/2K2R2 b - - 1 25,Qh2,-251,-200,51,1
r6k/pppb3p/3p1n1n/3Pp3/2P1Pp2/2NB1P2/PP1QN2q/2K2R2 w - - 2 26,Kb1,-200,-219,-19,1
r6k/pppb3p/3p1n1n/3Pp3/2P1Pp2/2NB1P2/PP1QN2q/1K3R2 b - - 3 26,Rg8,-205,-205,0,1
6rk/pppb3p/3p1n1n/3Pp3/2P1Pp2/2NB1P2/PP1QN2q/1K3R2 w - - 4 27,Nb5,-201,-195,6,1
6rk/pppb3p/3p1n1n/1N1Pp3/2P1Pp2/3B1P2/PP1QN2q/1K3R2 b - - 5 27,Bxb5,-204,-184,20,1
6rk/ppp4p/3p1n1n/1b1Pp3/2P1Pp2/3B1P2/PP1QN2q/1K3R2 w - - 0 28,cxb5,-189,-201,-12,1
6rk/ppp4p/3p1n1n/1P1Pp3/4Pp2/3B1P2/PP1QN2q/1K3R2 b - - 0 28,Rg2,-215,-76,139,1
7k/ppp4p/3p1n1n/1P1Pp3/4Pp2/3B1P2/PP1QN1rq/1K3R2 w - - 1 29,Qc2,-63,-127,-64,1
7k/ppp4p/3p1n1n/1P1Pp3/4Pp2/3B1P2/PPQ1N1rq/1K3R2 b - - 2 29,Ne8,-154,-198,-44,1
4n2k/ppp4p/3p3n/1P1Pp3/4Pp2/3B1P2/PPQ1N1rq/1K3R2 w - - 3 30,a4,-176,-219,-43,1
4n2k/ppp4p/3p3n/1P1Pp3/P3Pp2/3B1P2/1PQ1N1rq/1K3R2 b - - 0 30,Rf2,-193,-235,-42,1
4n2k/ppp4p/3p3n/1P1Pp3/P3Pp2/3B1P2/1PQ1Nr1q/1K3R2 w - - 1 31,Rg1,-228,-387,-159,0
4n2k/ppp4p/3p3n/1P1Pp3/P3Pp2/3B1P2/1PQ1Nr1q/1K4R1 b - - 2 31,Rxf3,-420,-255,165,1
4n2k/ppp4p/3p3n/1P1Pp3/P3Pp2/3B1r2/1PQ1N2q/1K4R1 w - - 0 32,a5,-268,-288,-20,1
4n2k/ppp4p/3p3n/PP1Pp3/4Pp2/3B1r2/1PQ1N2q/1K4R1 b - - 0 32,Rf2,-267,-287,-20,1
4n2k/ppp4p/3p3n/PP1Pp3/4Pp2/3B4/1PQ1Nr1q/1K4R1 w - - 1 33,b6,-296,-425,-129,0
4n2k/ppp4p/1P1p3n/P2Pp3/4Pp2/3B4/1PQ1Nr1q/1K4R1 b - - 0 33,Rxe2,-413,-439,-26,1
4n2k/ppp4p/1P1p3n/P2Pp3/4Pp2/3B4/1PQ1r2q/1K4R1 w - - 0 34,Qxe2,-415,-480,-65,1
4n2k/ppp4p/1P1p3n/P2Pp3/4Pp2/3B4/1P2Q2q/1K4R1 b - - 0 34,Qxg1+,-505,-517,-12,1
4n2k/ppp4p/1P1p3n/P2Pp3/4Pp2/3B4/1P2Q3/1K4q1 w - - 0 35,Ka2,-506,-503,3,1
4n2k/ppp4p/1P1p3n/P2Pp3/4Pp2/3B4/KP2Q3/6q1 b - - 1 35,axb6,-508,-502,6,1
4n2k/1pp4p/1p1p3n/P2Pp3/4Pp2/3B4/KP2Q3/6q1 w - - 0 36,axb6,-525,-526,-1,1
4n2k/1pp4p/1P1p3n/3Pp3/4Pp2/3B4/KP2Q3/6q1 b - - 0 36,Qxb6,-537,-385,152,1
4n2k/1pp4p/1q1p3n/3Pp3/4Pp2/3B4/KP2Q3/8 w - - 0 37,Qh5,-346,-369,-23,1
4n2k/1pp4p/1q1p3n/3Pp2Q/4Pp2/3B4/KP6/8 b - - 1 37,Ng7,-338,-308,30,1
7k/1pp3np/1q1p3n/3Pp2Q/4Pp2/3B4/KP6/8 w - - 2 38,Qxh6,-339,-359,-20,1
7k/1pp3np/1q1p3Q/3Pp3/4Pp2/3B4/KP6/8 b - - 0 38,f3,-327,-216,111,1
7k/1pp3np/1q1p3Q/3Pp3/4P3/3B1p2/KP6/8 w - - 0 39,Qf6,-213,-212,1,1
7k/1pp3np/1q1p1Q2/3Pp3/4P3/3B1p2/KP6/8 b - - 1 39,f2,-254,9999,10253,1
7k/1pp3np/1q1p1Q2/3Pp3/4P3/3B4/KP3p2/8 w - - 0 40,Qf8#,9999,10000,1,1
rnbqkbnr/pppppppp/8/8/8/8/PPPPPPPP/RNBQKBNR w KQkq - 0 1,e4,23,12,-11,1
rnbqkbnr/pppppppp/8/8/4P3/8/PPPP1PPP/RNBQKBNR b KQkq - 0 1,c5,25,25,0,1
rnbqkbnr/pp1ppppp/8/2p5/4P3/8/PPPP1PPP/RNBQKBNR w KQkq - 0 2,Nf3,31,36,5,1
rnbqkbnr/pp1ppppp/8/2p5/4P3/5N2/PPPP1PPP/RNBQKB1R b KQkq - 1 2,e6,32,64,32,1
rnbqkbnr/pp1p1ppp/4p3/2p5/4P3/5N2/PPPP1PPP/RNBQKB1R w KQkq - 0 3,d4,44,34,-10,1
rnbqkbnr/pp1p1ppp/4p3/2p5/3PP3/5N2/PPP2PPP/RNBQKB1R b KQkq - 0 3,d5,28,114,86,1
rnbqkbnr/pp3ppp/4p3/2pp4/3PP3/5N2/PPP2PPP/RNBQKB1R w KQkq - 0 4,exd5,94,86,-8,1
rnbqkbnr/pp3ppp/4p3/2pP4/3P4/5N2/PPP2PPP/RNBQKB1R b KQkq - 0 4,exd5,89,92,3,1
rnbqkbnr/pp3ppp/8/2pp4/3P4/5N2/PPP2PPP/RNBQKB1R w KQkq - 0 5,Nc3,78,15,-63,1
rnbqkbnr/pp3ppp/8/2pp4/3P4/2N2N2/PPP2PPP/R1BQKB1R b KQkq - 1 5,c4,11,8,-3,1
rnbqkbnr/pp3ppp/8/3p4/2pP4/2N2N2/PPP2PPP/R1BQKB1R w KQkq - 0 6,Ne5,31,-22,-53,1
rnbqkbnr/pp3ppp/8/3pN3/2pP4/2N5/PPP2PPP/R1BQKB1R b KQkq - 1 6,Nf6,-1,72,73,1
rnbqkb1r/pp3ppp/5n2/3pN3/2pP4/2N5/PPP2PPP/R1BQKB1R w KQkq - 2 7,f4,24,-81,-105,0
rnbqkb1r/pp3ppp/5n2/3pN3/2pP1P2/2N5/PPP3PP/R1BQKB1R b KQkq - 0 7,Bd6,-49,31,80,1
rnbqk2r/pp3ppp/3b1n2/3pN3/2pP1P2/2N5/PPP3PP/R1BQKB1R w KQkq - 1 8,Be2,58,-29,-87,1
rnbqk2r/pp3ppp/3b1n2/3pN3/2pP1P2/2N5/PPP1B1PP/R1BQK2R b KQkq - 2 8,O-O,-8,-2,6,1
rnbq1rk1/pp3ppp/3b1n2/3pN3/2pP1P2/2N5/PPP1B1PP/R1BQK2R w KQ - 3 9,O-O,17,0,-17,1
rnbq1rk1/pp3ppp/3b1n2/3pN3/2pP1P2/2N5/PPP1B1PP/R1BQ1RK1 b - - 4 9,Bf5,-2,168,170,1
rn1q1rk1/pp3ppp/3b1n2/3pNb2/2pP1P2/2N5/PPP1B1PP/R1BQ1RK1 w - - 5 10,Bf3,189,68,-121,0
rn1q1rk1/pp3ppp/3b1n2/3pNb2/2pP1P2/2N2B2/PPP3PP/R1BQ1RK1 b - - 6 10,Ne4,73,346,273,1
rn1q1rk1/pp3ppp/3b4/3pNb2/2pPnP2/2N2B2/PPP3PP/R1BQ1RK1 w - - 7 11,Bd2,376,51,-325,0
rn1q1rk1/pp3ppp/3b4/3pNb2/2pPnP2/2N2B2/PPPB2PP/R2Q1RK1 b - - 8 11,Nxd2,47,69,22,1
rn1q1rk1/pp3ppp/3b4/3pNb2/2pP1P2/2N2B2/PPPn2PP/R2Q1RK1 w - - 0 12,Qxd2,59,61,2,1
rn1q1rk1/pp3ppp/3b4/3pNb2/2pP1P2/2N2B2/PPPQ2PP/R4RK1 b - - 0 12,Be6,77,242,165,1
rn1q1rk1/pp3ppp/3bb3/3pN3/2pP1P2/2N2B2/PPPQ2PP/R4RK1 w - - 1 13,Nxd5,218,97,-121,0
rn1q1rk1/pp3ppp/3bb3/3NN3/2pP1P2/5B2/PPPQ2PP/R4RK1 b - - 0 13,Qb6,105,673,568,1
rnbqkbnr/pppppppp/8/8/8/8/PPPPPPPP/RNBQKBNR w KQkq - 0 1,d4,30,19,-11,1
rnbqkbnr/pppppppp/8/8/3P4/8/PPP1PPPP/RNBQKBNR b KQkq - 0 1,e6,21,51,30,1
rnbqkbnr/pppp1ppp/4p3/8/3P4/8/PPP1PPPP/RNBQKBNR w KQkq - 0 2,c4,36,16,-20,1
rnbqkbnr/pppp1ppp/4p3/8/2PP4/8/PP2PPPP/RNBQKBNR b KQkq - 0 2,d5,20,21,1,1
rnbqkbnr/ppp2ppp/4p3/3p4/2PP4/8/PP2PPPP/RNBQKBNR w KQkq - 0 3,e3,18,13,-5,1
rnbqkbnr/ppp2ppp/4p3/3p4/2PP4/4P3/PP3PPP/RNBQKBNR b KQkq - 0 3,Nf6,12,4,-8,1
rnbqkb1r/ppp2ppp/4pn2/3p4/2PP4/4P3/PP3PPP/RNBQKBNR w KQkq - 1 4,Nf3,6,7,1,1
rnbqkb1r/ppp2ppp/4pn2/3p4/2PP4/4PN2/PP3PPP/RNBQKB1R b KQkq - 2 4,Be7,7,7,0,1
rnbqk2r/ppp1bppp/4pn2/3p4/2PP4/4PN2/PP3PPP/RNBQKB1R w KQkq - 3 5,cxd5,4,-17,-21,1
rnbqk2r/ppp1bppp/4pn2/3P4/3P4/4PN2/PP3PPP/RNBQKB1R b KQkq - 0 5,exd5,-11,-18,-7,1
rnbqk2r/ppp1bppp/5n2/3p4/3P4/4PN2/PP3PPP/RNBQKB1R w KQkq - 0 6,Nc3,-12,0,12,1
rnbqk2r/ppp1bppp/5n2/3p4/3P4/2N1PN2/PP3PPP/R1BQKB1R b KQkq - 1 6,O-O,0,0,0,1
rnbq1rk1/ppp1bppp/5n2/3p4/3P4/2N1PN2/PP3PPP/R1BQKB1R w KQ - 2 7,Bd3,0,-7,-7,1
rnbq1rk1/ppp1bppp/5n2/3p4/3P4/2NBPN2/PP3PPP/R1BQK2R b KQ - 3 7,b6,-3,27,30,1
rnbq1rk1/p1p1bppp/1p3n2/3p4/3P4/2NBPN2/PP3PPP/R1BQK2R w KQ - 0 8,Qc2,27,-20,-47,1
rnbq1rk1/p1p1bppp/1p3n2/3p4/3P4/2NBPN2/PPQ2PPP/R1B1K2R b KQ - 1 8,Bb7,-26,20,46,1
rn1q1rk1/pbp1bppp/1p3n2/3p4/3P4/2NBPN2/PPQ2PPP/R1B1K2R w KQ - 2 9,Ng5,20,-64,-84,1
rn1q1rk1/pbp1bppp/1p3n2/3p2N1/3P4/2NBP3/PPQ2PPP/R1B1K2R b KQ - 3 9,h6,-67,-41,26,1
rn1q1rk1/pbp1bpp1/1p3n1p/3p2N1/3P4/2NBP3/PPQ2PPP/R1B1K2R w KQ - 0 10,Nh7,-36,-60,-24,1
rn1q1rk1/pbp1bppN/1p3n1p/3p4/3P4/2NBP3/PPQ2PPP/R1B1K2R b KQ - 1 10,Nxh7,-47,-21,26,1
rn1q1rk1/pbp1bppn/1p5p/3p4/3P4/2NBP3/PPQ2PPP/R1B1K2R w KQ - 0 11,Bxh7+,-21,-23,-2,1
rn1q1rk1/pbp1bppB/1p5p/3p4/3P4/2N1P3/PPQ2PPP/R1B1K2R b KQ - 0 11,Kh8,-23,-15,8,1
rn1q1r1k/pbp1bppB/1p5p/3p4/3P4/2N1P3/PPQ2PPP/R1B1K2R w KQ - 1 12,g4,-18,-289,-271,0
rn1q1r1k/pbp1bppB/1p5p/3p4/3P2P1/2N1P3/PPQ2P1P/R1B1K2R b KQ - 0 12,Bb4,-321,-87,234,1
rn1q1r1k/pbp2ppB/1p5p/3p4/1b1P2P1/2N1P3/PPQ2P1P/R1B1K2R w KQ - 1 13,f4,-82,-426,-344,0
rn1q1r1k/pbp2ppB/1p5p/3p4/1b1P1PP1/2N1P3/PPQ4P/R1B1K2R b KQ - 0 13,Bxc3+,-421,-426,-5,1
rn1q1r1k/pbp2ppB/1p5p/3p4/3P1PP1/2b1P3/PPQ4P/R1B1K2R w KQ - 0 14,bxc3,-446,-426,20,1
rn1q1r1k/pbp2ppB/1p5p/3p4/3P1PP1/2P1P3/P1Q4P/R1B1K2R b KQ - 0 14,g6,-445,-196,249,1
rn1q1r1k/pbp2p1B/1p4pp/3p4/3P1PP1/2P1P3/P1Q4P/R1B1K2R w KQ - 0 15,Bxg6,-157,-417,-260,0
rn1q1r1k/pbp2p2/1p4Bp/3p4/3P1PP1/2P1P3/P1Q4P/R1B1K2R b KQ - 0 15,fxg6,-385,-298,87,1
rn1q1r1k/pbp5/1p4pp/3p4/3P1PP1/2P1P3/P1Q4P/R1B1K2R w KQ - 0 16,Qxg6,-291,-364,-73,1
rn1q1r1k/pbp5/1p4Qp/3p4/3P1PP1/2P1P3/P6P/R1B1K2R b KQ - 0 16,Qe7,-418,-102,316,1
rn3r1k/pbp1q3/1p4Qp/3p4/3P1PP1/2P1P3/P6P/R1B1K2R w KQ - 1 17,Qxh6+,-42,-144,-102,0
rn3r1k/pbp1q3/1p5Q/3p4/3P1PP1/2P1P3/P6P/R1B1K2R b KQ - 0 17,Kg8,-102,-106,-4,1
rn3rk1/pbp1q3/1p5Q/3p4/3P1PP1/2P1P3/P6P/R1B1K2R w KQ - 1 18,g5,-140,-128,12,1
rn3rk1/pbp1q3/1p5Q/3p2P1/3P1P2/2P1P3/P6P/R1B1K2R b KQ - 0 18,Qg7,-177,-60,117,1
rn3rk1/pbp3q1/1p5Q/3p2P1/3P1P2/2P1P3/P6P/R1B1K2R w KQ - 1 19,Qh5,-52,-127,-75,1
rn3rk1/pbp3q1/1p6/3p2PQ/3P1P2/2P1P3/P6P/R1B1K2R b KQ - 2 19,Nd7,-109,-87,22,1
r4rk1/pbpn2q1/1p6/3p2PQ/3P1P2/2P1P3/P6P/R1B1K2R w KQ - 3 20,h4,-123,-112,11,1
r4rk1/pbpn2q1/1p6/3p2PQ/3P1P1P/2P1P3/P7/R1B1K2R b KQ - 0 20,c5,-129,-111,18,1
r4rk1/pb1n2q1/1p6/2pp2PQ/3P1P1P/2P1P3/P7/R1B1K2R w KQ - 0 21,Qg4,-118,-202,-84,1
r4rk1/pb1n2q1/1p6/2pp2P1/3P1PQP/2P1P3/P7/R1B1K2R b KQ - 1 21,Bc8,-226,-68,158,1
r1b2rk1/p2n2q1/1p6/2pp2P1/3P1PQP/2P1P3/P7/R1B1K2R w KQ - 2 22,h5,-57,-213,-156,0
r1b2rk1/p2n2q1/1p6/2pp2PP/3P1PQ1/2P1P3/P7/R1B1K2R b KQ - 0 22,Nf6,-203,-205,-2,1
r1b2rk1/p5q1/1p3n2/2pp2PP/3P1PQ1/2P1P3/P7/R1B1K2R w KQ - 1 23,Qh4,-214,-217,-3,1
r1b2rk1/p5q1/1p3n2/2pp2PP/3P1P1Q/2P1P3/P7/R1B1K2R b KQ - 2 23,Ne4,-219,-207,12,1
r1b2rk1/p5q1/1p6/2pp2PP/3PnP1Q/2P1P3/P7/R1B1K2R w KQ - 3 24,Ba3,-218,-254,-36,1
r1b2rk1/p5q1/1p6/2pp2PP/3PnP1Q/B1P1P3/P7/R3K2R b KQ - 4 24,Nxc3,-278,-278,0,1
r1b2rk1/p5q1/1p6/2pp2PP/3P1P1Q/B1n1P3/P7/R3K2R w KQ - 0 25,dxc5,-277,-273,4,1
r1b2rk1/p5q1/1p6/2Pp2PP/5P1Q/B1n1P3/P7/R3K2R b KQ - 0 25,Qe7,-294,-248,46,1
r1b2rk1/p3q3/1p6/2Pp2PP/5P1Q/B1n1P3/P7/R3K2R w KQ - 1 26,Kd2,-279,-449,-170,0
r1b2rk1/p3q3/1p6/2Pp2PP/5P1Q/B1n1P3/P2K4/R6R b - - 2 26,Ne4+,-456,-350,106,1
r1b2rk1/p3q3/1p6/2Pp2PP/4nP1Q/B3P3/P2K4/R6R w - - 3 27,Ke2,-350,-334,16,1
r1b2rk1/p3q3/1p6/2Pp2PP/4nP1Q/B3P3/P3K3/R6R b - - 4 27,Nc3+,-373,-249,124,1
r1b2rk1/p3q3/1p6/2Pp2PP/5P1Q/B1n1P3/P3K3/R6R w - - 5 28,Kd3,-266,-696,-430,0
r1b2rk1/p3q3/1p6/2Pp2PP/5P1Q/B1nKP3/P7/R6R b - - 6 28,Nb5,-707,-364,343,1
r1b2rk1/p3q3/1p6/1nPp2PP/5P1Q/B2KP3/P7/R6R w - - 7 29,Bb2,-367,-415,-48,1
r1b2rk1/p3q3/1p6/1nPp2PP/5P1Q/3KP3/PB6/R6R b - - 8 29,Qe4+,-494,-442,52,1
r1b2rk1/p7/1p6/1nPp2PP/4qP1Q/3KP3/PB6/R6R w - - 9 30,Kd2,-477,-483,-6,1
r1b2rk1/p7/1p6/1nPp2PP/4qP1Q/4P3/PB1K4/R6R b - - 10 30,Re8,-481,-398,83,1
r1b1r1k1/p7/1p6/1nPp2PP/4qP1Q/4P3/PB1K4/R6R w - - 11 31,Qg3,-370,-497,-127,0
r1b1r1k1/p7/1p6/1nPp2PP/4qP2/4P1Q1/PB1K4/R6R b - - 12 31,d4,-549,-450,99,1
r1b1r1k1/p7/1p6/1nP3PP/3pqP2/4P1Q1/PB1K4/R6R w - - 0 32,Bxd4,-458,-576,-118,0
r1b1r1k1/p7/1p6/1nP3PP/3BqP2/4P1Q1/P2K4/R6R b - - 0 32,Nxd4,-620,-622,-2,1
r1b1r1k1/p7/1p6/2P3PP/3nqP2/4P1Q1/P2K4/R6R w - - 0 33,exd4,-633,-818,-185,0
r1b1r1k1/p7/1p6/2P3PP/3PqP2/6Q1/P2K4/R6R b - - 0 33,Qe2+,-769,-727,42,1
r1b1r1k1/p7/1p6/2P3PP/3P1P2/6Q1/P2Kq3/R6R w - - 1 34,Kc3,-9988,-9988,0,1
r1b1r1k1/p7/1p6/2P3PP/3P1P2/2K3Q1/P3q3/R6R b - - 2 34,Re3+,-9988,-9989,-1,1
r1b3k1/p7/1p6/2P3PP/3P1P2/2K1r1Q1/P3q3/R6R w - - 3 35,Qxe3,-9989,-9989,0,1
r1b3k1/p7/1p6/2P3PP/3P1P2/2K1Q3/P3q3/R6R b - - 0 35,Qxe3+,-9989,-9990,-1,1
r1b3k1/p7/1p6/2P3PP/3P1P2/2K1q3/P7/R6R w - - 0 36,Kc2,-9990,-9993,-3,1
r1b3k1/p7/1p6/2P3PP/3P1P2/4q3/P1K5/R6R b - - 1 36,Qxf4,-9993,-629,9364,1
r1b3k1/p7/1p6/2P3PP/3P1q2/8/P1K5/R6R w - - 0 37,Rhf1,-646,-9990,-9344,0
r1b3k1/p7/1p6/2P3PP/3P1q2/8/P1K5/R4R2 b - - 1 37,Qxd4,-9990,-569,9421,1
r1b3k1/p7/1p6/2P3PP/3q4/8/P1K5/R4R2 w - - 0 38,Rf8+,-569,-671,-102,0
r1b2Rk1/p7/1p6/2P3PP/3q4/8/P1K5/R7 b - - 1 38,Kxf8,-707,-707,0,1
r1b2k2/p7/1p6/2P3PP/3q4/8/P1K5/R7 w - - 0 39,Rf1+,-712,-754,-42,1
r1b2k2/p7/1p6/2P3PP/3q4/8/P1K5/5R2 b - - 1 39,Bf5+,-753,-618,135,1
r4k2/p7/1p6/2P2bPP/3q4/8/P1K5/5R2 w - - 2 40,Rxf5+,-634,-629,5,1
rnbqkbnr/pppppppp/8/8/8/8/PPPPPPPP/RNBQKBNR w KQkq - 0 1,Nf3,31,13,-18,1
rnbqkbnr/pppppppp/8/8/8/5N2/PPPPPPPP/RNBQKB1R b KQkq - 1 1,Nf6,9,28,19,1
rnbqkb1r/pppppppp/5n2/8/8/5N2/PPPPPPPP/RNBQKB1R w KQkq - 2 2,c4,29,17,-12,1
rnbqkb1r/pppppppp/5n2/8/2P5/5N2/PP1PPPPP/RNBQKB1R b KQkq - 0 2,g6,15,31,16,1
rnbqkb1r/pppppp1p/5np1/8/2P5/5N2/PP1PPPPP/RNBQKB1R w KQkq - 0 3,Nc3,39,24,-15,1
rnbqkb1r/pppppp1p/5np1/8/2P5/2N2N2/PP1PPPPP/R1BQKB1R b KQkq - 1 3,Bg7,16,34,18,1
rnbqk2r/ppppppbp/5np1/8/2P5/2N2N2/PP1PPPPP/R1BQKB1R w KQkq - 2 4,e4,28,32,4,1
rnbqk2r/ppppppbp/5np1/8/2P1P3/2N2N2/PP1P1PPP/R1BQKB1R b KQkq - 0 4,d6,28,46,18,1
rnbqk2r/ppp1ppbp/3p1np1/8/2P1P3/2N2N2/PP1P1PPP/R1BQKB1R w KQkq - 0 5,d4,43,19,-24,1
rnbqk2r/ppp1ppbp/3p1np1/8/2PPP3/2N2N2/PP3PPP/R1BQKB1R b KQkq - 0 5,O-O,38,36,-2,1
rnbq1rk1/ppp1ppbp/3p1np1/8/2PPP3/2N2N2/PP3PPP/R1BQKB1R w KQ - 1 6,Bg5,46,29,-17,1
rnbq1rk1/ppp1ppbp/3p1np1/6B1/2PPP3/2N2N2/PP3PPP/R2QKB1R b KQ - 2 6,Ne8,18,115,97,1
rnbqnrk1/ppp1ppbp/3p2p1/6B1/2PPP3/2N2N2/PP3PPP/R2QKB1R w KQ - 3 7,Be2,120,84,-36,1
rnbqnrk1/ppp1ppbp/3p2p1/6B1/2PPP3/2N2N2/PP2BPPP/R2QK2R b KQ - 4 7,h6,79,123,44,1
rnbqnrk1/ppp1ppb1/3p2pp/6B1/2PPP3/2N2N2/PP2BPPP/R2QK2R w KQ - 0 8,Be3,113,129,16,1
rnbqnrk1/ppp1ppb1/3p2pp/8/2PPP3/2N1BN2/PP2BPPP/R2QK2R b KQ - 1 8,Kh7,144,170,26,1
rnbqnr2/ppp1ppbk/3p2pp/8/2PPP3/2N1BN2/PP2BPPP/R2QK2R w KQ - 2 9,Nd2,171,49,-122,0
rnbqnr2/ppp1ppbk/3p2pp/8/2PPP3/2N1B3/PP1NBPPP/R2QK2R b KQ - 3 9,e5,53,104,51,1
rnbqnr2/ppp2pbk/3p2pp/4p3/2PPP3/2N1B3/PP1NBPPP/R2QK2R w KQ - 0 10,d5,100,110,10,1
rnbqnr2/ppp2pbk/3p2pp/3Pp3/2P1P3/2N1B3/PP1NBPPP/R2QK2R b KQ - 0 10,c5,114,194,80,1
rnbqnr2/pp3pbk/3p2pp/2pPp3/2P1P3/2N1B3/PP1NBPPP/R2QK2R w KQ c6 0 11,f3,195,164,-31,1
rnbqnr2/pp3pbk/3p2pp/2pPp3/2P1P3/2N1BP2/PP1NB1PP/R2QK2R b KQ - 0 11,a6,173,166,-7,1
rnbqnr2/1p3pbk/p2p2pp/2pPp3/2P1P3/2N1BP2/PP1NB1PP/R2QK2R w KQ - 0 12,h4,160,155,-5,1
rnbqnr2/1p3pbk/p2p2pp/2pPp3/2P1P2P/2N1BP2/PP1NB1P1/R2QK2R b KQ - 0 12,Bd7,151,174,23,1
rn1qnr2/1p1b1pbk/p2p2pp/2pPp3/2P1P2P/2N1BP2/PP1NB1P1/R2QK2R w KQ - 1 13,g4,174,168,-6,1
rn1qnr2/1p1b1pbk/p2p2pp/2pPp3/2P1P1PP/2N1BP2/PP1NB3/R2QK2R b KQ - 0 13,f6,166,228,62,1
rn1qnr2/1p1b2bk/p2p1ppp/2pPp3/2P1P1PP/2N1BP2/PP1NB3/R2QK2R w KQ - 0 14,h5,241,169,-72,1
rn1qnr2/1p1b2bk/p2p1ppp/2pPp2P/2P1P1P1/2N1BP2/PP1NB3/R2QK2R b KQ - 0 14,g5,164,168,4,1
rn1qnr2/1p1b2bk/p2p1p1p/2pPp1pP/2P1P1P1/2N1BP2/PP1NB3/R2QK2R w KQ - 0 15,Nf1,177,164,-13,1
rn1qnr2/1p1b2bk/p2p1p1p/2pPp1pP/2P1P1P1/2N1BP2/PP2B3/R2QKN1R b KQ - 1 15,Rf7,165,173,8,1
rn1qn3/1p1b1rbk/p2p1p1p/2pPp1pP/2P1P1P1/2N1BP2/PP2B3/R2QKN1R w KQ - 2 16,Ng3,172,164,-8,1
rn1qn3/1p1b1rbk/p2p1p1p/2pPp1pP/2P1P1P1/2N1BPN1/PP2B3/R2QK2R b KQ - 3 16,Bf8,152,165,13,1
rn1qnb2/1p1b1r1k/p2p1p1p/2pPp1pP/2P1P1P1/2N1BPN1/PP2B3/R2QK2R w KQ - 4 17,Nf5,184,154,-30,1
rn1qnb2/1p1b1r1k/p2p1p1p/2pPpNpP/2P1P1P1/2N1BP2/PP2B3/R2QK2R b KQ - 5 17,Bxf5,166,171,5,1
rn1qnb2/1p3r1k/p2p1p1p/2pPpbpP/2P1P1P1/2N1BP2/PP2B3/R2QK2R w KQ - 0 18,exf5,164,160,-4,1
rn1qnb2/1p3r1k/p2p1p1p/2pPpPpP/2P3P1/2N1BP2/PP2B3/R2QK2R b KQ - 0 18,Nd7,164,174,10,1
r2qnb2/1p1n1r1k/p2p1p1p/2pPpPpP/2P3P1/2N1BP2/PP2B3/R2QK2R w KQ - 1 19,Ne4,156,135,-21,1
r2qnb2/1p1n1r1k/p2p1p1p/2pPpPpP/2P1N1P1/4BP2/PP2B3/R2QK2R b KQ - 2 19,Nc7,138,136,-2,1
r2q1b2/1pnn1r1k/p2p1p1p/2pPpPpP/2P1N1P1/4BP2/PP2B3/R2QK2R w KQ - 3 20,a4,140,41,-99,1
r2q1b2/1pnn1r1k/p2p1p1p/2pPpPpP/P1P1N1P1/4BP2/1P2B3/R2QK2R b KQ - 0 20,Be7,41,235,194,1
r2q4/1pnnbr1k/p2p1p1p/2pPpPpP/P1P1N1P1/4BP2/1P2B3/R2QK2R w KQ - 1 21,Kf2,245,37,-208,0
r2q4/1pnnbr1k/p2p1p1p/2pPpPpP/P1P1N1P1/4BP2/1P2BK2/R2Q3R b - - 2 21,a5,39,37,-2,1
r2q4/1pnnbr1k/3p1p1p/p1pPpPpP/P1P1N1P1/4BP2/1P2BK2/R2Q3R w - - 0 22,Qd2,36,31,-5,1
r2q4/1pnnbr1k/3p1p1p/p1pPpPpP/P1P1N1P1/4BP2/1P1QBK2/R6R b - - 1 22,Na6,20,38,18,1
r2q4/1p1nbr1k/n2p1p1p/p1pPpPpP/P1P1N1P1/4BP2/1P1QBK2/R6R w - - 2 23,b3,33,50,17,1
r2q4/1p1nbr1k/n2p1p1p/p1pPpPpP/P1P1N1P1/1P2BP2/3QBK2/R6R b - - 0 23,Nb4,52,32,-20,1
r2q4/1p1nbr1k/3p1p1p/p1pPpPpP/PnP1N1P1/1P2BP2/3QBK2/R6R w - - 1 24,Qc3,57,44,-13,1
r2q4/1p1nbr1k/3p1p1p/p1pPpPpP/PnP1N1P1/1PQ1BP2/4BK2/R6R b - - 2 24,Qc7,36,43,7,1
r7/1pqnbr1k/3p1p1p/p1pPpPpP/PnP1N1P1/1PQ1BP2/4BK2/R6R w - - 3 25,Rag1,49,56,7,1
r7/1pqnbr1k/3p1p1p/p1pPpPpP/PnP1N1P1/1PQ1BP2/4BK2/6RR b - - 4 25,Rg8,56,56,0,1
6r1/1pqnbr1k/3p1p1p/p1pPpPpP/PnP1N1P1/1PQ1BP2/4BK2/6RR w - - 5 26,Bd3,56,57,1,1
6r1/1pqnbr1k/3p1p1p/p1pPpPpP/PnP1N1P1/1PQBBP2/5K2/6RR b - - 6 26,b6,38,43,5,1
6r1/2qnbr1k/1p1p1p1p/p1pPpPpP/PnP1N1P1/1PQBBP2/5K2/6RR w - - 0 27,Bb1,39,22,-17,1
6r1/2qnbr1k/1p1p1p1p/p1pPpPpP/PnP1N1P1/1PQ1BP2/5K2/1B4RR b - - 1 27,Qb8,30,55,25,1
rnbqkbnr/pppppppp/8/8/8/8/PPPPPPPP/RNBQKBNR w KQkq - 0 1,e4,30,24,-6,1
rnbqkbnr/pppppppp/8/8/4P3/8/PPPP1PPP/RNBQKBNR b KQkq - 0 1,e5,39,37,-2,1
rnbqkbnr/pppp1ppp/8/4p3/4P3/8/PPPP1PPP/RNBQKBNR w KQkq - 0 2,d4,30,2,-28,1
rnbqkbnr/pppp1ppp/8/4p3/3PP3/8/PPP2PPP/RNBQKBNR b KQkq - 0 2,exd4,-4,21,25,1
rnbqkbnr/pppp1ppp/8/8/3pP3/8/PPP2PPP/RNBQKBNR w KQkq - 0 3,Qxd4,4,-18,-22,1
rnbqkbnr/pppp1ppp/8/8/3QP3/8/PPP2PPP/RNB1KBNR b KQkq - 0 3,Nc6,-19,6,25,1
r1bqkbnr/pppp1ppp/2n5/8/3QP3/8/PPP2PPP/RNB1KBNR w KQkq - 1 4,Qe3,-24,-29,-5,1
r1bqkbnr/pppp1ppp/2n5/8/4P3/4Q3/PPP2PPP/RNB1KBNR b KQkq - 2 4,d6,-33,42,75,1
r1bqkbnr/ppp2ppp/2np4/8/4P3/4Q3/PPP2PPP/RNB1KBNR w KQkq - 0 5,Nc3,34,19,-15,1
r1bqkbnr/ppp2ppp/2np4/8/4P3/2N1Q3/PPP2PPP/R1B1KBNR b KQkq - 1 5,Nf6,43,43,0,1
r1bqkb1r/ppp2ppp/2np1n2/8/4P3/2N1Q3/PPP2PPP/R1B1KBNR w KQkq - 2 6,Be2,60,-21,-81,1
r1bqkb1r/ppp2ppp/2np1n2/8/4P3/2N1Q3/PPP1BPPP/R1B1K1NR b KQkq - 3 6,h6,-31,27,58,1
r1bqkb1r/ppp2pp1/2np1n1p/8/4P3/2N1Q3/PPP1BPPP/R1B1K1NR w KQkq - 0 7,a3,62,2,-60,1
r1bqkb1r/ppp2pp1/2np1n1p/8/4P3/P1N1Q3/1PP1BPPP/R1B1K1NR b KQkq - 0 7,Be6,22,34,12,1
r2qkb1r/ppp2pp1/2npbn1p/8/4P3/P1N1Q3/1PP1BPPP/R1B1K1NR w KQkq - 1 8,h3,37,-55,-92,1
r2qkb1r/ppp2pp1/2npbn1p/8/4P3/P1N1Q2P/1PP1BPP1/R1B1K1NR b KQkq - 0 8,Qe7,-67,36,103,1
r3kb1r/ppp1qpp1/2npbn1p/8/4P3/P1N1Q2P/1PP1BPP1/R1B1K1NR w KQkq - 1 9,Bd2,39,-29,-68,1
r3kb1r/ppp1qpp1/2npbn1p/8/4P3/P1N1Q2P/1PPBBPP1/R3K1NR b KQkq - 2 9,O-O-O,-11,0,11,1
2kr1b1r/ppp1qpp1/2npbn1p/8/4P3/P1N1Q2P/1PPBBPP1/R3K1NR w KQ - 3 10,Nf3,8,-3,-11,1
2kr1b1r/ppp1qpp1/2npbn1p/8/4P3/P1N1QN1P/1PPBBPP1/R3K2R b KQ - 4 10,d5,-7,-8,-1,1
2kr1b1r/ppp1qpp1/2n1bn1p/3p4/4P3/P1N1QN1P/1PPBBPP1/R3K2R w KQ - 0 11,exd5,-7,-2,5,1
2kr1b1r/ppp1qpp1/2n1bn1p/3P4/8/P1N1QN1P/1PPBBPP1/R3K2R b KQ - 0 11,Nxd5,-6,1,7,1
2kr1b1r/ppp1qpp1/2n1b2p/3n4/8/P1N1QN1P/1PPBBPP1/R3K2R w KQ - 0 12,Nxd5,1,-6,-7,1
2kr1b1r/ppp1qpp1/2n1b2p/3N4/8/P3QN1P/1PPBBPP1/R3K2R b KQ - 0 12,Bxd5,5,1,-4,1
2kr1b1r/ppp1qpp1/2n4p/3b4/8/P3QN1P/1PPBBPP1/R3K2R w KQ - 0 13,O-O,8,-20,-28,1
2kr1b1r/ppp1qpp1/2n4p/3b4/8/P3QN1P/1PPBBPP1/R4RK1 b - - 1 13,Qxe3,-25,-19,6,1
2kr1b1r/ppp2pp1/2n4p/3b4/8/P3qN1P/1PPBBPP1/R4RK1 w - - 0 14,Bxe3,-12,-9,3,1
2kr1b1r/ppp2pp1/2n4p/3b4/8/P3BN1P/1PP1BPP1/R4RK1 b - - 0 14,Bd6,-16,1,17,1
2kr3r/ppp2pp1/2nb3p/3b4/8/P3BN1P/1PP1BPP1/R4RK1 w - - 1 15,Rfd1,6,-11,-17,1
2kr3r/ppp2pp1/2nb3p/3b4/8/P3BN1P/1PP1BPP1/R2R2K1 b - - 2 15,Be4,-6,-8,-2,1
2kr3r/ppp2pp1/2nb3p/8/4b3/P3BN1P/1PP1BPP1/R2R2K1 w - - 3 16,c3,-3,-4,-1,1
2kr3r/ppp2pp1/2nb3p/8/4b3/P1P1BN1P/1P2BPP1/R2R2K1 b - - 0 16,Rhe8,1,1,0,1
2krr3/ppp2pp1/2nb3p/8/4b3/P1P1BN1P/1P2BPP1/R2R2K1 w - - 1 17,Nd2,-4,-9,-5,1
2krr3/ppp2pp1/2nb3p/8/4b3/P1P1B2P/1P1NBPP1/R2R2K1 b - - 2 17,Bf5,-12,-6,6,1
2krr3/ppp2pp1/2nb3p/5b2/8/P1P1B2P/1P1NBPP1/R2R2K1 w - - 3 18,Bf3,-4,-36,-32,1
2krr3/ppp2pp1/2nb3p/5b2/8/P1P1BB1P/1P1N1PP1/R2R2K1 b - - 4 18,Ne5,-29,-42,-13,1
2krr3/ppp2pp1/3b3p/4nb2/8/P1P1BB1P/1P1N1PP1/R2R2K1 w - - 5 19,Be4,-24,-53,-29,1
2krr3/ppp2pp1/3b3p/4nb2/4B3/P1P1B2P/1P1N1PP1/R2R2K1 b - - 6 19,Bxe4,-40,-51,-11,1
2krr3/ppp2pp1/3b3p/4n3/4b3/P1P1B2P/1P1N1PP1/R2R2K1 w - - 0 20,Nxe4,-38,-41,-3,1
2krr3/ppp2pp1/3b3p/4n3/4N3/P1P1B2P/1P3PP1/R2R2K1 b - - 0 20,Nc4,-44,-46,-2,1
2krr3/ppp2pp1/3b3p/8/2n1N3/P1P1B2P/1P3PP1/R2R2K1 w - - 1 21,Nxd6+,-36,-41,-5,1
2krr3/ppp2pp1/3N3p/8/2n5/P1P1B2P/1P3PP1/R2R2K1 b - - 0 21,Nxd6,-28,-25,3,1
2krr3/ppp2pp1/3n3p/8/8/P1P1B2P/1P3PP1/R2R2K1 w - - 0 22,a4,-18,-46,-28,1
2krr3/ppp2pp1/3n3p/8/P7/2P1B2P/1P3PP1/R2R2K1 b - - 0 22,b6,-52,-7,45,1
2krr3/p1p2pp1/1p1n3p/8/P7/2P1B2P/1P3PP1/R2R2K1 w - - 0 23,a5,-14,-11,3,1
2krr3/p1p2pp1/1p1n3p/P7/8/2P1B2P/1P3PP1/R2R2K1 b - - 0 23,Kb7,-18,-22,-4,1
3rr3/pkp2pp1/1p1n3p/P7/8/2P1B2P/1P3PP1/R2R2K1 w - - 1 24,axb6,-17,-23,-6,1
3rr3/pkp2pp1/1P1n3p/8/8/2P1B2P/1P3PP1/R2R2K1 b - - 0 24,axb6,-24,-16,8,1
3rr3/1kp2pp1/1p1n3p/8/8/2P1B2P/1P3PP1/R2R2K1 w - - 0 25,b3,-16,-32,-16,1
3rr3/1kp2pp1/1p1n3p/8/8/1PP1B2P/5PP1/R2R2K1 b - - 0 25,Nb5,-27,19,46,1
3rr3/1kp2pp1/1p5p/1n6/8/1PP1B2P/5PP1/R2R2K1 w - - 1 26,c4,15,8,-7,1
3rr3/1kp2pp1/1p5p/1n6/2P5/1P2B2P/5PP1/R2R2K1 b - - 0 26,Nc3,15,19,4,1
3rr3/1kp2pp1/1p5p/8/2P5/1Pn1B2P/5PP1/R2R2K1 w - - 1 27,Rxd8,14,5,-9,1
3Rr3/1kp2pp1/1p5p/8/2P5/1Pn1B2P/5PP1/R5K1 b - - 0 27,Rxd8,0,1,1,1
3r4/1kp2pp1/1p5p/8/2P5/1Pn1B2P/5PP1/R5K1 w - - 0 28,c5,6,-197,-203,0
3r4/1kp2pp1/1p5p/2P5/8/1Pn1B2P/5PP1/R5K1 b - - 0 28,Nd1,-149,-43,106,1
3r4/1kp2pp1/1p5p/2P5/8/1P2B2P/5PP1/R2n2K1 w - - 1 29,cxb6,-45,-21,24,1
3r4/1kp2pp1/1P5p/8/8/1P2B2P/5PP1/R2n2K1 b - - 0 29,Nxe3,-18,-13,5,1
3r4/1kp2pp1/1P5p/8/8/1P2n2P/5PP1/R5K1 w - - 0 30,bxc7,-20,-336,-316,0
3r4/1kP2pp1/7p/8/8/1P2n2P/5PP1/R5K1 b - - 0 30,Kxc7,-342,136,478,1
3r4/2k2pp1/7p/8/8/1P2n2P/5PP1/R5K1 w - - 0 31,fxe3,113,52,-61,1
3r4/2k2pp1/7p/8/8/1P2P2P/6P1/R5K1 b - - 0 31,Rd3,77,269,192,1
8/2k2pp1/7p/8/8/1P1rP2P/6P1/R5K1 w - - 1 32,Rc1+,327,10,-317,0
8/2k2pp1/7p/8/8/1P1rP2P/6P1/2R3K1 b - - 2 32,Kd6,20,13,-7,1
8/5pp1/3k3p/8/8/1P1rP2P/6P1/2R3K1 w - - 3 33,b4,18,5,-13,1
8/5pp1/3k3p/8/1P6/3rP2P/6P1/2R3K1 b - - 0 33,Rb3,1,10,9,1
8/5pp1/3k3p/8/1P6/1r2P2P/6P1/2R3K1 w - - 1 34,Rc4,12,-3,-15,1
8/5pp1/3k3p/8/1PR5/1r2P2P/6P1/6K1 b - - 2 34,Rxe3,0,0,0,1
8/5pp1/3k3p/8/1PR5/4r2P/6P1/6K1 w - - 0 35,Kf2,-6,-13,-7,1
8/5pp1/3k3p/8/1PR5/4r2P/5KP1/8 b - - 1 35,Rb3,-21,-7,14,1
8/5pp1/3k3p/8/1PR5/1r5P/5KP1/8 w - - 2 36,h4,-4,-4,0,1
8/5pp1/3k3p/8/1PR4P/1r6/5KP1/8 b - - 0 36,Ke6,-3,-4,-1,1
8/5pp1/4k2p/8/1PR4P/1r6/5KP1/8 w - - 1 37,g4,-1,-1,0,1
8/5pp1/4k2p/8/1PR3PP/1r6/5K2/8 b - - 0 37,Kf6,-1,0,1,1
8/5pp1/5k1p/8/1PR3PP/1r6/5K2/8 w - - 1 38,Ke2,0,-4,-4,1
8/5pp1/5k1p/8/1PR3PP/1r6/4K3/8 b - - 2 38,g6,0,1,1,1
8/5p2/5kpp/8/1PR3PP/1r6/4K3/8 w - - 0 39,Kd2,8,13,5,1
8/5p2/5kpp/8/1PR3PP/1r6/3K4/8 b - - 1 39,Rh3,25,22,-3,1
8/5p2/5kpp/8/1PR3PP/7r/3K4/8 w - - 2 40,b5,12,0,-12,1
8/5p2/5kpp/1P6/2R3PP/7r/3K4/8 b - - 0 40,Ra3,-7,164,171,1
8/5p2/5kpp/1P6/2R3PP/r7/3K4/8 w - - 1 41,Rb4,178,165,-13,1
8/5p2/5kpp/1P6/1R4PP/r7/3K4/8 b - - 2 41,Ra8,186,165,-21,1
r7/5p2/5kpp/1P6/1R4PP/8/3K4/8 w - - 3 42,b6,149,146,-3,1
r7/5p2/1P3kpp/8/1R4PP/8/3K4/8 b - - 0 42,Rb8,153,179,26,1
1r6/5p2/1P3kpp/8/1R4PP/8/3K4/8 w - - 1 43,b7,177,133,-44,1
1r6/1P3p2/5kpp/8/1R4PP/8/3K4/8 b - - 0 43,Ke6,143,258,115,1
1r6/1P3p2/4k1pp/8/1R4PP/8/3K4/8 w - - 1 44,Kd3,248,247,-1,1
1r6/1P3p2/4k1pp/8/1R4PP/3K4/8/8 b - - 2 44,f5,268,280,12,1
1r6/1P6/4k1pp/5p2/1R4PP/3K4/8/8 w - - 0 45,g5,302,32,-270,0
1r6/1P6/4k1pp/5pP1/1R5P/3K4/8/8 b - - 0 45,hxg5,33,39,6,1
1r6/1P6/4k1p1/5pp1/1R5P/3K4/8/8 w - - 0 46,hxg5,26,39,13,1
1r6/1P6/4k1p1/5pP1/1R6/3K4/8/8 b - - 0 46,Ke5,12,389,377,1
1r6/1P6/6p1/4kpP1/1R6/3K4/8/8 w - - 1 47,Ke3,443,386,-57,1
1r6/1P6/6p1/4kpP1/1R6/4K3/8/8 b - - 2 47,Kd6,434,432,-2,1
1r6/1P6/3k2p1/5pP1/1R6/4K3/8/8 w - - 3 48,Kd4,481,15,-466,0
1r6/1P6/3k2p1/5pP1/1R1K4/8/8/8 b - - 4 48,Kc6,5,8,3,1
1r6/1P6/2k3p1/5pP1/1R1K4/8/8/8 w - - 5 49,Ke5,9,0,-9,1
1r6/1P6/2k3p1/4KpP1/1R6/8/8/8 b - - 6 49,Rxb7,0,0,0,1
8/1r6/2k3p1/4KpP1/1R6/8/8/8 w - - 0 50,Rc4+,0,0,0,1
8/1r6/2k3p1/4KpP1/2R5/8/8/8 b - - 1 50,Kd7,0,1,1,1
8/1r1k4/6p1/4KpP1/2R5/8/8/8 w - - 2 51,Kf6,3,0,-3,1
8/1r1k4/5Kp1/5pP1/2R5/8/8/8 b - - 3 51,Rb6+,0,0,0,1
8/3k4/1r3Kp1/5pP1/2R5/8/8/8 w - - 4 52,Kg7,0,0,0,1
8/3k2K1/1r4p1/5pP1/2R5/8/8/8 b - - 5 52,Ke7,0,12,12,1
8/4k1K1/1r4p1/5pP1/2R5/8/8/8 w - - 6 53,Rc7+,33,7,-26,1
8/2R1k1K1/1r4p1/5pP1/8/8/8/8 b - - 7 53,Ke6,5,28,23,1
8/2R3K1/1r2k1p1/5pP1/8/8/8/8 w - - 8 54,Kxg6,8,5,-3,1
8/2R5/1r2k1K1/5pP1/8/8/8/8 b - - 0 54,Ke5+,7,14,7,1
8/2R5/1r4K1/4kpP1/8/8/8/8 w - - 1 55,Kh5,13,0,-13,1
8/2R5/1r6/4kpPK/8/8/8/8 b - - 2 55,f4,1,293,292,1
8/2R5/1r6/4k1PK/5p2/8/8/8 w - - 0 56,Rf7,277,0,-277,0
8/5R2/1r6/4k1PK/5p2/8/8/8 b - - 1 56,Ke4,0,406,406,1
8/5R2/1r6/6PK/4kp2/8/8/8 w - - 2 57,g6,394,0,-394,0
8/5R2/1r4P1/7K/4kp2/8/8/8 b - - 0 57,Rb8,0,437,437,1
1r6/5R2/6P1/7K/4kp2/8/8/8 w - - 1 58,g7,446,0,-446,0
1r6/5RP1/8/7K/4kp2/8/8/8 b - - 0 58,Rg8,0,4,4,1
6r1/5RP1/8/7K/4kp2/8/8/8 w - - 1 59,Kh6,0,0,0,1
6r1/5RP1/7K/8/4kp2/8/8/8 b - - 2 59,f3,0,0,0,1
6r1/5RP1/7K/8/4k3/5p2/8/8 w - - 0 60,Kh7,0,0,0,1
6r1/5RPK/8/8/4k3/5p2/8/8 b - - 1 60,f2,0,706,706,1
6r1/5RPK/8/8/4k3/8/5p2/8 w - - 0 61,Rxf2,699,461,-238,0
6r1/6PK/8/8/4k3/8/5R2/8 b - - 0 61,Ra8,444,508,64,1
r7/6PK/8/8/4k3/8/5R2/8 w - - 1 62,g8=Q,494,440,-54,1
r5Q1/7K/8/8/4k3/8/5R2/8 b - - 0 62,Ra7+,434,659,225,1
6Q1/r6K/8/8/4k3/8/5R2/8 w - - 1 63,Kh6,676,707,31,1
6Q1/r7/7K/8/4k3/8/5R2/8 b - - 2 63,Ra6+,727,697,-30,1
6Q1/8/r6K/8/4k3/8/5R2/8 w - - 3 64,Kh5,878,906,28,1
6Q1/8/r7/7K/4k3/8/5R2/8 b - - 4 64,Ra5+,907,923,16,1
6Q1/8/8/r6K/4k3/8/5R2/8 w - - 5 65,Kh4,915,965,50,1
rnbqkbnr/pppppppp/8/8/8/8/PPPPPPPP/RNBQKBNR w KQkq - 0 1,e4,27,36,9,1
rnbqkbnr/pppppppp/8/8/4P3/8/PPPP1PPP/RNBQKBNR b KQkq - 0 1,c5,31,27,-4,1
rnbqkbnr/pp1ppppp/8/2p5/4P3/8/PPPP1PPP/RNBQKBNR w KQkq - 0 2,Nf3,31,28,-3,1
rnbqkbnr/pp1ppppp/8/2p5/4P3/5N2/PPPP1PPP/RNBQKB1R b KQkq - 1 2,d6,26,23,-3,1
rnbqkbnr/pp2pppp/3p4/2p5/4P3/5N2/PPPP1PPP/RNBQKB1R w KQkq - 0 3,d4,27,30,3,1
rnbqkbnr/pp2pppp/3p4/2p5/3PP3/5N2/PPP2PPP/RNBQKB1R b KQkq - 0 3,cxd4,35,34,-1,1
rnbqkbnr/pp2pppp/3p4/8/3pP3/5N2/PPP2PPP/RNBQKB1R w KQkq - 0 4,Qxd4,50,14,-36,1
rnbqkbnr/pp2pppp/3p4/8/3QP3/5N2/PPP2PPP/RNB1KB1R b KQkq - 0 4,Nf6,7,62,55,1
rnbqkb1r/pp2pppp/3p1n2/8/3QP3/5N2/PPP2PPP/RNB1KB1R w KQkq - 1 5,e5,89,75,-14,1
rnbqkb1r/pp2pppp/3p1n2/4P3/3Q4/5N2/PPP2PPP/RNB1KB1R b KQkq - 0 5,dxe5,24,144,120,1
rnbqkb1r/pp2pppp/5n2/4p3/3Q4/5N2/PPP2PPP/RNB1KB1R w KQkq - 0 6,Qxd8+,132,116,-16,1
rnbQkb1r/pp2pppp/5n2/4p3/8/5N2/PPP2PPP/RNB1KB1R b KQkq - 0 6,Kxd8,111,98,-13,1
rnbk1b1r/pp2pppp/5n2/4p3/8/5N2/PPP2PPP/RNB1KB1R w KQ - 0 7,Nxe5,118,109,-9,1
rnbk1b1r/pp2pppp/5n2/4N3/8/8/PPP2PPP/RNB1KB1R b KQ - 0 7,Be6,110,146,36,1
rn1k1b1r/pp2pppp/4bn2/4N3/8/8/PPP2PPP/RNB1KB1R w KQ - 1 8,Nc3,155,113,-42,1
rn1k1b1r/pp2pppp/4bn2/4N3/8/2N5/PPP2PPP/R1B1KB1R b KQ - 2 8,a6,96,167,71,1
rn1k1b1r/1p2pppp/p3bn2/4N3/8/2N5/PPP2PPP/R1B1KB1R w KQ - 0 9,Be3,181,84,-97,1
rn1k1b1r/1p2pppp/p3bn2/4N3/8/2N1B3/PPP2PPP/R3KB1R b KQ - 1 9,Nbd7,59,75,16,1
r2k1b1r/1p1npppp/p3bn2/4N3/8/2N1B3/PPP2PPP/R3KB1R w KQ - 2 10,O-O-O,73,67,-6,1
r2k1b1r/1p1npppp/p3bn2/4N3/8/2N1B3/PPP2PPP/2KR1B1R b - - 3 10,Ke8,92,97,5,1
r3kb1r/1p1npppp/p3bn2/4N3/8/2N1B3/PPP2PPP/2KR1B1R w - - 4 11,f4,87,67,-20,1
r3kb1r/1p1npppp/p3bn2/4N3/5P2/2N1B3/PPP3PP/2KR1B1R b - - 0 11,Ng4,62,80,18,1
r3kb1r/1p1npppp/p3b3/4N3/5Pn1/2N1B3/PPP3PP/2KR1B1R w - - 1 12,Bd4,91,46,-45,1
r3kb1r/1p1npppp/p3b3/4N3/3B1Pn1/2N5/PPP3PP/2KR1B1R b - - 2 12,f6,42,219,177,1
r3kb1r/1p1np1pp/p3bp2/4N3/3B1Pn1/2N5/PPP3PP/2KR1B1R w - - 0 13,Nxd7,234,272,38,1
r3kb1r/1p1Np1pp/p3bp2/8/3B1Pn1/2N5/PPP3PP/2KR1B1R b - - 0 13,Bxd7,272,271,-1,1
r3kb1r/1p1bp1pp/p4p2/8/3B1Pn1/2N5/PPP3PP/2KR1B1R w - - 0 14,h3,282,266,-16,1
r3kb1r/1p1bp1pp/p4p2/8/3B1Pn1/2N4P/PPP3P1/2KR1B1R b - - 0 14,Nh6,277,271,-6,1
r3kb1r/1p1bp1pp/p4p1n/8/3B1P2/2N4P/PPP3P1/2KR1B1R w - - 1 15,Bc4,266,214,-52,1
r3kb1r/1p1bp1pp/p4p1n/8/2BB1P2/2N4P/PPP3P1/2KR3R b - - 2 15,Rc8,214,253,39,1
2r1kb1r/1p1bp1pp/p4p1n/8/2BB1P2/2N4P/PPP3P1/2KR3R w - - 3 16,Bb3,257,210,-47,1
2r1kb1r/1p1bp1pp/p4p1n/8/3B1P2/1BN4P/PPP3P1/2KR3R b - - 4 16,Nf5,203,219,16,1
2r1kb1r/1p1bp1pp/p4p2/5n2/3B1P2/1BN4P/PPP3P1/2KR3R w - - 5 17,Bb6,215,189,-26,1
2r1kb1r/1p1bp1pp/pB3p2/5n2/5P2/1BN4P/PPP3P1/2KR3R b - - 6 17,Rc6,155,200,45,1
4kb1r/1p1bp1pp/pBr2p2/5n2/5P2/1BN4P/PPP3P1/2KR3R w - - 7 18,Bf2,218,167,-51,1
4kb1r/1p1bp1pp/p1r2p2/5n2/5P2/1BN4P/PPP2BP1/2KR3R b - - 8 18,Nd6,187,218,31,1
4kb1r/1p1bp1pp/p1rn1p2/8/5P2/1BN4P/PPP2BP1/2KR3R w - - 9 19,g4,211,95,-116,0
4kb1r/1p1bp1pp/p1rn1p2/8/5PP1/1BN4P/PPP2B2/2KR3R b - - 0 19,h5,81,89,8,1
4kb1r/1p1bp1p1/p1rn1p2/7p/5PP1/1BN4P/PPP2B2/2KR3R w - - 0 20,Rhe1,77,-133,-210,0
4kb1r/1p1bp1p1/p1rn1p2/7p/5PP1/1BN4P/PPP2B2/2KRR3 b - - 1 20,hxg4,-55,-52,3,1
4kb1r/1p1bp1p1/p1rn1p2/8/5Pp1/1BN4P/PPP2B2/2KRR3 w - - 0 21,hxg4,-16,-49,-33,1
4kb1r/1p1bp1p1/p1rn1p2/8/5PP1/1BN5/PPP2B2/2KRR3 b - - 0 21,Bxg4,-53,-47,6,1
4kb1r/1p2p1p1/p1rn1p2/8/5Pb1/1BN5/PPP2B2/2KRR3 w - - 0 22,Rd3,-44,-110,-66,1
4kb1r/1p2p1p1/p1rn1p2/8/5Pb1/1BNR4/PPP2B2/2K1R3 b - - 1 22,Rh3,-95,-25,70,1
4kb2/1p2p1p1/p1rn1p2/8/5Pb1/1BNR3r/PPP2B2/2K1R3 w - - 2 23,Bd5,-24,-63,-39,1
4kb2/1p2p1p1/p1rn1p2/3B4/5Pb1/2NR3r/PPP2B2/2K1R3 b - - 3 23,Rxd3,-54,194,248,1
4kb2/1p2p1p1/p1rn1p2/3B4/5Pb1/2Nr4/PPP2B2/2K1R3 w - - 0 24,cxd3,178,-76,-254,0
4kb2/1p2p1p1/p1rn1p2/3B4/5Pb1/2NP4/PP3B2/2K1R3 b - - 0 24,Rc8,-76,-53,23,1
2r1kb2/1p2p1p1/p2n1p2/3B4/5Pb1/2NP4/PP3B2/2K1R3 w - - 1 25,Bb6,-65,-115,-50,1
2r1kb2/1p2p1p1/pB1n1p2/3B4/5Pb1/2NP4/PP6/2K1R3 b - - 2 25,Bd7,-111,-72,39,1
2r1kb2/1p1bp1p1/pB1n1p2/3B4/5P2/2NP4/PP6/2K1R3 w - - 3 26,Kd2,-67,-62,5,1
2r1kb2/1p1bp1p1/pB1n1p2/3B4/5P2/2NP4/PP1K4/4R3 b - - 4 26,Bc6,-59,-39,20,1
2r1kb2/1p2p1p1/pBbn1p2/3B4/5P2/2NP4/PP1K4/4R3 w - - 5 27,Bb3,-33,-42,-9,1
2r1kb2/1p2p1p1/pBbn1p2/8/5P2/1BNP4/PP1K4/4R3 b - - 6 27,Nb5,-38,14,52,1
2r1kb2/1p2p1p1/pBb2p2/1n6/5P2/1BNP4/PP1K4/4R3 w - - 7 28,Na4,42,-40,-82,1
2r1kb2/1p2p1p1/pBb2p2/1n6/N4P2/1B1P4/PP1K4/4R3 b - - 8 28,e5,-46,55,101,1
2r1kb2/1p4p1/pBb2p2/1n2p3/N4P2/1B1P4/PP1K4/4R3 w - - 0 29,Be6,52,-60,-112,0
2r1kb2/1p4p1/pBb1Bp2/1n2p3/N4P2/3P4/PP1K4/4R3 b - - 1 29,Ra8,-55,46,101,1
r3kb2/1p4p1/pBb1Bp2/1n2p3/N4P2/3P4/PP1K4/4R3 w - - 2 30,fxe5,41,37,-4,1
r3kb2/1p4p1/pBb1Bp2/1n2P3/N7/3P4/PP1K4/4R3 b - - 0 30,Bb4+,36,32,-4,1
r3k3/1p4p1/pBb1Bp2/1n2P3/Nb6/3P4/PP1K4/4R3 w - - 1 31,Nc3,36,21,-15,1
r3k3/1p4p1/pBb1Bp2/1n2P3/1b6/2NP4/PP1K4/4R3 b - - 2 31,f5,23,273,250,1
r3k3/1p4p1/pBb1B3/1n2Pp2/1b6/2NP4/PP1K4/4R3 w - - 0 32,Bxf5,271,272,1,1
r3k3/1p4p1/pBb5/1n2PB2/1b6/2NP4/PP1K4/4R3 b - - 0 32,Ke7,262,333,71,1
r7/1p2k1p1/pBb5/1n2PB2/1b6/2NP4/PP1K4/4R3 w - - 1 33,Kc2,337,151,-186,0
r7/1p2k1p1/pBb5/1n2PB2/1b6/2NP4/PPK5/4R3 b - - 2 33,Bxc3,135,387,252,1
r7/1p2k1p1/pBb5/1n2PB2/8/2bP4/PPK5/4R3 w - - 0 34,bxc3,404,436,32,1
r7/1p2k1p1/pBb5/1n2PB2/8/2PP4/P1K5/4R3 b - - 0 34,Kf8,434,453,19,1
r4k2/1p4p1/pBb5/1n2PB2/8/2PP4/P1K5/4R3 w - - 1 35,Be4,479,234,-245,0
r4k2/1p4p1/pBb5/1n2P3/4B3/2PP4/P1K5/4R3 b - - 2 35,Kg8,248,406,158,1
rnbqkbnr/pppppppp/8/8/8/8/PPPPPPPP/RNBQKBNR w KQkq - 0 1,d4,38,12,-26,1
rnbqkbnr/pppppppp/8/8/3P4/8/PPP1PPPP/RNBQKBNR b KQkq - 0 1,c5,17,80,63,1
rnbqkbnr/pp1ppppp/8/2p5/3P4/8/PPP1PPPP/RNBQKBNR w KQkq - 0 2,c3,94,4,-90,1
rnbqkbnr/pp1ppppp/8/2p5/3P4/2P5/PP2PPPP/RNBQKBNR b KQkq - 0 2,cxd4,4,8,4,1
rnbqkbnr/pp1ppppp/8/8/3p4/2P5/PP2PPPP/RNBQKBNR w KQkq - 0 3,cxd4,8,12,4,1
rnbqkbnr/pp1ppppp/8/8/3P4/8/PP2PPPP/RNBQKBNR b KQkq - 0 3,d5,11,9,-2,1
rnbqkbnr/pp2pppp/8/3p4/3P4/8/PP2PPPP/RNBQKBNR w KQkq - 0 4,Nf3,18,25,7,1
rnbqkbnr/pp2pppp/8/3p4/3P4/5N2/PP2PPPP/RNBQKB1R b KQkq - 1 4,Nc6,17,23,6,1
r1bqkbnr/pp2pppp/2n5/3p4/3P4/5N2/PP2PPPP/RNBQKB1R w KQkq - 2 5,Nc3,27,25,-2,1
r1bqkbnr/pp2pppp/2n5/3p4/3P4/2N2N2/PP2PPPP/R1BQKB1R b KQkq - 3 5,e6,31,32,1,1
r1bqkbnr/pp3ppp/2n1p3/3p4/3P4/2N2N2/PP2PPPP/R1BQKB1R w KQkq - 0 6,Bf4,32,34,2,1
r1bqkbnr/pp3ppp/2n1p3/3p4/3P1B2/2N2N2/PP2PPPP/R2QKB1R b KQkq - 1 6,Nf6,27,32,5,1
r1bqkb1r/pp3ppp/2n1pn2/3p4/3P1B2/2N2N2/PP2PPPP/R2QKB1R w KQkq - 2 7,e3,34,44,10,1
r1bqkb1r/pp3ppp/2n1pn2/3p4/3P1B2/2N1PN2/PP3PPP/R2QKB1R b KQkq - 0 7,Bd6,45,40,-5,1
r1bqk2r/pp3ppp/2nbpn2/3p4/3P1B2/2N1PN2/PP3PPP/R2QKB1R w KQkq - 1 8,Bg5,40,39,-1,1
r1bqk2r/pp3ppp/2nbpn2/3p2B1/3P4/2N1PN2/PP3PPP/R2QKB1R b KQkq - 2 8,Be7,40,47,7,1
r1bqk2r/pp2bppp/2n1pn2/3p2B1/3P4/2N1PN2/PP3PPP/R2QKB1R w KQkq - 3 9,Be2,40,33,-7,1
r1bqk2r/pp2bppp/2n1pn2/3p2B1/3P4/2N1PN2/PP2BPPP/R2QK2R b KQkq - 4 9,O-O,30,30,0,1
r1bq1rk1/pp2bppp/2n1pn2/3p2B1/3P4/2N1PN2/PP2BPPP/R2QK2R w KQ - 5 10,Qc2,31,11,-20,1
r1bq1rk1/pp2bppp/2n1pn2/3p2B1/3P4/2N1PN2/PPQ1BPPP/R3K2R b KQ - 6 10,h6,13,11,-2,1
r1bq1rk1/pp2bpp1/2n1pn1p/3p2B1/3P4/2N1PN2/PPQ1BPPP/R3K2R w KQ - 0 11,Bh4,8,18,10,1
r1bq1rk1/pp2bpp1/2n1pn1p/3p4/3P3B/2N1PN2/PPQ1BPPP/R3K2R b KQ - 1 11,a6,16,24,8,1
r1bq1rk1/1p2bpp1/p1n1pn1p/3p4/3P3B/2N1PN2/PPQ1BPPP/R3K2R w KQ - 0 12,h3,24,13,-11,1
r1bq1rk1/1p2bpp1/p1n1pn1p/3p4/3P3B/2N1PN1P/PPQ1BPP1/R3K2R b KQ - 0 12,b5,12,20,8,1
r1bq1rk1/4bpp1/p1n1pn1p/1p1p4/3P3B/2N1PN1P/PPQ1BPP1/R3K2R w KQ - 0 13,a4,18,-11,-29,1
r1bq1rk1/4bpp1/p1n1pn1p/1p1p4/P2P3B/2N1PN1P/1PQ1BPP1/R3K2R b KQ - 0 13,b4,-16,0,16,1
r1bq1rk1/4bpp1/p1n1pn1p/3p4/Pp1P3B/2N1PN1P/1PQ1BPP1/R3K2R w KQ - 0 14,Na2,0,-10,-10,1
r1bq1rk1/4bpp1/p1n1pn1p/3p4/Pp1P3B/4PN1P/NPQ1BPP1/R3K2R b KQ - 1 14,Bd7,-12,-2,10,1
r2q1rk1/3bbpp1/p1n1pn1p/3p4/Pp1P3B/4PN1P/NPQ1BPP1/R3K2R w KQ - 2 15,Bg3,12,-112,-124,0
r2q1rk1/3bbpp1/p1n1pn1p/3p4/Pp1P4/4PNBP/NPQ1BPP1/R3K2R b KQ - 3 15,a5,-133,1,134,1
r2q1rk1/3bbpp1/2n1pn1p/p2p4/Pp1P4/4PNBP/NPQ1BPP1/R3K2R w KQ - 0 16,b3,7,-88,-95,1
r2q1rk1/3bbpp1/2n1pn1p/p2p4/Pp1P4/1P2PNBP/N1Q1BPP1/R3K2R b KQ - 0 16,Na7,-97,-18,79,1
r2q1rk1/n2bbpp1/4pn1p/p2p4/Pp1P4/1P2PNBP/N1Q1BPP1/R3K2R w KQ - 1 17,Nc1,-8,-77,-69,1
r2q1rk1/n2bbpp1/4pn1p/p2p4/Pp1P4/1P2PNBP/2Q1BPP1/R1N1K2R b KQ - 2 17,Rc8,-78,-39,39,1
2rq1rk1/n2bbpp1/4pn1p/p2p4/Pp1P4/1P2PNBP/2Q1BPP1/R1N1K2R w KQ - 3 18,Qb2,-30,-24,6,1
2rq1rk1/n2bbpp1/4pn1p/p2p4/Pp1P4/1P2PNBP/1Q2BPP1/R1N1K2R b KQ - 4 18,Nc6,-30,27,57,1
2rq1rk1/3bbpp1/2n1pn1p/p2p4/Pp1P4/1P2PNBP/1Q2BPP1/R1N1K2R w KQ - 5 19,Nd3,35,-107,-142,0
2rq1rk1/3bbpp1/2n1pn1p/p2p4/Pp1P4/1P1NPNBP/1Q2BPP1/R3K2R b KQ - 6 19,Be8,-67,24,91,1
2rqbrk1/4bpp1/2n1pn1p/p2p4/Pp1P4/1P1NPNBP/1Q2BPP1/R3K2R w KQ - 7 20,Nde5,2,-180,-182,0
2rqbrk1/4bpp1/2n1pn1p/p2pN3/Pp1P4/1P2PNBP/1Q2BPP1/R3K2R b KQ - 8 20,Bd6,-143,-12,131,1
2rqbrk1/5pp1/2nbpn1p/p2pN3/Pp1P4/1P2PNBP/1Q2BPP1/R3K2R w KQ - 9 21,Nxc6,-8,-98,-90,1
2rqbrk1/5pp1/2Nbpn1p/p2p4/Pp1P4/1P2PNBP/1Q2BPP1/R3K2R b KQ - 0 21,Rxc6,-121,-68,53,1
3qbrk1/5pp1/2rbpn1p/p2p4/Pp1P4/1P2PNBP/1Q2BPP1/R3K2R w KQ - 0 22,Bh4,-95,-282,-187,0
3qbrk1/5pp1/2rbpn1p/p2p4/Pp1P3B/1P2PN1P/1Q2BPP1/R3K2R b KQ - 1 22,Be7,-289,-47,242,1
3qbrk1/4bpp1/2r1pn1p/p2p4/Pp1P3B/1P2PN1P/1Q2BPP1/R3K2R w KQ - 2 23,Bg3,-3,-208,-205,0
3qbrk1/4bpp1/2r1pn1p/p2p4/Pp1P4/1P2PNBP/1Q2BPP1/R3K2R b KQ - 3 23,Ne4,-183,-188,-5,1
3qbrk1/4bpp1/2r1p2p/p2p4/Pp1Pn3/1P2PNBP/1Q2BPP1/R3K2R w KQ - 4 24,Bh2,-168,-188,-20,1
3qbrk1/4bpp1/2r1p2p/p2p4/Pp1Pn3/1P2PN1P/1Q2BPPB/R3K2R b KQ - 5 24,Bd6,-185,-144,41,1
3qbrk1/5pp1/2rbp2p/p2p4/Pp1Pn3/1P2PN1P/1Q2BPPB/R3K2R w KQ - 6 25,Ne5,-129,-201,-72,1
3qbrk1/5pp1/2rbp2p/p2pN3/Pp1Pn3/1P2P2P/1Q2BPPB/R3K2R b KQ - 7 25,Bxe5,-207,-122,85,1
3qbrk1/5pp1/2r1p2p/p2pb3/Pp1Pn3/1P2P2P/1Q2BPPB/R3K2R w KQ - 0 26,Bxe5,-123,-147,-24,1
3qbrk1/5pp1/2r1p2p/p2pB3/Pp1Pn3/1P2P2P/1Q2BPP1/R3K2R b KQ - 0 26,Nc3,-145,-82,63,1
3qbrk1/5pp1/2r1p2p/p2pB3/Pp1P4/1Pn1P2P/1Q2BPP1/R3K2R w KQ - 1 27,Rc1,-87,-124,-37,1
3qbrk1/5pp1/2r1p2p/p2pB3/Pp1P4/1Pn1P2P/1Q2BPP1/2R1K2R b K - 2 27,f6,-118,-120,-2,1
3qbrk1/6p1/2r1pp1p/p2pB3/Pp1P4/1Pn1P2P/1Q2BPP1/2R1K2R w K - 0 28,Bg3,-101,-115,-14,1
3qbrk1/6p1/2r1pp1p/p2p4/Pp1P4/1Pn1P1BP/1Q2BPP1/2R1K2R b K - 1 28,Qe7,-107,-100,7,1
4brk1/4q1p1/2r1pp1p/p2p4/Pp1P4/1Pn1P1BP/1Q2BPP1/2R1K2R w K - 2 29,Bd1,-99,-224,-125,0
4brk1/4q1p1/2r1pp1p/p2p4/Pp1P4/1Pn1P1BP/1Q3PP1/2RBK2R b K - 3 29,Bd7,-193,-155,38,1
5rk1/3bq1p1/2r1pp1p/p2p4/Pp1P4/1Pn1P1BP/1Q3PP1/2RBK2R w K - 4 30,O-O,-174,-162,12,1
5rk1/3bq1p1/2r1pp1p/p2p4/Pp1P4/1Pn1P1BP/1Q3PP1/2RB1RK1 b - - 5 30,Rfc8,-159,-141,18,1
2r3k1/3bq1p1/2r1pp1p/p2p4/Pp1P4/1Pn1P1BP/1Q3PP1/2RB1RK1 w - - 6 31,Be2,-155,-520,-365,0
2r3k1/3bq1p1/2r1pp1p/p2p4/Pp1P4/1Pn1P1BP/1Q2BPP1/2R2RK1 b - - 7 31,Nxe2+,-528,-527,1,1
2r3k1/3bq1p1/2r1pp1p/p2p4/Pp1P4/1P2P1BP/1Q2nPP1/2R2RK1 w - - 0 32,Kh2,-527,-723,-196,0
2r3k1/3bq1p1/2r1pp1p/p2p4/Pp1P4/1P2P1BP/1Q2nPPK/2R2R2 b - - 1 32,Nxc1,-714,-711,3,1
2r3k1/3bq1p1/2r1pp1p/p2p4/Pp1P4/1P2P1BP/1Q3PPK/2n2R2 w - - 0 33,Rxc1,-702,-751,-49,1
2r3k1/3bq1p1/2r1pp1p/p2p4/Pp1P4/1P2P1BP/1Q3PPK/2R5 b - - 0 33,Rxc1,-788,-750,38,1
rnbqkbnr/pppppppp/8/8/8/8/PPPPPPPP/RNBQKBNR w KQkq - 0 1,f4,32,-14,-46,1
rnbqkbnr/pppppppp/8/8/5P2/8/PPPPP1PP/RNBQKBNR b KQkq - 0 1,e5,-18,18,36,1
rnbqkbnr/pppp1ppp/8/4p3/5P2/8/PPPPP1PP/RNBQKBNR w KQkq - 0 2,fxe5,44,23,-21,1
rnbqkbnr/pppp1ppp/8/4P3/8/8/PPPPP1PP/RNBQKBNR b KQkq - 0 2,Qh4+,47,205,158,1
rnb1kbnr/pppp1ppp/8/4P3/7q/8/PPPPP1PP/RNBQKBNR w KQkq - 1 3,g3,140,113,-27,1
rnb1kbnr/pppp1ppp/8/4P3/7q/6P1/PPPPP2P/RNBQKBNR b KQkq - 0 3,Qg5,103,243,140,1
rnb1kbnr/pppp1ppp/8/4P1q1/8/6P1/PPPPP2P/RNBQKBNR w KQkq - 1 4,Nf3,267,274,7,1
rnb1kbnr/pppp1ppp/8/4P1q1/8/5NP1/PPPPP2P/RNBQKB1R b KQkq - 2 4,Qg4,259,303,44,1
rnb1kbnr/pppp1ppp/8/4P3/6q1/5NP1/PPPPP2P/RNBQKB1R w KQkq - 3 5,Bg2,301,299,-2,1
rnb1kbnr/pppp1ppp/8/4P3/6q1/5NP1/PPPPP1BP/RNBQK2R b KQkq - 4 5,d6,290,276,-14,1
rnb1kbnr/ppp2ppp/3p4/4P3/6q1/5NP1/PPPPP1BP/RNBQK2R w KQkq - 0 6,exd6,250,225,-25,1
rnb1kbnr/ppp2ppp/3P4/8/6q1/5NP1/PPPPP1BP/RNBQK2R b KQkq - 0 6,cxd6,201,240,39,1
rnb1kbnr/pp3ppp/3p4/8/6q1/5NP1/PPPPP1BP/RNBQK2R w KQkq - 0 7,O-O,228,245,17,1
rnb1kbnr/pp3ppp/3p4/8/6q1/5NP1/PPPPP1BP/RNBQ1RK1 b kq - 1 7,Be7,267,235,-32,1
rnb1k1nr/pp2bppp/3p4/8/6q1/5NP1/PPPPP1BP/RNBQ1RK1 w kq - 2 8,Nc3,247,254,7,1
rnb1k1nr/pp2bppp/3p4/8/6q1/2N2NP1/PPPPP1BP/R1BQ1RK1 b kq - 3 8,Nf6,247,226,-21,1
rnb1k2r/pp2bppp/3p1n2/8/6q1/2N2NP1/PPPPP1BP/R1BQ1RK1 w kq - 4 9,e4,257,233,-24,1
rnb1k2r/pp2bppp/3p1n2/8/4P1q1/2N2NP1/PPPP2BP/R1BQ1RK1 b kq - 0 9,O-O,239,244,5,1
rnb2rk1/pp2bppp/3p1n2/8/4P1q1/2N2NP1/PPPP2BP/R1BQ1RK1 w - - 1 10,d3,247,241,-6,1
rnb2rk1/pp2bppp/3p1n2/8/4P1q1/2NP1NP1/PPP3BP/R1BQ1RK1 b - - 0 10,Qd7,224,274,50,1
rnb2rk1/pp1qbppp/3p1n2/8/4P3/2NP1NP1/PPP3BP/R1BQ1RK1 w - - 1 11,e5,275,26,-249,0
rnb2rk1/pp1qbppp/3p1n2/4P3/8/2NP1NP1/PPP3BP/R1BQ1RK1 b - - 0 11,dxe5,34,20,-14,1
rnb2rk1/pp1qbppp/5n2/4p3/8/2NP1NP1/PPP3BP/R1BQ1RK1 w - - 0 12,Re1,16,-42,-58,1
rnb2rk1/pp1qbppp/5n2/4p3/8/2NP1NP1/PPP3BP/R1BQR1K1 b - - 1 12,e4,-37,166,203,1
rnb2rk1/pp1qbppp/5n2/8/4p3/2NP1NP1/PPP3BP/R1BQR1K1 w - - 0 13,dxe4,168,67,-101,0
rnb2rk1/pp1qbppp/5n2/8/4P3/2N2NP1/PPP3BP/R1BQR1K1 b - - 0 13,Qxd1,69,69,0,1
rnb2rk1/pp2bppp/5n2/8/4P3/2N2NP1/PPP3BP/R1BqR1K1 w - - 0 14,Rxd1,65,53,-12,1
rnb2rk1/pp2bppp/5n2/8/4P3/2N2NP1/PPP3BP/R1BR2K1 b - - 0 14,Bg4,63,203,140,1
rn3rk1/pp2bppp/5n2/8/4P1b1/2N2NP1/PPP3BP/R1BR2K1 w - - 1 15,h3,210,152,-58,1
rn3rk1/pp2bppp/5n2/8/4P1b1/2N2NPP/PPP3B1/R1BR2K1 b - - 0 15,Bxf3,147,189,42,1
rn3rk1/pp2bppp/5n2/8/4P3/2N2bPP/PPP3B1/R1BR2K1 w - - 0 16,Bxf3,165,195,30,1
rn3rk1/pp2bppp/5n2/8/4P3/2N2BPP/PPP5/R1BR2K1 b - - 0 16,Nc6,185,211,26,1
r4rk1/pp2bppp/2n2n2/8/4P3/2N2BPP/PPP5/R1BR2K1 w - - 1 17,Nd5,203,167,-36,1
r4rk1/pp2bppp/2n2n2/3N4/4P3/5BPP/PPP5/R1BR2K1 b - - 2 17,Nxd5,157,156,-1,1
r4rk1/pp2bppp/2n5/3n4/4P3/5BPP/PPP5/R1BR2K1 w - - 0 18,exd5,158,148,-10,1
r4rk1/pp2bppp/2n5/3P4/8/5BPP/PPP5/R1BR2K1 b - - 0 18,Ne5,135,154,19,1
r4rk1/pp2bppp/8/3Pn3/8/5BPP/PPP5/R1BR2K1 w - - 1 19,Bg2,144,120,-24,1
r4rk1/pp2bppp/8/3Pn3/8/6PP/PPP3B1/R1BR2K1 b - - 2 19,Bf6,135,242,107,1
r4rk1/pp3ppp/5b2/3Pn3/8/6PP/PPP3B1/R1BR2K1 w - - 3 20,Bf4,232,192,-40,1
r4rk1/pp3ppp/5b2/3Pn3/5B2/6PP/PPP3B1/R2R2K1 b - - 4 20,Rad8,185,210,25,1
3r1rk1/pp3ppp/5b2/3Pn3/5B2/6PP/PPP3B1/R2R2K1 w - - 5 21,Bxe5,225,33,-192,0
3r1rk1/pp3ppp/5b2/3PB3/8/6PP/PPP3B1/R2R2K1 b - - 0 21,Bxe5,28,27,-1,1
3r1rk1/pp3ppp/8/3Pb3/8/6PP/PPP3B1/R2R2K1 w - - 0 22,g4,25,15,-10,1
3r1rk1/pp3ppp/8/3Pb3/6P1/7P/PPP3B1/R2R2K1 b - - 0 22,Rd6,27,37,10,1
5rk1/pp3ppp/3r4/3Pb3/6P1/7P/PPP3B1/R2R2K1 w - - 1 23,c3,35,34,-1,1
5rk1/pp3ppp/3r4/3Pb3/6P1/2P4P/PP4B1/R2R2K1 b - - 0 23,Rfd8,31,66,35,1
3r2k1/pp3ppp/3r4/3Pb3/6P1/2P4P/PP4B1/R2R2K1 w - - 1 24,Rd3,54,44,-10,1
3r2k1/pp3ppp/3r4/3Pb3/6P1/2PR3P/PP4B1/R5K1 b - - 2 24,f6,36,87,51,1
3r2k1/pp4pp/3r1p2/3Pb3/6P1/2PR3P/PP4B1/R5K1 w - - 0 25,Rad1,116,84,-32,1
3r2k1/pp4pp/3r1p2/3Pb3/6P1/2PR3P/PP4B1/3R2K1 b - - 1 25,Kf7,66,88,22,1
3r4/pp3kpp/3r1p2/3Pb3/6P1/2PR3P/PP4B1/3R2K1 w - - 2 26,b3,67,42,-25,1
3r4/pp3kpp/3r1p2/3Pb3/6P1/1PPR3P/P5B1/3R2K1 b - - 0 26,Kg6,34,159,125,1
3r4/pp4pp/3r1pk1/3Pb3/6P1/1PPR3P/P5B1/3R2K1 w - - 1 27,c4,133,127,-6,1
3r4/pp4pp/3r1pk1/3Pb3/2P3P1/1P1R3P/P5B1/3R2K1 b - - 0 27,R6d7,118,291,173,1
3r4/pp1r2pp/5pk1/3Pb3/2P3P1/1P1R3P/P5B1/3R2K1 w - - 1 28,c5,298,278,-20,1
3r4/pp1r2pp/5pk1/2PPb3/6P1/1P1R3P/P5B1/3R2K1 b - - 0 28,Kf7,295,426,131,1
3r4/pp1r1kpp/5p2/2PPb3/6P1/1P1R3P/P5B1/3R2K1 w - - 1 29,Rf1,439,207,-232,0
3r4/pp1r1kpp/5p2/2PPb3/6P1/1P1R3P/P5B1/5RK1 b - - 2 29,Kg6,174,371,197,1
3r4/pp1r2pp/5pk1/2PPb3/6P1/1P1R3P/P5B1/5RK1 w - - 3 30,Rdf3,413,-82,-495,0
3r4/pp1r2pp/5pk1/2PPb3/6P1/1P3R1P/P5B1/5RK1 b - - 4 30,Kf7,-81,190,271,1
3r4/pp1r1kpp/5p2/2PPb3/6P1/1P3R1P/P5B1/5RK1 w - - 5 31,Re3,190,-392,-582,0
3r4/pp1r1kpp/5p2/2PPb3/6P1/1P2R2P/P5B1/5RK1 b - - 6 31,Kg6,-438,257,695,1
3r4/pp1r2pp/5pk1/2PPb3/6P1/1P2R2P/P5B1/5RK1 w - - 7 32,h4,256,-273,-529,0
3r4/pp1r2pp/5pk1/2PPb3/6PP/1P2R3/P5B1/5RK1 b - - 0 32,Kh6,-327,242,569,1
3r4/pp1r2pp/5p1k/2PPb3/6PP/1P2R3/P5B1/5RK1 w - - 1 33,g5+,304,265,-39,1
3r4/pp1r2pp/5p1k/2PPb1P1/7P/1P2R3/P5B1/5RK1 b - - 0 33,Kh5,245,256,11,1
rnbqkbnr/pppppppp/8/8/8/8/PPPPPPPP/RNBQKBNR w KQkq - 0 1,c4,29,-12,-41,1
rnbqkbnr/pppppppp/8/8/2P5/8/PP1PPPPP/RNBQKBNR b KQkq - 0 1,c6,-20,36,56,1
rnbqkbnr/pp1ppppp/2p5/8/2P5/8/PP1PPPPP/RNBQKBNR w KQkq - 0 2,e4,38,49,11,1
rnbqkbnr/pp1ppppp/2p5/8/2P1P3/8/PP1P1PPP/RNBQKBNR b KQkq - 0 2,d5,-25,18,43,1
rnbqkbnr/pp2pppp/2p5/3p4/2P1P3/8/PP1P1PPP/RNBQKBNR w KQkq - 0 3,cxd5,64,-21,-85,1
rnbqkbnr/pp2pppp/2p5/3P4/4P3/8/PP1P1PPP/RNBQKBNR b KQkq - 0 3,cxd5,49,62,13,1
rnbqkbnr/pp2pppp/8/3p4/4P3/8/PP1P1PPP/RNBQKBNR w KQkq - 0 4,exd5,53,44,-9,1
rnbqkbnr/pp2pppp/8/3P4/8/8/PP1P1PPP/RNBQKBNR b KQkq - 0 4,Nf6,43,60,17,1
rnbqkb1r/pp2pppp/5n2/3P4/8/8/PP1P1PPP/RNBQKBNR w KQkq - 1 5,Nc3,61,26,-35,1
rnbqkb1r/pp2pppp/5n2/3P4/8/2N5/PP1P1PPP/R1BQKBNR b KQkq - 2 5,Nxd5,22,22,0,1
rnbqkb1r/pp2pppp/8/3n4/8/2N5/PP1P1PPP/R1BQKBNR w KQkq - 0 6,Nxd5,29,-42,-71,1
rnbqkb1r/pp2pppp/8/3N4/8/8/PP1P1PPP/R1BQKBNR b KQkq - 0 6,Qxd5,-77,-63,14,1
rnb1kb1r/pp2pppp/8/3q4/8/8/PP1P1PPP/R1BQKBNR w KQkq - 0 7,Nf3,-42,-59,-17,1
rnb1kb1r/pp2pppp/8/3q4/8/5N2/PP1P1PPP/R1BQKB1R b KQkq - 1 7,Nc6,-57,-56,1,1
r1b1kb1r/pp2pppp/2n5/3q4/8/5N2/PP1P1PPP/R1BQKB1R w KQkq - 2 8,a3,-55,-88,-33,1
r1b1kb1r/pp2pppp/2n5/3q4/8/P4N2/1P1P1PPP/R1BQKB1R b KQkq - 0 8,Bf5,-116,-71,45,1
r3kb1r/pp2pppp/2n5/3q1b2/8/P4N2/1P1P1PPP/R1BQKB1R w KQkq - 1 9,Be2,-70,-120,-50,1
r3kb1r/pp2pppp/2n5/3q1b2/8/P4N2/1P1PBPPP/R1BQK2R b KQkq - 2 9,e6,-119,-80,39,1
r3kb1r/pp3ppp/2n1p3/3q1b2/8/P4N2/1P1PBPPP/R1BQK2R w KQkq - 0 10,O-O,-37,-77,-40,1
r3kb1r/pp3ppp/2n1p3/3q1b2/8/P4N2/1P1PBPPP/R1BQ1RK1 b kq - 1 10,Bd6,-80,-54,26,1
r3k2r/pp3ppp/2nbp3/3q1b2/8/P4N2/1P1PBPPP/R1BQ1RK1 w kq - 2 11,d4,-40,-65,-25,1
r3k2r/pp3ppp/2nbp3/3q1b2/3P4/P4N2/1P2BPPP/R1BQ1RK1 b kq - 0 11,O-O,-50,-61,-11,1
r4rk1/pp3ppp/2nbp3/3q1b2/3P4/P4N2/1P2BPPP/R1BQ1RK1 w - - 1 12,Be3,-54,-49,5,1
r4rk1/pp3ppp/2nbp3/3q1b2/3P4/P3BN2/1P2BPPP/R2Q1RK1 b - - 2 12,Rac8,-43,-30,13,1
2r2rk1/pp3ppp/2nbp3/3q1b2/3P4/P3BN2/1P2BPPP/R2Q1RK1 w - - 3 13,Nh4,-35,-69,-34,1
2r2rk1/pp3ppp/2nbp3/3q1b2/3P3N/P3B3/1P2BPPP/R2Q1RK1 b - - 4 13,Be4,-83,-67,16,1
2r2rk1/pp3ppp/2nbp3/3q4/3Pb2N/P3B3/1P2BPPP/R2Q1RK1 w - - 5 14,Bf3,-88,-89,-1,1
2r2rk1/pp3ppp/2nbp3/3q4/3Pb2N/P3BB2/1P3PPP/R2Q1RK1 b - - 6 14,Bxf3,-100,-92,8,1
2r2rk1/pp3ppp/2nbp3/3q4/3P3N/P3Bb2/1P3PPP/R2Q1RK1 w - - 0 15,Qxf3,-87,-83,4,1
2r2rk1/pp3ppp/2nbp3/3q4/3P3N/P3BQ2/1P3PPP/R4RK1 b - - 0 15,Qxf3,-84,-48,36,1
2r2rk1/pp3ppp/2nbp3/8/3P3N/P3Bq2/1P3PPP/R4RK1 w - - 0 16,Nxf3,-33,-36,-3,1
2r2rk1/pp3ppp/2nbp3/8/3P4/P3BN2/1P3PPP/R4RK1 b - - 0 16,Ne7,-38,-36,2,1
2r2rk1/pp2nppp/3bp3/8/3P4/P3BN2/1P3PPP/R4RK1 w - - 1 17,Rac1,-37,-41,-4,1
2r2rk1/pp2nppp/3bp3/8/3P4/P3BN2/1P3PPP/2R2RK1 b - - 2 17,Nd5,-30,-28,2,1
2r2rk1/pp3ppp/3bp3/3n4/3P4/P3BN2/1P3PPP/2R2RK1 w - - 3 18,Bg5,-28,-65,-37,1
2r2rk1/pp3ppp/3bp3/3n2B1/3P4/P4N2/1P3PPP/2R2RK1 b - - 4 18,h6,-57,-53,4,1
2r2rk1/pp3pp1/3bp2p/3n2B1/3P4/P4N2/1P3PPP/2R2RK1 w - - 0 19,Bh4,-26,-231,-205,0
2r2rk1/pp3pp1/3bp2p/3n4/3P3B/P4N2/1P3PPP/2R2RK1 b - - 1 19,g5,-210,-111,99,1
2r2rk1/pp3p2/3bp2p/3n2p1/3P3B/P4N2/1P3PPP/2R2RK1 w - - 0 20,Bg3,-98,-122,-24,1
2r2rk1/pp3p2/3bp2p/3n2p1/3P4/P4NB1/1P3PPP/2R2RK1 b - - 1 20,Bxg3,-119,-54,65,1
2r2rk1/pp3p2/4p2p/3n2p1/3P4/P4Nb1/1P3PPP/2R2RK1 w - - 0 21,hxg3,-53,-58,-5,1
2r2rk1/pp3p2/4p2p/3n2p1/3P4/P4NP1/1P3PP1/2R2RK1 b - - 0 21,f6,-60,-34,26,1
2r2rk1/pp6/4pp1p/3n2p1/3P4/P4NP1/1P3PP1/2R2RK1 w - - 0 22,Rc5,-30,-45,-15,1
2r2rk1/pp6/4pp1p/2Rn2p1/3P4/P4NP1/1P3PP1/5RK1 b - - 1 22,b6,-78,-68,10,1
2r2rk1/p7/1p2pp1p/2Rn2p1/3P4/P4NP1/1P3PP1/5RK1 w - - 0 23,Rcc1,-72,-60,12,1
2r2rk1/p7/1p2pp1p/3n2p1/3P4/P4NP1/1P3PP1/2R2RK1 b - - 1 23,Kf7,-67,-52,15,1
2r2r2/p4k2/1p2pp1p/3n2p1/3P4/P4NP1/1P3PP1/2R2RK1 w - - 2 24,Nd2,-55,-72,-17,1
2r2r2/p4k2/1p2pp1p/3n2p1/3P4/P5P1/1P1N1PP1/2R2RK1 b - - 3 24,Ke7,-78,-39,39,1
2r2r2/p3k3/1p2pp1p/3n2p1/3P4/P5P1/1P1N1PP1/2R2RK1 w - - 4 25,Ne4,-46,-63,-17,1
2r2r2/p3k3/1p2pp1p/3n2p1/3PN3/P5P1/1P3PP1/2R2RK1 b - - 5 25,Kd7,-87,-24,63,1
2r2r2/p2k4/1p2pp1p/3n2p1/3PN3/P5P1/1P3PP1/2R2RK1 w - - 6 26,b4,-39,-155,-116,0
2r2r2/p2k4/1p2pp1p/3n2p1/1P1PN3/P5P1/5PP1/2R2RK1 b - - 0 26,Rxc1,-163,-108,55,1
5r2/p2k4/1p2pp1p/3n2p1/1P1PN3/P5P1/5PP1/2r2RK1 w - - 0 27,Rxc1,-119,-112,7,1
5r2/p2k4/1p2pp1p/3n2p1/1P1PN3/P5P1/5PP1/2R3K1 b - - 0 27,Rc8,-105,-132,-27,1
2r5/p2k4/1p2pp1p/3n2p1/1P1PN3/P5P1/5PP1/2R3K1 w - - 1 28,Rxc8,-145,-150,-5,1
2R5/p2k4/1p2pp1p/3n2p1/1P1PN3/P5P1/5PP1/6K1 b - - 0 28,Kxc8,-130,-174,-44,1
2k5/p7/1p2pp1p/3n2p1/1P1PN3/P5P1/5PP1/6K1 w - - 0 29,Nd6+,-184,-291,-107,0
2k5/p7/1p1Npp1p/3n2p1/1P1P4/P5P1/5PP1/6K1 b - - 1 29,Kd7,-264,-330,-66,1
8/p2k4/1p1Npp1p/3n2p1/1P1P4/P5P1/5PP1/6K1 w - - 2 30,Ne4,-337,-341,-4,1
8/p2k4/1p2pp1p/3n2p1/1P1PN3/P5P1/5PP1/6K1 b - - 3 30,f5,-352,-341,11,1
8/p2k4/1p2p2p/3n1pp1/1P1PN3/P5P1/5PP1/6K1 w - - 0 31,Nd2,-372,-372,0,1
8/p2k4/1p2p2p/3n1pp1/1P1P4/P5P1/3N1PP1/6K1 b - - 1 31,Nc3,-363,-273,90,1
8/p2k4/1p2p2p/5pp1/1P1P4/P1n3P1/3N1PP1/6K1 w - - 2 32,Nf3,-291,-349,-58,1
8/p2k4/1p2p2p/5pp1/1P1P4/P1n2NP1/5PP1/6K1 b - - 3 32,Nb1,-363,-262,101,1
8/p2k4/1p2p2p/5pp1/1P1P4/P4NP1/5PP1/1n4K1 w - - 4 33,Ne5+,-264,-279,-15,1
8/p2k4/1p2p2p/4Npp1/1P1P4/P5P1/5PP1/1n4K1 b - - 5 33,Ke7,-306,-212,94,1
8/p3k3/1p2p2p/4Npp1/1P1P4/P5P1/5PP1/1n4K1 w - - 6 34,a4,-203,-219,-16,1
8/p3k3/1p2p2p/4Npp1/PP1P4/6P1/5PP1/1n4K1 b - - 0 34,Nc3,-214,-133,81,1
8/p3k3/1p2p2p/4Npp1/PP1P4/2n3P1/5PP1/6K1 w - - 1 35,a5,-212,-261,-49,1
8/p3k3/1p2p2p/P3Npp1/1P1P4/2n3P1/5PP1/6K1 b - - 0 35,bxa5,-285,-175,110,1
8/p3k3/4p2p/p3Npp1/1P1P4/2n3P1/5PP1/6K1 w - - 0 36,bxa5,-171,-203,-32,1
8/p3k3/4p2p/P3Npp1/3P4/2n3P1/5PP1/6K1 b - - 0 36,Nb5,-148,-109,39,1
8/p3k3/4p2p/Pn2Npp1/3P4/6P1/5PP1/6K1 w - - 1 37,Nc6+,-127,-219,-92,1
8/p3k3/2N1p2p/Pn3pp1/3P4/6P1/5PP1/6K1 b - - 2 37,Kd6,-247,-292,-45,1
8/p7/2Nkp2p/Pn3pp1/3P4/6P1/5PP1/6K1 w - - 3 38,Nxa7,-278,-400,-122,0
8/N7/3kp2p/Pn3pp1/3P4/6P1/5PP1/6K1 b - - 0 38,Nxd4,-433,-21,412,1
8/N7/3kp2p/P4pp1/3n4/6P1/5PP1/6K1 w - - 0 39,a6,-15,-350,-335,0
8/N7/P2kp2p/5pp1/3n4/6P1/5PP1/6K1 b - - 0 39,Kc7,-379,-371,8,1
8/N1k5/P3p2p/5pp1/3n4/6P1/5PP1/6K1 w - - 1 40,f4,-369,-399,-30,1
8/N1k5/P3p2p/5pp1/3n1P2/6P1/6P1/6K1 b - - 0 40,Kb8,-395,-348,47,1
1k6/N7/P3p2p/5pp1/3n1P2/6P1/6P1/6K1 w - - 1 41,fxg5,-374,-389,-15,1
1k6/N7/P3p2p/5pP1/3n4/6P1/6P1/6K1 b - - 0 41,hxg5,-439,-449,-10,1
1k6/N7/P3p3/5pp1/3n4/6P1/6P1/6K1 w - - 0 42,Nb5,-458,-461,-3,1
1k6/8/P3p3/1N3pp1/3n4/6P1/6P1/6K1 b - - 1 42,Nxb5,-459,-473,-14,1
1k6/8/P3p3/1n3pp1/8/6P1/6P1/6K1 w - - 0 43,Kf2,-496,-480,16,1
1k6/8/P3p3/1n3pp1/8/6P1/5KP1/8 b - - 1 43,Ka7,-487,-400,87,1
8/k7/P3p3/1n3pp1/8/6P1/5KP1/8 w - - 2 44,Ke3,-407,-444,-37,1
8/k7/P3p3/1n3pp1/8/4K1P1/6P1/8 b - - 3 44,Kxa6,-448,-491,-43,1
8/8/k3p3/1n3pp1/8/4K1P1/6P1/8 w - - 0 45,Kd3,-520,-540,-20,1
8/8/k3p3/1n3pp1/8/3K2P1/6P1/8 b - - 1 45,Kb6,-551,-534,17,1
8/8/1k2p3/1n3pp1/8/3K2P1/6P1/8 w - - 2 46,Kc4,-545,-582,-37,1
8/8/1k2p3/1n3pp1/2K5/6P1/6P1/8 b - - 3 46,Kc6,-573,-567,6,1
8/8/2k1p3/1n3pp1/2K5/6P1/6P1/8 w - - 4 47,Kd3,-564,-586,-22,1
8/8/2k1p3/1n3pp1/8/3K2P1/6P1/8 b - - 5 47,Kd5,-587,-569,18,1
8/8/4p3/1n1k1pp1/8/3K2P1/6P1/8 w - - 6 48,Ke3,-588,-601,-13,1
8/8/4p3/1n1k1pp1/8/4K1P1/6P1/8 b - - 7 48,e5,-605,-597,8,1
8/8/8/1n1kppp1/8/4K1P1/6P1/8 w - - 0 49,Kf3,-590,-640,-50,1
8/8/8/1n1kppp1/8/5KP1/6P1/8 b - - 1 49,g4+,-627,-627,0,1
8/8/8/1n1kpp2/6p1/5KP1/6P1/8 w - - 0 50,Ke3,-677,-734,-57,1
8/8/8/1n1kpp2/6p1/4K1P1/6P1/8 b - - 1 50,Nd4,-676,-597,79,1
8/8/8/3kpp2/3n2p1/4K1P1/6P1/8 w - - 2 51,Kd3,-692,-713,-21,1
8/8/8/3kpp2/3n2p1/3K2P1/6P1/8 b - - 3 51,Ne6,-773,-734,39,1
8/8/4n3/3kpp2/6p1/3K2P1/6P1/8 w - - 4 52,Ke3,-813,-918,-105,0
8/8/4n3/3kpp2/6p1/4K1P1/6P1/8 b - - 5 52,Kc4,-930,-965,-35,1
8/8/4n3/4pp2/2k3p1/4K1P1/6P1/8 w - - 6 53,Kd2,-978,-951,27,1
8/8/4n3/4pp2/2k3p1/6P1/3K2P1/8 b - - 7 53,Kd4,-861,-1018,-157,0
8/8/4n3/4pp2/3k2p1/6P1/3K2P1/8 w - - 8 54,Ke2,-1017,-1014,3,1
8/8/4n3/4pp2/3k2p1/6P1/4K1P1/8 b - - 9 54,Kc3,-1027,-917,110,1
8/8/4n3/4pp2/6p1/2k3P1/4K1P1/8 w - - 10 55,Kf2,-1017,-1026,-9,1
8/8/4n3/4pp2/6p1/2k3P1/5KP1/8 b - - 11 55,Nd4,-1107,-1025,82,1
8/8/8/4pp2/3n2p1/2k3P1/5KP1/8 w - - 12 56,Ke3,-982,-1169,-187,0
8/8/8/4pp2/3n2p1/2k1K1P1/6P1/8 b - - 13 56,Kc2,-1169,-1256,-87,1
8/8/8/4pp2/3n2p1/4K1P1/2k3P1/8 w - - 14 57,Kf2,-1258,-1268,-10,1
8/8/8/4pp2/3n2p1/6P1/2k2KP1/8 b - - 15 57,e4,-1226,-1169,57,1
8/8/8/5p2/3np1p1/6P1/2k2KP1/8 w - - 0 58,Ke3,-1157,-1194,-37,1
8/8/8/5p2/3np1p1/4K1P1/2k3P1/8 b - - 1 58,Ne6,-1194,-1195,-1,1
8/8/4n3/5p2/4p1p1/4K1P1/2k3P1/8 w - - 2 59,Ke2,-1195,-1196,-1,1
8/8/4n3/5p2/4p1p1/6P1/2k1K1P1/8 b - - 3 59,Kc3,-1196,-1186,10,1
8/8/4n3/5p2/4p1p1/2k3P1/4K1P1/8 w - - 4 60,Ke3,-1192,-1099,93,1
8/8/4n3/5p2/4p1p1/2k1K1P1/6P1/8 b - - 5 60,Kc4,-1108,-1197,-89,1
8/8/4n3/5p2/2k1p1p1/4K1P1/6P1/8 w - - 6 61,Ke2,-1197,-1327,-130,0
8/8/4n3/5p2/2k1p1p1/6P1/4K1P1/8 b - - 7 61,Kd5,-1343,-1332,11,1
8/8/4n3/3k1p2/4p1p1/6P1/4K1P1/8 w - - 8 62,Ke3,-1142,-1615,-473,0
8/8/4n3/3k1p2/4p1p1/4K1P1/6P1/8 b - - 9 62,Ke5,-1358,-1520,-162,0
8/8/4n3/4kp2/4p1p1/4K1P1/6P1/8 w - - 10 63,Ke2,-9975,-1617,8358,1
8/8/4n3/4kp2/4p1p1/6P1/4K1P1/8 b - - 11 63,Kd4,-9976,-9976,0,1
8/8/4n3/5p2/3kp1p1/6P1/4K1P1/8 w - - 12 64,Kf2,-9977,-1259,8718,1
8/8/4n3/5p2/3kp1p1/6P1/5KP1/8 b - - 13 64,e3+,-1251,-1208,43,1
8/8/4n3/5p2/3k2p1/4p1P1/5KP1/8 w - - 0 65,Ke1,-1270,-1252,18,1
8/8/4n3/5p2/3k2p1/4p1P1/6P1/4K3 b - - 1 65,Nc5,-1269,-9977,-8708,0
8/8/8/2n2p2/3k2p1/4p1P1/6P1/4K3 w - - 2 66,Ke2,-9977,-9984,-7,1
8/8/8/2n2p2/3k2p1/4p1P1/4K1P1/8 b - - 3 66,Ne4,-9984,-9976,8,1
8/8/8/5p2/3kn1p1/4p1P1/4K1P1/8 w - - 4 67,Ke1,-9976,-1433,8543,1
8/8/8/5p2/3kn1p1/4p1P1/6P1/4K3 b - - 5 67,Nc3,-9983,-891,9092,1
8/8/8/5p2/3k2p1/2n1p1P1/6P1/4K3 w - - 6 68,Kf1,-9989,-9989,0,1
8/8/8/5p2/3k2p1/2n1p1P1/6P1/5K2 b - - 7 68,Kd3,-9989,-9990,-1,1
8/8/8/5p2/6p1/2nkp1P1/6P1/5K2 w - - 8 69,Ke1,-9990,-9990,0,1
8/8/8/5p2/6p1/2nkp1P1/6P1/4K3 b - - 9 69,e2,-9990,-9991,-1,1
8/8/8/5p2/6p1/2nk2P1/4p1P1/4K3 w - - 0 70,Kf2,-9991,-9991,0,1
8/8/8/5p2/6p1/2nk2P1/4pKP1/8 b - - 1 70,Kd2,-9991,-9995,-4,1
8/8/8/5p2/6p1/2n3P1/3kpKP1/8 w - - 2 71,Kg1,-9995,-9996,-1,1
8/8/8/5p2/6p1/2n3P1/3kp1P1/6K1 b - - 3 71,e1=Q+,-9996,-9997,-1,1
8/8/8/5p2/6p1/2n3P1/3k2P1/4q1K1 w - - 0 72,Kh2,-9997,-9997,0,1
rnbqkbnr/pppppppp/8/8/8/8/PPPPPPPP/RNBQKBNR w KQkq - 0 1,d4,22,-9,-31,1
rnbqkbnr/pppppppp/8/8/3P4/8/PPP1PPPP/RNBQKBNR b KQkq - 0 1,d5,18,15,-3,1
rnbqkbnr/ppp1pppp/8/3p4/3P4/8/PPP1PPPP/RNBQKBNR w KQkq - 0 2,f4,24,-48,-72,1
rnbqkbnr/ppp1pppp/8/3p4/3P1P2/8/PPP1P1PP/RNBQKBNR b KQkq - 0 2,e6,-49,-32,17,1
rnbqkbnr/ppp2ppp/4p3/3p4/3P1P2/8/PPP1P1PP/RNBQKBNR w KQkq - 0 3,c4,-24,-49,-25,1
rnbqkbnr/ppp2ppp/4p3/3p4/2PP1P2/8/PP2P1PP/RNBQKBNR b KQkq - 0 3,c6,-57,-22,35,1
rnbqkbnr/pp3ppp/2p1p3/3p4/2PP1P2/8/PP2P1PP/RNBQKBNR w KQkq - 0 4,a3,-17,-114,-97,1
rnbqkbnr/pp3ppp/2p1p3/3p4/2PP1P2/P7/1P2P1PP/RNBQKBNR b KQkq - 0 4,Nf6,-95,-19,76,1
rnbqkb1r/pp3ppp/2p1pn2/3p4/2PP1P2/P7/1P2P1PP/RNBQKBNR w KQkq - 1 5,Nc3,-17,-112,-95,1
rnbqkb1r/pp3ppp/2p1pn2/3p4/2PP1P2/P1N5/1P2P1PP/R1BQKBNR b KQkq - 2 5,Bd6,-115,-13,102,1
rnbqk2r/pp3ppp/2pbpn2/3p4/2PP1P2/P1N5/1P2P1PP/R1BQKBNR w KQkq - 3 6,g3,-17,-39,-22,1
rnbqk2r/pp3ppp/2pbpn2/3p4/2PP1P2/P1N3P1/1P2P2P/R1BQKBNR b KQkq - 0 6,dxc4,-48,20,68,1
rnbqk2r/pp3ppp/2pbpn2/8/2pP1P2/P1N3P1/1P2P2P/R1BQKBNR w KQkq - 0 7,e4,30,20,-10,1
rnbqk2r/pp3ppp/2pbpn2/8/2pPPP2/P1N3P1/1P5P/R1BQKBNR b KQkq - 0 7,Be7,17,10,-7,1
rnbqk2r/pp2bppp/2p1pn2/8/2pPPP2/P1N3P1/1P5P/R1BQKBNR w KQkq - 1 8,Bxc4,34,25,-9,1
rnbqk2r/pp2bppp/2p1pn2/8/2BPPP2/P1N3P1/1P5P/R1BQK1NR b KQkq - 0 8,Nbd7,26,96,70,1
r1bqk2r/pp1nbppp/2p1pn2/8/2BPPP2/P1N3P1/1P5P/R1BQK1NR w KQkq - 1 9,Nf3,103,109,6,1
r1bqk2r/pp1nbppp/2p1pn2/8/2BPPP2/P1N2NP1/1P5P/R1BQK2R b KQkq - 2 9,Nb6,87,143,56,1
r1bqk2r/pp2bppp/1np1pn2/8/2BPPP2/P1N2NP1/1P5P/R1BQK2R w KQkq - 3 10,Qd3,124,-72,-196,0
r1bqk2r/pp2bppp/1np1pn2/8/2BPPP2/P1NQ1NP1/1P5P/R1B1K2R b KQkq - 4 10,Nxc4,-70,-72,-2,1
r1bqk2r/pp2bppp/2p1pn2/8/2nPPP2/P1NQ1NP1/1P5P/R1B1K2R w KQkq - 0 11,Qxc4,-66,-68,-2,1
r1bqk2r/pp2bppp/2p1pn2/8/2QPPP2/P1N2NP1/1P5P/R1B1K2R b KQkq - 0 11,b5,-81,-9,72,1
r1bqk2r/p3bppp/2p1pn2/1p6/2QPPP2/P1N2NP1/1P5P/R1B1K2R w KQkq - 0 12,Qd3,5,-78,-83,1
r1bqk2r/p3bppp/2p1pn2/1p6/3PPP2/P1NQ1NP1/1P5P/R1B1K2R b KQkq - 1 12,Bb7,-73,-54,19,1
r2qk2r/pb2bppp/2p1pn2/1p6/3PPP2/P1NQ1NP1/1P5P/R1B1K2R w KQkq - 2 13,Be3,-66,-117,-51,1
r2qk2r/pb2bppp/2p1pn2/1p6/3PPP2/P1NQBNP1/1P5P/R3K2R b KQkq - 3 13,c5,-107,66,173,1
r2qk2r/pb2bppp/4pn2/1pp5/3PPP2/P1NQBNP1/1P5P/R3K2R w KQkq - 0 14,d5,81,-150,-231,0
r2qk2r/pb2bppp/4pn2/1ppP4/4PP2/P1NQBNP1/1P5P/R3K2R b KQkq - 0 14,exd5,-99,33,132,1
r2qk2r/pb2bppp/5n2/1ppp4/4PP2/P1NQBNP1/1P5P/R3K2R w KQkq - 0 15,Qxb5+,33,30,-3,1
r2qk2r/pb2bppp/5n2/1Qpp4/4PP2/P1N1BNP1/1P5P/R3K2R b KQkq - 0 15,Qd7,22,19,-3,1
r3k2r/pb1qbppp/5n2/1Qpp4/4PP2/P1N1BNP1/1P5P/R3K2R w KQkq - 1 16,Qxd7+,17,11,-6,1
r3k2r/pb1Qbppp/5n2/2pp4/4PP2/P1N1BNP1/1P5P/R3K2R b KQkq - 0 16,Nxd7,13,153,140,1
r3k2r/pb1nbppp/8/2pp4/4PP2/P1N1BNP1/1P5P/R3K2R w KQkq - 0 17,exd5,168,-11,-179,0
r3k2r/pb1nbppp/8/2pP4/5P2/P1N1BNP1/1P5P/R3K2R b KQkq - 0 17,Nf6,9,8,-1,1
r3k2r/pb2bppp/5n2/2pP4/5P2/P1N1BNP1/1P5P/R3K2R w KQkq - 1 18,O-O-O,19,12,-7,1
r3k2r/pb2bppp/5n2/2pP4/5P2/P1N1BNP1/1P5P/2KR3R b kq - 2 18,Rd8,7,87,80,1
3rk2r/pb2bppp/5n2/2pP4/5P2/P1N1BNP1/1P5P/2KR3R w k - 3 19,Rhe1,80,80,0,1
3rk2r/pb2bppp/5n2/2pP4/5P2/P1N1BNP1/1P5P/2KRR3 b k - 4 19,O-O,79,91,12,1
3r1rk1/pb2bppp/5n2/2pP4/5P2/P1N1BNP1/1P5P/2KRR3 w - - 5 20,Ne5,89,11,-78,1
3r1rk1/pb2bppp/5n2/2pPN3/5P2/P1N1B1P1/1P5P/2KRR3 b - - 6 20,Nxd5,0,2,2,1
3r1rk1/pb2bppp/8/2pnN3/5P2/P1N1B1P1/1P5P/2KRR3 w - - 0 21,Na4,10,-18,-28,1
3r1rk1/pb2bppp/8/2pnN3/N4P2/P3B1P1/1P5P/2KRR3 b - - 1 21,Nxe3,-29,20,49,1
3r1rk1/pb2bppp/8/2p1N3/N4P2/P3n1P1/1P5P/2KRR3 w - - 0 22,Rxe3,8,-12,-20,1
3r1rk1/pb2bppp/8/2p1N3/N4P2/P3R1P1/1P5P/2KR4 b - - 0 22,Rxd1+,-32,-13,19,1
5rk1/pb2bppp/8/2p1N3/N4P2/P3R1P1/1P5P/2Kr4 w - - 0 23,Kxd1,-4,-10,-6,1
5rk1/pb2bppp/8/2p1N3/N4P2/P3R1P1/1P5P/3K4 b - - 0 23,Rd8+,-23,11,34,1
3r2k1/pb2bppp/8/2p1N3/N4P2/P3R1P1/1P5P/3K4 w - - 1 24,Kc2,15,-17,-32,1
3r2k1/pb2bppp/8/2p1N3/N4P2/P3R1P1/1PK4P/8 b - - 2 24,f6,-22,68,90,1
3r2k1/pb2b1pp/5p2/2p1N3/N4P2/P3R1P1/1PK4P/8 w - - 0 25,Nd3,48,29,-19,1
3r2k1/pb2b1pp/5p2/2p5/N4P2/P2NR1P1/1PK4P/8 b - - 1 25,Bf8,33,43,10,1
3r1bk1/pb4pp/5p2/2p5/N4P2/P2NR1P1/1PK4P/8 w - - 2 26,Ndxc5,52,41,-11,1
3r1bk1/pb4pp/5p2/2N5/N4P2/P3R1P1/1PK4P/8 b - - 0 26,Bxc5,39,196,157,1
3r2k1/pb4pp/5p2/2b5/N4P2/P3R1P1/1PK4P/8 w - - 0 27,Nxc5,220,229,9,1
3r2k1/pb4pp/5p2/2N5/5P2/P3R1P1/1PK4P/8 b - - 0 27,Rc8,211,189,-22,1
2r3k1/pb4pp/5p2/2N5/5P2/P3R1P1/1PK4P/8 w - - 1 28,b4,207,181,-26,1
2r3k1/pb4pp/5p2/2N5/1P3P2/P3R1P1/2K4P/8 b - - 0 28,Ba6,170,399,229,1
2r3k1/p5pp/b4p2/2N5/1P3P2/P3R1P1/2K4P/8 w - - 1 29,Re7,409,405,-4,1
2r3k1/p3R1pp/b4p2/2N5/1P3P2/P5P1/2K4P/8 b - - 2 29,Ra8,396,555,159,1
r5k1/p3R1pp/b4p2/2N5/1P3P2/P5P1/2K4P/8 w - - 3 30,Nxa6,573,581,8,1
rnbqkbnr/pppppppp/8/8/8/8/PPPPPPPP/RNBQKBNR w KQkq - 0 1,e4,26,26,0,1
rnbqkbnr/pppppppp/8/8/4P3/8/PPPP1PPP/RNBQKBNR b KQkq - 0 1,c6,29,38,9,1
rnbqkbnr/pp1ppppp/2p5/8/4P3/8/PPPP1PPP/RNBQKBNR w KQkq - 0 2,Nc3,35,32,-3,1
rnbqkbnr/pp1ppppp/2p5/8/4P3/2N5/PPPP1PPP/R1BQKBNR b KQkq - 1 2,d5,34,26,-8,1
rnbqkbnr/pp2pppp/2p5/3p4/4P3/2N5/PPPP1PPP/R1BQKBNR w KQkq - 0 3,Qf3,25,-26,-51,1
rnbqkbnr/pp2pppp/2p5/3p4/4P3/2N2Q2/PPPP1PPP/R1B1KBNR b KQkq - 1 3,e6,-39,33,72,1
rnbqkbnr/pp3ppp/2p1p3/3p4/4P3/2N2Q2/PPPP1PPP/R1B1KBNR w KQkq - 0 4,Nh3,37,-91,-128,0
rnbqkbnr/pp3ppp/2p1p3/3p4/4P3/2N2Q1N/PPPP1PPP/R1B1KB1R b KQkq - 1 4,Bd6,-101,83,184,1
rnbqk1nr/pp3ppp/2pbp3/3p4/4P3/2N2Q1N/PPPP1PPP/R1B1KB1R w KQkq - 2 5,d4,88,87,-1,1
rnbqk1nr/pp3ppp/2pbp3/3p4/3PP3/2N2Q1N/PPP2PPP/R1B1KB1R b KQkq - 0 5,Nd7,80,120,40,1
r1bqk1nr/pp1n1ppp/2pbp3/3p4/3PP3/2N2Q1N/PPP2PPP/R1B1KB1R w KQkq - 1 6,e5,105,87,-18,1
r1bqk1nr/pp1n1ppp/2pbp3/3pP3/3P4/2N2Q1N/PPP2PPP/R1B1KB1R b KQkq - 0 6,Bc7,111,117,6,1
r1bqk1nr/ppbn1ppp/2p1p3/3pP3/3P4/2N2Q1N/PPP2PPP/R1B1KB1R w KQkq - 1 7,Ne2,122,30,-92,1
r1bqk1nr/ppbn1ppp/2p1p3/3pP3/3P4/5Q1N/PPP1NPPP/R1B1KB1R b KQkq - 2 7,Nb6,20,167,147,1
r1bqk1nr/ppb2ppp/1np1p3/3pP3/3P4/5Q1N/PPP1NPPP/R1B1KB1R w KQkq - 3 8,c3,171,117,-54,1
r1bqk1nr/ppb2ppp/1np1p3/3pP3/3P4/2P2Q1N/PP2NPPP/R1B1KB1R b KQkq - 0 8,Ne7,123,221,98,1
r1bqk2r/ppb1nppp/1np1p3/3pP3/3P4/2P2Q1N/PP2NPPP/R1B1KB1R w KQkq - 1 9,Ng3,228,195,-33,1
r1bqk2r/ppb1nppp/1np1p3/3pP3/3P4/2P2QNN/PP3PPP/R1B1KB1R b KQkq - 2 9,Bd7,186,299,113,1
r2qk2r/ppbbnppp/1np1p3/3pP3/3P4/2P2QNN/PP3PPP/R1B1KB1R w KQkq - 3 10,Bd3,264,288,24,1
r2qk2r/ppbbnppp/1np1p3/3pP3/3P4/2PB1QNN/PP3PPP/R1B1K2R b KQkq - 4 10,Nec8,287,503,216,1
r1nqk2r/ppbb1ppp/1np1p3/3pP3/3P4/2PB1QNN/PP3PPP/R1B1K2R w KQkq - 5 11,O-O,502,334,-168,0
r1nqk2r/ppbb1ppp/1np1p3/3pP3/3P4/2PB1QNN/PP3PPP/R1B2RK1 b kq - 6 11,Nc4,311,526,215,1
r1nqk2r/ppbb1ppp/2p1p3/3pP3/2nP4/2PB1QNN/PP3PPP/R1B2RK1 w kq - 7 12,Qg4,535,473,-62,1
r1nqk2r/ppbb1ppp/2p1p3/3pP3/2nP2Q1/2PB2NN/PP3PPP/R1B2RK1 b kq - 8 12,O-O,471,631,160,1
r1nq1rk1/ppbb1ppp/2p1p3/3pP3/2nP2Q1/2PB2NN/PP3PPP/R1B2RK1 w - - 9 13,Bh6,610,400,-210,0
rnbqkbnr/pppppppp/8/8/8/8/PPPPPPPP/RNBQKBNR w KQkq - 0 1,e4,36,25,-11,1
rnbqkbnr/pppppppp/8/8/4P3/8/PPPP1PPP/RNBQKBNR b KQkq - 0 1,e5,28,40,12,1
rnbqkbnr/pppp1ppp/8/4p3/4P3/8/PPPP1PPP/RNBQKBNR w KQkq - 0 2,Nf3,39,39,0,1
rnbqkbnr/pppp1ppp/8/4p3/4P3/5N2/PPPP1PPP/RNBQKB1R b KQkq - 1 2,d6,30,47,17,1
rnbqkbnr/ppp2ppp/3p4/4p3/4P3/5N2/PPPP1PPP/RNBQKB1R w KQkq - 0 3,Bc4,59,29,-30,1
rnbqkbnr/ppp2ppp/3p4/4p3/2B1P3/5N2/PPPP1PPP/RNBQK2R b KQkq - 1 3,Nc6,36,41,5,1
r1bqkbnr/ppp2ppp/2np4/4p3/2B1P3/5N2/PPPP1PPP/RNBQK2R w KQkq - 2 4,O-O,43,42,-1,1
r1bqkbnr/ppp2ppp/2np4/4p3/2B1P3/5N2/PPPP1PPP/RNBQ1RK1 b kq - 3 4,Bg4,30,53,23,1
r2qkbnr/ppp2ppp/2np4/4p3/2B1P1b1/5N2/PPPP1PPP/RNBQ1RK1 w kq - 4 5,c3,43,25,-18,1
r2qkbnr/ppp2ppp/2np4/4p3/2B1P1b1/2P2N2/PP1P1PPP/RNBQ1RK1 b kq - 0 5,Nf6,24,25,1,1
r2qkb1r/ppp2ppp/2np1n2/4p3/2B1P1b1/2P2N2/PP1P1PPP/RNBQ1RK1 w kq - 1 6,h3,31,27,-4,1
r2qkb1r/ppp2ppp/2np1n2/4p3/2B1P1b1/2P2N1P/PP1P1PP1/RNBQ1RK1 b kq - 0 6,Bxf3,46,90,44,1
r2qkb1r/ppp2ppp/2np1n2/4p3/2B1P3/2P2b1P/PP1P1PP1/RNBQ1RK1 w kq - 0 7,Qxf3,102,76,-26,1
r2qkb1r/ppp2ppp/2np1n2/4p3/2B1P3/2P2Q1P/PP1P1PP1/RNB2RK1 b kq - 0 7,Be7,88,110,22,1
r2qk2r/ppp1bppp/2np1n2/4p3/2B1P3/2P2Q1P/PP1P1PP1/RNB2RK1 w kq - 1 8,Na3,108,64,-44,1
r2qk2r/ppp1bppp/2np1n2/4p3/2B1P3/N1P2Q1P/PP1P1PP1/R1B2RK1 b kq - 2 8,O-O,84,81,-3,1
r2q1rk1/ppp1bppp/2np1n2/4p3/2B1P3/N1P2Q1P/PP1P1PP1/R1B2RK1 w - - 3 9,Nc2,87,91,4,1
r2q1rk1/ppp1bppp/2np1n2/4p3/2B1P3/2P2Q1P/PPNP1PP1/R1B2RK1 b - - 4 9,a6,100,103,3,1
r2q1rk1/1pp1bppp/p1np1n2/4p3/2B1P3/2P2Q1P/PPNP1PP1/R1B2RK1 w - - 0 10,d4,110,80,-30,1
r2q1rk1/1pp1bppp/p1np1n2/4p3/2BPP3/2P2Q1P/PPN2PP1/R1B2RK1 b - - 0 10,b5,104,107,3,1
r2q1rk1/2p1bppp/p1np1n2/1p2p3/2BPP3/2P2Q1P/PPN2PP1/R1B2RK1 w - - 0 11,Bd3,107,176,69,1
r2q1rk1/2p1bppp/p1np1n2/1p2p3/3PP3/2PB1Q1P/PPN2PP1/R1B2RK1 b - - 1 11,exd4,171,221,50,1
r2q1rk1/2p1bppp/p1np1n2/1p6/3pP3/2PB1Q1P/PPN2PP1/R1B2RK1 w - - 0 12,cxd4,211,209,-2,1
r2q1rk1/2p1bppp/p1np1n2/1p6/3PP3/3B1Q1P/PPN2PP1/R1B2RK1 b - - 0 12,h6,200,402,202,1
r2q1rk1/2p1bpp1/p1np1n1p/1p6/3PP3/3B1Q1P/PPN2PP1/R1B2RK1 w - - 0 13,Bf4,371,205,-166,0
r2q1rk1/2p1bpp1/p1np1n1p/1p6/3PPB2/3B1Q1P/PPN2PP1/R4RK1 b - - 1 13,Qd7,232,248,16,1
r4rk1/2pqbpp1/p1np1n1p/1p6/3PPB2/3B1Q1P/PPN2PP1/R4RK1 w - - 2 14,Rac1,307,202,-105,0
r4rk1/2pqbpp1/p1np1n1p/1p6/3PPB2/3B1Q1P/PPN2PP1/2R2RK1 b - - 3 14,Rfe8,215,305,90,1
r3r1k1/2pqbpp1/p1np1n1p/1p6/3PPB2/3B1Q1P/PPN2PP1/2R2RK1 w - - 4 15,Rfd1,316,225,-91,1
r3r1k1/2pqbpp1/p1np1n1p/1p6/3PPB2/3B1Q1P/PPN2PP1/2RR2K1 b - - 5 15,Nh7,201,201,0,1
r3r1k1/2pqbppn/p1np3p/1p6/3PPB2/3B1Q1P/PPN2PP1/2RR2K1 w - - 6 16,e5,196,217,21,1
r3r1k1/2pqbppn/p1np3p/1p2P3/3P1B2/3B1Q1P/PPN2PP1/2RR2K1 b - - 0 16,dxe5,194,290,96,1
r3r1k1/2pqbppn/p1n4p/1p2p3/3P1B2/3B1Q1P/PPN2PP1/2RR2K1 w - - 0 17,dxe5,291,221,-70,1
r3r1k1/2pqbppn/p1n4p/1p2P3/5B2/3B1Q1P/PPN2PP1/2RR2K1 b - - 0 17,Nd4,226,661,435,1
r3r1k1/2pqbppn/p6p/1p2P3/3n1B2/3B1Q1P/PPN2PP1/2RR2K1 w - - 1 18,Qe4,628,477,-151,0
r3r1k1/2pqbppn/p6p/1p2P3/3nQB2/3B3P/PPN2PP1/2RR2K1 b - - 2 18,f5,431,584,153,1
r3r1k1/2pqb1pn/p6p/1p2Pp2/3nQB2/3B3P/PPN2PP1/2RR2K1 w - f6 0 19,Qxd4,558,565,7,1
r3r1k1/2pqb1pn/p6p/1p2Pp2/3Q1B2/3B3P/PPN2PP1/2RR2K1 b - - 0 19,Qxd4,559,545,-14,1
r3r1k1/2p1b1pn/p6p/1p2Pp2/3q1B2/3B3P/PPN2PP1/2RR2K1 w - - 0 20,Nxd4,557,580,23,1
r3r1k1/2p1b1pn/p6p/1p2Pp2/3N1B2/3B3P/PP3PP1/2RR2K1 b - - 0 20,g6,570,662,92,1
r3r1k1/2p1b2n/p5pp/1p2Pp2/3N1B2/3B3P/PP3PP1/2RR2K1 w - - 0 21,Nc6,653,638,-15,1
r3r1k1/2p1b2n/p1N3pp/1p2Pp2/5B2/3B3P/PP3PP1/2RR2K1 b - - 1 21,Bg5,635,628,-7,1
r3r1k1/2p4n/p1N3pp/1p2Ppb1/5B2/3B3P/PP3PP1/2RR2K1 w - - 2 22,Bxg5,661,630,-31,1
r3r1k1/2p4n/p1N3pp/1p2PpB1/8/3B3P/PP3PP1/2RR2K1 b - - 0 22,Nxg5,644,643,-1,1
r3r1k1/2p5/p1N3pp/1p2Ppn1/8/3B3P/PP3PP1/2RR2K1 w - - 0 23,f4,625,629,4,1
r3r1k1/2p5/p1N3pp/1p2Ppn1/5P2/3B3P/PP4P1/2RR2K1 b - - 0 23,Ne6,602,602,0,1
r3r1k1/2p5/p1N1n1pp/1p2Pp2/5P2/3B3P/PP4P1/2RR2K1 w - - 1 24,g3,583,568,-15,1
r3r1k1/2p5/p1N1n1pp/1p2Pp2/5P2/3B2PP/PP6/2RR2K1 b - - 0 24,Kf7,583,626,43,1
r3r3/2p2k2/p1N1n1pp/1p2Pp2/5P2/3B2PP/PP6/2RR2K1 w - - 1 25,Bc2,597,594,-3,1
r3r3/2p2k2/p1N1n1pp/1p2Pp2/5P2/6PP/PPB5/2RR2K1 b - - 2 25,a5,614,628,14,1
r3r3/2p2k2/2N1n1pp/pp2Pp2/5P2/6PP/PPB5/2RR2K1 w - - 0 26,Bb3,662,617,-45,1
r3r3/2p2k2/2N1n1pp/pp2Pp2/5P2/1B4PP/PP6/2RR2K1 b - - 1 26,a4,605,652,47,1
r3r3/2p2k2/2N1n1pp/1p2Pp2/p4P2/1B4PP/PP6/2RR2K1 w - - 0 27,Rd7+,619,615,-4,1
r3r3/2pR1k2/2N1n1pp/1p2Pp2/p4P2/1B4PP/PP6/2R3K1 b - - 1 27,Kf8,587,594,7,1
r3rk2/2pR4/2N1n1pp/1p2Pp2/p4P2/1B4PP/PP6/2R3K1 w - - 2 28,Bd5,582,553,-29,1
r3rk2/2pR4/2N1n1pp/1p1BPp2/p4P2/6PP/PP6/2R3K1 b - - 3 28,Ra6,577,622,45,1
4rk2/2pR4/r1N1n1pp/1p1BPp2/p4P2/6PP/PP6/2R3K1 w - - 4 29,Bxe6,609,566,-43,1
4rk2/2pR4/r1N1B1pp/1p2Pp2/p4P2/6PP/PP6/2R3K1 b - - 0 29,Rxe6,555,560,5,1
5k2/2pR4/r1N1r1pp/1p2Pp2/p4P2/6PP/PP6/2R3K1 w - - 0 30,Nd4,551,532,-19,1
5k2/2pR4/r3r1pp/1p2Pp2/p2N1P2/6PP/PP6/2R3K1 b - - 1 30,Reb6,512,650,138,1
5k2/2pR4/rr4pp/1p2Pp2/p2N1P2/6PP/PP6/2R3K1 w - - 2 31,Rcxc7,619,619,0,1
5k2/2RR4/rr4pp/1p2Pp2/p2N1P2/6PP/PP6/6K1 b - - 0 31,Ra8,597,616,19,1
r4k2/2RR4/1r4pp/1p2Pp2/p2N1P2/6PP/PP6/6K1 w - - 1 32,Rf7+,631,608,-23,1
r4k2/2R2R2/1r4pp/1p2Pp2/p2N1P2/6PP/PP6/6K1 b - - 2 32,Ke8,592,9996,9404,1
r3k3/2R2R2/1r4pp/1p2Pp2/p2N1P2/6PP/PP6/6K1 w - - 3 33,Rce7+,9996,684,-9312,0
r3k3/4RR2/1r4pp/1p2Pp2/p2N1P2/6PP/PP6/6K1 b - - 4 33,Kd8,725,809,84,1
r2k4/4RR2/1r4pp/1p2Pp2/p2N1P2/6PP/PP6/6K1 w - - 5 34,Ne6+,825,851,26,1
r2k4/4RR2/1r2N1pp/1p2Pp2/p4P2/6PP/PP6/6K1 b - - 6 34,Kc8,853,9999,9146,1
r1k5/4RR2/1r2N1pp/1p2Pp2/p4P2/6PP/PP6/6K1 w - - 7 35,Rf8#,9999,10000,1,1
rnbqkbnr/pppppppp/8/8/8/8/PPPPPPPP/RNBQKBNR w KQkq - 0 1,d4,29,18,-11,1
rnbqkbnr/pppppppp/8/8/3P4/8/PPP1PPPP/RNBQKBNR b KQkq - 0 1,f5,26,52,26,1
rnbqkbnr/ppppp1pp/8/5p2/3P4/8/PPP1PPPP/RNBQKBNR w KQkq - 0 2,c4,44,54,10,1
rnbqkbnr/ppppp1pp/8/5p2/2PP4/8/PP2PPPP/RNBQKBNR b KQkq - 0 2,Nf6,53,55,2,1
rnbqkb1r/ppppp1pp/5n2/5p2/2PP4/8/PP2PPPP/RNBQKBNR w KQkq - 1 3,Nc3,56,57,1,1
rnbqkb1r/ppppp1pp/5n2/5p2/2PP4/2N5/PP2PPPP/R1BQKBNR b KQkq - 2 3,b6,60,75,15,1
rnbqkb1r/p1ppp1pp/1p3n2/5p2/2PP4/2N5/PP2PPPP/R1BQKBNR w KQkq - 0 4,Nf3,68,46,-22,1
rnbqkb1r/p1ppp1pp/1p3n2/5p2/2PP4/2N2N2/PP2PPPP/R1BQKB1R b KQkq - 1 4,e6,37,35,-2,1
rnbqkb1r/p1pp2pp/1p2pn2/5p2/2PP4/2N2N2/PP2PPPP/R1BQKB1R w KQkq - 0 5,e3,29,20,-9,1
rnbqkb1r/p1pp2pp/1p2pn2/5p2/2PP4/2N1PN2/PP3PPP/R1BQKB1R b KQkq - 0 5,Bb4,17,14,-3,1
rnbqk2r/p1pp2pp/1p2pn2/5p2/1bPP4/2N1PN2/PP3PPP/R1BQKB1R w KQkq - 1 6,Bd2,13,2,-11,1
rnbqk2r/p1pp2pp/1p2pn2/5p2/1bPP4/2N1PN2/PP1B1PPP/R2QKB1R b KQkq - 2 6,a5,24,32,8,1
rnbqk2r/2pp2pp/1p2pn2/p4p2/1bPP4/2N1PN2/PP1B1PPP/R2QKB1R w KQkq - 0 7,Bd3,28,31,3,1
rnbqk2r/2pp2pp/1p2pn2/p4p2/1bPP4/2NBPN2/PP1B1PPP/R2QK2R b KQkq - 1 7,Ba6,28,55,27,1
rn1qk2r/2pp2pp/bp2pn2/p4p2/1bPP4/2NBPN2/PP1B1PPP/R2QK2R w KQkq - 2 8,O-O,61,59,-2,1
rn1qk2r/2pp2pp/bp2pn2/p4p2/1bPP4/2NBPN2/PP1B1PPP/R2Q1RK1 b kq - 3 8,O-O,51,42,-9,1
rn1q1rk1/2pp2pp/bp2pn2/p4p2/1bPP4/2NBPN2/PP1B1PPP/R2Q1RK1 w - - 4 9,a3,41,55,14,1
rn1q1rk1/2pp2pp/bp2pn2/p4p2/1bPP4/P1NBPN2/1P1B1PPP/R2Q1RK1 b - - 0 9,Bxc3,51,53,2,1
rn1q1rk1/2pp2pp/bp2pn2/p4p2/2PP4/P1bBPN2/1P1B1PPP/R2Q1RK1 w - - 0 10,Bxc3,61,61,0,1
rn1q1rk1/2pp2pp/bp2pn2/p4p2/2PP4/P1BBPN2/1P3PPP/R2Q1RK1 b - - 0 10,d5,53,61,8,1
rn1q1rk1/2p3pp/bp2pn2/p2p1p2/2PP4/P1BBPN2/1P3PPP/R2Q1RK1 w - - 0 11,cxd5,63,60,-3,1
rn1q1rk1/2p3pp/bp2pn2/p2P1p2/3P4/P1BBPN2/1P3PPP/R2Q1RK1 b - - 0 11,Nxd5,59,75,16,1
rn1q1rk1/2p3pp/bp2p3/p2n1p2/3P4/P1BBPN2/1P3PPP/R2Q1RK1 w - - 0 12,Bxa6,86,86,0,1
rn1q1rk1/2p3pp/Bp2p3/p2n1p2/3P4/P1B1PN2/1P3PPP/R2Q1RK1 b - - 0 12,Nxa6,88,100,12,1
r2q1rk1/2p3pp/np2p3/p2n1p2/3P4/P1B1PN2/1P3PPP/R2Q1RK1 w - - 0 13,Ne5,107,62,-45,1
r2q1rk1/2p3pp/np2p3/p2nNp2/3P4/P1B1P3/1P3PPP/R2Q1RK1 b - - 1 13,c5,60,105,45,1
r2q1rk1/6pp/np2p3/p1pnNp2/3P4/P1B1P3/1P3PPP/R2Q1RK1 w - - 0 14,Qd3,101,86,-15,1
r2q1rk1/6pp/np2p3/p1pnNp2/3P4/P1BQP3/1P3PPP/R4RK1 b - - 1 14,Nxc3,75,108,33,1
r2q1rk1/6pp/np2p3/p1p1Np2/3P4/P1nQP3/1P3PPP/R4RK1 w - - 0 15,bxc3,110,102,-8,1
r2q1rk1/6pp/np2p3/p1p1Np2/3P4/P1PQP3/5PPP/R4RK1 b - - 0 15,cxd4,85,122,37,1
r2q1rk1/6pp/np2p3/p3Np2/3p4/P1PQP3/5PPP/R4RK1 w - - 0 16,cxd4,120,107,-13,1
r2q1rk1/6pp/np2p3/p3Np2/3P4/P2QP3/5PPP/R4RK1 b - - 0 16,Qd5,126,256,130,1
r4rk1/6pp/np2p3/p2qNp2/3P4/P2QP3/5PPP/R4RK1 w - - 1 17,Rfc1,263,197,-66,1
r4rk1/6pp/np2p3/p2qNp2/3P4/P2QP3/5PPP/R1R3K1 b - - 2 17,Rac8,175,505,330,1
2r2rk1/6pp/np2p3/p2qNp2/3P4/P2QP3/5PPP/R1R3K1 w - - 3 18,Rc4,487,88,-399,0
2r2rk1/6pp/np2p3/p2qNp2/2RP4/P2QP3/5PPP/R5K1 b - - 4 18,Rxc4,111,95,-16,1
5rk1/6pp/np2p3/p2qNp2/2rP4/P2QP3/5PPP/R5K1 w - - 0 19,Nxc4,98,0,-98,1
5rk1/6pp/np2p3/p2q1p2/2NP4/P2QP3/5PPP/R5K1 b - - 0 19,Nc7,15,178,163,1
5rk1/2n3pp/1p2p3/p2q1p2/2NP4/P2QP3/5PPP/R5K1 w - - 1 20,Nxb6,184,174,-10,1
5rk1/2n3pp/1N2p3/p2q1p2/3P4/P2QP3/5PPP/R5K1 b - - 0 20,Qb5,176,204,28,1
5rk1/2n3pp/1N2p3/pq3p2/3P4/P2QP3/5PPP/R5K1 w - - 1 21,Qxb5,212,220,8,1
5rk1/2n3pp/1N2p3/pQ3p2/3P4/P3P3/5PPP/R5K1 b - - 0 21,Nxb5,231,234,3,1
5rk1/6pp/1N2p3/pn3p2/3P4/P3P3/5PPP/R5K1 w - - 0 22,a4,235,186,-49,1
5rk1/6pp/1N2p3/pn3p2/P2P4/4P3/5PPP/R5K1 b - - 0 22,Nc3,168,195,27,1
5rk1/6pp/1N2p3/p4p2/P2P4/2n1P3/5PPP/R5K1 w - - 1 23,Ra3,182,-8,-190,0
5rk1/6pp/1N2p3/p4p2/P2P4/R1n1P3/5PPP/6K1 b - - 2 23,Nd5,128,219,91,1
5rk1/6pp/1N2p3/p2n1p2/P2P4/R3P3/5PPP/6K1 w - - 3 24,Nc4,267,-54,-321,0
5rk1/6pp/4p3/p2n1p2/P1NP4/R3P3/5PPP/6K1 b - - 4 24,Rb8,-52,193,245,1
1r4k1/6pp/4p3/p2n1p2/P1NP4/R3P3/5PPP/6K1 w - - 5 25,g3,199,184,-15,1
1r4k1/6pp/4p3/p2n1p2/P1NP4/R3P1P1/5P1P/6K1 b - - 0 25,Rb4,183,350,167,1
6k1/6pp/4p3/p2n1p2/PrNP4/R3P1P1/5P1P/6K1 w - - 1 26,Nxa5,313,357,44,1
6k1/6pp/4p3/N2n1p2/Pr1P4/R3P1P1/5P1P/6K1 b - - 0 26,Nb6,305,331,26,1
6k1/6pp/1n2p3/N4p2/Pr1P4/R3P1P1/5P1P/6K1 w - - 1 27,Nc6,349,357,8,1
6k1/6pp/1nN1p3/5p2/Pr1P4/R3P1P1/5P1P/6K1 b - - 2 27,Rxa4,327,331,4,1
6k1/6pp/1nN1p3/5p2/r2P4/R3P1P1/5P1P/6K1 w - - 0 28,Rxa4,323,299,-24,1
6k1/6pp/1nN1p3/5p2/R2P4/4P1P1/5P1P/6K1 b - - 0 28,Nxa4,299,315,16,1
6k1/6pp/2N1p3/5p2/n2P4/4P1P1/5P1P/6K1 w - - 0 29,Ne5,332,139,-193,0
6k1/6pp/4p3/4Np2/n2P4/4P1P1/5P1P/6K1 b - - 1 29,g6,138,185,47,1
6k1/7p/4p1p1/4Np2/n2P4/4P1P1/5P1P/6K1 w - - 0 30,Kg2,179,128,-51,1
6k1/7p/4p1p1/4Np2/n2P4/4P1P1/5PKP/8 b - - 1 30,Kg7,123,174,51,1
8/6kp/4p1p1/4Np2/n2P4/4P1P1/5PKP/8 w - - 2 31,Kf3,156,120,-36,1
8/6kp/4p1p1/4Np2/n2P4/4PKP1/5P1P/8 b - - 3 31,Nb6,123,171,48,1
8/6kp/1n2p1p1/4Np2/3P4/4PKP1/5P1P/8 w - - 4 32,h3,165,114,-51,1
8/6kp/1n2p1p1/4Np2/3P4/4PKPP/5P2/8 b - - 0 32,Kf6,112,169,57,1
8/7p/1n2pkp1/4Np2/3P4/4PKPP/5P2/8 w - - 1 33,g4,173,114,-59,1
8/7p/1n2pkp1/4Np2/3P2P1/4PK1P/5P2/8 b - - 0 33,h6,109,118,9,1
8/8/1n2pkpp/4Np2/3P2P1/4PK1P/5P2/8 w - - 0 34,Nd3,122,100,-22,1
8/8/1n2pkpp/5p2/3P2P1/3NPK1P/5P2/8 b - - 1 34,fxg4+,106,165,59,1
8/8/1n2pkpp/8/3P2p1/3NPK1P/5P2/8 w - - 0 35,hxg4,171,158,-13,1
8/8/1n2pkpp/8/3P2P1/3NPK2/5P2/8 b - - 0 35,g5,152,189,37,1
8/8/1n2pk1p/6p1/3P2P1/3NPK2/5P2/8 w - - 0 36,Ke4,197,191,-6,1
8/8/1n2pk1p/6p1/3PK1P1/3NP3/5P2/8 b - - 1 36,Nc4,203,205,2,1
8/8/4pk1p/6p1/2nPK1P1/3NP3/5P2/8 w - - 2 37,Nc5,186,182,-4,1
8/8/4pk1p/2N3p1/2nPK1P1/4P3/5P2/8 b - - 3 37,Nd2+,163,211,48,1
8/8/4pk1p/2N3p1/3PK1P1/4P3/3n1P2/8 w - - 4 38,Kd3,237,254,17,1
8/8/4pk1p/2N3p1/3P2P1/3KP3/3n1P2/8 b - - 5 38,Nf1,230,367,137,1
8/8/4pk1p/2N3p1/3P2P1/3KP3/5P2/5n2 w - - 6 39,Ke2,448,489,41,1
8/8/4pk1p/2N3p1/3P2P1/4P3/4KP2/5n2 b - - 7 39,Nh2,509,510,1,1
8/8/4pk1p/2N3p1/3P2P1/4P3/4KP1n/8 w - - 8 40,f3,513,391,-122,0
8/8/4pk1p/2N3p1/3P2P1/4PP2/4K2n/8 b - - 0 40,e5,493,540,47,1
8/8/5k1p/2N1p1p1/3P2P1/4PP2/4K2n/8 w - - 0 41,Nd7+,511,564,53,1
8/3N4/5k1p/4p1p1/3P2P1/4PP2/4K2n/8 b - - 1 41,Ke6,544,572,28,1
8/3N4/4k2p/4p1p1/3P2P1/4PP2/4K2n/8 w - - 2 42,Nxe5,575,569,-6,1
8/8/4k2p/4N1p1/3P2P1/4PP2/4K2n/8 b - - 0 42,Kd5,565,578,13,1
8/8/7p/3kN1p1/3P2P1/4PP2/4K2n/8 w - - 1 43,Nf7,583,528,-55,1
8/5N2/7p/3k2p1/3P2P1/4PP2/4K2n/8 b - - 2 43,Nxg4,546,647,101,1
8/5N2/7p/3k2p1/3P2n1/4PP2/4K3/8 w - - 0 44,fxg4,617,635,18,1
8/5N2/7p/3k2p1/3P2P1/4P3/4K3/8 b - - 0 44,h5,654,633,-21,1
8/5N2/8/3k2pp/3P2P1/4P3/4K3/8 w - - 0 45,Nxg5,691,548,-143,0
8/8/8/3k2Np/3P2P1/4P3/4K3/8 b - - 0 45,h4,584,639,55,1
8/8/8/3k2N1/3P2Pp/4P3/4K3/8 w - - 0 46,Nh3,658,690,32,1
8/8/8/3k4/3P2Pp/4P2N/4K3/8 b - - 1 46,Ke4,674,677,3,1
8/8/8/8/3Pk1Pp/4P2N/4K3/8 w - - 2 47,g5,685,699,14,1
8/8/8/6P1/3Pk2p/4P2N/4K3/8 b - - 0 47,Kf5,698,693,-5,1
8/8/8/5kP1/3P3p/4P2N/4K3/8 w - - 1 48,Kf3,713,764,51,1
8/8/8/5kP1/3P3p/4PK1N/8/8 b - - 2 48,Kg6,712,790,78,1
8/8/6k1/6P1/3P3p/4PK1N/8/8 w - - 3 49,e4,766,713,-53,1
rnbqkbnr/pppppppp/8/8/8/8/PPPPPPPP/RNBQKBNR w KQkq - 0 1,e4,24,21,-3,1
rnbqkbnr/pppppppp/8/8/4P3/8/PPPP1PPP/RNBQKBNR b KQkq - 0 1,c6,23,57,34,1
rnbqkbnr/pp1ppppp/2p5/8/4P3/8/PPPP1PPP/RNBQKBNR w KQkq - 0 2,Nf3,33,27,-6,1
rnbqkbnr/pp1ppppp/2p5/8/4P3/5N2/PPPP1PPP/RNBQKB1R b KQkq - 1 2,d5,30,30,0,1
rnbqkbnr/pp2pppp/2p5/3p4/4P3/5N2/PPPP1PPP/RNBQKB1R w KQkq - 0 3,Bd3,34,-11,-45,1
rnbqkbnr/pp2pppp/2p5/3p4/4P3/3B1N2/PPPP1PPP/RNBQK2R b KQkq - 1 3,dxe4,-18,5,23,1
rnbqkbnr/pp2pppp/2p5/8/4p3/3B1N2/PPPP1PPP/RNBQK2R w KQkq - 0 4,Bxe4,9,8,-1,1
rnbqkbnr/pp2pppp/2p5/8/4B3/5N2/PPPP1PPP/RNBQK2R b KQkq - 0 4,Nf6,10,16,6,1
rnbqkb1r/pp2pppp/2p2n2/8/4B3/5N2/PPPP1PPP/RNBQK2R w KQkq - 1 5,Nc3,5,-10,-15,1
rnbqkb1r/pp2pppp/2p2n2/8/4B3/2N2N2/PPPP1PPP/R1BQK2R b KQkq - 2 5,Nxe4,-6,8,14,1
rnbqkb1r/pp2pppp/2p5/8/4n3/2N2N2/PPPP1PPP/R1BQK2R w KQkq - 0 6,Nxe4,9,2,-7,1
rnbqkb1r/pp2pppp/2p5/8/4N3/5N2/PPPP1PPP/R1BQK2R b KQkq - 0 6,e6,4,60,56,1
rnbqkb1r/pp3ppp/2p1p3/8/4N3/5N2/PPPP1PPP/R1BQK2R w KQkq - 0 7,O-O,63,20,-43,1
rnbqkb1r/pp3ppp/2p1p3/8/4N3/5N2/PPPP1PPP/R1BQ1RK1 b kq - 1 7,Be7,35,75,40,1
rnbqk2r/pp2bppp/2p1p3/8/4N3/5N2/PPPP1PPP/R1BQ1RK1 w kq - 2 8,h3,70,-16,-86,1
rnbqk2r/pp2bppp/2p1p3/8/4N3/5N1P/PPPP1PP1/R1BQ1RK1 b kq - 0 8,O-O,-24,52,76,1
rnbq1rk1/pp2bppp/2p1p3/8/4N3/5N1P/PPPP1PP1/R1BQ1RK1 w - - 1 9,d4,45,43,-2,1
rnbq1rk1/pp2bppp/2p1p3/8/3PN3/5N1P/PPP2PP1/R1BQ1RK1 b - - 0 9,Na6,38,80,42,1
r1bq1rk1/pp2bppp/n1p1p3/8/3PN3/5N1P/PPP2PP1/R1BQ1RK1 w - - 1 10,c4,70,25,-45,1
r1bq1rk1/pp2bppp/n1p1p3/8/2PPN3/5N1P/PP3PP1/R1BQ1RK1 b - - 0 10,c5,26,39,13,1
r1bq1rk1/pp2bppp/n3p3/2p5/2PPN3/5N1P/PP3PP1/R1BQ1RK1 w - - 0 11,dxc5,45,-20,-65,1
r1bq1rk1/pp2bppp/n3p3/2P5/2P1N3/5N1P/PP3PP1/R1BQ1RK1 b - - 0 11,Nxc5,-16,-14,2,1
r1bq1rk1/pp2bppp/4p3/2n5/2P1N3/5N1P/PP3PP1/R1BQ1RK1 w - - 0 12,Qxd8,-17,-55,-38,1
r1bQ1rk1/pp2bppp/4p3/2n5/2P1N3/5N1P/PP3PP1/R1B2RK1 b - - 0 12,Rxd8,-42,-45,-3,1
r1br2k1/pp2bppp/4p3/2n5/2P1N3/5N1P/PP3PP1/R1B2RK1 w - - 0 13,Nxc5,-42,-35,7,1
r1br2k1/pp2bppp/4p3/2N5/2P5/5N1P/PP3PP1/R1B2RK1 b - - 0 13,Bxc5,-32,-49,-17,1
r1br2k1/pp3ppp/4p3/2b5/2P5/5N1P/PP3PP1/R1B2RK1 w - - 0 14,Ne5,-40,-97,-57,1
r1br2k1/pp3ppp/4p3/2b1N3/2P5/7P/PP3PP1/R1B2RK1 b - - 1 14,Bd4,-110,-37,73,1
r1br2k1/pp3ppp/4p3/4N3/2Pb4/7P/PP3PP1/R1B2RK1 w - - 2 15,Bf4,-37,-107,-70,1
r1br2k1/pp3ppp/4p3/4N3/2Pb1B2/7P/PP3PP1/R4RK1 b - - 3 15,Bxb2,-108,-55,53,1
r1br2k1/pp3ppp/4p3/4N3/2P2B2/7P/Pb3PP1/R4RK1 w - - 0 16,Rae1,-46,-267,-221,0
r1br2k1/pp3ppp/4p3/4N3/2P2B2/7P/Pb3PP1/4RRK1 b - - 1 16,Bxe5,-314,-158,156,1
r1br2k1/pp3ppp/4p3/4b3/2P2B2/7P/P4PP1/4RRK1 w - - 0 17,Rxe5,-149,-146,3,1
r1br2k1/pp3ppp/4p3/4R3/2P2B2/7P/P4PP1/5RK1 b - - 0 17,Bd7,-144,-164,-20,1
r2r2k1/pp1b1ppp/4p3/4R3/2P2B2/7P/P4PP1/5RK1 w - - 1 18,Be3,-152,-213,-61,1
r2r2k1/pp1b1ppp/4p3/4R3/2P5/4B2P/P4PP1/5RK1 b - - 2 18,Bc6,-227,-228,-1,1
r2r2k1/pp3ppp/2b1p3/4R3/2P5/4B2P/P4PP1/5RK1 w - - 3 19,Re1,-252,-278,-26,1
r2r2k1/pp3ppp/2b1p3/4R3/2P5/4B2P/P4PP1/4R1K1 b - - 4 19,a6,-273,-218,55,1
r2r2k1/1p3ppp/p1b1p3/4R3/2P5/4B2P/P4PP1/4R1K1 w - - 0 20,a3,-219,-305,-86,1
r2r2k1/1p3ppp/p1b1p3/4R3/2P5/P3B2P/5PP1/4R1K1 b - - 0 20,Rd3,-288,-304,-16,1
r5k1/1p3ppp/p1b1p3/4R3/2P5/P2rB2P/5PP1/4R1K1 w - - 1 21,Rc1,-322,-372,-50,1
r5k1/1p3ppp/p1b1p3/4R3/2P5/P2rB2P/5PP1/2R3K1 b - - 2 21,Rxa3,-393,-395,-2,1
r5k1/1p3ppp/p1b1p3/4R3/2P5/r3B2P/5PP1/2R3K1 w - - 0 22,Re1,-403,-442,-39,1
r5k1/1p3ppp/p1b1p3/4R3/2P5/r3B2P/5PP1/4R1K1 b - - 1 22,Rd3,-438,-372,66,1
r5k1/1p3ppp/p1b1p3/4R3/2P5/3rB2P/5PP1/4R1K1 w - - 2 23,g4,-388,-455,-67,1
r5k1/1p3ppp/p1b1p3/4R3/2P3P1/3rB2P/5P2/4R1K1 b - - 0 23,Rad8,-466,-406,60,1
3r2k1/1p3ppp/p1b1p3/4R3/2P3P1/3rB2P/5P2/4R1K1 w - - 1 24,Re2,-350,-438,-88,1
3r2k1/1p3ppp/p1b1p3/4R3/2P3P1/3rB2P/4RP2/6K1 b - - 2 24,Rd1+,-462,-417,45,1
3r2k1/1p3ppp/p1b1p3/4R3/2P3P1/4B2P/4RP2/3r2K1 w - - 3 25,Kh2,-438,-436,2,1
3r2k1/1p3ppp/p1b1p3/4R3/2P3P1/4B2P/4RP1K/3r4 b - - 4 25,Rh1+,-441,-420,21,1
3r2k1/1p3ppp/p1b1p3/4R3/2P3P1/4B2P/4RP1K/7r w - - 5 26,Kg3,-416,-411,5,1
3r2k1/1p3ppp/p1b1p3/4R3/2P3P1/4B1KP/4RP2/7r b - - 6 26,Rdd1,-414,-397,17,1
6k1/1p3ppp/p1b1p3/4R3/2P3P1/4B1KP/4RP2/3r3r w - - 7 27,Rd2,-393,-410,-17,1
6k1/1p3ppp/p1b1p3/4R3/2P3P1/4B1KP/3R1P2/3r3r b - - 8 27,Rxd2,-423,-419,4,1
6k1/1p3ppp/p1b1p3/4R3/2P3P1/4B1KP/3r1P2/7r w - - 0 28,Bxd2,-406,-428,-22,1
6k1/1p3ppp/p1b1p3/4R3/2P3P1/6KP/3B1P2/7r b - - 0 28,Rg1+,-379,-385,-6,1
6k1/1p3ppp/p1b1p3/4R3/2P3P1/6KP/3B1P2/6r1 w - - 1 29,Kh4,-378,-393,-15,1
6k1/1p3ppp/p1b1p3/4R3/2P3PK/7P/3B1P2/6r1 b - - 2 29,Rd1,-378,-408,-30,1
6k1/1p3ppp/p1b1p3/4R3/2P3PK/7P/3B1P2/3r4 w - - 3 30,Re3,-403,-589,-186,0
6k1/1p3ppp/p1b1p3/8/2P3PK/4R2P/3B1P2/3r4 b - - 4 30,Rxd2,-618,-587,31,1
6k1/1p3ppp/p1b1p3/8/2P3PK/4R2P/3r1P2/8 w - - 0 31,Re4,-566,-811,-245,0
6k1/1p3ppp/p1b1p3/8/2P1R1PK/7P/3r1P2/8 b - - 1 31,Bxe4,-833,-824,9,1
6k1/1p3ppp/p3p3/8/2P1b1PK/7P/3r1P2/8 w - - 0 32,f3,-821,-837,-16,1
6k1/1p3ppp/p3p3/8/2P1b1PK/5P1P/3r4/8 b - - 0 32,Bxf3,-870,-871,-1,1
6k1/1p3ppp/p3p3/8/2P3PK/5b1P/3r4/8 w - - 0 33,Kg5,-882,-860,22,1
6k1/1p3ppp/p3p3/6K1/2P3P1/5b1P/3r4/8 b - - 1 33,Bc6,-905,-883,22,1
6k1/1p3ppp/p1b1p3/6K1/2P3P1/7P/3r4/8 w - - 2 34,Kh4,-888,-914,-26,1
6k1/1p3ppp/p1b1p3/8/2P3PK/7P/3r4/8 b - - 3 34,a5,-9992,-855,9137,1
6k1/1p3ppp/2b1p3/p7/2P3PK/7P/3r4/8 w - - 0 35,Kg5,-903,-908,-5,1
6k1/1p3ppp/2b1p3/p5K1/2P3P1/7P/3r4/8 b - - 1 35,a4,-918,-894,24,1
6k1/1p3ppp/2b1p3/6K1/p1P3P1/7P/3r4/8 w - - 0 36,Kh4,-894,-909,-15,1
6k1/1p3ppp/2b1p3/8/p1P3PK/7P/3r4/8 b - - 1 36,a3,-1001,-9993,-8992,0
6k1/1p3ppp/2b1p3/8/2P3PK/p6P/3r4/8 w - - 0 37,Kg5,-9993,-9993,0,1
6k1/1p3ppp/2b1p3/6K1/2P3P1/p6P/3r4/8 b - - 1 37,a2,-9993,-9994,-1,1
6k1/1p3ppp/2b1p3/6K1/2P3P1/7P/p2r4/8 w - - 0 38,Kh4,-9995,-9995,0,1
6k1/1p3ppp/2b1p3/8/2P3PK/7P/p2r4/8 b - - 1 38,a1=Q,-9995,-9996,-1,1
6k1/1p3ppp/2b1p3/8/2P3PK/7P/3r4/q7 w - - 0 39,Kg5,-9995,-9998,-3,1
6k1/1p3ppp/2b1p3/6K1/2P3P1/7P/3r4/q7 b - - 1 39,Qe1,-9998,-9996,2,1
6k1/1p3ppp/2b1p3/6K1/2P3P1/7P/3r4/4q3 w - - 2 40,c5,-9996,-9998,-2,1
6k1/1p3ppp/2b1p3/2P3K1/6P1/7P/3r4/4q3 b - - 0 40,Qe5+,-9998,-9997,1,1
6k1/1p3ppp/2b1p3/2P1q1K1/6P1/7P/3r4/8 w - - 1 41,Kh4,-9997,-9998,-1,1
6k1/1p3ppp/2b1p3/2P1q3/6PK/7P/3r4/8 b - - 2 41,g5+,-9998,-9998,0,1
6k1/1p3p1p/2b1p3/2P1q1p1/6PK/7P/3r4/8 w - - 0 42,Kh5,-9998,-9998,0,1
6k1/1p3p1p/2b1p3/2P1q1pK/6P1/7P/3r4/8 b - - 1 42,Rh2,-9998,-9999,-1,1
6k1/1p3p1p/2b1p3/2P1q1pK/6P1/7P/7r/8 w - - 2 43,Kh6,-9999,-9999,0,1
6k1/1p3p1p/2b1p2K/2P1q1p1/6P1/7P/7r/8 b - - 3 43,Rxh3#,-9999,-10000,-1,1
rnbqkbnr/pppppppp/8/8/8/8/PPPPPPPP/RNBQKBNR w KQkq - 0 1,e4,21,24,3,1
rnbqkbnr/pppppppp/8/8/4P3/8/PPPP1PPP/RNBQKBNR b KQkq - 0 1,d5,28,71,43,1
rnbqkbnr/ppp1pppp/8/3p4/4P3/8/PPPP1PPP/RNBQKBNR w KQkq - 0 2,e5,73,1,-72,1
rnbqkbnr/ppp1pppp/8/3pP3/8/8/PPPP1PPP/RNBQKBNR b KQkq - 0 2,f6,-8,73,81,1
rnbqkbnr/ppp1p1pp/5p2/3pP3/8/8/PPPP1PPP/RNBQKBNR w KQkq - 0 3,exf6,50,-31,-81,1
rnbqkbnr/ppp1p1pp/5P2/3p4/8/8/PPPP1PPP/RNBQKBNR b KQkq - 0 3,Nxf6,-26,-24,2,1
rnbqkb1r/ppp1p1pp/5n2/3p4/8/8/PPPP1PPP/RNBQKBNR w KQkq - 0 4,d4,-30,-46,-16,1
rnbqkb1r/ppp1p1pp/5n2/3p4/3P4/8/PPP2PPP/RNBQKBNR b KQkq - 0 4,Bg4,-39,32,71,1
rn1qkb1r/ppp1p1pp/5n2/3p4/3P2b1/8/PPP2PPP/RNBQKBNR w KQkq - 1 5,f3,10,-36,-46,1
rn1qkb1r/ppp1p1pp/5n2/3p4/3P2b1/5P2/PPP3PP/RNBQKBNR b KQkq - 0 5,Bf5,-27,-29,-2,1
rn1qkb1r/ppp1p1pp/5n2/3p1b2/3P4/5P2/PPP3PP/RNBQKBNR w KQkq - 1 6,Be3,-30,-49,-19,1
rn1qkb1r/ppp1p1pp/5n2/3p1b2/3P4/4BP2/PPP3PP/RN1QKBNR b KQkq - 2 6,Nc6,-41,-41,0,1
r2qkb1r/ppp1p1pp/2n2n2/3p1b2/3P4/4BP2/PPP3PP/RN1QKBNR w KQkq - 3 7,c3,-43,-123,-80,1
r2qkb1r/ppp1p1pp/2n2n2/3p1b2/3P4/2P1BP2/PP4PP/RN1QKBNR b KQkq - 0 7,e5,-120,-126,-6,1
r2qkb1r/ppp3pp/2n2n2/3ppb2/3P4/2P1BP2/PP4PP/RN1QKBNR w KQkq - 0 8,Bf2,-135,-177,-42,1
r2qkb1r/ppp3pp/2n2n2/3ppb2/3P4/2P2P2/PP3BPP/RN1QKBNR b KQkq - 1 8,e4,-166,-122,44,1
r2qkb1r/ppp3pp/2n2n2/3p1b2/3Pp3/2P2P2/PP3BPP/RN1QKBNR w KQkq - 0 9,Bb5,-124,-168,-44,1
r2qkb1r/ppp3pp/2n2n2/1B1p1b2/3Pp3/2P2P2/PP3BPP/RN1QK1NR b KQkq - 1 9,Bd6,-217,-192,25,1
r2qk2r/ppp3pp/2nb1n2/1B1p1b2/3Pp3/2P2P2/PP3BPP/RN1QK1NR w KQkq - 2 10,Nd2,-174,-170,4,1
r2qk2r/ppp3pp/2nb1n2/1B1p1b2/3Pp3/2P2P2/PP1N1BPP/R2QK1NR b KQkq - 3 10,O-O,-205,-205,0,1
r2q1rk1/ppp3pp/2nb1n2/1B1p1b2/3Pp3/2P2P2/PP1N1BPP/R2QK1NR w KQ - 4 11,Qe2,-184,-354,-170,0
r2q1rk1/ppp3pp/2nb1n2/1B1p1b2/3Pp3/2P2P2/PP1NQBPP/R3K1NR b KQ - 5 11,Re8,-334,-317,17,1
r2qr1k1/ppp3pp/2nb1n2/1B1p1b2/3Pp3/2P2P2/PP1NQBPP/R3K1NR w KQ - 6 12,Be3,-280,-327,-47,1
r2qr1k1/ppp3pp/2nb1n2/1B1p1b2/3Pp3/2P1BP2/PP1NQ1PP/R3K1NR b KQ - 7 12,Qe7,-343,-211,132,1
r3r1k1/ppp1q1pp/2nb1n2/1B1p1b2/3Pp3/2P1BP2/PP1NQ1PP/R3K1NR w KQ - 8 13,f4,-203,-186,17,1
r3r1k1/ppp1q1pp/2nb1n2/1B1p1b2/3PpP2/2P1B3/PP1NQ1PP/R3K1NR b KQ - 0 13,a6,-198,-203,-5,1
r3r1k1/1pp1q1pp/p1nb1n2/1B1p1b2/3PpP2/2P1B3/PP1NQ1PP/R3K1NR w KQ - 0 14,Ba4,-198,-214,-16,1
r3r1k1/1pp1q1pp/p1nb1n2/3p1b2/B2PpP2/2P1B3/PP1NQ1PP/R3K1NR b KQ - 1 14,Ng4,-215,-206,9,1
r3r1k1/1pp1q1pp/p1nb4/3p1b2/B2PpPn1/2P1B3/PP1NQ1PP/R3K1NR w KQ - 2 15,O-O-O,-187,-280,-93,1
r3r1k1/1pp1q1pp/p1nb4/3p1b2/B2PpPn1/2P1B3/PP1NQ1PP/2KR2NR b - - 3 15,Nxe3,-255,-231,24,1
r3r1k1/1pp1q1pp/p1nb4/3p1b2/B2PpP2/2P1n3/PP1NQ1PP/2KR2NR w - - 0 16,Qxe3,-240,-234,6,1
r3r1k1/1pp1q1pp/p1nb4/3p1b2/B2PpP2/2P1Q3/PP1N2PP/2KR2NR b - - 0 16,b5,-241,-245,-4,1
r3r1k1/2p1q1pp/p1nb4/1p1p1b2/B2PpP2/2P1Q3/PP1N2PP/2KR2NR w - - 0 17,Bc2,-251,-261,-10,1
r3r1k1/2p1q1pp/p1nb4/1p1p1b2/3PpP2/2P1Q3/PPBN2PP/2KR2NR b - - 1 17,b4,-252,-236,16,1
r3r1k1/2p1q1pp/p1nb4/3p1b2/1p1PpP2/2P1Q3/PPBN2PP/2KR2NR w - - 0 18,h3,-242,-343,-101,0
r3r1k1/2p1q1pp/p1nb4/3p1b2/1p1PpP2/2P1Q2P/PPBN2P1/2KR2NR b - - 0 18,bxc3,-379,-338,41,1
r3r1k1/2p1q1pp/p1nb4/3p1b2/3PpP2/2p1Q2P/PPBN2P1/2KR2NR w - - 0 19,bxc3,-357,-344,13,1
r3r1k1/2p1q1pp/p1nb4/3p1b2/3PpP2/2P1Q2P/P1BN2P1/2KR2NR b - - 0 19,Ba3+,-339,-359,-20,1
r3r1k1/2p1q1pp/p1n5/3p1b2/3PpP2/b1P1Q2P/P1BN2P1/2KR2NR w - - 1 20,Kb1,-461,-438,23,1
r3r1k1/2p1q1pp/p1n5/3p1b2/3PpP2/b1P1Q2P/P1BN2P1/1K1R2NR b - - 2 20,Rab8+,-504,-344,160,1
1r2r1k1/2p1q1pp/p1n5/3p1b2/3PpP2/b1P1Q2P/P1BN2P1/1K1R2NR w - - 3 21,Nb3,-363,-509,-146,0
1r2r1k1/2p1q1pp/p1n5/3p1b2/3PpP2/bNP1Q2P/P1B3P1/1K1R2NR b - - 4 21,a5,-512,-512,0,1
1r2r1k1/2p1q1pp/2n5/p2p1b2/3PpP2/bNP1Q2P/P1B3P1/1K1R2NR w - - 0 22,Ka1,-531,-514,17,1
1r2r1k1/2p1q1pp/2n5/p2p1b2/3PpP2/bNP1Q2P/P1B3P1/K2R2NR b - - 1 22,a4,-535,-544,-9,1
1r2r1k1/2p1q1pp/2n5/3p1b2/p2PpP2/bNP1Q2P/P1B3P1/K2R2NR w - - 0 23,Nc5,-569,-701,-132,0
1r2r1k1/2p1q1pp/2n5/2Np1b2/p2PpP2/b1P1Q2P/P1B3P1/K2R2NR b - - 1 23,Bb2+,-756,-782,-26,1
1r2r1k1/2p1q1pp/2n5/2Np1b2/p2PpP2/2P1Q2P/PbB3P1/K2R2NR w - - 2 24,Kb1,-779,-770,9,1
1r2r1k1/2p1q1pp/2n5/2Np1b2/p2PpP2/2P1Q2P/PbB3P1/1K1R2NR b - - 3 24,Bxc3+,-764,-764,0,1
1r2r1k1/2p1q1pp/2n5/2Np1b2/p2PpP2/2b1Q2P/P1B3P1/1K1R2NR w - - 0 25,Kc1,-745,-867,-122,0
1r2r1k1/2p1q1pp/2n5/2Np1b2/p2PpP2/2b1Q2P/P1B3P1/2KR2NR b - - 1 25,Bb2+,-861,-857,4,1
1r2r1k1/2p1q1pp/2n5/2Np1b2/p2PpP2/4Q2P/PbB3P1/2KR2NR w - - 2 26,Kd2,-875,-853,22,1
1r2r1k1/2p1q1pp/2n5/2Np1b2/p2PpP2/4Q2P/PbBK2P1/3R2NR b - - 3 26,Bxd4,-870,-855,15,1
1r2r1k1/2p1q1pp/2n5/2Np1b2/p2bpP2/4Q2P/P1BK2P1/3R2NR w - - 0 27,Qg3,-890,-987,-97,1
1r2r1k1/2p1q1pp/2n5/2Np1b2/p2bpP2/6QP/P1BK2P1/3R2NR b - - 1 27,Qxc5,-996,-903,93,1
1r2r1k1/2p3pp/2n5/2qp1b2/p2bpP2/6QP/P1BK2P1/3R2NR w - - 0 28,Ne2,-1020,-1013,7,1
1r2r1k1/2p3pp/2n5/2qp1b2/p2bpP2/6QP/P1BKN1P1/3R3R b - - 1 28,e3+,-1017,-1084,-67,1
1r2r1k1/2p3pp/2n5/2qp1b2/p2b1P2/4p1QP/P1BKN1P1/3R3R w - - 0 29,Ke1,-996,-1135,-139,0
1r2r1k1/2p3pp/2n5/2qp1b2/p2b1P2/4p1QP/P1B1N1P1/3RK2R b - - 1 29,Bxc2,-1212,-869,343,1
rnbqkbnr/pppppppp/8/8/8/8/PPPPPPPP/RNBQKBNR w KQkq - 0 1,e4,20,15,-5,1
rnbqkbnr/pppppppp/8/8/4P3/8/PPPP1PPP/RNBQKBNR b KQkq - 0 1,e5,12,30,18,1
rnbqkbnr/pppp1ppp/8/4p3/4P3/8/PPPP1PPP/RNBQKBNR w KQkq - 0 2,Nf3,36,40,4,1
rnbqkbnr/pppp1ppp/8/4p3/4P3/5N2/PPPP1PPP/RNBQKB1R b KQkq - 1 2,d6,35,54,19,1
rnbqkbnr/ppp2ppp/3p4/4p3/4P3/5N2/PPPP1PPP/RNBQKB1R w KQkq - 0 3,Bb5+,49,-3,-52,1
rnbqkbnr/ppp2ppp/3p4/1B2p3/4P3/5N2/PPPP1PPP/RNBQK2R b KQkq - 1 3,Bd7,-9,26,35,1
rn1qkbnr/pppb1ppp/3p4/1B2p3/4P3/5N2/PPPP1PPP/RNBQK2R w KQkq - 2 4,Be2,50,-30,-80,1
rn1qkbnr/pppb1ppp/3p4/4p3/4P3/5N2/PPPPBPPP/RNBQK2R b KQkq - 3 4,Nf6,-28,-1,27,1
rn1qkb1r/pppb1ppp/3p1n2/4p3/4P3/5N2/PPPPBPPP/RNBQK2R w KQkq - 4 5,Bd3,0,-41,-41,1
rn1qkb1r/pppb1ppp/3p1n2/4p3/4P3/3B1N2/PPPP1PPP/RNBQK2R b KQkq - 5 5,Bc6,-42,-5,37,1
rn1qkb1r/ppp2ppp/2bp1n2/4p3/4P3/3B1N2/PPPP1PPP/RNBQK2R w KQkq - 6 6,Qe2,-3,-10,-7,1
rn1qkb1r/ppp2ppp/2bp1n2/4p3/4P3/3B1N2/PPPPQPPP/RNB1K2R b KQkq - 7 6,Nbd7,-17,9,26,1
r2qkb1r/pppn1ppp/2bp1n2/4p3/4P3/3B1N2/PPPPQPPP/RNB1K2R w KQkq - 8 7,a3,1,-59,-60,1
r2qkb1r/pppn1ppp/2bp1n2/4p3/4P3/P2B1N2/1PPPQPPP/RNB1K2R b KQkq - 0 7,Nc5,-38,-40,-2,1
r2qkb1r/ppp2ppp/2bp1n2/2n1p3/4P3/P2B1N2/1PPPQPPP/RNB1K2R w KQkq - 1 8,Nc3,-38,-54,-16,1
r2qkb1r/ppp2ppp/2bp1n2/2n1p3/4P3/P1NB1N2/1PPPQPPP/R1B1K2R b KQkq - 2 8,Be7,-41,-18,23,1
r2qk2r/ppp1bppp/2bp1n2/2n1p3/4P3/P1NB1N2/1PPPQPPP/R1B1K2R w KQkq - 3 9,Bb5,-27,-106,-79,1
r2qk2r/ppp1bppp/2bp1n2/1Bn1p3/4P3/P1N2N2/1PPPQPPP/R1B1K2R b KQkq - 4 9,Bxb5,-42,-44,-2,1
r2qk2r/ppp1bppp/3p1n2/1bn1p3/4P3/P1N2N2/1PPPQPPP/R1B1K2R w KQkq - 0 10,Nxb5,-42,-156,-114,0
r2qk2r/ppp1bppp/3p1n2/1Nn1p3/4P3/P4N2/1PPPQPPP/R1B1K2R b KQkq - 0 10,Ncxe4,-163,-145,18,1
r2qk2r/ppp1bppp/3p1n2/1N2p3/4n3/P4N2/1PPPQPPP/R1B1K2R w KQkq - 0 11,d3,-193,-180,13,1
r2qk2r/ppp1bppp/3p1n2/1N2p3/4n3/P2P1N2/1PP1QPPP/R1B1K2R b KQkq - 0 11,Nc5,-185,-181,4,1
r2qk2r/ppp1bppp/3p1n2/1Nn1p3/8/P2P1N2/1PP1QPPP/R1B1K2R w KQkq - 1 12,d4,-198,-204,-6,1
r2qk2r/ppp1bppp/3p1n2/1Nn1p3/3P4/P4N2/1PP1QPPP/R1B1K2R b KQkq - 0 12,exd4,-177,-173,4,1
r2qk2r/ppp1bppp/3p1n2/1Nn5/3p4/P4N2/1PP1QPPP/R1B1K2R w KQkq - 0 13,Nfxd4,-182,-204,-22,1
r2qk2r/ppp1bppp/3p1n2/1Nn5/3N4/P7/1PP1QPPP/R1B1K2R b KQkq - 0 13,O-O,-206,-195,11,1
r2q1rk1/ppp1bppp/3p1n2/1Nn5/3N4/P7/1PP1QPPP/R1B1K2R w KQ - 1 14,Bg5,-200,-251,-51,1
r2q1rk1/ppp1bppp/3p1n2/1Nn3B1/3N4/P7/1PP1QPPP/R3K2R b KQ - 2 14,Re8,-238,-225,13,1
r2qr1k1/ppp1bppp/3p1n2/1Nn3B1/3N4/P7/1PP1QPPP/R3K2R w KQ - 3 15,O-O,-230,-246,-16,1
r2qr1k1/ppp1bppp/3p1n2/1Nn3B1/3N4/P7/1PP1QPPP/R4RK1 b - - 4 15,Nd5,-232,-153,79,1
r2qr1k1/ppp1bppp/3p4/1Nnn2B1/3N4/P7/1PP1QPPP/R4RK1 w - - 5 16,Bxe7,-160,-167,-7,1
r2qr1k1/ppp1Bppp/3p4/1Nnn4/3N4/P7/1PP1QPPP/R4RK1 b - - 0 16,Rxe7,-157,-114,43,1
r2q2k1/ppp1rppp/3p4/1Nnn4/3N4/P7/1PP1QPPP/R4RK1 w - - 0 17,Qd2,-121,-199,-78,1
r2q2k1/ppp1rppp/3p4/1Nnn4/3N4/P7/1PPQ1PPP/R4RK1 b - - 1 17,Ne4,-205,-196,9,1
r2q2k1/ppp1rppp/3p4/1N1n4/3Nn3/P7/1PPQ1PPP/R4RK1 w - - 2 18,Qd3,-193,-181,12,1
r2q2k1/ppp1rppp/3p4/1N1n4/3Nn3/P2Q4/1PP2PPP/R4RK1 b - - 3 18,Nef6,-181,-113,68,1
r2q2k1/ppp1rppp/3p1n2/1N1n4/3N4/P2Q4/1PP2PPP/R4RK1 w - - 4 19,Rfe1,-133,-177,-44,1
r2q2k1/ppp1rppp/3p1n2/1N1n4/3N4/P2Q4/1PP2PPP/R3R1K1 b - - 5 19,Rxe1+,-156,-142,14,1
r2q2k1/ppp2ppp/3p1n2/1N1n4/3N4/P2Q4/1PP2PPP/R3r1K1 w - - 0 20,Rxe1,-151,-149,2,1
r2q2k1/ppp2ppp/3p1n2/1N1n4/3N4/P2Q4/1PP2PPP/4R1K1 b - - 0 20,Nf4,-136,-4,132,1
r2q2k1/ppp2ppp/3p1n2/1N6/3N1n2/P2Q4/1PP2PPP/4R1K1 w - - 1 21,Qf3,-4,-20,-16,1
r2q2k1/ppp2ppp/3p1n2/1N6/3N1n2/P4Q2/1PP2PPP/4R1K1 b - - 2 21,N4d5,-10,-2,8,1
r2q2k1/ppp2ppp/3p1n2/1N1n4/3N4/P4Q2/1PP2PPP/4R1K1 w - - 3 22,Qg3,15,-119,-134,0
r2q2k1/ppp2ppp/3p1n2/1N1n4/3N4/P5Q1/1PP2PPP/4R1K1 b - - 4 22,a6,-130,-145,-15,1
r2q2k1/1pp2ppp/p2p1n2/1N1n4/3N4/P5Q1/1PP2PPP/4R1K1 w - - 0 23,Nf5,-128,-184,-56,1
r2q2k1/1pp2ppp/p2p1n2/1N1n1N2/8/P5Q1/1PP2PPP/4R1K1 b - - 1 23,g6,-170,-151,19,1
r2q2k1/1pp2p1p/p2p1np1/1N1n1N2/8/P5Q1/1PP2PPP/4R1K1 w - - 0 24,Nh6+,-132,-260,-128,0
r2q2k1/1pp2p1p/p2p1npN/1N1n4/8/P5Q1/1PP2PPP/4R1K1 b - - 1 24,Kg7,-285,-265,20,1
r2q4/1pp2pkp/p2p1npN/1N1n4/8/P5Q1/1PP2PPP/4R1K1 w - - 2 25,Nf5+,-271,-313,-42,1
r2q4/1pp2pkp/p2p1np1/1N1n1N2/8/P5Q1/1PP2PPP/4R1K1 b - - 3 25,Kh8,-323,-311,12,1
r2q3k/1pp2p1p/p2p1np1/1N1n1N2/8/P5Q1/1PP2PPP/4R1K1 w - - 4 26,Nh6,-326,-372,-46,1
r2q3k/1pp2p1p/p2p1npN/1N1n4/8/P5Q1/1PP2PPP/4R1K1 b - - 5 26,Qd7,-324,-159,165,1
r6k/1ppq1p1p/p2p1npN/1N1n4/8/P5Q1/1PP2PPP/4R1K1 w - - 6 27,Nc3,-182,-235,-53,1
r6k/1ppq1p1p/p2p1npN/3n4/8/P1N3Q1/1PP2PPP/4R1K1 b - - 7 27,Nxc3,-208,-96,112,1
r6k/1ppq1p1p/p2p1npN/8/8/P1n3Q1/1PP2PPP/4R1K1 w - - 0 28,bxc3,-149,-302,-153,0
r6k/1ppq1p1p/p2p1npN/8/8/P1P3Q1/2P2PPP/4R1K1 b - - 0 28,Re8,-352,-326,26,1
4r2k/1ppq1p1p/p2p1npN/8/8/P1P3Q1/2P2PPP/4R1K1 w - - 1 29,Rxe8+,-319,-301,18,1
4R2k/1ppq1p1p/p2p1npN/8/8/P1P3Q1/2P2PPP/6K1 b - - 0 29,Qxe8,-349,-333,16,1
4q2k/1pp2p1p/p2p1npN/8/8/P1P3Q1/2P2PPP/6K1 w - - 0 30,Qe3,-314,-471,-157,0
4q2k/1pp2p1p/p2p1npN/8/8/P1P1Q3/2P2PPP/6K1 b - - 1 30,Qxe3,-501,-515,-14,1
7k/1pp2p1p/p2p1npN/8/8/P1P1q3/2P2PPP/6K1 w - - 0 31,fxe3,-532,-532,0,1
7k/1pp2p1p/p2p1npN/8/8/P1P1P3/2P3PP/6K1 b - - 0 31,Kg7,-543,-518,25,1
8/1pp2pkp/p2p1npN/8/8/P1P1P3/2P3PP/6K1 w - - 1 32,Nxf7,-517,-580,-63,1
8/1pp2Nkp/p2p1np1/8/8/P1P1P3/2P3PP/6K1 b - - 0 32,Kxf7,-547,-574,-27,1
8/1pp2k1p/p2p1np1/8/8/P1P1P3/2P3PP/6K1 w - - 0 33,Kf2,-556,-575,-19,1
8/1pp2k1p/p2p1np1/8/8/P1P1P3/2P2KPP/8 b - - 1 33,Ne4+,-577,-571,6,1
8/1pp2k1p/p2p2p1/8/4n3/P1P1P3/2P2KPP/8 w - - 2 34,Ke2,-569,-583,-14,1
8/1pp2k1p/p2p2p1/8/4n3/P1P1P3/2P1K1PP/8 b - - 3 34,Nxc3+,-573,-538,35,1
8/1pp2k1p/p2p2p1/8/8/P1n1P3/2P1K1PP/8 w - - 0 35,Kd3,-546,-550,-4,1
8/1pp2k1p/p2p2p1/8/8/P1nKP3/2P3PP/8 b - - 1 35,Nb5,-557,-495,62,1
8/1pp2k1p/p2p2p1/1n6/8/P2KP3/2P3PP/8 w - - 2 36,a4,-518,-504,14,1
8/1pp2k1p/p2p2p1/1n6/P7/3KP3/2P3PP/8 b - - 0 36,Na7,-526,-558,-32,1
8/npp2k1p/p2p2p1/8/P7/3KP3/2P3PP/8 w - - 1 37,c3,-559,-578,-19,1
8/npp2k1p/p2p2p1/8/P7/2PKP3/6PP/8 b - - 0 37,Ke6,-570,-580,-10,1
8/npp4p/p2pk1p1/8/P7/2PKP3/6PP/8 w - - 1 38,Kd4,-591,-606,-15,1
8/npp4p/p2pk1p1/8/P2K4/2P1P3/6PP/8 b - - 2 38,c5+,-626,-608,18,1
8/np5p/p2pk1p1/2p5/P2K4/2P1P3/6PP/8 w - - 0 39,Kd3,-619,-621,-2,1
8/np5p/p2pk1p1/2p5/P7/2PKP3/6PP/8 b - - 1 39,b5,-625,-633,-8,1
8/n6p/p2pk1p1/1pp5/P7/2PKP3/6PP/8 w - - 0 40,axb5,-629,-640,-11,1
8/n6p/p2pk1p1/1Pp5/8/2PKP3/6PP/8 b - - 0 40,axb5,-656,-664,-8,1
8/n6p/3pk1p1/1pp5/8/2PKP3/6PP/8 w - - 0 41,h4,-659,-677,-18,1
8/n6p/3pk1p1/1pp5/7P/2PKP3/6P1/8 b - - 0 41,b4,-649,-652,-3,1
8/n6p/3pk1p1/2p5/1p5P/2PKP3/6P1/8 w - - 0 42,cxb4,-635,-646,-11,1
8/n6p/3pk1p1/2p5/1P5P/3KP3/6P1/8 b - - 0 42,cxb4,-657,-648,9,1
8/n6p/3pk1p1/8/1p5P/3KP3/6P1/8 w - - 0 43,Kc4,-628,-646,-18,1
8/n6p/3pk1p1/8/1pK4P/4P3/6P1/8 b - - 1 43,Nc6,-633,-659,-26,1
8/7p/2npk1p1/8/1pK4P/4P3/6P1/8 w - - 2 44,Kb5,-642,-727,-85,1
8/7p/2npk1p1/1K6/1p5P/4P3/6P1/8 b - - 3 44,Ke5,-755,-696,59,1
rnbqkbnr/pppppppp/8/8/8/8/PPPPPPPP/RNBQKBNR w KQkq - 0 1,d4,22,4,-18,1
rnbqkbnr/pppppppp/8/8/3P4/8/PPP1PPPP/RNBQKBNR b KQkq - 0 1,e6,11,45,34,1
rnbqkbnr/pppp1ppp/4p3/8/3P4/8/PPP1PPPP/RNBQKBNR w KQkq - 0 2,c4,44,19,-25,1
rnbqkbnr/pppp1ppp/4p3/8/2PP4/8/PP2PPPP/RNBQKBNR b KQkq - 0 2,c5,21,76,55,1
rnbqkbnr/pp1p1ppp/4p3/2p5/2PP4/8/PP2PPPP/RNBQKBNR w KQkq - 0 3,d5,49,50,1,1
rnbqkbnr/pp1p1ppp/4p3/2pP4/2P5/8/PP2PPPP/RNBQKBNR b KQkq - 0 3,exd5,92,99,7,1
rnbqkbnr/pp1p1ppp/8/2pp4/2P5/8/PP2PPPP/RNBQKBNR w KQkq - 0 4,cxd5,99,94,-5,1
rnbqkbnr/pp1p1ppp/8/2pP4/8/8/PP2PPPP/RNBQKBNR b KQkq - 0 4,d6,66,106,40,1
rnbqkbnr/pp3ppp/3p4/2pP4/8/8/PP2PPPP/RNBQKBNR w KQkq - 0 5,Nc3,91,86,-5,1
rnbqkbnr/pp3ppp/3p4/2pP4/8/2N5/PP2PPPP/R1BQKBNR b KQkq - 1 5,Be7,86,98,12,1
rnbqk1nr/pp2bppp/3p4/2pP4/8/2N5/PP2PPPP/R1BQKBNR w KQkq - 2 6,b3,95,-17,-112,0
rnbqk1nr/pp2bppp/3p4/2pP4/8/1PN5/P3PPPP/R1BQKBNR b KQkq - 0 6,a6,11,19,8,1
rnbqk1nr/1p2bppp/p2p4/2pP4/8/1PN5/P3PPPP/R1BQKBNR w KQkq - 0 7,Bb2,34,30,-4,1
rnbqk1nr/1p2bppp/p2p4/2pP4/8/1PN5/PB2PPPP/R2QKBNR b KQkq - 1 7,b5,30,21,-9,1
rnbqk1nr/4bppp/p2p4/1ppP4/8/1PN5/PB2PPPP/R2QKBNR w KQkq - 0 8,Nxb5,26,-461,-487,0
rnbqk1nr/4bppp/p2p4/1NpP4/8/1P6/PB2PPPP/R2QKBNR b KQkq - 0 8,Nf6,-472,183,655,1
rnbqk2r/4bppp/p2p1n2/1NpP4/8/1P6/PB2PPPP/R2QKBNR w KQkq - 1 9,Nc3,177,175,-2,1
rnbqk2r/4bppp/p2p1n2/2pP4/8/1PN5/PB2PPPP/R2QKBNR b KQkq - 2 9,O-O,175,158,-17,1
rnbq1rk1/4bppp/p2p1n2/2pP4/8/1PN5/PB2PPPP/R2QKBNR w KQ - 3 10,e4,157,162,5,1
rnbq1rk1/4bppp/p2p1n2/2pP4/4P3/1PN5/PB3PPP/R2QKBNR b KQ - 0 10,Re8,161,161,0,1
rnbqr1k1/4bppp/p2p1n2/2pP4/4P3/1PN5/PB3PPP/R2QKBNR w KQ - 1 11,Nge2,137,107,-30,1
rnbqr1k1/4bppp/p2p1n2/2pP4/4P3/1PN5/PB2NPPP/R2QKB1R b KQ - 2 11,Ng4,110,184,74,1
rnbqr1k1/4bppp/p2p4/2pP4/4P1n1/1PN5/PB2NPPP/R2QKB1R w KQ - 3 12,Ng3,198,194,-4,1
rnbqr1k1/4bppp/p2p4/2pP4/4P1n1/1PN3N1/PB3PPP/R2QKB1R b KQ - 4 12,Bf8,194,206,12,1
rnbqrbk1/5ppp/p2p4/2pP4/4P1n1/1PN3N1/PB3PPP/R2QKB1R w KQ - 5 13,h3,220,168,-52,1
rnbqrbk1/5ppp/p2p4/2pP4/4P1n1/1PN3NP/PB3PP1/R2QKB1R b KQ - 0 13,Ne5,177,184,7,1
rnbqrbk1/5ppp/p2p4/2pPn3/4P3/1PN3NP/PB3PP1/R2QKB1R w KQ - 1 14,Be2,228,231,3,1
rnbqrbk1/5ppp/p2p4/2pPn3/4P3/1PN3NP/PB2BPP1/R2QK2R b KQ - 2 14,Bd7,223,306,83,1
rn1qrbk1/3b1ppp/p2p4/2pPn3/4P3/1PN3NP/PB2BPP1/R2QK2R w KQ - 3 15,O-O,262,277,15,1
rn1qrbk1/3b1ppp/p2p4/2pPn3/4P3/1PN3NP/PB2BPP1/R2Q1RK1 b - - 4 15,Qc8,274,360,86,1
rnq1rbk1/3b1ppp/p2p4/2pPn3/4P3/1PN3NP/PB2BPP1/R2Q1RK1 w - - 5 16,Qc2,349,363,14,1
rnq1rbk1/3b1ppp/p2p4/2pPn3/4P3/1PN3NP/PBQ1BPP1/R4RK1 b - - 6 16,Bxh3,304,466,162,1
rnq1rbk1/5ppp/p2p4/2pPn3/4P3/1PN3Nb/PBQ1BPP1/R4RK1 w - - 0 17,gxh3,465,246,-219,0
rnq1rbk1/5ppp/p2p4/2pPn3/4P3/1PN3NP/PBQ1BP2/R4RK1 b - - 0 17,Qxh3,308,318,10,1
rn2rbk1/5ppp/p2p4/2pPn3/4P3/1PN3Nq/PBQ1BP2/R4RK1 w - - 0 18,Qd1,389,250,-139,0
rn2rbk1/5ppp/p2p4/2pPn3/4P3/1PN3Nq/PB2BP2/R2Q1RK1 b - - 1 18,Nbd7,255,263,8,1
r3rbk1/3n1ppp/p2p4/2pPn3/4P3/1PN3Nq/PB2BP2/R2Q1RK1 w - - 2 19,Bf3,249,159,-90,1
r3rbk1/3n1ppp/p2p4/2pPn3/4P3/1PN2BNq/PB3P2/R2Q1RK1 b - - 3 19,Nf6,176,340,164,1
r3rbk1/5ppp/p2p1n2/2pPn3/4P3/1PN2BNq/PB3P2/R2Q1RK1 w - - 4 20,Bg2,335,343,8,1
r3rbk1/5ppp/p2p1n2/2pPn3/4P3/1PN3Nq/PB3PB1/R2Q1RK1 b - - 5 20,Qh6,342,384,42,1
r3rbk1/5ppp/p2p1n1q/2pPn3/4P3/1PN3N1/PB3PB1/R2Q1RK1 w - - 6 21,Bc1,400,399,-1,1
r3rbk1/5ppp/p2p1n1q/2pPn3/4P3/1PN3N1/P4PB1/R1BQ1RK1 b - - 7 21,Qg6,363,399,36,1
r3rbk1/5ppp/p2p1nq1/2pPn3/4P3/1PN3N1/P4PB1/R1BQ1RK1 w - - 8 22,Nce2,351,337,-14,1
r3rbk1/5ppp/p2p1nq1/2pPn3/4P3/1P4N1/P3NPB1/R1BQ1RK1 b - - 9 22,h5,326,371,45,1
r3rbk1/5pp1/p2p1nq1/2pPn2p/4P3/1P4N1/P3NPB1/R1BQ1RK1 w - - 0 23,Nf4,383,363,-20,1
r3rbk1/5pp1/p2p1nq1/2pPn2p/4PN2/1P4N1/P4PB1/R1BQ1RK1 b - - 1 23,Qg4,371,413,42,1
r3rbk1/5pp1/p2p1n2/2pPn2p/4PNq1/1P4N1/P4PB1/R1BQ1RK1 w - - 2 24,Qxg4,407,285,-122,0
r3rbk1/5pp1/p2p1n2/2pPn2p/4PNQ1/1P4N1/P4PB1/R1B2RK1 b - - 0 24,hxg4,317,277,-40,1
r3rbk1/5pp1/p2p1n2/2pPn3/4PNp1/1P4N1/P4PB1/R1B2RK1 w - - 0 25,Bb2,290,286,-4,1
r3rbk1/5pp1/p2p1n2/2pPn3/4PNp1/1P4N1/PB3PB1/R4RK1 b - - 1 25,Be7,277,370,93,1
r3r1k1/4bpp1/p2p1n2/2pPn3/4PNp1/1P4N1/PB3PB1/R4RK1 w - - 2 26,Nf5,515,339,-176,0
r3r1k1/4bpp1/p2p1n2/2pPnN2/4PNp1/1P6/PB3PB1/R4RK1 b - - 3 26,Nfd7,332,353,21,1
r3r1k1/3nbpp1/p2p4/2pPnN2/4PNp1/1P6/PB3PB1/R4RK1 w - - 4 27,Bxe5,360,307,-53,1
r3r1k1/3nbpp1/p2p4/2pPBN2/4PNp1/1P6/P4PB1/R4RK1 b - - 0 27,Nxe5,267,322,55,1
r3r1k1/4bpp1/p2p4/2pPnN2/4PNp1/1P6/P4PB1/R4RK1 w - - 0 28,Nxe7+,302,291,-11,1
r3r1k1/4Npp1/p2p4/2pPn3/4PNp1/1P6/P4PB1/R4RK1 b - - 0 28,Rxe7,302,334,32,1
r5k1/4rpp1/p2p4/2pPn3/4PNp1/1P6/P4PB1/R4RK1 w - - 0 29,Rfd1,327,281,-46,1
r5k1/4rpp1/p2p4/2pPn3/4PNp1/1P6/P4PB1/R2R2K1 b - - 1 29,g5,264,340,76,1
r5k1/4rp2/p2p4/2pPn1p1/4PNp1/1P6/P4PB1/R2R2K1 w - - 0 30,Nd3,341,320,-21,1
r5k1/4rp2/p2p4/2pPn1p1/4P1p1/1P1N4/P4PB1/R2R2K1 b - - 1 30,f6,322,380,58,1
r5k1/4r3/p2p1p2/2pPn1p1/4P1p1/1P1N4/P4PB1/R2R2K1 w - - 0 31,Nxe5,367,348,-19,1
r5k1/4r3/p2p1p2/2pPN1p1/4P1p1/1P6/P4PB1/R2R2K1 b - - 0 31,fxe5,363,399,36,1
r5k1/4r3/p2p4/2pPp1p1/4P1p1/1P6/P4PB1/R2R2K1 w - - 0 32,Rac1,375,343,-32,1
r5k1/4r3/p2p4/2pPp1p1/4P1p1/1P6/P4PB1/2RR2K1 b - - 1 32,a5,333,355,22,1
r5k1/4r3/3p4/p1pPp1p1/4P1p1/1P6/P4PB1/2RR2K1 w - - 0 33,Rc3,319,301,-18,1
r5k1/4r3/3p4/p1pPp1p1/4P1p1/1PR5/P4PB1/3R2K1 b - - 1 33,Rf8,335,332,-3,1
5rk1/4r3/3p4/p1pPp1p1/4P1p1/1PR5/P4PB1/3R2K1 w - - 2 34,Rc4,338,317,-21,1
5rk1/4r3/3p4/p1pPp1p1/2R1P1p1/1P6/P4PB1/3R2K1 b - - 3 34,Ref7,297,299,2,1
5rk1/5r2/3p4/p1pPp1p1/2R1P1p1/1P6/P4PB1/3R2K1 w - - 4 35,Rd2,310,286,-24,1
5rk1/5r2/3p4/p1pPp1p1/2R1P1p1/1P6/P2R1PB1/6K1 b - - 5 35,Rb8,294,302,8,1
1r4k1/5r2/3p4/p1pPp1p1/2R1P1p1/1P6/P2R1PB1/6K1 w - - 6 36,Ra4,301,314,13,1
1r4k1/5r2/3p4/p1pPp1p1/R3P1p1/1P6/P2R1PB1/6K1 b - - 7 36,Ra7,305,296,-9,1
1r4k1/r7/3p4/p1pPp1p1/R3P1p1/1P6/P2R1PB1/6K1 w - - 8 37,Rd3,297,347,50,1
1r4k1/r7/3p4/p1pPp1p1/R3P1p1/1P1R4/P4PB1/6K1 b - - 9 37,Kg7,315,336,21,1
1r6/r5k1/3p4/p1pPp1p1/R3P1p1/1P1R4/P4PB1/6K1 w - - 10 38,Rg3,314,368,54,1
1r6/r5k1/3p4/p1pPp1p1/R3P1p1/1P4R1/P4PB1/6K1 b - - 11 38,Kg6,368,371,3,1
1r6/r7/3p2k1/p1pPp1p1/R3P1p1/1P4R1/P4PB1/6K1 w - - 12 39,Rxg4,401,392,-9,1
1r6/r7/3p2k1/p1pPp1p1/R3P1R1/1P6/P4PB1/6K1 b - - 0 39,Kh5,394,400,6,1
1r6/r7/3p4/p1pPp1pk/R3P1R1/1P6/P4PB1/6K1 w - - 1 40,Bf3,384,473,89,1
1r6/r7/3p4/p1pPp1pk/R3P1R1/1P3B2/P4P2/6K1 b - - 2 40,Rb4,441,472,31,1
8/r7/3p4/p1pPp1pk/Rr2P1R1/1P3B2/P4P2/6K1 w - - 3 41,Rg3+,470,457,-13,1
8/r7/3p4/p1pPp1pk/Rr2P3/1P3BR1/P4P2/6K1 b - - 4 41,Kh4,464,684,220,1
8/r7/3p4/p1pPp1p1/Rr2P2k/1P3BR1/P4P2/6K1 w - - 5 42,Rg4+,734,474,-260,0
8/r7/3p4/p1pPp1p1/Rr2P1Rk/1P3B2/P4P2/6K1 b - - 6 42,Kh5,465,477,12,1
8/r7/3p4/p1pPp1pk/Rr2P1R1/1P3B2/P4P2/6K1 w - - 7 43,Rg2+,470,458,-12,1
8/r7/3p4/p1pPp1pk/Rr2P3/1P3B2/P4PR1/6K1 b - - 8 43,Kg6,446,455,9,1
8/r7/3p2k1/p1pPp1p1/Rr2P3/1P3B2/P4PR1/6K1 w - - 9 44,Rh2,424,356,-68,1
8/r7/3p2k1/p1pPp1p1/Rr2P3/1P3B2/P4P1R/6K1 b - - 10 44,Rxa4,348,352,4,1
8/r7/3p2k1/p1pPp1p1/r3P3/1P3B2/P4P1R/6K1 w - - 0 45,bxa4,396,455,59,1
8/r7/3p2k1/p1pPp1p1/P3P3/5B2/P4P1R/6K1 b - - 0 45,Rh7,461,568,107,1
8/7r/3p2k1/p1pPp1p1/P3P3/5B2/P4P1R/6K1 w - - 1 46,Rxh7,552,488,-64,1
8/7R/3p2k1/p1pPp1p1/P3P3/5B2/P4P2/6K1 b - - 0 46,Kxh7,598,608,10,1
8/7k/3p4/p1pPp1p1/P3P3/5B2/P4P2/6K1 w - - 0 47,Kg2,594,556,-38,1
8/7k/3p4/p1pPp1p1/P3P3/5B2/P4PK1/8 b - - 1 47,Kg6,607,615,8,1
8/8/3p2k1/p1pPp1p1/P3P3/5B2/P4PK1/8 w - - 2 48,Kg3,610,623,13,1
8/8/3p2k1/p1pPp1p1/P3P3/5BK1/P4P2/8 b - - 3 48,Kf6,606,546,-60,1
8/8/3p1k2/p1pPp1p1/P3P3/5BK1/P4P2/8 w - - 4 49,Kg4,607,614,7,1
8/8/3p1k2/p1pPp1p1/P3P1K1/5B2/P4P2/8 b - - 5 49,Kg6,610,621,11,1
8/8/3p2k1/p1pPp1p1/P3P1K1/5B2/P4P2/8 w - - 6 50,Be2,594,602,8,1
8/8/3p2k1/p1pPp1p1/P3P1K1/8/P3BP2/8 b - - 7 50,Kf6,610,617,7,1
8/8/3p1k2/p1pPp1p1/P3P1K1/8/P3BP2/8 w - - 8 51,Kh5,621,634,13,1
8/8/3p1k2/p1pPp1pK/P3P3/8/P3BP2/8 b - - 9 51,g4,655,655,0,1
8/8/3p1k2/p1pPp2K/P3P1p1/8/P3BP2/8 w - - 0 52,Bxg4,669,615,-54,1
8/8/3p1k2/p1pPp2K/P3P1B1/8/P4P2/8 b - - 0 52,c4,656,670,14,1
8/8/3p1k2/p2Pp2K/P1p1P1B1/8/P4P2/8 w - - 0 53,Bd1,681,639,-42,1
8/8/3p1k2/p2Pp2K/P1p1P3/8/P4P2/3B4 b - - 1 53,c3,693,695,2,1
8/8/3p1k2/p2Pp2K/P3P3/2p5/P4P2/3B4 w - - 0 54,f3,658,704,46,1
8/8/3p1k2/p2Pp2K/P3P3/2p2P2/P7/3B4 b - - 0 54,Ke7,706,709,3,1
8/4k3/3p4/p2Pp2K/P3P3/2p2P2/P7/3B4 w - - 1 55,Kg5,745,689,-56,1
8/4k3/3p4/p2Pp1K1/P3P3/2p2P2/P7/3B4 b - - 2 55,Kd7,682,757,75,1
8/3k4/3p4/p2Pp1K1/P3P3/2p2P2/P7/3B4 w - - 3 56,Kf5,775,680,-95,1
8/3k4/3p4/p2PpK2/P3P3/2p2P2/P7/3B4 b - - 4 56,Ke7,660,660,0,1
8/4k3/3p4/p2PpK2/P3P3/2p2P2/P7/3B4 w - - 5 57,Bb3,707,669,-38,1
8/4k3/3p4/p2PpK2/P3P3/1Bp2P2/P7/8 b - - 6 57,Kf7,773,776,3,1
8/5k2/3p4/p2PpK2/P3P3/1Bp2P2/P7/8 w - - 7 58,f4,793,652,-141,0
8/5k2/3p4/p2PpK2/P3PP2/1Bp5/P7/8 b - - 0 58,exf4,653,660,7,1
8/5k2/3p4/p2P1K2/P3Pp2/1Bp5/P7/8 w - - 0 59,Kxf4,661,654,-7,1
8/5k2/3p4/p2P4/P3PK2/1Bp5/P7/8 b - - 0 59,Kf6,679,694,15,1
8/8/3p1k2/p2P4/P3PK2/1Bp5/P7/8 w - - 1 60,Ke3,712,658,-54,1
8/8/3p1k2/p2P4/P3P3/1Bp1K3/P7/8 b - - 2 60,Ke5,633,667,34,1
8/8/3p4/p2Pk3/P3P3/1Bp1K3/P7/8 w - - 3 61,Kd3,643,632,-11,1
8/8/3p4/p2Pk3/P3P3/1BpK4/P7/8 b - - 4 61,Kf4,685,694,9,1
8/8/3p4/p2P4/P3Pk2/1BpK4/P7/8 w - - 5 62,Bc2,713,709,-4,1
8/8/3p4/p2P4/P3Pk2/2pK4/P1B5/8 b - - 6 62,Kf3,696,727,31,1
8/8/3p4/p2P4/P3P3/2pK1k2/P1B5/8 w - - 7 63,Kxc3,719,733,14,1
8/8/3p4/p2P4/P3P3/2K2k2/P1B5/8 b - - 0 63,Ke3,777,800,23,1
8/8/3p4/p2P4/P3P3/2K1k3/P1B5/8 w - - 1 64,a3,811,674,-137,0
8/8/3p4/p2P4/P3P3/P1K1k3/2B5/8 b - - 0 64,Ke2,721,831,110,1
8/8/3p4/p2P4/P3P3/P1K5/2B1k3/8 w - - 1 65,Kd4,830,679,-151,0
8/8/3p4/p2P4/P2KP3/P7/2B1k3/8 b - - 2 65,Kd2,665,739,74,1
8/8/3p4/p2P4/P2KP3/P7/2Bk4/8 w - - 3 66,Bd3,810,837,27,1
8/8/3p4/p2P4/P2KP3/P2B4/3k4/8 b - - 4 66,Kc1,873,925,52,1
8/8/3p4/p2P4/P2KP3/P2B4/8/2k5 w - - 5 67,e5,934,889,-45,1
8/8/3p4/p2PP3/P2K4/P2B4/8/2k5 b - - 0 67,dxe5+,916,934,18,1
8/8/8/p2Pp3/P2K4/P2B4/8/2k5 w - - 0 68,Kxe5,934,770,-164,0
8/8/8/p2PK3/P7/P2B4/8/2k5 b - - 0 68,Kb2,781,950,169,1
8/8/8/p2PK3/P7/P2B4/1k6/8 w - - 1 69,d6,992,775,-217,0
8/8/3P4/p3K3/P7/P2B4/1k6/8 b - - 0 69,Kxa3,753,753,0,1
8/8/3P4/p3K3/P7/k2B4/8/8 w - - 0 70,Bb5,811,876,65,1
rnbqkbnr/pppppppp/8/8/8/8/PPPPPPPP/RNBQKBNR w KQkq - 0 1,c4,36,-6,-42,1
rnbqkbnr/pppppppp/8/8/2P5/8/PP1PPPPP/RNBQKBNR b KQkq - 0 1,c5,-14,20,34,1
rnbqkbnr/pp1ppppp/8/2p5/2P5/8/PP1PPPPP/RNBQKBNR w KQkq - 0 2,Nc3,18,17,-1,1
rnbqkbnr/pp1ppppp/8/2p5/2P5/2N5/PP1PPPPP/R1BQKBNR b KQkq - 1 2,e6,20,18,-2,1
rnbqkbnr/pp1p1ppp/4p3/2p5/2P5/2N5/PP1PPPPP/R1BQKBNR w KQkq - 0 3,d4,16,-22,-38,1
rnbqkbnr/pp1p1ppp/4p3/2p5/2PP4/2N5/PP2PPPP/R1BQKBNR b KQkq - 0 3,Qb6,-14,137,151,1
rnb1kbnr/pp1p1ppp/1q2p3/2p5/2PP4/2N5/PP2PPPP/R1BQKBNR w KQkq - 1 4,e3,125,94,-31,1
rnb1kbnr/pp1p1ppp/1q2p3/2p5/2PP4/2N1P3/PP3PPP/R1BQKBNR b KQkq - 0 4,g6,102,154,52,1
rnb1kbnr/pp1p1p1p/1q2p1p1/2p5/2PP4/2N1P3/PP3PPP/R1BQKBNR w KQkq - 0 5,Nf3,148,116,-32,1
rnb1kbnr/pp1p1p1p/1q2p1p1/2p5/2PP4/2N1PN2/PP3PPP/R1BQKB1R b KQkq - 1 5,Bg7,108,180,72,1
rnb1k1nr/pp1p1pbp/1q2p1p1/2p5/2PP4/2N1PN2/PP3PPP/R1BQKB1R w KQkq - 2 6,d5,190,80,-110,0
rnb1k1nr/pp1p1pbp/1q2p1p1/2pP4/2P5/2N1PN2/PP3PPP/R1BQKB1R b KQkq - 0 6,exd5,72,151,79,1
rnb1k1nr/pp1p1pbp/1q4p1/2pp4/2P5/2N1PN2/PP3PPP/R1BQKB1R w KQkq - 0 7,Nxd5,117,75,-42,1
rnb1k1nr/pp1p1pbp/1q4p1/2pN4/2P5/4PN2/PP3PPP/R1BQKB1R b KQkq - 0 7,Qa5+,59,139,80,1
rnb1k1nr/pp1p1pbp/6p1/q1pN4/2P5/4PN2/PP3PPP/R1BQKB1R w KQkq - 1 8,Bd2,140,132,-8,1
rnb1k1nr/pp1p1pbp/6p1/q1pN4/2P5/4PN2/PP1B1PPP/R2QKB1R b KQkq - 2 8,Qa6,134,706,572,1
rnb1k1nr/pp1p1pbp/q5p1/2pN4/2P5/4PN2/PP1B1PPP/R2QKB1R w KQkq - 3 9,Qc2,681,322,-359,0
rnb1k1nr/pp1p1pbp/q5p1/2pN4/2P5/4PN2/PPQB1PPP/R3KB1R b KQkq - 4 9,Nc6,354,645,291,1
r1b1k1nr/pp1p1pbp/q1n3p1/2pN4/2P5/4PN2/PPQB1PPP/R3KB1R w KQkq - 5 10,Be2,669,431,-238,0
r1b1k1nr/pp1p1pbp/q1n3p1/2pN4/2P5/4PN2/PPQBBPPP/R3K2R b KQkq - 6 10,Nb4,458,645,187,1
r1b1k1nr/pp1p1pbp/q5p1/2pN4/1nP5/4PN2/PPQBBPPP/R3K2R w KQkq - 7 11,Qb3,673,91,-582,0
r1b1k1nr/pp1p1pbp/q5p1/2pN4/1nP5/1Q2PN2/PP1BBPPP/R3K2R b KQkq - 8 11,Ne7,96,639,543,1
r1b1k2r/pp1pnpbp/q5p1/2pN4/1nP5/1Q2PN2/PP1BBPPP/R3K2R w KQkq - 9 12,Nxe7,666,181,-485,0
r1b1k2r/pp1pNpbp/q5p1/2p5/1nP5/1Q2PN2/PP1BBPPP/R3K2R b KQkq - 0 12,Kxe7,172,183,11,1
r1b4r/pp1pkpbp/q5p1/2p5/1nP5/1Q2PN2/PP1BBPPP/R3K2R w KQ - 0 13,a3,192,184,-8,1
r1b4r/pp1pkpbp/q5p1/2p5/1nP5/PQ2PN2/1P1BBPPP/R3K2R b KQ - 0 13,Nc6,153,159,6,1
r1b4r/pp1pkpbp/q1n3p1/2p5/2P5/PQ2PN2/1P1BBPPP/R3K2R w KQ - 1 14,O-O,172,122,-50,1
r1b4r/pp1pkpbp/q1n3p1/2p5/2P5/PQ2PN2/1P1BBPPP/R4RK1 b - - 2 14,h5,108,268,160,1
r1b4r/pp1pkpb1/q1n3p1/2p4p/2P5/PQ2PN2/1P1BBPPP/R4RK1 w - - 0 15,Nh4,285,9,-276,0
r1b4r/pp1pkpb1/q1n3p1/2p4p/2P4N/PQ2P3/1P1BBPPP/R4RK1 b - - 1 15,g5,99,488,389,1
r1b4r/pp1pkpb1/q1n5/2p3pp/2P4N/PQ2P3/1P1BBPPP/R4RK1 w - - 0 16,Nf5+,473,467,-6,1
r1b4r/pp1pkpb1/q1n5/2p2Npp/2P5/PQ2P3/1P1BBPPP/R4RK1 b - - 1 16,Kf8,443,484,41,1
r1b2k1r/pp1p1pb1/q1n5/2p2Npp/2P5/PQ2P3/1P1BBPPP/R4RK1 w - - 2 17,Nxg7,459,452,-7,1
r1b2k1r/pp1p1pN1/q1n5/2p3pp/2P5/PQ2P3/1P1BBPPP/R4RK1 b - - 0 17,Kxg7,466,454,-12,1
r1b4r/pp1p1pk1/q1n5/2p3pp/2P5/PQ2P3/1P1BBPPP/R4RK1 w - - 0 18,Bc3+,461,444,-17,1
r1b4r/pp1p1pk1/q1n5/2p3pp/2P5/PQB1P3/1P2BPPP/R4RK1 b - - 1 18,f6,450,416,-34,1
r1b4r/pp1p2k1/q1n2p2/2p3pp/2P5/PQB1P3/1P2BPPP/R4RK1 w - - 0 19,Rad1,490,400,-90,1
r1b4r/pp1p2k1/q1n2p2/2p3pp/2P5/PQB1P3/1P2BPPP/3R1RK1 b - - 1 19,Ne7,411,429,18,1
r1b4r/pp1pn1k1/q4p2/2p3pp/2P5/PQB1P3/1P2BPPP/3R1RK1 w - - 2 20,Qc2,421,404,-17,1
r1b4r/pp1pn1k1/q4p2/2p3pp/2P5/P1B1P3/1PQ1BPPP/3R1RK1 b - - 3 20,h4,416,446,30,1
r1b4r/pp1pn1k1/q4p2/2p3p1/2P4p/P1B1P3/1PQ1BPPP/3R1RK1 w - - 0 21,Rd3,463,313,-150,0
r1b4r/pp1pn1k1/q4p2/2p3p1/2P4p/P1BRP3/1PQ1BPPP/5RK1 b - - 1 21,h3,324,381,57,1
r1b4r/pp1pn1k1/q4p2/2p3p1/2P5/P1BRP2p/1PQ1BPPP/5RK1 w - - 0 22,g3,338,338,0,1
r1b4r/pp1pn1k1/q4p2/2p3p1/2P5/P1BRP1Pp/1PQ1BP1P/5RK1 b - - 0 22,Qc6,319,392,73,1
r1b4r/pp1pn1k1/2q2p2/2p3p1/2P5/P1BRP1Pp/1PQ1BP1P/5RK1 w - - 1 23,f3,375,227,-148,0
r1b4r/pp1pn1k1/2q2p2/2p3p1/2P5/P1BRPPPp/1PQ1B2P/5RK1 b - - 0 23,g4,200,482,282,1
r1b4r/pp1pn1k1/2q2p2/2p5/2P3p1/P1BRPPPp/1PQ1B2P/5RK1 w - - 0 24,e4,481,441,-40,1
r1b4r/pp1pn1k1/2q2p2/2p5/2P1P1p1/P1BR1PPp/1PQ1B2P/5RK1 b - - 0 24,Rf8,492,471,-21,1
r1b2r2/pp1pn1k1/2q2p2/2p5/2P1P1p1/P1BR1PPp/1PQ1B2P/5RK1 w - - 1 25,Re3,532,337,-195,0
r1b2r2/pp1pn1k1/2q2p2/2p5/2P1P1p1/P1B1RPPp/1PQ1B2P/5RK1 b - - 2 25,Kf7,357,526,169,1
r1b2r2/pp1pnk2/2q2p2/2p5/2P1P1p1/P1B1RPPp/1PQ1B2P/5RK1 w - - 3 26,e5,553,446,-107,0
r1b2r2/pp1pnk2/2q2p2/2p1P3/2P3p1/P1B1RPPp/1PQ1B2P/5RK1 b - - 0 26,Nf5,462,715,253,1
r1b2r2/pp1p1k2/2q2p2/2p1Pn2/2P3p1/P1B1RPPp/1PQ1B2P/5RK1 w - - 1 27,Qxf5,723,692,-31,1
r1b2r2/pp1p1k2/2q2p2/2p1PQ2/2P3p1/P1B1RPPp/1P2B2P/5RK1 b - - 0 27,Ke8,666,688,22,1
r1b1kr2/pp1p4/2q2p2/2p1PQ2/2P3p1/P1B1RPPp/1P2B2P/5RK1 w - - 1 28,exf6+,722,733,11,1
r1b1kr2/pp1p4/2q2P2/2p2Q2/2P3p1/P1B1RPPp/1P2B2P/5RK1 b - - 0 28,Kd8,706,711,5,1
r1bk1r2/pp1p4/2q2P2/2p2Q2/2P3p1/P1B1RPPp/1P2B2P/5RK1 w - - 1 29,Qxg4,715,743,28,1
r1bk1r2/pp1p4/2q2P2/2p5/2P3Q1/P1B1RPPp/1P2B2P/5RK1 b - - 0 29,d6,728,750,22,1
r1bk1r2/pp6/2qp1P2/2p5/2P3Q1/P1B1RPPp/1P2B2P/5RK1 w - - 0 30,Qg5,754,704,-50,1
r1bk1r2/pp6/2qp1P2/2p3Q1/2P5/P1B1RPPp/1P2B2P/5RK1 b - - 1 30,Bd7,684,717,33,1
r2k1r2/pp1b4/2qp1P2/2p3Q1/2P5/P1B1RPPp/1P2B2P/5RK1 w - - 2 31,f7+,727,708,-19,1
r2k1r2/pp1b1P2/2qp4/2p3Q1/2P5/P1B1RPPp/1P2B2P/5RK1 b - - 0 31,Kc7,698,721,23,1
r4r2/ppkb1P2/2qp4/2p3Q1/2P5/P1B1RPPp/1P2B2P/5RK1 w - - 1 32,Bf6,696,405,-291,0
r4r2/ppkb1P2/2qp1B2/2p3Q1/2P5/P3RPPp/1P2B2P/5RK1 b - - 2 32,Qb6,439,646,207,1
r4r2/ppkb1P2/1q1p1B2/2p3Q1/2P5/P3RPPp/1P2B2P/5RK1 w - - 3 33,Re4,684,461,-223,0
r4r2/ppkb1P2/1q1p1B2/2p3Q1/2P1R3/P4PPp/1P2B2P/5RK1 b - - 4 33,Qc6,456,699,243,1
r4r2/ppkb1P2/2qp1B2/2p3Q1/2P1R3/P4PPp/1P2B2P/5RK1 w - - 5 34,b4,688,500,-188,0
r4r2/ppkb1P2/2qp1B2/2p3Q1/1PP1R3/P4PPp/4B2P/5RK1 b - - 0 34,cxb4,465,629,164,1
r4r2/ppkb1P2/2qp1B2/6Q1/1pP1R3/P4PPp/4B2P/5RK1 w - - 0 35,axb4,610,504,-106,0
r4r2/ppkb1P2/2qp1B2/6Q1/1PP1R3/5PPp/4B2P/5RK1 b - - 0 35,a6,576,735,159,1
r4r2/1pkb1P2/p1qp1B2/6Q1/1PP1R3/5PPp/4B2P/5RK1 w - - 0 36,c5,701,658,-43,1
r4r2/1pkb1P2/p1qp1B2/2P3Q1/1P2R3/5PPp/4B2P/5RK1 b - - 0 36,Rxf7,641,721,80,1
r7/1pkb1r2/p1qp1B2/2P3Q1/1P2R3/5PPp/4B2P/5RK1 w - - 0 37,cxd6+,788,802,14,1
r7/1pkb1r2/p1qP1B2/6Q1/1P2R3/5PPp/4B2P/5RK1 b - - 0 37,Kb6,814,9998,9184,1
r7/1p1b1r2/pkqP1B2/6Q1/1P2R3/5PPp/4B2P/5RK1 w - - 1 38,Bd4+,9998,9999,1,1
rnbqkbnr/pppppppp/8/8/8/8/PPPPPPPP/RNBQKBNR w KQkq - 0 1,e4,30,30,0,1
rnbqkbnr/pppppppp/8/8/4P3/8/PPPP1PPP/RNBQKBNR b KQkq - 0 1,b6,29,90,61,1
rnbqkbnr/p1pppppp/1p6/8/4P3/8/PPPP1PPP/RNBQKBNR w KQkq - 0 2,d4,90,94,4,1
rnbqkbnr/p1pppppp/1p6/8/3PP3/8/PPP2PPP/RNBQKBNR b KQkq - 0 2,Bb7,95,118,23,1
rn1qkbnr/pbpppppp/1p6/8/3PP3/8/PPP2PPP/RNBQKBNR w KQkq - 1 3,f3,90,39,-51,1
rn1qkbnr/pbpppppp/1p6/8/3PP3/5P2/PPP3PP/RNBQKBNR b KQkq - 0 3,e6,32,47,15,1
rn1qkbnr/pbpp1ppp/1p2p3/8/3PP3/5P2/PPP3PP/RNBQKBNR w KQkq - 0 4,Nh3,42,36,-6,1
rn1qkbnr/pbpp1ppp/1p2p3/8/3PP3/5P1N/PPP3PP/RNBQKB1R b KQkq - 1 4,f5,15,108,93,1
rn1qkbnr/pbpp2pp/1p2p3/5p2/3PP3/5P1N/PPP3PP/RNBQKB1R w KQkq - 0 5,Nf2,78,58,-20,1
rn1qkbnr/pbpp2pp/1p2p3/5p2/3PP3/5P2/PPP2NPP/RNBQKB1R b KQkq - 1 5,fxe4,65,110,45,1
rn1qkbnr/pbpp2pp/1p2p3/8/3Pp3/5P2/PPP2NPP/RNBQKB1R w KQkq - 0 6,Nxe4,105,-151,-256,0
rn1qkbnr/pbpp2pp/1p2p3/8/3PN3/5P2/PPP3PP/RNBQKB1R b KQkq - 0 6,Nf6,-126,12,138,1
rn1qkb1r/pbpp2pp/1p2pn2/8/3PN3/5P2/PPP3PP/RNBQKB1R w KQkq - 1 7,Nf2,7,-80,-87,1
rn1qkb1r/pbpp2pp/1p2pn2/8/3P4/5P2/PPP2NPP/RNBQKB1R b KQkq - 2 7,Be7,-84,-53,31,1
rn1qk2r/pbppb1pp/1p2pn2/8/3P4/5P2/PPP2NPP/RNBQKB1R w KQkq - 3 8,Nc3,-66,-89,-23,1
rn1qk2r/pbppb1pp/1p2pn2/8/3P4/2N2P2/PPP2NPP/R1BQKB1R b KQkq - 4 8,O-O,-97,-91,6,1
rn1q1rk1/pbppb1pp/1p2pn2/8/3P4/2N2P2/PPP2NPP/R1BQKB1R w KQ - 5 9,Bd3,-77,-82,-5,1
rn1q1rk1/pbppb1pp/1p2pn2/8/3P4/2NB1P2/PPP2NPP/R1BQK2R b KQ - 6 9,c5,-74,-77,-3,1
rn1q1rk1/pb1pb1pp/1p2pn2/2p5/3P4/2NB1P2/PPP2NPP/R1BQK2R w KQ - 0 10,dxc5,-88,-74,14,1
rn1q1rk1/pb1pb1pp/1p2pn2/2P5/8/2NB1P2/PPP2NPP/R1BQK2R b KQ - 0 10,bxc5,-76,-72,4,1
rn1q1rk1/pb1pb1pp/4pn2/2p5/8/2NB1P2/PPP2NPP/R1BQK2R w KQ - 0 11,O-O,-68,-69,-1,1
rn1q1rk1/pb1pb1pp/4pn2/2p5/8/2NB1P2/PPP2NPP/R1BQ1RK1 b - - 1 11,Nc6,-74,-72,2,1
r2q1rk1/pb1pb1pp/2n1pn2/2p5/8/2NB1P2/PPP2NPP/R1BQ1RK1 w - - 2 12,Bg5,-69,-85,-16,1
r2q1rk1/pb1pb1pp/2n1pn2/2p3B1/8/2NB1P2/PPP2NPP/R2Q1RK1 b - - 3 12,h6,-66,-83,-17,1
r2q1rk1/pb1pb1p1/2n1pn1p/2p3B1/8/2NB1P2/PPP2NPP/R2Q1RK1 w - - 0 13,Bh4,-79,-74,5,1
r2q1rk1/pb1pb1p1/2n1pn1p/2p5/7B/2NB1P2/PPP2NPP/R2Q1RK1 b - - 1 13,Nd4,-74,-67,7,1
r2q1rk1/pb1pb1p1/4pn1p/2p5/3n3B/2NB1P2/PPP2NPP/R2Q1RK1 w - - 2 14,Re1,-69,-89,-20,1
r2q1rk1/pb1pb1p1/4pn1p/2p5/3n3B/2NB1P2/PPP2NPP/R2QR1K1 b - - 3 14,Qb6,-99,10,109,1
r4rk1/pb1pb1p1/1q2pn1p/2p5/3n3B/2NB1P2/PPP2NPP/R2QR1K1 w - - 4 15,Kh1,25,-184,-209,0
r4rk1/pb1pb1p1/1q2pn1p/2p5/3n3B/2NB1P2/PPP2NPP/R2QR2K b - - 5 15,Qxb2,-196,-36,160,1
r4rk1/pb1pb1p1/4pn1p/2p5/3n3B/2NB1P2/PqP2NPP/R2QR2K w - - 0 16,Na4,-73,-231,-158,0
r4rk1/pb1pb1p1/4pn1p/2p5/N2n3B/3B1P2/PqP2NPP/R2QR2K b - - 1 16,Qa3,-158,-177,-19,1
r4rk1/pb1pb1p1/4pn1p/2p5/N2n3B/q2B1P2/P1P2NPP/R2QR2K w - - 2 17,c3,-174,-179,-5,1
r4rk1/pb1pb1p1/4pn1p/2p5/N2n3B/q1PB1P2/P4NPP/R2QR2K b - - 0 17,Nf5,-188,215,403,1
r4rk1/pb1pb1p1/4pn1p/2p2n2/N6B/q1PB1P2/P4NPP/R2QR2K w - - 1 18,Bxf5,191,221,30,1
r4rk1/pb1pb1p1/4pn1p/2p2B2/N6B/q1P2P2/P4NPP/R2QR2K b - - 0 18,exf5,238,263,25,1
r4rk1/pb1pb1p1/5n1p/2p2p2/N6B/q1P2P2/P4NPP/R2QR2K w - - 0 19,Rxe7,313,353,40,1
r4rk1/pb1pR1p1/5n1p/2p2p2/N6B/q1P2P2/P4NPP/R2Q3K b - - 0 19,g5,348,339,-9,1
r4rk1/pb1pR3/5n1p/2p2pp1/N6B/q1P2P2/P4NPP/R2Q3K w - - 0 20,Rb1,363,-32,-395,0
r4rk1/pb1pR3/5n1p/2p2pp1/N6B/q1P2P2/P4NPP/1R1Q3K b - - 1 20,Bc6,-16,-13,3,1
r4rk1/p2pR3/2b2n1p/2p2pp1/N6B/q1P2P2/P4NPP/1R1Q3K w - - 2 21,Qb3+,69,-59,-128,0
r4rk1/p2pR3/2b2n1p/2p2pp1/N6B/qQP2P2/P4NPP/1R5K b - - 3 21,Qxb3,-66,-70,-4,1
r4rk1/p2pR3/2b2n1p/2p2pp1/N6B/1qP2P2/P4NPP/1R5K w - - 0 22,axb3,-68,-68,0,1
r4rk1/p2pR3/2b2n1p/2p2pp1/N6B/1PP2P2/5NPP/1R5K b - - 0 22,gxh4,-70,-85,-15,1
r4rk1/p2pR3/2b2n1p/2p2p2/N6p/1PP2P2/5NPP/1R5K w - - 0 23,Re5,-61,-137,-76,1
r4rk1/p2p4/2b2n1p/2p1Rp2/N6p/1PP2P2/5NPP/1R5K b - - 1 23,d6,-168,-26,142,1
r4rk1/p7/2bp1n1p/2p1Rp2/N6p/1PP2P2/5NPP/1R5K w - - 0 24,Rxf5,-22,-130,-108,0
r4rk1/p7/2bp1n1p/2p2R2/N6p/1PP2P2/5NPP/1R5K b - - 0 24,Nd5,-140,-76,64,1
r4rk1/p7/2bp3p/2pn1R2/N6p/1PP2P2/5NPP/1R5K w - - 1 25,Rxf8+,-69,-86,-17,1
r4Rk1/p7/2bp3p/2pn4/N6p/1PP2P2/5NPP/1R5K b - - 0 25,Rxf8,-90,-46,44,1
5rk1/p7/2bp3p/2pn4/N6p/1PP2P2/5NPP/1R5K w - - 0 26,Ra1,-66,-165,-99,1
5rk1/p7/2bp3p/2pn4/N6p/1PP2P2/5NPP/R6K b - - 1 26,Bxa4,-112,-60,52,1
5rk1/p7/3p3p/2pn4/b6p/1PP2P2/5NPP/R6K w - - 0 27,Rxa4,-35,-59,-24,1
5rk1/p7/3p3p/2pn4/R6p/1PP2P2/5NPP/7K b - - 0 27,Rf7,-58,34,92,1
6k1/p4r2/3p3p/2pn4/R6p/1PP2P2/5NPP/7K w - - 1 28,c4,36,-16,-52,1
6k1/p4r2/3p3p/2pn4/R1P4p/1P3P2/5NPP/7K b - - 0 28,Nb4,-14,35,49,1
6k1/p4r2/3p3p/2p5/RnP4p/1P3P2/5NPP/7K w - - 1 29,Ne4,30,27,-3,1
6k1/p4r2/3p3p/2p5/RnP1N2p/1P3P2/6PP/7K b - - 2 29,Re7,23,76,53,1
6k1/p3r3/3p3p/2p5/RnP1N2p/1P3P2/6PP/7K w - - 3 30,Kg1,72,50,-22,1
6k1/p3r3/3p3p/2p5/RnP1N2p/1P3P2/6PP/6K1 b - - 4 30,a6,60,69,9,1
6k1/4r3/p2p3p/2p5/RnP1N2p/1P3P2/6PP/6K1 w - - 0 31,Kf2,89,58,-31,1
6k1/4r3/p2p3p/2p5/RnP1N2p/1P3P2/5KPP/8 b - - 1 31,Re6,69,77,8,1
6k1/8/p2pr2p/2p5/RnP1N2p/1P3P2/5KPP/8 w - - 2 32,Ke3,70,74,4,1
6k1/8/p2pr2p/2p5/RnP1N2p/1P2KP2/6PP/8 b - - 3 32,Kf7,63,50,-13,1
8/5k2/p2pr2p/2p5/RnP1N2p/1P2KP2/6PP/8 w - - 4 33,Kf4,53,61,8,1
8/5k2/p2pr2p/2p5/RnP1NK1p/1P3P2/6PP/8 b - - 5 33,Kg6,49,198,149,1
8/8/p2pr1kp/2p5/RnP1NK1p/1P3P2/6PP/8 w - - 6 34,Kg4,259,265,6,1
8/8/p2pr1kp/2p5/RnP1N1Kp/1P3P2/6PP/8 b - - 7 34,d5,280,337,57,1
8/8/p3r1kp/2pp4/RnP1N1Kp/1P3P2/6PP/8 w - - 0 35,cxd5,364,275,-89,1
8/8/p3r1kp/2pP4/Rn2N1Kp/1P3P2/6PP/8 b - - 0 35,Nxd5,281,267,-14,1
8/8/p3r1kp/2pn4/R3N1Kp/1P3P2/6PP/8 w - - 0 36,Kxh4,277,276,-1,1
8/8/p3r1kp/2pn4/R3N2K/1P3P2/6PP/8 b - - 0 36,Rb6,270,355,85,1
8/8/pr4kp/2pn4/R3N2K/1P3P2/6PP/8 w - - 1 37,Ra5,387,252,-135,0
8/8/pr4kp/R1pn4/4N2K/1P3P2/6PP/8 b - - 2 37,Ne7,260,330,70,1
8/4n3/pr4kp/R1p5/4N2K/1P3P2/6PP/8 w - - 3 38,Rxc5,355,259,-96,1
8/4n3/pr4kp/2R5/4N2K/1P3P2/6PP/8 b - - 0 38,Nf5+,277,313,36,1
8/8/pr4kp/2R2n2/4N2K/1P3P2/6PP/8 w - - 1 39,Kg4,291,195,-96,1
8/8/pr4kp/2R2n2/4N1K1/1P3P2/6PP/8 b - - 2 39,h5+,167,312,145,1
8/8/pr4k1/2R2n1p/4N1K1/1P3P2/6PP/8 w - - 0 40,Kf4,324,223,-101,0
8/8/pr4k1/2R2n1p/4NK2/1P3P2/6PP/8 b - - 1 40,Rb4,230,576,346,1
8/8/p5k1/2R2n1p/1r2NK2/1P3P2/6PP/8 w - - 2 41,g4,557,293,-264,0
8/8/p5k1/2R2n1p/1r2NKP1/1P3P2/7P/8 b - - 0 41,hxg4,292,405,113,1
8/8/p5k1/2R2n2/1r2NKp1/1P3P2/7P/8 w - - 0 42,fxg4,402,262,-140,0
8/8/p5k1/2R2n2/1r2NKP1/1P6/7P/8 b - - 0 42,Nd4,257,328,71,1
8/8/p5k1/2R5/1r1nNKP1/1P6/7P/8 w - - 1 43,Ke5,298,37,-261,0
8/8/p5k1/2R1K3/1r1nN1P1/1P6/7P/8 b - - 2 43,Kf7,26,290,264,1
8/5k2/p7/2R1K3/1r1nN1P1/1P6/7P/8 w - - 3 44,Kd5,240,41,-199,0
8/5k2/p7/2RK4/1r1nN1P1/1P6/7P/8 b - - 4 44,Nf3,40,75,35,1
8/5k2/p7/2RK4/1r2N1P1/1P3n2/7P/8 w - - 5 45,Rc7+,61,66,5,1
8/2R2k2/p7/3K4/1r2N1P1/1P3n2/7P/8 b - - 6 45,Ke8,49,337,288,1
4k3/2R5/p7/3K4/1r2N1P1/1P3n2/7P/8 w - - 7 46,Kd6,322,-32,-354,0
4k3/2R5/p2K4/8/1r2N1P1/1P3n2/7P/8 b - - 8 46,Rd4+,-34,-29,5,1
4k3/2R5/p2K4/8/3rN1P1/1P3n2/7P/8 w - - 9 47,Kc5,-27,-19,8,1
4k3/2R5/p7/2K5/3rN1P1/1P3n2/7P/8 b - - 10 47,Rxe4,-19,-14,5,1
4k3/2R5/p7/2K5/4r1P1/1P3n2/7P/8 w - - 0 48,Rc8+,-16,-22,-6,1
2R1k3/8/p7/2K5/4r1P1/1P3n2/7P/8 b - - 1 48,Kd7,-19,-16,3,1
2R5/3k4/p7/2K5/4r1P1/1P3n2/7P/8 w - - 2 49,Rc6,-25,-509,-484,0
8/3k4/p1R5/2K5/4r1P1/1P3n2/7P/8 b - - 3 49,Kd8,-491,-6,485,1
3k4/8/p1R5/2K5/4r1P1/1P3n2/7P/8 w - - 4 50,Kb6,-16,-33,-17,1
rnbqkbnr/pppppppp/8/8/8/8/PPPPPPPP/RNBQKBNR w KQkq - 0 1,d4,37,19,-18,1
rnbqkbnr/pppppppp/8/8/3P4/8/PPP1PPPP/RNBQKBNR b KQkq - 0 1,d6,19,55,36,1
rnbqkbnr/ppp1pppp/3p4/8/3P4/8/PPP1PPPP/RNBQKBNR w KQkq - 0 2,Bf4,66,22,-44,1
rnbqkbnr/ppp1pppp/3p4/8/3P1B2/8/PPP1PPPP/RN1QKBNR b KQkq - 1 2,d5,12,54,42,1
rnbqkbnr/ppp1pppp/8/3p4/3P1B2/8/PPP1PPPP/RN1QKBNR w KQkq - 0 3,Nc3,53,34,-19,1
rnbqkbnr/ppp1pppp/8/3p4/3P1B2/2N5/PPP1PPPP/R2QKBNR b KQkq - 1 3,Nc6,32,78,46,1
r1bqkbnr/ppp1pppp/2n5/3p4/3P1B2/2N5/PPP1PPPP/R2QKBNR w KQkq - 2 4,Nb5,98,80,-18,1
r1bqkbnr/ppp1pppp/2n5/1N1p4/3P1B2/8/PPP1PPPP/R2QKBNR b KQkq - 3 4,e6,67,460,393,1
r1bqkbnr/ppp2ppp/2n1p3/1N1p4/3P1B2/8/PPP1PPPP/R2QKBNR w KQkq - 0 5,Nxc7+,437,369,-68,1
r1bqkbnr/ppN2ppp/2n1p3/3p4/3P1B2/8/PPP1PPPP/R2QKBNR b KQkq - 0 5,Ke7,410,469,59,1
r1bq1bnr/ppN1kppp/2n1p3/3p4/3P1B2/8/PPP1PPPP/R2QKBNR w KQ - 1 6,Nxa8,489,491,2,1
N1bq1bnr/pp2kppp/2n1p3/3p4/3P1B2/8/PPP1PPPP/R2QKBNR b KQ - 0 6,e5,429,478,49,1
N1bq1bnr/pp2kppp/2n5/3pp3/3P1B2/8/PPP1PPPP/R2QKBNR w KQ - 0 7,dxe5,428,487,59,1
N1bq1bnr/pp2kppp/2n5/3pP3/5B2/8/PPP1PPPP/R2QKBNR b KQ - 0 7,Be6,488,511,23,1
N2q1bnr/pp2kppp/2n1b3/3pP3/5B2/8/PPP1PPPP/R2QKBNR w KQ - 1 8,Nf3,514,487,-27,1
N2q1bnr/pp2kppp/2n1b3/3pP3/5B2/5N2/PPP1PPPP/R2QKB1R b KQ - 2 8,Qxa8,495,540,45,1
q4bnr/pp2kppp/2n1b3/3pP3/5B2/5N2/PPP1PPPP/R2QKB1R w KQ - 0 9,a3,532,488,-44,1
q4bnr/pp2kppp/2n1b3/3pP3/5B2/P4N2/1PP1PPPP/R2QKB1R b KQ - 0 9,f6,495,550,55,1
q4bnr/pp2k1pp/2n1bp2/3pP3/5B2/P4N2/1PP1PPPP/R2QKB1R w KQ - 0 10,exf6+,526,501,-25,1
q4bnr/pp2k1pp/2n1bP2/3p4/5B2/P4N2/1PP1PPPP/R2QKB1R b KQ - 0 10,Nxf6,526,534,8,1
q4b1r/pp2k1pp/2n1bn2/3p4/5B2/P4N2/1PP1PPPP/R2QKB1R w KQ - 0 11,e3,526,541,15,1
q4b1r/pp2k1pp/2n1bn2/3p4/5B2/P3PN2/1PP2PPP/R2QKB1R b KQ - 0 11,Kf7,529,588,59,1
q4b1r/pp3kpp/2n1bn2/3p4/5B2/P3PN2/1PP2PPP/R2QKB1R w KQ - 1 12,Ng5+,644,617,-27,1
q4b1r/pp3kpp/2n1bn2/3p2N1/5B2/P3P3/1PP2PPP/R2QKB1R b KQ - 2 12,Ke7,567,580,13,1
q4b1r/pp2k1pp/2n1bn2/3p2N1/5B2/P3P3/1PP2PPP/R2QKB1R w KQ - 3 13,Bb5,593,510,-83,1
q4b1r/pp2k1pp/2n1bn2/1B1p2N1/5B2/P3P3/1PP2PPP/R2QK2R b KQ - 4 13,h6,522,556,34,1
q4b1r/pp2k1p1/2n1bn1p/1B1p2N1/5B2/P3P3/1PP2PPP/R2QK2R w KQ - 0 14,Nf3,580,465,-115,0
q4b1r/pp2k1p1/2n1bn1p/1B1p4/5B2/P3PN2/1PP2PPP/R2QK2R b KQ - 1 14,Bg4,480,568,88,1
rnbqkbnr/pppppppp/8/8/8/8/PPPPPPPP/RNBQKBNR w KQkq - 0 1,e4,32,26,-6,1
rnbqkbnr/pppppppp/8/8/4P3/8/PPPP1PPP/RNBQKBNR b KQkq - 0 1,c5,29,17,-12,1
rnbqkbnr/pp1ppppp/8/2p5/4P3/8/PPPP1PPP/RNBQKBNR w KQkq - 0 2,Bc4,34,-15,-49,1
rnbqkbnr/pp1ppppp/8/2p5/2B1P3/8/PPPP1PPP/RNBQK1NR b KQkq - 1 2,d6,-12,-7,5,1
rnbqkbnr/pp2pppp/3p4/2p5/2B1P3/8/PPPP1PPP/RNBQK1NR w KQkq - 0 3,Nf3,3,10,7,1
rnbqkbnr/pp2pppp/3p4/2p5/2B1P3/5N2/PPPP1PPP/RNBQK2R b KQkq - 1 3,Nc6,26,24,-2,1
r1bqkbnr/pp2pppp/2np4/2p5/2B1P3/5N2/PPPP1PPP/RNBQK2R w KQkq - 2 4,c3,25,3,-22,1
r1bqkbnr/pp2pppp/2np4/2p5/2B1P3/2P2N2/PP1P1PPP/RNBQK2R b KQkq - 0 4,g6,15,61,46,1
r1bqkbnr/pp2pp1p/2np2p1/2p5/2B1P3/2P2N2/PP1P1PPP/RNBQK2R w KQkq - 0 5,d4,76,64,-12,1
r1bqkbnr/pp2pp1p/2np2p1/2p5/2BPP3/2P2N2/PP3PPP/RNBQK2R b KQkq - 0 5,cxd4,58,66,8,1
r1bqkbnr/pp2pp1p/2np2p1/8/2BpP3/2P2N2/PP3PPP/RNBQK2R w KQkq - 0 6,cxd4,78,62,-16,1
r1bqkbnr/pp2pp1p/2np2p1/8/2BPP3/5N2/PP3PPP/RNBQK2R b KQkq - 0 6,Bg4,69,154,85,1
r2qkbnr/pp2pp1p/2np2p1/8/2BPP1b1/5N2/PP3PPP/RNBQK2R w KQkq - 1 7,Bxf7+,158,114,-44,1
r2qkbnr/pp2pB1p/2np2p1/8/3PP1b1/5N2/PP3PPP/RNBQK2R b KQkq - 0 7,Kxf7,105,110,5,1
r2q1bnr/pp2pk1p/2np2p1/8/3PP1b1/5N2/PP3PPP/RNBQK2R w KQ - 0 8,Ng5+,116,105,-11,1
r2q1bnr/pp2pk1p/2np2p1/6N1/3PP1b1/8/PP3PPP/RNBQK2R b KQ - 1 8,Ke8,154,182,28,1
r2qkbnr/pp2p2p/2np2p1/6N1/3PP1b1/8/PP3PPP/RNBQK2R w KQ - 2 9,Qxg4,192,192,0,1
r2qkbnr/pp2p2p/2np2p1/6N1/3PP1Q1/8/PP3PPP/RNB1K2R b KQ - 0 9,Nxd4,177,175,-2,1
r2qkbnr/pp2p2p/3p2p1/6N1/3nP1Q1/8/PP3PPP/RNB1K2R w KQ - 0 10,Qd1,170,177,7,1
r2qkbnr/pp2p2p/3p2p1/6N1/3nP3/8/PP3PPP/RNBQK2R b KQ - 1 10,e5,165,178,13,1
r2qkbnr/pp5p/3p2p1/4p1N1/3nP3/8/PP3PPP/RNBQK2R w KQ - 0 11,Nc3,180,142,-38,1
r2qkbnr/pp5p/3p2p1/4p1N1/3nP3/2N5/PP3PPP/R1BQK2R b KQ - 1 11,Be7,191,197,6,1
r2qk1nr/pp2b2p/3p2p1/4p1N1/3nP3/2N5/PP3PPP/R1BQK2R w KQ - 2 12,Nf3,183,167,-16,1
r2qk1nr/pp2b2p/3p2p1/4p3/3nP3/2N2N2/PP3PPP/R1BQK2R b KQ - 3 12,Nxf3+,170,173,3,1
r2qk1nr/pp2b2p/3p2p1/4p3/4P3/2N2n2/PP3PPP/R1BQK2R w KQ - 0 13,Qxf3,173,167,-6,1
r2qk1nr/pp2b2p/3p2p1/4p3/4P3/2N2Q2/PP3PPP/R1B1K2R b KQ - 0 13,Nf6,179,167,-12,1
r2qk2r/pp2b2p/3p1np1/4p3/4P3/2N2Q2/PP3PPP/R1B1K2R w KQ - 1 14,O-O,161,183,22,1
r2qk2r/pp2b2p/3p1np1/4p3/4P3/2N2Q2/PP3PPP/R1B2RK1 b - - 2 14,Rf8,186,197,11,1
r2qkr2/pp2b2p/3p1np1/4p3/4P3/2N2Q2/PP3PPP/R1B2RK1 w - - 3 15,Bh6,185,166,-19,1
r2qkr2/pp2b2p/3p1npB/4p3/4P3/2N2Q2/PP3PPP/R4RK1 b - - 4 15,Rf7,171,171,0,1
r2qk3/pp2br1p/3p1npB/4p3/4P3/2N2Q2/PP3PPP/R4RK1 w - - 5 16,Bg5,156,39,-117,0
r2qk3/pp2br1p/3p1np1/4p1B1/4P3/2N2Q2/PP3PPP/R4RK1 b - - 6 16,Nxe4,72,189,117,1
r2qk3/pp2br1p/3p2p1/4p1B1/4n3/2N2Q2/PP3PPP/R4RK1 w - - 0 17,Bxe7,185,176,-9,1
r2qk3/pp2Br1p/3p2p1/4p3/4n3/2N2Q2/PP3PPP/R4RK1 b - - 0 17,Nxc3,129,337,208,1
r2qk3/pp2Br1p/3p2p1/4p3/8/2n2Q2/PP3PPP/R4RK1 w - - 0 18,Bxd8,320,300,-20,1
r2Bk3/pp3r1p/3p2p1/4p3/8/2n2Q2/PP3PPP/R4RK1 b - - 0 18,Rxf3,305,293,-12,1
r2Bk3/pp5p/3p2p1/4p3/8/2n2r2/PP3PPP/R4RK1 w - - 0 19,bxc3,292,280,-12,1
r2Bk3/pp5p/3p2p1/4p3/8/2P2r2/P4PPP/R4RK1 b - - 0 19,Rxc3,284,281,-3,1
r2Bk3/pp5p/3p2p1/4p3/8/2r5/P4PPP/R4RK1 w - - 0 20,Bg5,281,286,5,1
r3k3/pp5p/3p2p1/4p1B1/8/2r5/P4PPP/R4RK1 b - - 1 20,Rac8,269,330,61,1
2r1k3/pp5p/3p2p1/4p1B1/8/2r5/P4PPP/R4RK1 w - - 2 21,Rfc1,296,235,-61,1
2r1k3/pp5p/3p2p1/4p1B1/8/2r5/P4PPP/R1R3K1 b - - 3 21,Rc2,262,306,44,1
2r1k3/pp5p/3p2p1/4p1B1/8/8/P1r2PPP/R1R3K1 w - - 4 22,Rxc2,283,203,-80,1
2r1k3/pp5p/3p2p1/4p1B1/8/8/P1R2PPP/R5K1 b - - 0 22,Rxc2,198,191,-7,1
4k3/pp5p/3p2p1/4p1B1/8/8/P1r2PPP/R5K1 w - - 0 23,Be3,201,186,-15,1
4k3/pp5p/3p2p1/4p3/8/4B3/P1r2PPP/R5K1 b - - 1 23,b6,169,174,5,1
4k3/p6p/1p1p2p1/4p3/8/4B3/P1r2PPP/R5K1 w - - 0 24,a4,196,171,-25,1
4k3/p6p/1p1p2p1/4p3/P7/4B3/2r2PPP/R5K1 b - - 0 24,d5,178,179,1,1
4k3/p6p/1p4p1/3pp3/P7/4B3/2r2PPP/R5K1 w - - 0 25,Kf1,169,166,-3,1
4k3/p6p/1p4p1/3pp3/P7/4B3/2r2PPP/R4K2 b - - 1 25,Kd7,166,170,4,1
8/p2k3p/1p4p1/3pp3/P7/4B3/2r2PPP/R4K2 w - - 2 26,Ke1,170,174,4,1
8/p2k3p/1p4p1/3pp3/P7/4B3/2r2PPP/R3K3 b - - 3 26,d4,164,157,-7,1
8/p2k3p/1p4p1/4p3/P2p4/4B3/2r2PPP/R3K3 w - - 0 27,Bd2,168,152,-16,1
8/p2k3p/1p4p1/4p3/P2p4/8/2rB1PPP/R3K3 b - - 1 27,e4,150,166,16,1
8/p2k3p/1p4p1/8/P2pp3/8/2rB1PPP/R3K3 w - - 0 28,a5,168,115,-53,1
8/p2k3p/1p4p1/P7/3pp3/8/2rB1PPP/R3K3 b - - 0 28,b5,119,88,-31,1
8/p2k3p/6p1/Pp6/3pp3/8/2rB1PPP/R3K3 w - - 0 29,Kd1,126,105,-21,1
8/p2k3p/6p1/Pp6/3pp3/8/2rB1PPP/R2K4 b - - 1 29,Rc4,122,151,29,1
8/p2k3p/6p1/Pp6/2rpp3/8/3B1PPP/R2K4 w - - 2 30,g3,144,64,-80,1
8/p2k3p/6p1/Pp6/2rpp3/6P1/3B1P1P/R2K4 b - - 0 30,a6,47,49,2,1
8/3k3p/p5p1/Pp6/2rpp3/6P1/3B1P1P/R2K4 w - - 0 31,h4,49,15,-34,1
8/3k3p/p5p1/Pp6/2rpp2P/6P1/3B1P2/R2K4 b - - 0 31,Ke6,7,23,16,1
8/7p/p3k1p1/Pp6/2rpp2P/6P1/3B1P2/R2K4 w - - 1 32,Rc1,29,19,-10,1
8/7p/p3k1p1/Pp6/2rpp2P/6P1/3B1P2/2RK4 b - - 2 32,Kf5,37,50,13,1
8/7p/p5p1/Pp3k2/2rpp2P/6P1/3B1P2/2RK4 w - - 3 33,Rxc4,70,123,53,1
8/7p/p5p1/Pp3k2/2Rpp2P/6P1/3B1P2/3K4 b - - 0 33,bxc4,127,145,18,1
8/7p/p5p1/P4k2/2ppp2P/6P1/3B1P2/3K4 w - - 0 34,Ke2,141,-52,-193,0
8/7p/p5p1/P4k2/2ppp2P/6P1/3BKP2/8 b - - 1 34,Kg4,-19,0,19,1
8/7p/p5p1/P7/2ppp1kP/6P1/3BKP2/8 w - - 2 35,Bb4,0,0,0,1
8/7p/p5p1/P7/1Bppp1kP/6P1/4KP2/8 b - - 3 35,c3,0,0,0,1
8/7p/p5p1/P7/1B1pp1kP/2p3P1/4KP2/8 w - - 0 36,Bc5,0,0,0,1
8/7p/p5p1/P1B5/3pp1kP/2p3P1/4KP2/8 b - - 1 36,d3+,0,0,0,1
8/7p/p5p1/P1B5/4p1kP/2pp2P1/4KP2/8 w - - 0 37,Ke3,0,0,0,1
8/7p/p5p1/P1B5/4p1kP/2ppK1P1/5P2/8 b - - 1 37,g5,0,139,139,1
8/7p/p7/P1B3p1/4p1kP/2ppK1P1/5P2/8 w - - 0 38,hxg5,245,0,-245,0
8/7p/p7/P1B3P1/4p1k1/2ppK1P1/5P2/8 b - - 0 38,Kxg5,0,325,325,1
8/7p/p7/P1B3k1/4p3/2ppK1P1/5P2/8 w - - 0 39,Bb4,362,377,15,1
8/7p/p7/P5k1/1B2p3/2ppK1P1/5P2/8 b - - 1 39,c2,410,430,20,1
8/7p/p7/P5k1/1B2p3/3pK1P1/2p2P2/8 w - - 0 40,Bd2,459,433,-26,1
8/7p/p7/P5k1/4p3/3pK1P1/2pB1P2/8 b - - 1 40,Kf5,493,501,8,1
8/7p/p7/P4k2/4p3/3pK1P1/2pB1P2/8 w - - 2 41,Kd4,497,497,0,1
8/7p/p7/P4k2/3Kp3/3p2P1/2pB1P2/8 b - - 3 41,h6,472,525,53,1
8/8/p6p/P4k2/3Kp3/3p2P1/2pB1P2/8 w - - 0 42,Bxh6,536,565,29,1
8/8/p6B/P4k2/3Kp3/3p2P1/2p2P2/8 b - - 0 42,Kg6,574,577,3,1
8/8/p5kB/P7/3Kp3/3p2P1/2p2P2/8 w - - 1 43,Be3,569,583,14,1
8/8/p5k1/P7/3Kp3/3pB1P1/2p2P2/8 b - - 2 43,Kf5,580,583,3,1
8/8/p7/P4k2/3Kp3/3pB1P1/2p2P2/8 w - - 3 44,Bf4,578,580,2,1
8/8/p7/P4k2/3KpB2/3p2P1/2p2P2/8 b - - 4 44,e3,608,600,-8,1
8/8/p7/P4k2/3K1B2/3pp1P1/2p2P2/8 w - - 0 45,Bxe3,613,626,13,1
rnbqkbnr/pppppppp/8/8/8/8/PPPPPPPP/RNBQKBNR w KQkq - 0 1,e4,25,25,0,1
rnbqkbnr/pppppppp/8/8/4P3/8/PPPP1PPP/RNBQKBNR b KQkq - 0 1,c5,26,29,3,1
rnbqkbnr/pp1ppppp/8/2p5/4P3/8/PPPP1PPP/RNBQKBNR w KQkq - 0 2,Nf3,40,29,-11,1
rnbqkbnr/pp1ppppp/8/2p5/4P3/5N2/PPPP1PPP/RNBQKB1R b KQkq - 1 2,d6,23,37,14,1
rnbqkbnr/pp2pppp/3p4/2p5/4P3/5N2/PPPP1PPP/RNBQKB1R w KQkq - 0 3,Bc4,34,8,-26,1
rnbqkbnr/pp2pppp/3p4/2p5/2B1P3/5N2/PPPP1PPP/RNBQK2R b KQkq - 1 3,a6,9,46,37,1
rnbqkbnr/1p2pppp/p2p4/2p5/2B1P3/5N2/PPPP1PPP/RNBQK2R w KQkq - 0 4,a3,29,-19,-48,1
rnbqkbnr/1p2pppp/p2p4/2p5/2B1P3/P4N2/1PPP1PPP/RNBQK2R b KQkq - 0 4,Nc6,-16,16,32,1
r1bqkbnr/1p2pppp/p1np4/2p5/2B1P3/P4N2/1PPP1PPP/RNBQK2R w KQkq - 1 5,d3,19,-8,-27,1
r1bqkbnr/1p2pppp/p1np4/2p5/2B1P3/P2P1N2/1PP2PPP/RNBQK2R b KQkq - 0 5,Bg4,-17,244,261,1
r2qkbnr/1p2pppp/p1np4/2p5/2B1P1b1/P2P1N2/1PP2PPP/RNBQK2R w KQkq - 1 6,h3,153,8,-145,0
r2qkbnr/1p2pppp/p1np4/2p5/2B1P1b1/P2P1N1P/1PP2PP1/RNBQK2R b KQkq - 0 6,Bxf3,4,10,6,1
r2qkbnr/1p2pppp/p1np4/2p5/2B1P3/P2P1b1P/1PP2PP1/RNBQK2R w KQkq - 0 7,Qxf3,10,22,12,1
r2qkbnr/1p2pppp/p1np4/2p5/2B1P3/P2P1Q1P/1PP2PP1/RNB1K2R b KQkq - 0 7,Nf6,10,9,-1,1
r2qkb1r/1p2pppp/p1np1n2/2p5/2B1P3/P2P1Q1P/1PP2PP1/RNB1K2R w KQkq - 1 8,Nc3,11,-12,-23,1
r2qkb1r/1p2pppp/p1np1n2/2p5/2B1P3/P1NP1Q1P/1PP2PP1/R1B1K2R b KQkq - 2 8,Nd4,-19,14,33,1
r2qkb1r/1p2pppp/p2p1n2/2p5/2BnP3/P1NP1Q1P/1PP2PP1/R1B1K2R w KQkq - 3 9,Qd1,22,24,2,1
r2qkb1r/1p2pppp/p2p1n2/2p5/2BnP3/P1NP3P/1PP2PP1/R1BQK2R b KQkq - 4 9,e6,22,27,5,1
r2qkb1r/1p3ppp/p2ppn2/2p5/2BnP3/P1NP3P/1PP2PP1/R1BQK2R w KQkq - 0 10,O-O,26,31,5,1
r2qkb1r/1p3ppp/p2ppn2/2p5/2BnP3/P1NP3P/1PP2PP1/R1BQ1RK1 b kq - 1 10,b5,45,35,-10,1
r2qkb1r/5ppp/p2ppn2/1pp5/2BnP3/P1NP3P/1PP2PP1/R1BQ1RK1 w kq - 0 11,Ba2,45,25,-20,1
r2qkb1r/5ppp/p2ppn2/1pp5/3nP3/P1NP3P/BPP2PP1/R1BQ1RK1 b kq - 1 11,Be7,29,34,5,1
r2qk2r/4bppp/p2ppn2/1pp5/3nP3/P1NP3P/BPP2PP1/R1BQ1RK1 w kq - 2 12,Bf4,35,23,-12,1
r2qk2r/4bppp/p2ppn2/1pp5/3nPB2/P1NP3P/BPP2PP1/R2Q1RK1 b kq - 3 12,O-O,24,25,1,1
r2q1rk1/4bppp/p2ppn2/1pp5/3nPB2/P1NP3P/BPP2PP1/R2Q1RK1 w - - 4 13,Ne2,32,14,-18,1
r2q1rk1/4bppp/p2ppn2/1pp5/3nPB2/P2P3P/BPP1NPP1/R2Q1RK1 b - - 5 13,e5,30,79,49,1
r2q1rk1/4bppp/p2p1n2/1pp1p3/3nPB2/P2P3P/BPP1NPP1/R2Q1RK1 w - - 0 14,Be3,84,35,-49,1
r2q1rk1/4bppp/p2p1n2/1pp1p3/3nP3/P2PB2P/BPP1NPP1/R2Q1RK1 b - - 1 14,Nc6,47,124,77,1
r2q1rk1/4bppp/p1np1n2/1pp1p3/4P3/P2PB2P/BPP1NPP1/R2Q1RK1 w - - 2 15,Ng3,111,105,-6,1
r2q1rk1/4bppp/p1np1n2/1pp1p3/4P3/P2PB1NP/BPP2PP1/R2Q1RK1 b - - 3 15,d5,108,163,55,1
r2q1rk1/4bppp/p1n2n2/1pppp3/4P3/P2PB1NP/BPP2PP1/R2Q1RK1 w - - 0 16,c3,180,40,-140,0
r2q1rk1/4bppp/p1n2n2/1pppp3/4P3/P1PPB1NP/BP3PP1/R2Q1RK1 b - - 0 16,d4,48,79,31,1
r2q1rk1/4bppp/p1n2n2/1pp1p3/3pP3/P1PPB1NP/BP3PP1/R2Q1RK1 w - - 0 17,cxd4,60,54,-6,1
r2q1rk1/4bppp/p1n2n2/1pp1p3/3PP3/P2PB1NP/BP3PP1/R2Q1RK1 b - - 0 17,cxd4,64,227,163,1
r2q1rk1/4bppp/p1n2n2/1p2p3/3pP3/P2PB1NP/BP3PP1/R2Q1RK1 w - - 0 18,Bg5,230,120,-110,0
r2q1rk1/4bppp/p1n2n2/1p2p1B1/3pP3/P2P2NP/BP3PP1/R2Q1RK1 b - - 1 18,h6,113,194,81,1
r2q1rk1/4bpp1/p1n2n1p/1p2p1B1/3pP3/P2P2NP/BP3PP1/R2Q1RK1 w - - 0 19,Bh4,220,45,-175,0
r2q1rk1/4bpp1/p1n2n1p/1p2p3/3pP2B/P2P2NP/BP3PP1/R2Q1RK1 b - - 1 19,g5,36,221,185,1
r2q1rk1/4bp2/p1n2n1p/1p2p1p1/3pP2B/P2P2NP/BP3PP1/R2Q1RK1 w - - 0 20,Bxg5,272,5,-267,0
r2q1rk1/4bp2/p1n2n1p/1p2p1B1/3pP3/P2P2NP/BP3PP1/R2Q1RK1 b - - 0 20,hxg5,50,48,-2,1
r2q1rk1/4bp2/p1n2n2/1p2p1p1/3pP3/P2P2NP/BP3PP1/R2Q1RK1 w - - 0 21,Nf5,55,-36,-91,1
r2q1rk1/4bp2/p1n2n2/1p2pNp1/3pP3/P2P3P/BP3PP1/R2Q1RK1 b - - 1 21,Rc8,-22,-11,11,1
2rq1rk1/4bp2/p1n2n2/1p2pNp1/3pP3/P2P3P/BP3PP1/R2Q1RK1 w - - 2 22,Bd5,-11,-171,-160,0
2rq1rk1/4bp2/p1n2n2/1p1BpNp1/3pP3/P2P3P/1P3PP1/R2Q1RK1 b - - 3 22,Bd6,-176,-122,54,1
2rq1rk1/5p2/p1nb1n2/1p1BpNp1/3pP3/P2P3P/1P3PP1/R2Q1RK1 w - - 4 23,h4,-129,-204,-75,1
2rq1rk1/5p2/p1nb1n2/1p1BpNp1/3pP2P/P2P4/1P3PP1/R2Q1RK1 b - - 0 23,Ne7,-226,-192,34,1
2rq1rk1/4np2/p2b1n2/1p1BpNp1/3pP2P/P2P4/1P3PP1/R2Q1RK1 w - - 1 24,hxg5,-190,-267,-77,1
2rq1rk1/4np2/p2b1n2/1p1BpNP1/3pP3/P2P4/1P3PP1/R2Q1RK1 b - - 0 24,Nfxd5,-238,-260,-22,1
2rq1rk1/4np2/p2b4/1p1npNP1/3pP3/P2P4/1P3PP1/R2Q1RK1 w - - 0 25,Qh5,-256,-321,-65,1
2rq1rk1/4np2/p2b4/1p1npNPQ/3pP3/P2P4/1P3PP1/R4RK1 b - - 1 25,Nxf5,-342,-335,7,1
2rq1rk1/5p2/p2b4/1p1npnPQ/3pP3/P2P4/1P3PP1/R4RK1 w - - 0 26,exf5,-369,-354,15,1
2rq1rk1/5p2/p2b4/1p1npPPQ/3p4/P2P4/1P3PP1/R4RK1 b - - 0 26,Nf4,-354,-366,-12,1
2rq1rk1/5p2/p2b4/1p2pPPQ/3p1n2/P2P4/1P3PP1/R4RK1 w - - 1 27,Qh4,-335,-289,46,1
2rq1rk1/5p2/p2b4/1p2pPP1/3p1n1Q/P2P4/1P3PP1/R4RK1 b - - 2 27,Be7,-363,-360,3,1
2rq1rk1/4bp2/p7/1p2pPP1/3p1n1Q/P2P4/1P3PP1/R4RK1 w - - 3 28,f6,-375,-418,-43,1
2rq1rk1/4bp2/p4P2/1p2p1P1/3p1n1Q/P2P4/1P3PP1/R4RK1 b - - 0 28,Ng6,-401,-407,-6,1
2rq1rk1/4bp2/p4Pn1/1p2p1P1/3p3Q/P2P4/1P3PP1/R4RK1 w - - 1 29,Qh6,-457,-447,10,1
2rq1rk1/4bp2/p4PnQ/1p2p1P1/3p4/P2P4/1P3PP1/R4RK1 b - - 2 29,Bxf6,-469,-454,15,1
2rq1rk1/5p2/p4bnQ/1p2p1P1/3p4/P2P4/1P3PP1/R4RK1 w - - 0 30,gxf6,-457,-448,9,1
2rq1rk1/5p2/p4PnQ/1p2p3/3p4/P2P4/1P3PP1/R4RK1 b - - 0 30,Qxf6,-454,-486,-32,1
2r2rk1/5p2/p4qnQ/1p2p3/3p4/P2P4/1P3PP1/R4RK1 w - - 0 31,g3,-467,-491,-24,1
rnbqkbnr/pppppppp/8/8/8/8/PPPPPPPP/RNBQKBNR w KQkq - 0 1,e4,22,34,12,1
rnbqkbnr/pppppppp/8/8/4P3/8/PPPP1PPP/RNBQKBNR b KQkq - 0 1,Nc6,35,45,10,1
r1bqkbnr/pppppppp/2n5/8/4P3/8/PPPP1PPP/RNBQKBNR w KQkq - 1 2,d4,71,55,-16,1
r1bqkbnr/pppppppp/2n5/8/3PP3/8/PPP2PPP/RNBQKBNR b KQkq - 0 2,e5,62,58,-4,1
r1bqkbnr/pppp1ppp/2n5/4p3/3PP3/8/PPP2PPP/RNBQKBNR w KQkq - 0 3,d5,64,63,-1,1
r1bqkbnr/pppp1ppp/2n5/3Pp3/4P3/8/PPP2PPP/RNBQKBNR b KQkq - 0 3,Nce7,69,71,2,1
r1bqkbnr/ppppnppp/8/3Pp3/4P3/8/PPP2PPP/RNBQKBNR w KQkq - 1 4,f4,69,-24,-93,1
r1bqkbnr/ppppnppp/8/3Pp3/4PP2/8/PPP3PP/RNBQKBNR b KQkq - 0 4,Ng6,-39,-31,8,1
r1bqkbnr/pppp1ppp/6n1/3Pp3/4PP2/8/PPP3PP/RNBQKBNR w KQkq - 1 5,f5,-22,-191,-169,0
r1bqkbnr/pppp1ppp/6n1/3PpP2/4P3/8/PPP3PP/RNBQKBNR b KQkq - 0 5,N6e7,-123,154,277,1
r1bqkbnr/ppppnppp/8/3PpP2/4P3/8/PPP3PP/RNBQKBNR w KQkq - 1 6,Nf3,151,124,-27,1
r1bqkbnr/ppppnppp/8/3PpP2/4P3/5N2/PPP3PP/RNBQKB1R b KQkq - 2 6,h6,124,235,111,1
r1bqkbnr/ppppnpp1/7p/3PpP2/4P3/5N2/PPP3PP/RNBQKB1R w KQkq - 0 7,Nxe5,268,261,-7,1
r1bqkbnr/ppppnpp1/7p/3PNP2/4P3/8/PPP3PP/RNBQKB1R b KQkq - 0 7,d6,234,553,319,1
r1bqkbnr/ppp1npp1/3p3p/3PNP2/4P3/8/PPP3PP/RNBQKB1R w KQkq - 0 8,Nf3,547,204,-343,0
r1bqkbnr/ppp1npp1/3p3p/3P1P2/4P3/5N2/PPP3PP/RNBQKB1R b KQkq - 1 8,Nf6,204,206,2,1
r1bqkb1r/ppp1npp1/3p1n1p/3P1P2/4P3/5N2/PPP3PP/RNBQKB1R w KQkq - 2 9,Bd3,238,216,-22,1
r1bqkb1r/ppp1npp1/3p1n1p/3P1P2/4P3/3B1N2/PPP3PP/RNBQK2R b KQkq - 3 9,Bd7,218,220,2,1
r2qkb1r/pppbnpp1/3p1n1p/3P1P2/4P3/3B1N2/PPP3PP/RNBQK2R w KQkq - 4 10,h3,234,222,-12,1
r2qkb1r/pppbnpp1/3p1n1p/3P1P2/4P3/3B1N1P/PPP3P1/RNBQK2R b KQkq - 0 10,a6,223,250,27,1
r2qkb1r/1ppbnpp1/p2p1n1p/3P1P2/4P3/3B1N1P/PPP3P1/RNBQK2R w KQkq - 0 11,Be3,250,266,16,1
r2qkb1r/1ppbnpp1/p2p1n1p/3P1P2/4P3/3BBN1P/PPP3P1/RN1QK2R b KQkq - 1 11,Bb5,258,343,85,1
r2qkb1r/1pp1npp1/p2p1n1p/1b1P1P2/4P3/3BBN1P/PPP3P1/RN1QK2R w KQkq - 2 12,Bxb5+,349,261,-88,1
r2qkb1r/1pp1npp1/p2p1n1p/1B1P1P2/4P3/4BN1P/PPP3P1/RN1QK2R b KQkq - 0 12,axb5,273,239,-34,1
r2qkb1r/1pp1npp1/3p1n1p/1p1P1P2/4P3/4BN1P/PPP3P1/RN1QK2R w KQkq - 0 13,Qd3,251,222,-29,1
r2qkb1r/1pp1npp1/3p1n1p/1p1P1P2/4P3/3QBN1P/PPP3P1/RN2K2R b KQkq - 1 13,Qd7,230,254,24,1
r3kb1r/1ppqnpp1/3p1n1p/1p1P1P2/4P3/3QBN1P/PPP3P1/RN2K2R w KQkq - 2 14,Nbd2,271,191,-80,1
r3kb1r/1ppqnpp1/3p1n1p/1p1P1P2/4P3/3QBN1P/PPPN2P1/R3K2R b KQkq - 3 14,c5,197,255,58,1
r3kb1r/1p1qnpp1/3p1n1p/1ppP1P2/4P3/3QBN1P/PPPN2P1/R3K2R w KQkq c6 0 15,O-O,235,228,-7,1
r3kb1r/1p1qnpp1/3p1n1p/1ppP1P2/4P3/3QBN1P/PPPN2P1/R4RK1 b kq - 1 15,c4,219,336,117,1
r3kb1r/1p1qnpp1/3p1n1p/1p1P1P2/2p1P3/3QBN1P/PPPN2P1/R4RK1 w kq - 0 16,Qd4,334,293,-41,1
r3kb1r/1p1qnpp1/3p1n1p/1p1P1P2/2pQP3/4BN1P/PPPN2P1/R4RK1 b kq - 1 16,Nc8,268,271,3,1
r1n1kb1r/1p1q1pp1/3p1n1p/1p1P1P2/2pQP3/4BN1P/PPPN2P1/R4RK1 w kq - 2 17,Bf4,246,186,-60,1
r1n1kb1r/1p1q1pp1/3p1n1p/1p1P1P2/2pQPB2/5N1P/PPPN2P1/R4RK1 b kq - 3 17,Be7,190,199,9,1
r1n1k2r/1p1qbpp1/3p1n1p/1p1P1P2/2pQPB2/5N1P/PPPN2P1/R4RK1 w kq - 4 18,e5,200,38,-162,0
r1n1k2r/1p1qbpp1/3p1n1p/1p1PPP2/2pQ1B2/5N1P/PPPN2P1/R4RK1 b kq - 0 18,dxe5,72,63,-9,1
r1n1k2r/1p1qbpp1/5n1p/1p1PpP2/2pQ1B2/5N1P/PPPN2P1/R4RK1 w kq - 0 19,Bxe5,65,69,4,1
r1n1k2r/1p1qbpp1/5n1p/1p1PBP2/2pQ4/5N1P/PPPN2P1/R4RK1 b kq - 0 19,Nxd5,65,381,316,1
r1n1k2r/1p1qbpp1/7p/1p1nBP2/2pQ4/5N1P/PPPN2P1/R4RK1 w kq - 0 20,Bxg7,403,394,-9,1
r1n1k2r/1p1qbpB1/7p/1p1n1P2/2pQ4/5N1P/PPPN2P1/R4RK1 b kq - 0 20,Rg8,413,358,-55,1
r1n1k1r1/1p1qbpB1/7p/1p1n1P2/2pQ4/5N1P/PPPN2P1/R4RK1 w q - 1 21,Rae1,391,347,-44,1
r1n1k1r1/1p1qbpB1/7p/1p1n1P2/2pQ4/5N1P/PPPN2P1/4RRK1 b q - 2 21,b6,337,485,148,1
r1n1k1r1/3qbpB1/1p5p/1p1n1P2/2pQ4/5N1P/PPPN2P1/4RRK1 w q - 0 22,Ne4,510,491,-19,1
r1n1k1r1/3qbpB1/1p5p/1p1n1P2/2pQN3/5N1P/PPP3P1/4RRK1 b q - 1 22,Qxf5,496,553,57,1
r1n1k1r1/4bpB1/1p5p/1p1n1q2/2pQN3/5N1P/PPP3P1/4RRK1 w q - 0 23,Nf6+,554,314,-240,0
r1n1k1r1/4bpB1/1p3N1p/1p1n1q2/2pQ4/5N1P/PPP3P1/4RRK1 b q - 1 23,Nxf6,275,320,45,1
r1n1k1r1/4bpB1/1p3n1p/1p3q2/2pQ4/5N1P/PPP3P1/4RRK1 w q - 0 24,Bxf6,352,311,-41,1
r1n1k1r1/4bp2/1p3B1p/1p3q2/2pQ4/5N1P/PPP3P1/4RRK1 b q - 0 24,Kf8,350,587,237,1
r1n2kr1/4bp2/1p3B1p/1p3q2/2pQ4/5N1P/PPP3P1/4RRK1 w - - 1 25,Bxe7+,638,655,17,1
r1n2kr1/4Bp2/1p5p/1p3q2/2pQ4/5N1P/PPP3P1/4RRK1 b - - 0 25,Nxe7,599,662,63,1
r4kr1/4np2/1p5p/1p3q2/2pQ4/5N1P/PPP3P1/4RRK1 w - - 0 26,Ne5,687,697,10,1
r4kr1/4np2/1p5p/1p2Nq2/2pQ4/7P/PPP3P1/4RRK1 b - - 1 26,Qxh3,669,9995,9326,1
r4kr1/4np2/1p5p/1p2N3/2pQ4/7q/PPP3P1/4RRK1 w - - 0 27,Nd7+,9995,578,-9417,0
r4kr1/3Nnp2/1p5p/1p6/2pQ4/7q/PPP3P1/4RRK1 b - - 1 27,Ke8,624,673,49,1
r3k1r1/3Nnp2/1p5p/1p6/2pQ4/7q/PPP3P1/4RRK1 w - - 2 28,Nf6+,683,749,66,1
r3k1r1/4np2/1p3N1p/1p6/2pQ4/7q/PPP3P1/4RRK1 b - - 3 28,Kf8,783,807,24,1
r4kr1/4np2/1p3N1p/1p6/2pQ4/7q/PPP3P1/4RRK1 w - - 4 29,Nxg8,794,744,-50,1
r4kN1/4np2/1p5p/1p6/2pQ4/7q/PPP3P1/4RRK1 b - - 0 29,Qxg2+,742,748,6,1
r4kN1/4np2/1p5p/1p6/2pQ4/8/PPP3q1/4RRK1 w - - 0 30,Kxg2,809,814,5,1
r4kN1/4np2/1p5p/1p6/2pQ4/8/PPP3K1/4RR2 b - - 0 30,Nxg8,809,854,45,1
r4kn1/5p2/1p5p/1p6/2pQ4/8/PPP3K1/4RR2 w - - 0 31,Qe5,859,770,-89,1
r4kn1/5p2/1p5p/1p2Q3/2p5/8/PPP3K1/4RR2 b - - 1 31,Ra7,833,1215,382,1
5kn1/r4p2/1p5p/1p2Q3/2p5/8/PPP3K1/4RR2 w - - 2 32,Qh8,1187,739,-448,0
5knQ/r4p2/1p5p/1p6/2p5/8/PPP3K1/4RR2 b - - 3 32,f6,755,907,152,1
5knQ/r7/1p3p1p/1p6/2p5/8/PPP3K1/4RR2 w - - 0 33,Rxf6+,873,984,111,1
5knQ/r7/1p3R1p/1p6/2p5/8/PPP3K1/4R3 b - - 0 33,Rf7,1021,9997,8976,1
5knQ/5r2/1p3R1p/1p6/2p5/8/PPP3K1/4R3 w - - 1 34,Rxf7+,9997,9991,-6,1
5knQ/5R2/1p5p/1p6/2p5/8/PPP3K1/4R3 b - - 0 34,Kxf7,9991,9991,0,1
6nQ/5k2/1p5p/1p6/2p5/8/PPP3K1/4R3 w - - 0 35,Rf1+,9991,904,-9087,0
6nQ/5k2/1p5p/1p6/2p5/8/PPP3K1/5R2 b - - 1 35,Ke6,917,9992,9075,1
6nQ/8/1p2k2p/1p6/2p5/8/PPP3K1/5R2 w - - 2 36,Qxg8+,9992,9993,1,1
6Q1/8/1p2k2p/1p6/2p5/8/PPP3K1/5R2 b - - 0 36,Ke5,9993,9994,1,1
6Q1/8/1p5p/1p2k3/2p5/8/PPP3K1/5R2 w - - 1 37,Qe8+,9994,9995,1,1
4Q3/8/1p5p/1p2k3/2p5/8/PPP3K1/5R2 b - - 2 37,Kd6,9995,9995,0,1
4Q3/8/1p1k3p/1p6/2p5/8/PPP3K1/5R2 w - - 3 38,Rd1+,9995,9997,2,1
4Q3/8/1p1k3p/1p6/2p5/8/PPP3K1/3R4 b - - 4 38,Kc5,9997,9998,1,1
4Q3/8/1p5p/1pk5/2p5/8/PPP3K1/3R4 w - - 5 39,Qc8+,9998,9998,0,1
2Q5/8/1p5p/1pk5/2p5/8/PPP3K1/3R4 b - - 6 39,Kb4,9998,9998,0,1
2Q5/8/1p5p/1p6/1kp5/8/PPP3K1/3R4 w - - 7 40,c3+,9998,9999,1,1
2Q5/8/1p5p/1p6/1kp5/2P5/PP4K1/3R4 b - - 0 40,Ka5,9999,9999,0,1
2Q5/8/1p5p/kp6/2p5/2P5/PP4K1/3R4 w - - 1 41,Qa8#,9999,10000,1,1
rnbqkbnr/pppppppp/8/8/8/8/PPPPPPPP/RNBQKBNR w KQkq - 0 1,e4,35,31,-4,1
rnbqkbnr/pppppppp/8/8/4P3/8/PPPP1PPP/RNBQKBNR b KQkq - 0 1,e5,21,33,12,1
rnbqkbnr/pppp1ppp/8/4p3/4P3/8/PPPP1PPP/RNBQKBNR w KQkq - 0 2,Bc4,26,-8,-34,1
rnbqkbnr/pppp1ppp/8/4p3/2B1P3/8/PPPP1PPP/RNBQK1NR b KQkq - 1 2,Nc6,-13,21,34,1
r1bqkbnr/pppp1ppp/2n5/4p3/2B1P3/8/PPPP1PPP/RNBQK1NR w KQkq - 2 3,Nf3,28,31,3,1
r1bqkbnr/pppp1ppp/2n5/4p3/2B1P3/5N2/PPPP1PPP/RNBQK2R b KQkq - 3 3,Bc5,34,25,-9,1
r1bqk1nr/pppp1ppp/2n5/2b1p3/2B1P3/5N2/PPPP1PPP/RNBQK2R w KQkq - 4 4,c3,18,4,-14,1
r1bqk1nr/pppp1ppp/2n5/2b1p3/2B1P3/2P2N2/PP1P1PPP/RNBQK2R b KQkq - 0 4,Nf6,13,21,8,1
r1bqk2r/pppp1ppp/2n2n2/2b1p3/2B1P3/2P2N2/PP1P1PPP/RNBQK2R w KQkq - 1 5,d3,10,-6,-16,1
r1bqk2r/pppp1ppp/2n2n2/2b1p3/2B1P3/2PP1N2/PP3PPP/RNBQK2R b KQkq - 0 5,h6,13,38,25,1
r1bqk2r/pppp1pp1/2n2n1p/2b1p3/2B1P3/2PP1N2/PP3PPP/RNBQK2R w KQkq - 0 6,b4,29,18,-11,1
r1bqk2r/pppp1pp1/2n2n1p/2b1p3/1PB1P3/2PP1N2/P4PPP/RNBQK2R b KQkq - 0 6,Bb6,26,29,3,1
r1bqk2r/pppp1pp1/1bn2n1p/4p3/1PB1P3/2PP1N2/P4PPP/RNBQK2R w KQkq - 1 7,Bd5,26,-58,-84,1
r1bqk2r/pppp1pp1/1bn2n1p/3Bp3/1P2P3/2PP1N2/P4PPP/RNBQK2R b KQkq - 2 7,d6,-51,-44,7,1
r1bqk2r/ppp2pp1/1bnp1n1p/3Bp3/1P2P3/2PP1N2/P4PPP/RNBQK2R w KQkq - 0 8,h3,-39,-78,-39,1
r1bqk2r/ppp2pp1/1bnp1n1p/3Bp3/1P2P3/2PP1N1P/P4PP1/RNBQK2R b KQkq - 0 8,Nxd5,-113,-93,20,1
r1bqk2r/ppp2pp1/1bnp3p/3np3/1P2P3/2PP1N1P/P4PP1/RNBQK2R w KQkq - 0 9,exd5,-96,-120,-24,1
r1bqk2r/ppp2pp1/1bnp3p/3Pp3/1P6/2PP1N1P/P4PP1/RNBQK2R b KQkq - 0 9,Ne7,-124,-122,2,1
r1bqk2r/ppp1npp1/1b1p3p/3Pp3/1P6/2PP1N1P/P4PP1/RNBQK2R w KQkq - 1 10,c4,-116,-118,-2,1
r1bqk2r/ppp1npp1/1b1p3p/3Pp3/1PP5/3P1N1P/P4PP1/RNBQK2R b KQkq - 0 10,Bf5,-128,-70,58,1
r2qk2r/ppp1npp1/1b1p3p/3Ppb2/1PP5/3P1N1P/P4PP1/RNBQK2R w KQkq - 1 11,O-O,-69,-81,-12,1
r2qk2r/ppp1npp1/1b1p3p/3Ppb2/1PP5/3P1N1P/P4PP1/RNBQ1RK1 b kq - 2 11,Ng6,-81,-34,47,1
r2qk2r/ppp2pp1/1b1p2np/3Ppb2/1PP5/3P1N1P/P4PP1/RNBQ1RK1 w kq - 3 12,Be3,-28,-39,-11,1
r2qk2r/ppp2pp1/1b1p2np/3Ppb2/1PP5/3PBN1P/P4PP1/RN1Q1RK1 b kq - 4 12,Qf6,-40,215,255,1
r3k2r/ppp2pp1/1b1p1qnp/3Ppb2/1PP5/3PBN1P/P4PP1/RN1Q1RK1 w kq - 5 13,c5,233,226,-7,1
r3k2r/ppp2pp1/1b1p1qnp/2PPpb2/1P6/3PBN1P/P4PP1/RN1Q1RK1 b kq - 0 13,dxc5,227,247,20,1
r3k2r/ppp2pp1/1b3qnp/2pPpb2/1P6/3PBN1P/P4PP1/RN1Q1RK1 w kq - 0 14,Bxc5,256,-137,-393,0
r3k2r/ppp2pp1/1b3qnp/2BPpb2/1P6/3P1N1P/P4PP1/RN1Q1RK1 b kq - 0 14,Nf4,-142,-126,16,1
r3k2r/ppp2pp1/1b3q1p/2BPpb2/1P3n2/3P1N1P/P4PP1/RN1Q1RK1 w kq - 1 15,Re1,-126,-183,-57,1
r3k2r/ppp2pp1/1b3q1p/2BPpb2/1P3n2/3P1N1P/P4PP1/RN1QR1K1 b kq - 2 15,Nxd3,-199,-217,-18,1
r3k2r/ppp2pp1/1b3q1p/2BPpb2/1P6/3n1N1P/P4PP1/RN1QR1K1 w kq - 0 16,Re2,-196,-301,-105,0
r3k2r/ppp2pp1/1b3q1p/2BPpb2/1P6/3n1N1P/P3RPP1/RN1Q2K1 b kq - 1 16,Bxc5,-267,-253,14,1
r3k2r/ppp2pp1/5q1p/2bPpb2/1P6/3n1N1P/P3RPP1/RN1Q2K1 w kq - 0 17,bxc5,-247,-262,-15,1
r3k2r/ppp2pp1/5q1p/2PPpb2/8/3n1N1P/P3RPP1/RN1Q2K1 b kq - 0 17,O-O,-274,-245,29,1
r4rk1/ppp2pp1/5q1p/2PPpb2/8/3n1N1P/P3RPP1/RN1Q2K1 w - - 1 18,Nc3,-246,-256,-10,1
r4rk1/ppp2pp1/5q1p/2PPpb2/8/2Nn1N1P/P3RPP1/R2Q2K1 b - - 2 18,Rfe8,-272,-262,10,1
r3r1k1/ppp2pp1/5q1p/2PPpb2/8/2Nn1N1P/P3RPP1/R2Q2K1 w - - 3 19,Ne1,-256,-328,-72,1
r3r1k1/ppp2pp1/5q1p/2PPpb2/8/2Nn3P/P3RPP1/R2QN1K1 b - - 4 19,Nxc5,-357,-312,45,1
r3r1k1/ppp2pp1/5q1p/2nPpb2/8/2N4P/P3RPP1/R2QN1K1 w - - 0 20,Nf3,-333,-375,-42,1
r3r1k1/ppp2pp1/5q1p/2nPpb2/8/2N2N1P/P3RPP1/R2Q2K1 b - - 1 20,e4,-419,-379,40,1
r3r1k1/ppp2pp1/5q1p/2nP1b2/4p3/2N2N1P/P3RPP1/R2Q2K1 w - - 0 21,Nd4,-408,-425,-17,1
r3r1k1/ppp2pp1/5q1p/2nP1b2/3Np3/2N4P/P3RPP1/R2Q2K1 b - - 1 21,Bg6,-381,-408,-27,1
r3r1k1/ppp2pp1/5qbp/2nP4/3Np3/2N4P/P3RPP1/R2Q2K1 w - - 2 22,Ncb5,-401,-431,-30,1
r3r1k1/ppp2pp1/5qbp/1NnP4/3Np3/7P/P3RPP1/R2Q2K1 b - - 3 22,Na6,-434,-393,41,1
r3r1k1/ppp2pp1/n4qbp/1N1P4/3Np3/7P/P3RPP1/R2Q2K1 w - - 4 23,Rc1,-366,-360,6,1
r3r1k1/ppp2pp1/n4qbp/1N1P4/3Np3/7P/P3RPP1/2RQ2K1 b - - 5 23,Re7,-334,-296,38,1
r5k1/ppp1rpp1/n4qbp/1N1P4/3Np3/7P/P3RPP1/2RQ2K1 w - - 6 24,Qc2,-299,-375,-76,1
r5k1/ppp1rpp1/n4qbp/1N1P4/3Np3/7P/P1Q1RPP1/2R3K1 b - - 7 24,Nb4,-385,-381,4,1
r5k1/ppp1rpp1/5qbp/1N1P4/1n1Np3/7P/P1Q1RPP1/2R3K1 w - - 8 25,Qb3,-378,-369,9,1
r5k1/ppp1rpp1/5qbp/1N1P4/1n1Np3/1Q5P/P3RPP1/2R3K1 b - - 9 25,Nd3,-393,-399,-6,1
r5k1/ppp1rpp1/5qbp/1N1P4/3Np3/1Q1n3P/P3RPP1/2R3K1 w - - 10 26,Rf1,-379,-441,-62,1
r5k1/ppp1rpp1/5qbp/1N1P4/3Np3/1Q1n3P/P3RPP1/5RK1 b - - 11 26,c6,-482,-425,57,1
r5k1/pp2rpp1/2p2qbp/1N1P4/3Np3/1Q1n3P/P3RPP1/5RK1 w - - 0 27,Nc3,-385,-539,-154,0
r5k1/pp2rpp1/2p2qbp/3P4/3Np3/1QNn3P/P3RPP1/5RK1 b - - 1 27,Qxd4,-537,-524,13,1
r5k1/pp2rpp1/2p3bp/3P4/3qp3/1QNn3P/P3RPP1/5RK1 w - - 0 28,d6,-539,-682,-143,0
r5k1/pp2rpp1/2pP2bp/8/3qp3/1QNn3P/P3RPP1/5RK1 b - - 0 28,Qxd6,-670,-671,-1,1
r5k1/pp2rpp1/2pq2bp/8/4p3/1QNn3P/P3RPP1/5RK1 w - - 0 29,Nxe4,-659,-720,-61,1
r5k1/pp2rpp1/2pq2bp/8/4N3/1Q1n3P/P3RPP1/5RK1 b - - 0 29,Bxe4,-705,-732,-27,1
r5k1/pp2rpp1/2pq3p/8/4b3/1Q1n3P/P3RPP1/5RK1 w - - 0 30,Rd1,-696,-724,-28,1
r5k1/pp2rpp1/2pq3p/8/4b3/1Q1n3P/P3RPP1/3R2K1 b - - 1 30,Rd8,-716,-696,20,1
3r2k1/pp2rpp1/2pq3p/8/4b3/1Q1n3P/P3RPP1/3R2K1 w - - 2 31,Red2,-732,-772,-40,1
3r2k1/pp2rpp1/2pq3p/8/4b3/1Q1n3P/P2R1PP1/3R2K1 b - - 3 31,Qg6,-812,-796,16,1
3r2k1/pp2rpp1/2p3qp/8/4b3/1Q1n3P/P2R1PP1/3R2K1 w - - 4 32,f3,-748,-778,-30,1
3r2k1/pp2rpp1/2p3qp/8/4b3/1Q1n1P1P/P2R2P1/3R2K1 b - - 0 32,Bxf3,-818,-829,-11,1
3r2k1/pp2rpp1/2p3qp/8/8/1Q1n1b1P/P2R2P1/3R2K1 w - - 0 33,Rf1,-794,-844,-50,1
3r2k1/pp2rpp1/2p3qp/8/8/1Q1n1b1P/P2R2P1/5RK1 b - - 1 33,Be4,-851,-839,12,1
3r2k1/pp2rpp1/2p3qp/8/4b3/1Q1n3P/P2R2P1/5RK1 w - - 2 34,g4,-842,-837,5,1
3r2k1/pp2rpp1/2p3qp/8/4b1P1/1Q1n3P/P2R4/5RK1 b - - 0 34,h5,-837,-850,-13,1
3r2k1/pp2rpp1/2p3q1/7p/4b1P1/1Q1n3P/P2R4/5RK1 w - - 0 35,Qd1,-842,-869,-27,1
3r2k1/pp2rpp1/2p3q1/7p/4b1P1/3n3P/P2R4/3Q1RK1 b - - 1 35,hxg4,-823,-711,112,1
3r2k1/pp2rpp1/2p3q1/8/4b1p1/3n3P/P2R4/3Q1RK1 w - - 0 36,Qxg4,-840,-905,-65,1
3r2k1/pp2rpp1/2p3q1/8/4b1Q1/3n3P/P2R4/5RK1 b - - 0 36,Qxg4+,-856,-845,11,1
3r2k1/pp2rpp1/2p5/8/4b1q1/3n3P/P2R4/5RK1 w - - 0 37,hxg4,-805,-837,-32,1
3r2k1/pp2rpp1/2p5/8/4b1P1/3n4/P2R4/5RK1 b - - 0 37,Red7,-797,-800,-3,1
3r2k1/pp1r1pp1/2p5/8/4b1P1/3n4/P2R4/5RK1 w - - 1 38,Re2,-794,-823,-29,1
3r2k1/pp1r1pp1/2p5/8/4b1P1/3n4/P3R3/5RK1 b - - 2 38,Nc5,-817,-794,23,1
3r2k1/pp1r1pp1/2p5/2n5/4b1P1/8/P3R3/5RK1 w - - 3 39,Rfe1,-787,-827,-40,1
3r2k1/pp1r1pp1/2p5/2n5/4b1P1/8/P3R3/4R1K1 b - - 4 39,Bf3,-790,-737,53,1
3r2k1/pp1r1pp1/2p5/2n5/6P1/5b2/P3R3/4R1K1 w - - 5 40,Re3,-762,-797,-35,1
3r2k1/pp1r1pp1/2p5/2n5/6P1/4Rb2/P7/4R1K1 b - - 6 40,Bxg4,-748,-748,0,1
3r2k1/pp1r1pp1/2p5/2n5/6b1/4R3/P7/4R1K1 w - - 0 41,Rg3,-724,-757,-33,1
3r2k1/pp1r1pp1/2p5/2n5/6b1/6R1/P7/4R1K1 b - - 1 41,Be6,-757,-749,8,1
3r2k1/pp1r1pp1/2p1b3/2n5/8/6R1/P7/4R1K1 w - - 2 42,Rge3,-727,-808,-81,1
3r2k1/pp1r1pp1/2p1b3/2n5/8/4R3/P7/4R1K1 b - - 3 42,Rd2,-815,-774,41,1
3r2k1/pp3pp1/2p1b3/2n5/8/4R3/P2r4/4R1K1 w - - 4 43,R3e2,-810,-880,-70,1
3r2k1/pp3pp1/2p1b3/2n5/8/8/P2rR3/4R1K1 b - - 5 43,Rxe2,-888,-871,17,1
3r2k1/pp3pp1/2p1b3/2n5/8/8/P3r3/4R1K1 w - - 0 44,Rxe2,-863,-875,-12,1
3r2k1/pp3pp1/2p1b3/2n5/8/8/P3R3/6K1 b - - 0 44,Rd1+,-876,-842,34,1
6k1/pp3pp1/2p1b3/2n5/8/8/P3R3/3r2K1 w - - 1 45,Kf2,-861,-885,-24,1
6k1/pp3pp1/2p1b3/2n5/8/8/P3RK2/3r4 b - - 2 45,Nd3+,-881,-776,105,1
6k1/pp3pp1/2p1b3/8/8/3n4/P3RK2/3r4 w - - 3 46,Ke3,-808,-825,-17,1
6k1/pp3pp1/2p1b3/8/8/3nK3/P3R3/3r4 b - - 4 46,Nc1,-829,-734,95,1
6k1/pp3pp1/2p1b3/8/8/4K3/P3R3/2nr4 w - - 5 47,Ke4,-778,-876,-98,1
6k1/pp3pp1/2p1b3/8/4K3/8/P3R3/2nr4 b - - 6 47,Nxa2,-921,-790,131,1
6k1/pp3pp1/2p1b3/8/4K3/8/n3R3/3r4 w - - 0 48,Rxa2,-768,-950,-182,0
6k1/pp3pp1/2p1b3/8/4K3/8/R7/3r4 b - - 0 48,Bxa2,-981,-937,44,1
6k1/pp3pp1/2p5/8/4K3/8/b7/3r4 w - - 0 49,Ke5,-954,-967,-13,1
6k1/pp3pp1/2p5/4K3/8/8/b7/3r4 b - - 1 49,Rd3,-966,-971,-5,1
6k1/pp3pp1/2p5/4K3/8/3r4/b7/8 w - - 2 50,Kf4,-924,-944,-20,1
6k1/pp3pp1/2p5/8/5K2/3r4/b7/8 b - - 3 50,b5,-940,-935,5,1
6k1/p4pp1/2p5/1p6/5K2/3r4/b7/8 w - - 0 51,Ke4,-917,-936,-19,1
6k1/p4pp1/2p5/1p6/4K3/3r4/b7/8 b - - 1 51,Rh3,-926,-937,-11,1
6k1/p4pp1/2p5/1p6/4K3/7r/b7/8 w - - 2 52,Kf4,-926,-976,-50,1
6k1/p4pp1/2p5/1p6/5K2/7r/b7/8 b - - 3 52,c5,-953,-924,29,1
6k1/p4pp1/8/1pp5/5K2/7r/b7/8 w - - 0 53,Kg4,-947,-1014,-67,1
6k1/p4pp1/8/1pp5/6K1/7r/b7/8 b - - 1 53,Ra3,-9990,-997,8993,1
rnbqkbnr/pppppppp/8/8/8/8/PPPPPPPP/RNBQKBNR w KQkq - 0 1,e4,41,32,-9,1
rnbqkbnr/pppppppp/8/8/4P3/8/PPPP1PPP/RNBQKBNR b KQkq - 0 1,c5,26,32,6,1
rnbqkbnr/pp1ppppp/8/2p5/4P3/8/PPPP1PPP/RNBQKBNR w KQkq - 0 2,Nf3,34,31,-3,1
rnbqkbnr/pp1ppppp/8/2p5/4P3/5N2/PPPP1PPP/RNBQKB1R b KQkq - 1 2,d6,28,39,11,1
rnbqkbnr/pp2pppp/3p4/2p5/4P3/5N2/PPPP1PPP/RNBQKB1R w KQkq - 0 3,d4,41,22,-19,1
rnbqkbnr/pp2pppp/3p4/2p5/3PP3/5N2/PPP2PPP/RNBQKB1R b KQkq - 0 3,cxd4,51,52,1,1
rnbqkbnr/pp2pppp/3p4/8/3pP3/5N2/PPP2PPP/RNBQKB1R w KQkq - 0 4,Nxd4,50,52,2,1
rnbqkbnr/pp2pppp/3p4/8/3NP3/8/PPP2PPP/RNBQKB1R b KQkq - 0 4,Nf6,50,43,-7,1
rnbqkb1r/pp2pppp/3p1n2/8/3NP3/8/PPP2PPP/RNBQKB1R w KQkq - 1 5,Nc3,59,52,-7,1
rnbqkb1r/pp2pppp/3p1n2/8/3NP3/2N5/PPP2PPP/R1BQKB1R b KQkq - 2 5,a6,49,47,-2,1
rnbqkb1r/1p2pppp/p2p1n2/8/3NP3/2N5/PPP2PPP/R1BQKB1R w KQkq - 0 6,Be2,64,36,-28,1
rnbqkb1r/1p2pppp/p2p1n2/8/3NP3/2N5/PPP1BPPP/R1BQK2R b KQkq - 1 6,e6,23,55,32,1
rnbqkb1r/1p3ppp/p2ppn2/8/3NP3/2N5/PPP1BPPP/R1BQK2R w KQkq - 0 7,O-O,61,39,-22,1
rnbqkb1r/1p3ppp/p2ppn2/8/3NP3/2N5/PPP1BPPP/R1BQ1RK1 b kq - 1 7,Be7,34,47,13,1
rnbqk2r/1p2bppp/p2ppn2/8/3NP3/2N5/PPP1BPPP/R1BQ1RK1 w kq - 2 8,Be3,39,44,5,1
rnbqk2r/1p2bppp/p2ppn2/8/3NP3/2N1B3/PPP1BPPP/R2Q1RK1 b kq - 3 8,O-O,38,49,11,1
rnbq1rk1/1p2bppp/p2ppn2/8/3NP3/2N1B3/PPP1BPPP/R2Q1RK1 w - - 4 9,Qd2,38,31,-7,1
rnbq1rk1/1p2bppp/p2ppn2/8/3NP3/2N1B3/PPPQBPPP/R4RK1 b - - 5 9,b5,33,36,3,1
rnbq1rk1/4bppp/p2ppn2/1p6/3NP3/2N1B3/PPPQBPPP/R4RK1 w - - 0 10,a3,32,-53,-85,1
rnbq1rk1/4bppp/p2ppn2/1p6/3NP3/P1N1B3/1PPQBPPP/R4RK1 b - - 0 10,Bb7,-53,-55,-2,1
rn1q1rk1/1b2bppp/p2ppn2/1p6/3NP3/P1N1B3/1PPQBPPP/R4RK1 w - - 1 11,f3,-46,-51,-5,1
rn1q1rk1/1b2bppp/p2ppn2/1p6/3NP3/P1N1BP2/1PPQB1PP/R4RK1 b - - 0 11,Nc6,-48,-25,23,1
r2q1rk1/1b2bppp/p1nppn2/1p6/3NP3/P1N1BP2/1PPQB1PP/R4RK1 w - - 1 12,Rad1,-10,-38,-28,1
r2q1rk1/1b2bppp/p1nppn2/1p6/3NP3/P1N1BP2/1PPQB1PP/3R1RK1 b - - 2 12,Qc7,-30,-27,3,1
r4rk1/1bq1bppp/p1nppn2/1p6/3NP3/P1N1BP2/1PPQB1PP/3R1RK1 w - - 3 13,Nxc6,-26,-27,-1,1
r4rk1/1bq1bppp/p1Nppn2/1p6/4P3/P1N1BP2/1PPQB1PP/3R1RK1 b - - 0 13,Bxc6,-28,-25,3,1
r4rk1/2q1bppp/p1bppn2/1p6/4P3/P1N1BP2/1PPQB1PP/3R1RK1 w - - 0 14,h3,-22,-50,-28,1
r4rk1/2q1bppp/p1bppn2/1p6/4P3/P1N1BP1P/1PPQB1P1/3R1RK1 b - - 0 14,Qb7,-63,-24,39,1
r4rk1/1q2bppp/p1bppn2/1p6/4P3/P1N1BP1P/1PPQB1P1/3R1RK1 w - - 1 15,Bd3,-19,-30,-11,1
r4rk1/1q2bppp/p1bppn2/1p6/4P3/P1NBBP1P/1PPQ2P1/3R1RK1 b - - 2 15,d5,-22,17,39,1
r4rk1/1q2bppp/p1b1pn2/1p1p4/4P3/P1NBBP1P/1PPQ2P1/3R1RK1 w - - 0 16,e5,15,13,-2,1
r4rk1/1q2bppp/p1b1pn2/1p1pP3/8/P1NBBP1P/1PPQ2P1/3R1RK1 b - - 0 16,Nd7,19,17,-2,1
r4rk1/1q1nbppp/p1b1p3/1p1pP3/8/P1NBBP1P/1PPQ2P1/3R1RK1 w - - 1 17,f4,16,-2,-18,1
r4rk1/1q1nbppp/p1b1p3/1p1pP3/5P2/P1NBB2P/1PPQ2P1/3R1RK1 b - - 0 17,Nc5,7,21,14,1
r4rk1/1q2bppp/p1b1p3/1pnpP3/5P2/P1NBB2P/1PPQ2P1/3R1RK1 w - - 1 18,Be2,26,-54,-80,1
r4rk1/1q2bppp/p1b1p3/1pnpP3/5P2/P1N1B2P/1PPQB1P1/3R1RK1 b - - 2 18,Rfd8,-77,31,108,1
r2r2k1/1q2bppp/p1b1p3/1pnpP3/5P2/P1N1B2P/1PPQB1P1/3R1RK1 w - - 3 19,Bd4,22,19,-3,1
r2r2k1/1q2bppp/p1b1p3/1pnpP3/3B1P2/P1N4P/1PPQB1P1/3R1RK1 b - - 4 19,Ne4,8,30,22,1
r2r2k1/1q2bppp/p1b1p3/1p1pP3/3BnP2/P1N4P/1PPQB1P1/3R1RK1 w - - 5 20,Nxe4,27,-18,-45,1
r2r2k1/1q2bppp/p1b1p3/1p1pP3/3BNP2/P6P/1PPQB1P1/3R1RK1 b - - 0 20,dxe4,-20,-17,3,1
r2r2k1/1q2bppp/p1b1p3/1p2P3/3BpP2/P6P/1PPQB1P1/3R1RK1 w - - 0 21,Qe3,-16,-21,-5,1
r2r2k1/1q2bppp/p1b1p3/1p2P3/3BpP2/P3Q2P/1PP1B1P1/3R1RK1 b - - 1 21,Rd7,-24,47,71,1
r5k1/1q1rbppp/p1b1p3/1p2P3/3BpP2/P3Q2P/1PP1B1P1/3R1RK1 w - - 2 22,f5,57,-171,-228,0
r5k1/1q1rbppp/p1b1p3/1p2PP2/3Bp3/P3Q2P/1PP1B1P1/3R1RK1 b - - 0 22,Rad8,29,168,139,1
3r2k1/1q1rbppp/p1b1p3/1p2PP2/3Bp3/P3Q2P/1PP1B1P1/3R1RK1 w - - 1 23,f6,157,152,-5,1
3r2k1/1q1rbppp/p1b1pP2/1p2P3/3Bp3/P3Q2P/1PP1B1P1/3R1RK1 b - - 0 23,Bf8,151,148,-3,1
3r1bk1/1q1r1ppp/p1b1pP2/1p2P3/3Bp3/P3Q2P/1PP1B1P1/3R1RK1 w - - 1 24,fxg7,156,126,-30,1
3r1bk1/1q1r1pPp/p1b1p3/1p2P3/3Bp3/P3Q2P/1PP1B1P1/3R1RK1 b - - 0 24,Bxg7,119,129,10,1
3r2k1/1q1r1pbp/p1b1p3/1p2P3/3Bp3/P3Q2P/1PP1B1P1/3R1RK1 w - - 0 25,Bh5,130,104,-26,1
3r2k1/1q1r1pbp/p1b1p3/1p2P2B/3Bp3/P3Q2P/1PP3P1/3R1RK1 b - - 1 25,Bxe5,115,979,864,1
3r2k1/1q1r1p1p/p1b1p3/1p2b2B/3Bp3/P3Q2P/1PP3P1/3R1RK1 w - - 0 26,Bxe5,1022,701,-321,0
3r2k1/1q1r1p1p/p1b1p3/1p2B2B/4p3/P3Q2P/1PP3P1/3R1RK1 b - - 0 26,Rxd1,659,781,122,1
3r2k1/1q3p1p/p1b1p3/1p2B2B/4p3/P3Q2P/1PP3P1/3r1RK1 w - - 0 27,Qg5+,746,1399,653,1
3r2k1/1q3p1p/p1b1p3/1p2B1QB/4p3/P6P/1PP3P1/3r1RK1 b - - 1 27,Kf8,9985,9987,2,1
3r1k2/1q3p1p/p1b1p3/1p2B1QB/4p3/P6P/1PP3P1/3r1RK1 w - - 2 28,Rxd1,9987,497,-9490,0
3r1k2/1q3p1p/p1b1p3/1p2B1QB/4p3/P6P/1PP3P1/3R2K1 b - - 0 28,Rxd1+,495,510,15,1
5k2/1q3p1p/p1b1p3/1p2B1QB/4p3/P6P/1PP3P1/3r2K1 w - - 0 29,Bxd1,511,520,9,1
5k2/1q3p1p/p1b1p3/1p2B1Q1/4p3/P6P/1PP3P1/3B2K1 b - - 0 29,e3,528,9994,9466,1
5k2/1q3p1p/p1b1p3/1p2B1Q1/8/P3p2P/1PP3P1/3B2K1 w - - 0 30,Qd8+,9994,9995,1,1
3Q1k2/1q3p1p/p1b1p3/1p2B3/8/P3p2P/1PP3P1/3B2K1 b - - 1 30,Be8,9995,9995,0,1
3Qbk2/1q3p1p/p3p3/1p2B3/8/P3p2P/1PP3P1/3B2K1 w - - 2 31,Bd6+,9995,9996,1,1
3Qbk2/1q3p1p/p2Bp3/1p6/8/P3p2P/1PP3P1/3B2K1 b - - 3 31,Kg7,9996,9996,0,1
3Qb3/1q3pkp/p2Bp3/1p6/8/P3p2P/1PP3P1/3B2K1 w - - 4 32,Qg5+,9996,9997,1,1
4b3/1q3pkp/p2Bp3/1p4Q1/8/P3p2P/1PP3P1/3B2K1 b - - 5 32,Kh8,9997,9997,0,1
4b2k/1q3p1p/p2Bp3/1p4Q1/8/P3p2P/1PP3P1/3B2K1 w - - 6 33,Be5+,9997,9998,1,1
4b2k/1q3p1p/p3p3/1p2B1Q1/8/P3p2P/1PP3P1/3B2K1 b - - 7 33,f6,9998,9998,0,1
4b2k/1q5p/p3pp2/1p2B1Q1/8/P3p2P/1PP3P1/3B2K1 w - - 0 34,Bxf6+,9998,9999,1,1
rnbqkbnr/pppppppp/8/8/8/8/PPPPPPPP/RNBQKBNR w KQkq - 0 1,e4,35,37,2,1
rnbqkbnr/pppppppp/8/8/4P3/8/PPPP1PPP/RNBQKBNR b KQkq - 0 1,d5,35,75,40,1
rnbqkbnr/ppp1pppp/8/3p4/4P3/8/PPPP1PPP/RNBQKBNR w KQkq - 0 2,e5,69,-15,-84,1
rnbqkbnr/ppp1pppp/8/3pP3/8/8/PPPP1PPP/RNBQKBNR b KQkq - 0 2,Nc6,-20,74,94,1
r1bqkbnr/ppp1pppp/2n5/3pP3/8/8/PPPP1PPP/RNBQKBNR w KQkq - 1 3,d4,57,60,3,1
r1bqkbnr/ppp1pppp/2n5/3pP3/3P4/8/PPP2PPP/RNBQKBNR b KQkq - 0 3,f6,48,66,18,1
r1bqkbnr/ppp1p1pp/2n2p2/3pP3/3P4/8/PPP2PPP/RNBQKBNR w KQkq - 0 4,Bb5,62,60,-2,1
r1bqkbnr/ppp1p1pp/2n2p2/1B1pP3/3P4/8/PPP2PPP/RNBQK1NR b KQkq - 1 4,Bd7,39,59,20,1
r2qkbnr/pppbp1pp/2n2p2/1B1pP3/3P4/8/PPP2PPP/RNBQK1NR w KQkq - 2 5,exf6,65,22,-43,1
r2qkbnr/pppbp1pp/2n2P2/1B1p4/3P4/8/PPP2PPP/RNBQK1NR b KQkq - 0 5,Nxf6,24,34,10,1
r2qkb1r/pppbp1pp/2n2n2/1B1p4/3P4/8/PPP2PPP/RNBQK1NR w KQkq - 0 6,Nc3,47,-11,-58,1
r2qkb1r/pppbp1pp/2n2n2/1B1p4/3P4/2N5/PPP2PPP/R1BQK1NR b KQkq - 1 6,a6,-15,29,44,1
r2qkb1r/1ppbp1pp/p1n2n2/1B1p4/3P4/2N5/PPP2PPP/R1BQK1NR w KQkq - 0 7,Bxc6,73,34,-39,1
r2qkb1r/1ppbp1pp/p1B2n2/3p4/3P4/2N5/PPP2PPP/R1BQK1NR b KQkq - 0 7,Bxc6,38,32,-6,1
r2qkb1r/1pp1p1pp/p1b2n2/3p4/3P4/2N5/PPP2PPP/R1BQK1NR w KQkq - 0 8,Bg5,34,40,6,1
r2qkb1r/1pp1p1pp/p1b2n2/3p2B1/3P4/2N5/PPP2PPP/R2QK1NR b KQkq - 1 8,e6,27,12,-15,1
r2qkb1r/1pp3pp/p1b1pn2/3p2B1/3P4/2N5/PPP2PPP/R2QK1NR w KQkq - 0 9,Nf3,22,11,-11,1
r2qkb1r/1pp3pp/p1b1pn2/3p2B1/3P4/2N2N2/PPP2PPP/R2QK2R b KQkq - 1 9,Bb4,10,20,10,1
r2qk2r/1pp3pp/p1b1pn2/3p2B1/1b1P4/2N2N2/PPP2PPP/R2QK2R w KQkq - 2 10,Qd2,19,0,-19,1
r2qk2r/1pp3pp/p1b1pn2/3p2B1/1b1P4/2N2N2/PPPQ1PPP/R3K2R b KQkq - 3 10,Bxc3,-12,85,97,1
r2qk2r/1pp3pp/p1b1pn2/3p2B1/3P4/2b2N2/PPPQ1PPP/R3K2R w KQkq - 0 11,Qxc3,91,78,-13,1
r2qk2r/1pp3pp/p1b1pn2/3p2B1/3P4/2Q2N2/PPP2PPP/R3K2R b KQkq - 0 11,O-O,74,117,43,1
r2q1rk1/1pp3pp/p1b1pn2/3p2B1/3P4/2Q2N2/PPP2PPP/R3K2R w KQ - 1 12,O-O,99,33,-66,1
r2q1rk1/1pp3pp/p1b1pn2/3p2B1/3P4/2Q2N2/PPP2PPP/R4RK1 b - - 2 12,Ne4,33,97,64,1
r2q1rk1/1pp3pp/p1b1p3/3p2B1/3Pn3/2Q2N2/PPP2PPP/R4RK1 w - - 3 13,Qe3,81,-353,-434,0
r2q1rk1/1pp3pp/p1b1p3/3p2B1/3Pn3/4QN2/PPP2PPP/R4RK1 b - - 4 13,Nxg5,-394,121,515,1
r2q1rk1/1pp3pp/p1b1p3/3p2n1/3P4/4QN2/PPP2PPP/R4RK1 w - - 0 14,Nxg5,177,159,-18,1
r2q1rk1/1pp3pp/p1b1p3/3p2N1/3P4/4Q3/PPP2PPP/R4RK1 b - - 0 14,Bb5,145,313,168,1
r2q1rk1/1pp3pp/p3p3/1b1p2N1/3P4/4Q3/PPP2PPP/R4RK1 w - - 1 15,Nxe6,306,282,-24,1
r2q1rk1/1pp3pp/p3N3/1b1p4/3P4/4Q3/PPP2PPP/R4RK1 b - - 0 15,Qd6,255,265,10,1
r4rk1/1pp3pp/p2qN3/1b1p4/3P4/4Q3/PPP2PPP/R4RK1 w - - 1 16,Nxf8,285,279,-6,1
r4Nk1/1pp3pp/p2q4/1b1p4/3P4/4Q3/PPP2PPP/R4RK1 b - - 0 16,Bxf1,236,241,5,1
r4Nk1/1pp3pp/p2q4/3p4/3P4/4Q3/PPP2PPP/R4bK1 w - - 0 17,Rxf1,258,242,-16,1
r4Nk1/1pp3pp/p2q4/3p4/3P4/4Q3/PPP2PPP/5RK1 b - - 0 17,Rxf8,243,229,-14,1
5rk1/1pp3pp/p2q4/3p4/3P4/4Q3/PPP2PPP/5RK1 w - - 0 18,b3,227,137,-90,1
5rk1/1pp3pp/p2q4/3p4/3P4/1P2Q3/P1P2PPP/5RK1 b - - 0 18,Qa3,100,212,112,1
5rk1/1pp3pp/p7/3p4/3P4/qP2Q3/P1P2PPP/5RK1 w - - 1 19,Qe6+,239,237,-2,1
5rk1/1pp3pp/p3Q3/3p4/3P4/qP6/P1P2PPP/5RK1 b - - 2 19,Kh8,257,255,-2,1
5r1k/1pp3pp/p3Q3/3p4/3P4/qP6/P1P2PPP/5RK1 w - - 3 20,Qxd5,263,255,-8,1
5r1k/1pp3pp/p7/3Q4/3P4/qP6/P1P2PPP/5RK1 b - - 0 20,Qxa2,248,249,1,1
5r1k/1pp3pp/p7/3Q4/3P4/1P6/q1P2PPP/5RK1 w - - 0 21,c3,256,93,-163,0
5r1k/1pp3pp/p7/3Q4/3P4/1PP5/q4PPP/5RK1 b - - 0 21,c6,109,129,20,1
5r1k/1p4pp/p1p5/3Q4/3P4/1PP5/q4PPP/5RK1 w - - 0 22,Qd6,116,69,-47,1
5r1k/1p4pp/p1pQ4/8/3P4/1PP5/q4PPP/5RK1 b - - 1 22,Kg8,105,206,101,1
5rk1/1p4pp/p1pQ4/8/3P4/1PP5/q4PPP/5RK1 w - - 2 23,Qe6+,235,221,-14,1
5rk1/1p4pp/p1p1Q3/8/3P4/1PP5/q4PPP/5RK1 b - - 3 23,Kh8,223,240,17,1
5r1k/1p4pp/p1p1Q3/8/3P4/1PP5/q4PPP/5RK1 w - - 4 24,Qe7,216,237,21,1
5r1k/1p2Q1pp/p1p5/8/3P4/1PP5/q4PPP/5RK1 b - - 5 24,Rb8,238,245,7,1
1r5k/1p2Q1pp/p1p5/8/3P4/1PP5/q4PPP/5RK1 w - - 6 25,b4,274,171,-103,0
1r5k/1p2Q1pp/p1p5/8/1P1P4/2P5/q4PPP/5RK1 b - - 0 25,Qc2,112,118,6,1
1r5k/1p2Q1pp/p1p5/8/1P1P4/2P5/2q2PPP/5RK1 w - - 1 26,Qc7,99,84,-15,1
1r5k/1pQ3pp/p1p5/8/1P1P4/2P5/2q2PPP/5RK1 b - - 2 26,Re8,62,136,74,1
4r2k/1pQ3pp/p1p5/8/1P1P4/2P5/2q2PPP/5RK1 w - - 3 27,Qxb7,120,59,-61,1
4r2k/1Q4pp/p1p5/8/1P1P4/2P5/2q2PPP/5RK1 b - - 0 27,Qe2,46,407,361,1
4r2k/1Q4pp/p1p5/8/1P1P4/2P5/4qPPP/5RK1 w - - 1 28,h3,431,347,-84,1
rnbqkbnr/pppppppp/8/8/8/8/PPPPPPPP/RNBQKBNR w KQkq - 0 1,d4,36,11,-25,1
rnbqkbnr/pppppppp/8/8/3P4/8/PPP1PPPP/RNBQKBNR b KQkq - 0 1,h5,24,135,111,1
rnbqkbnr/ppppppp1/8/7p/3P4/8/PPP1PPPP/RNBQKBNR w KQkq - 0 2,e3,146,78,-68,1
rnbqkbnr/ppppppp1/8/7p/3P4/4P3/PPP2PPP/RNBQKBNR b KQkq - 0 2,h4,60,115,55,1
rnbqkbnr/ppppppp1/8/8/3P3p/4P3/PPP2PPP/RNBQKBNR w KQkq - 0 3,h3,103,117,14,1
rnbqkbnr/ppppppp1/8/8/3P3p/4P2P/PPP2PP1/RNBQKBNR b KQkq - 0 3,e6,100,96,-4,1
rnbqkbnr/pppp1pp1/4p3/8/3P3p/4P2P/PPP2PP1/RNBQKBNR w KQkq - 0 4,Bd3,124,106,-18,1
rnbqkbnr/pppp1pp1/4p3/8/3P3p/3BP2P/PPP2PP1/RNBQK1NR b KQkq - 1 4,d5,98,103,5,1
rnbqkbnr/ppp2pp1/4p3/3p4/3P3p/3BP2P/PPP2PP1/RNBQK1NR w KQkq - 0 5,Nd2,102,70,-32,1
rnbqkbnr/ppp2pp1/4p3/3p4/3P3p/3BP2P/PPPN1PP1/R1BQK1NR b KQkq - 1 5,Nf6,71,110,39,1
rnbqkb1r/ppp2pp1/4pn2/3p4/3P3p/3BP2P/PPPN1PP1/R1BQK1NR w KQkq - 2 6,f4,102,16,-86,1
rnbqkb1r/ppp2pp1/4pn2/3p4/3P1P1p/3BP2P/PPPN2P1/R1BQK1NR b KQkq - 0 6,c5,-4,16,20,1
rnbqkb1r/pp3pp1/4pn2/2pp4/3P1P1p/3BP2P/PPPN2P1/R1BQK1NR w KQkq - 0 7,c3,20,4,-16,1
rnbqkb1r/pp3pp1/4pn2/2pp4/3P1P1p/2PBP2P/PP1N2P1/R1BQK1NR b KQkq - 0 7,c4,3,78,75,1
rnbqkb1r/pp3pp1/4pn2/3p4/2pP1P1p/2PBP2P/PP1N2P1/R1BQK1NR w KQkq - 0 8,Bc2,61,58,-3,1
rnbqkb1r/pp3pp1/4pn2/3p4/2pP1P1p/2P1P2P/PPBN2P1/R1BQK1NR b KQkq - 1 8,Nc6,58,78,20,1
r1bqkb1r/pp3pp1/2n1pn2/3p4/2pP1P1p/2P1P2P/PPBN2P1/R1BQK1NR w KQkq - 2 9,Ngf3,82,84,2,1
r1bqkb1r/pp3pp1/2n1pn2/3p4/2pP1P1p/2P1PN1P/PPBN2P1/R1BQK2R b KQkq - 3 9,Bd6,83,103,20,1
r1bqk2r/pp3pp1/2nbpn2/3p4/2pP1P1p/2P1PN1P/PPBN2P1/R1BQK2R w KQkq - 4 10,O-O,90,89,-1,1
r1bqk2r/pp3pp1/2nbpn2/3p4/2pP1P1p/2P1PN1P/PPBN2P1/R1BQ1RK1 b kq - 5 10,Bd7,93,104,11,1
r2qk2r/pp1b1pp1/2nbpn2/3p4/2pP1P1p/2P1PN1P/PPBN2P1/R1BQ1RK1 w kq - 6 11,Ne5,93,86,-7,1
r2qk2r/pp1b1pp1/2nbpn2/3pN3/2pP1P1p/2P1P2P/PPBN2P1/R1BQ1RK1 b kq - 7 11,Qc7,83,194,111,1
r3k2r/ppqb1pp1/2nbpn2/3pN3/2pP1P1p/2P1P2P/PPBN2P1/R1BQ1RK1 w kq - 8 12,Qf3,194,60,-134,0
r3k2r/ppqb1pp1/2nbpn2/3pN3/2pP1P1p/2P1PQ1P/PPBN2P1/R1B2RK1 b kq - 9 12,O-O-O,72,306,234,1
2kr3r/ppqb1pp1/2nbpn2/3pN3/2pP1P1p/2P1PQ1P/PPBN2P1/R1B2RK1 w - - 10 13,Nxf7,248,268,20,1
2kr3r/ppqb1Np1/2nbpn2/3p4/2pP1P1p/2P1PQ1P/PPBN2P1/R1B2RK1 b - - 0 13,Rdf8,250,323,73,1
2k2r1r/ppqb1Np1/2nbpn2/3p4/2pP1P1p/2P1PQ1P/PPBN2P1/R1B2RK1 w - - 1 14,Nxh8,319,303,-16,1
2k2r1N/ppqb2p1/2nbpn2/3p4/2pP1P1p/2P1PQ1P/PPBN2P1/R1B2RK1 b - - 0 14,Rxh8,302,316,14,1
2k4r/ppqb2p1/2nbpn2/3p4/2pP1P1p/2P1PQ1P/PPBN2P1/R1B2RK1 w - - 0 15,e4,311,306,-5,1
2k4r/ppqb2p1/2nbpn2/3p4/2pPPP1p/2P2Q1P/PPBN2P1/R1B2RK1 b - - 0 15,dxe4,319,330,11,1
2k4r/ppqb2p1/2nbpn2/8/2pPpP1p/2P2Q1P/PPBN2P1/R1B2RK1 w - - 0 16,Nxe4,346,360,14,1
2k4r/ppqb2p1/2nbpn2/8/2pPNP1p/2P2Q1P/PPB3P1/R1B2RK1 b - - 0 16,Nxe4,315,325,10,1
2k4r/ppqb2p1/2nbp3/8/2pPnP1p/2P2Q1P/PPB3P1/R1B2RK1 w - - 0 17,Bxe4,337,355,18,1
2k4r/ppqb2p1/2nbp3/8/2pPBP1p/2P2Q1P/PP4P1/R1B2RK1 b - - 0 17,Ne7,332,355,23,1
2k4r/ppqbn1p1/3bp3/8/2pPBP1p/2P2Q1P/PP4P1/R1B2RK1 w - - 1 18,b3,365,369,4,1
2k4r/ppqbn1p1/3bp3/8/2pPBP1p/1PP2Q1P/P5P1/R1B2RK1 b - - 0 18,Nf5,356,366,10,1
2k4r/ppqb2p1/3bp3/5n2/2pPBP1p/1PP2Q1P/P5P1/R1B2RK1 w - - 1 19,bxc4,355,334,-21,1
2k4r/ppqb2p1/3bp3/5n2/2PPBP1p/2P2Q1P/P5P1/R1B2RK1 b - - 0 19,Bc6,317,514,197,1
2k4r/ppq3p1/2bbp3/5n2/2PPBP1p/2P2Q1P/P5P1/R1B2RK1 w - - 1 20,d5,461,303,-158,0
2k4r/ppq3p1/2bbp3/3P1n2/2P1BP1p/2P2Q1P/P5P1/R1B2RK1 b - - 0 20,exd5,307,517,210,1
2k4r/ppq3p1/2bb4/3p1n2/2P1BP1p/2P2Q1P/P5P1/R1B2RK1 w - - 0 21,cxd5,482,330,-152,0
2k4r/ppq3p1/2bb4/3P1n2/4BP1p/2P2Q1P/P5P1/R1B2RK1 b - - 0 21,Bd7,351,372,21,1
2k4r/ppqb2p1/3b4/3P1n2/4BP1p/2P2Q1P/P5P1/R1B2RK1 w - - 1 22,Bd2,439,199,-240,0
2k4r/ppqb2p1/3b4/3P1n2/4BP1p/2P2Q1P/P2B2P1/R4RK1 b - - 2 22,Ng3,195,196,1,1
2k4r/ppqb2p1/3b4/3P4/4BP1p/2P2QnP/P2B2P1/R4RK1 w - - 3 23,Rf2,200,110,-90,1
2k4r/ppqb2p1/3b4/3P4/4BP1p/2P2QnP/P2B1RP1/R5K1 b - - 4 23,Bc5,106,105,-1,1
2k4r/ppqb2p1/8/2bP4/4BP1p/2P2QnP/P2B1RP1/R5K1 w - - 5 24,Be3,96,3,-93,1
2k4r/ppqb2p1/8/2bP4/4BP1p/2P1BQnP/P4RP1/R5K1 b - - 6 24,Qb6,0,290,290,1
2k4r/pp1b2p1/1q6/2bP4/4BP1p/2P1BQnP/P4RP1/R5K1 w - - 7 25,Re1,322,67,-255,0
2k4r/pp1b2p1/1q6/2bP4/4BP1p/2P1BQnP/P4RP1/4R1K1 b - - 8 25,Re8,48,120,72,1
2k1r3/pp1b2p1/1q6/2bP4/4BP1p/2P1BQnP/P4RP1/4R1K1 w - - 9 26,Bxc5,160,84,-76,1
2k1r3/pp1b2p1/1q6/2BP4/4BP1p/2P2QnP/P4RP1/4R1K1 b - - 0 26,Qxc5,113,108,-5,1
2k1r3/pp1b2p1/8/2qP4/4BP1p/2P2QnP/P4RP1/4R1K1 w - - 0 27,Qe3,97,-82,-179,0
2k1r3/pp1b2p1/8/2qP4/4BP1p/2P1Q1nP/P4RP1/4R1K1 b - - 1 27,Qxe3,-99,-94,5,1
2k1r3/pp1b2p1/8/3P4/4BP1p/2P1q1nP/P4RP1/4R1K1 w - - 0 28,Rxe3,-101,-94,7,1
2k1r3/pp1b2p1/8/3P4/4BP1p/2P1R1nP/P4RP1/6K1 b - - 0 28,Kb8,-96,115,211,1
1k2r3/pp1b2p1/8/3P4/4BP1p/2P1R1nP/P4RP1/6K1 w - - 1 29,Ref3,117,-255,-372,0
1k2r3/pp1b2p1/8/3P4/4BP1p/2P2RnP/P4RP1/6K1 b - - 2 29,Nxe4,-255,-55,200,1
1k2r3/pp1b2p1/8/3P4/4nP1p/2P2R1P/P4RP1/6K1 w - - 0 30,Re2,-99,-91,8,1
1k2r3/pp1b2p1/8/3P4/4nP1p/2P2R1P/P3R1P1/6K1 b - - 1 30,Ng3,-94,58,152,1
1k2r3/pp1b2p1/8/3P4/5P1p/2P2RnP/P3R1P1/6K1 w - - 2 31,Rxe8+,64,66,2,1
1k2R3/pp1b2p1/8/3P4/5P1p/2P2RnP/P5P1/6K1 b - - 0 31,Bxe8,67,76,9,1
1k2b3/pp4p1/8/3P4/5P1p/2P2RnP/P5P1/6K1 w - - 0 32,Rd3,83,0,-83,1
1k2b3/pp4p1/8/3P4/5P1p/2PR2nP/P5P1/6K1 b - - 1 32,Bd7,-2,-24,-22,1
1k6/pp1b2p1/8/3P4/5P1p/2PR2nP/P5P1/6K1 w - - 2 33,c4,-19,-28,-9,1
1k6/pp1b2p1/8/3P4/2P2P1p/3R2nP/P5P1/6K1 b - - 0 33,Kc7,-34,-26,8,1
8/ppkb2p1/8/3P4/2P2P1p/3R2nP/P5P1/6K1 w - - 1 34,c5,-20,-46,-26,1
8/ppkb2p1/8/2PP4/5P1p/3R2nP/P5P1/6K1 b - - 0 34,b6,-39,-42,-3,1
8/p1kb2p1/1p6/2PP4/5P1p/3R2nP/P5P1/6K1 w - - 0 35,d6+,-27,-47,-20,1
8/p1kb2p1/1p1P4/2P5/5P1p/3R2nP/P5P1/6K1 b - - 0 35,Kc6,-30,-43,-13,1
8/p2b2p1/1pkP4/2P5/5P1p/3R2nP/P5P1/6K1 w - - 1 36,cxb6,-40,-103,-63,1
8/p2b2p1/1PkP4/8/5P1p/3R2nP/P5P1/6K1 b - - 0 36,axb6,-43,-42,1,1
8/3b2p1/1pkP4/8/5P1p/3R2nP/P5P1/6K1 w - - 0 37,Ra3,-39,-69,-30,1
8/3b2p1/1pkP4/8/5P1p/R5nP/P5P1/6K1 b - - 1 37,Kxd6,-76,-57,19,1
8/3b2p1/1p1k4/8/5P1p/R5nP/P5P1/6K1 w - - 0 38,Ra7,-66,-97,-31,1
8/R2b2p1/1p1k4/8/5P1p/6nP/P5P1/6K1 b - - 1 38,g6,-94,-49,45,1
8/R2b4/1p1k2p1/8/5P1p/6nP/P5P1/6K1 w - - 0 39,a4,-44,-65,-21,1
8/R2b4/1p1k2p1/8/P4P1p/6nP/6P1/6K1 b - - 0 39,Kc5,-70,459,529,1
8/R2b4/1p4p1/2k5/P4P1p/6nP/6P1/6K1 w - - 1 40,Ra6,425,-143,-568,0
8/3b4/Rp4p1/2k5/P4P1p/6nP/6P1/6K1 b - - 2 40,Bc6,-138,-117,21,1
8/8/Rpb3p1/2k5/P4P1p/6nP/6P1/6K1 w - - 3 41,Ra7,-124,-172,-48,1
8/R7/1pb3p1/2k5/P4P1p/6nP/6P1/6K1 b - - 4 41,Ne2+,-187,-161,26,1
8/R7/1pb3p1/2k5/P4P1p/7P/4n1P1/6K1 w - - 5 42,Kf2,-120,-203,-83,1
8/R7/1pb3p1/2k5/P4P1p/7P/4nKP1/8 b - - 6 42,Nxf4,-165,-148,17,1
rnbqkbnr/pppppppp/8/8/8/8/PPPPPPPP/RNBQKBNR w KQkq - 0 1,Nf3,57,12,-45,1
rnbqkbnr/pppppppp/8/8/8/5N2/PPPPPPPP/RNBQKB1R b KQkq - 1 1,d5,17,20,3,1
rnbqkbnr/ppp1pppp/8/3p4/8/5N2/PPPPPPPP/RNBQKB1R w KQkq - 0 2,d4,20,24,4,1
rnbqkbnr/ppp1pppp/8/3p4/3P4/5N2/PPP1PPPP/RNBQKB1R b KQkq - 0 2,f6,25,114,89,1
rnbqkbnr/ppp1p1pp/5p2/3p4/3P4/5N2/PPP1PPPP/RNBQKB1R w KQkq - 0 3,c4,118,117,-1,1
rnbqkbnr/ppp1p1pp/5p2/3p4/2PP4/5N2/PP2PPPP/RNBQKB1R b KQkq - 0 3,Nc6,125,229,104,1
r1bqkbnr/ppp1p1pp/2n2p2/3p4/2PP4/5N2/PP2PPPP/RNBQKB1R w KQkq - 1 4,e4,172,-200,-372,0
r1bqkbnr/ppp1p1pp/2n2p2/3p4/2PPP3/5N2/PP3PPP/RNBQKB1R b KQkq - 0 4,dxe4,-215,-198,17,1
r1bqkbnr/ppp1p1pp/2n2p2/8/2PPp3/5N2/PP3PPP/RNBQKB1R w KQkq - 0 5,d5,-210,-202,8,1
r1bqkbnr/ppp1p1pp/2n2p2/3P4/2P1p3/5N2/PP3PPP/RNBQKB1R b KQkq - 0 5,exf3,-255,-209,46,1
r1bqkbnr/ppp1p1pp/2n2p2/3P4/2P5/5p2/PP3PPP/RNBQKB1R w KQkq - 0 6,dxc6,-214,-241,-27,1
r1bqkbnr/ppp1p1pp/2P2p2/8/2P5/5p2/PP3PPP/RNBQKB1R b KQkq - 0 6,Qxd1+,-248,-242,6,1
r1b1kbnr/ppp1p1pp/2P2p2/8/2P5/5p2/PP3PPP/RNBqKB1R w KQkq - 0 7,Kxd1,-221,-223,-2,1
r1b1kbnr/ppp1p1pp/2P2p2/8/2P5/5p2/PP3PPP/RNBK1B1R b kq - 0 7,bxc6,-228,-176,52,1
r1b1kbnr/p1p1p1pp/2p2p2/8/2P5/5p2/PP3PPP/RNBK1B1R w kq - 0 8,gxf3,-174,-189,-15,1
r1b1kbnr/p1p1p1pp/2p2p2/8/2P5/5P2/PP3P1P/RNBK1B1R b kq - 0 8,e6,-186,-142,44,1
r1b1kbnr/p1p3pp/2p1pp2/8/2P5/5P2/PP3P1P/RNBK1B1R w kq - 0 9,Nc3,-154,-162,-8,1
r1b1kbnr/p1p3pp/2p1pp2/8/2P5/2N2P2/PP3P1P/R1BK1B1R b kq - 1 9,Bd6,-159,-112,47,1
r1b1k1nr/p1p3pp/2pbpp2/8/2P5/2N2P2/PP3P1P/R1BK1B1R w kq - 2 10,Be3,-112,-114,-2,1
r1b1k1nr/p1p3pp/2pbpp2/8/2P5/2N1BP2/PP3P1P/R2K1B1R b kq - 3 10,Ne7,-121,-116,5,1
r1b1k2r/p1p1n1pp/2pbpp2/8/2P5/2N1BP2/PP3P1P/R2K1B1R w kq - 4 11,c5,-106,-106,0,1
r1b1k2r/p1p1n1pp/2pbpp2/2P5/8/2N1BP2/PP3P1P/R2K1B1R b kq - 0 11,Be5,-106,-109,-3,1
r1b1k2r/p1p1n1pp/2p1pp2/2P1b3/8/2N1BP2/PP3P1P/R2K1B1R w kq - 1 12,Na4,-99,-197,-98,1
r1b1k2r/p1p1n1pp/2p1pp2/2P1b3/N7/4BP2/PP3P1P/R2K1B1R b kq - 2 12,O-O,-177,-146,31,1
r1b2rk1/p1p1n1pp/2p1pp2/2P1b3/N7/4BP2/PP3P1P/R2K1B1R w - - 3 13,f4,-163,-163,0,1
r1b2rk1/p1p1n1pp/2p1pp2/2P1b3/N4P2/4B3/PP3P1P/R2K1B1R b - - 0 13,Rd8+,-162,-126,36,1
r1br2k1/p1p1n1pp/2p1pp2/2P1b3/N4P2/4B3/PP3P1P/R2K1B1R w - - 1 14,Ke2,-115,-229,-114,0
r1br2k1/p1p1n1pp/2p1pp2/2P1b3/N4P2/4B3/PP2KP1P/R4B1R b - - 2 14,Bxf4,-218,-227,-9,1
r1br2k1/p1p1n1pp/2p1pp2/2P5/N4b2/4B3/PP2KP1P/R4B1R w - - 0 15,Bxf4,-229,-222,7,1
r1br2k1/p1p1n1pp/2p1pp2/2P5/N4B2/8/PP2KP1P/R4B1R b - - 0 15,Nf5,-218,208,426,1
r1br2k1/p1p3pp/2p1pp2/2P2n2/N4B2/8/PP2KP1P/R4B1R w - - 1 16,Bxc7,218,69,-149,0
r1br2k1/p1B3pp/2p1pp2/2P2n2/N7/8/PP2KP1P/R4B1R b - - 0 16,Nd4+,70,340,270,1
r1br2k1/p1B3pp/2p1pp2/2P5/N2n4/8/PP2KP1P/R4B1R w - - 1 17,Kd2,336,380,44,1
r1br2k1/p1B3pp/2p1pp2/2P5/N2n4/8/PP1K1P1P/R4B1R b - - 2 17,Nb3+,362,544,182,1
r1br2k1/p1B3pp/2p1pp2/2P5/N7/1n6/PP1K1P1P/R4B1R w - - 3 18,Kc3,519,452,-67,1
r1br2k1/p1B3pp/2p1pp2/2P5/N7/1nK5/PP3P1P/R4B1R b - - 4 18,Nxa1,460,591,131,1
r1br2k1/p1B3pp/2p1pp2/2P5/N7/2K5/PP3P1P/n4B1R w - - 0 19,Bxd8,680,658,-22,1
r1bB2k1/p5pp/2p1pp2/2P5/N7/2K5/PP3P1P/n4B1R b - - 0 19,Ba6,668,661,-7,1
r2B2k1/p5pp/b1p1pp2/2P5/N7/2K5/PP3P1P/n4B1R w - - 1 20,Bxa6,641,683,42,1
r2B2k1/p5pp/B1p1pp2/2P5/N7/2K5/PP3P1P/n6R b - - 0 20,Rxd8,643,643,0,1
3r2k1/p5pp/B1p1pp2/2P5/N7/2K5/PP3P1P/n6R w - - 0 21,Rxa1,644,636,-8,1
3r2k1/p5pp/B1p1pp2/2P5/N7/2K5/PP3P1P/R7 b - - 0 21,e5,636,622,-14,1
3r2k1/p5pp/B1p2p2/2P1p3/N7/2K5/PP3P1P/R7 w - - 0 22,Bb7,631,662,31,1
3r2k1/pB4pp/2p2p2/2P1p3/N7/2K5/PP3P1P/R7 b - - 1 22,Rd4,679,716,37,1
6k1/pB4pp/2p2p2/2P1p3/N2r4/2K5/PP3P1P/R7 w - - 2 23,b3,716,688,-28,1
6k1/pB4pp/2p2p2/2P1p3/N2r4/1PK5/P4P1P/R7 b - - 0 23,g5,690,723,33,1
6k1/pB5p/2p2p2/2P1p1p1/N2r4/1PK5/P4P1P/R7 w - - 0 24,Bxc6,682,690,8,1
rnbqkbnr/pppppppp/8/8/8/8/PPPPPPPP/RNBQKBNR w KQkq - 0 1,d4,67,28,-39,1
rnbqkbnr/pppppppp/8/8/3P4/8/PPP1PPPP/RNBQKBNR b KQkq - 0 1,Nf6,25,23,-2,1
rnbqkb1r/pppppppp/5n2/8/3P4/8/PPP1PPPP/RNBQKBNR w KQkq - 1 2,c4,24,21,-3,1
rnbqkb1r/pppppppp/5n2/8/2PP4/8/PP2PPPP/RNBQKBNR b KQkq - 0 2,e6,19,22,3,1
rnbqkb1r/pppp1ppp/4pn2/8/2PP4/8/PP2PPPP/RNBQKBNR w KQkq - 0 3,Nc3,22,22,0,1
rnbqkb1r/pppp1ppp/4pn2/8/2PP4/2N5/PP2PPPP/R1BQKBNR b KQkq - 1 3,d5,22,28,6,1
rnbqkb1r/ppp2ppp/4pn2/3p4/2PP4/2N5/PP2PPPP/R1BQKBNR w KQkq - 0 4,Bg5,29,30,1,1
rnbqkb1r/ppp2ppp/4pn2/3p2B1/2PP4/2N5/PP2PPPP/R2QKBNR b KQkq - 1 4,Be7,34,34,0,1
rnbqk2r/ppp1bppp/4pn2/3p2B1/2PP4/2N5/PP2PPPP/R2QKBNR w KQkq - 2 5,cxd5,31,17,-14,1
rnbqk2r/ppp1bppp/4pn2/3P2B1/3P4/2N5/PP2PPPP/R2QKBNR b KQkq - 0 5,exd5,8,31,23,1
rnbqk2r/ppp1bppp/5n2/3p2B1/3P4/2N5/PP2PPPP/R2QKBNR w KQkq - 0 6,e3,32,32,0,1
rnbqk2r/ppp1bppp/5n2/3p2B1/3P4/2N1P3/PP3PPP/R2QKBNR b KQkq - 0 6,O-O,31,24,-7,1
rnbq1rk1/ppp1bppp/5n2/3p2B1/3P4/2N1P3/PP3PPP/R2QKBNR w KQ - 1 7,Bd3,24,22,-2,1
rnbq1rk1/ppp1bppp/5n2/3p2B1/3P4/2NBP3/PP3PPP/R2QK1NR b KQ - 2 7,Re8,19,41,22,1
rnbqr1k1/ppp1bppp/5n2/3p2B1/3P4/2NBP3/PP3PPP/R2QK1NR w KQ - 3 8,Nge2,38,26,-12,1
rnbqr1k1/ppp1bppp/5n2/3p2B1/3P4/2NBP3/PP2NPPP/R2QK2R b KQ - 4 8,c6,26,33,7,1
rnbqr1k1/pp2bppp/2p2n2/3p2B1/3P4/2NBP3/PP2NPPP/R2QK2R w KQ - 0 9,O-O,26,21,-5,1
rnbqr1k1/pp2bppp/2p2n2/3p2B1/3P4/2NBP3/PP2NPPP/R2Q1RK1 b - - 1 9,Ne4,27,91,64,1
rnbqr1k1/pp2bppp/2p5/3p2B1/3Pn3/2NBP3/PP2NPPP/R2Q1RK1 w - - 2 10,Bxe7,78,88,10,1
rnbqr1k1/pp2Bppp/2p5/3p4/3Pn3/2NBP3/PP2NPPP/R2Q1RK1 b - - 0 10,Qxe7,49,51,2,1
rnb1r1k1/pp2qppp/2p5/3p4/3Pn3/2NBP3/PP2NPPP/R2Q1RK1 w - - 0 11,Qc2,70,25,-45,1
rnb1r1k1/pp2qppp/2p5/3p4/3Pn3/2NBP3/PPQ1NPPP/R4RK1 b - - 1 11,f5,32,99,67,1
rnb1r1k1/pp2q1pp/2p5/3p1p2/3Pn3/2NBP3/PPQ1NPPP/R4RK1 w - - 0 12,Ng3,94,26,-68,1
rnb1r1k1/pp2q1pp/2p5/3p1p2/3Pn3/2NBP1N1/PPQ2PPP/R4RK1 b - - 1 12,Nd7,31,387,356,1
r1b1r1k1/pp1nq1pp/2p5/3p1p2/3Pn3/2NBP1N1/PPQ2PPP/R4RK1 w - - 2 13,Nxf5,407,402,-5,1
r1b1r1k1/pp1nq1pp/2p5/3p1N2/3Pn3/2NBP3/PPQ2PPP/R4RK1 b - - 0 13,Qf6,420,347,-73,1
r1b1r1k1/pp1n2pp/2p2q2/3p1N2/3Pn3/2NBP3/PPQ2PPP/R4RK1 w - - 1 14,Ng3,360,291,-69,1
r1b1r1k1/pp1n2pp/2p2q2/3p4/3Pn3/2NBP1N1/PPQ2PPP/R4RK1 b - - 2 14,Qh4,273,414,141,1
r1b1r1k1/pp1n2pp/2p5/3p4/3Pn2q/2NBP1N1/PPQ2PPP/R4RK1 w - - 3 15,Ngxe4,386,373,-13,1
r1b1r1k1/pp1n2pp/2p5/3p4/3PN2q/2NBP3/PPQ2PPP/R4RK1 b - - 0 15,dxe4,390,398,8,1
r1b1r1k1/pp1n2pp/2p5/8/3Pp2q/2NBP3/PPQ2PPP/R4RK1 w - - 0 16,Nxe4,389,383,-6,1
r1b1r1k1/pp1n2pp/2p5/8/3PN2q/3BP3/PPQ2PPP/R4RK1 b - - 0 16,Nf6,398,390,-8,1
r1b1r1k1/pp4pp/2p2n2/8/3PN2q/3BP3/PPQ2PPP/R4RK1 w - - 1 17,Nxf6+,381,365,-16,1
r1b1r1k1/pp4pp/2p2N2/8/3P3q/3BP3/PPQ2PPP/R4RK1 b - - 0 17,gxf6,397,410,13,1
r1b1r1k1/pp5p/2p2p2/8/3P3q/3BP3/PPQ2PPP/R4RK1 w - - 0 18,Bxh7+,395,-174,-569,0
r1b1r1k1/pp5B/2p2p2/8/3P3q/4P3/PPQ2PPP/R4RK1 b - - 0 18,Qxh7,-169,-151,18,1
r1b1r1k1/pp5q/2p2p2/8/3P4/4P3/PPQ2PPP/R4RK1 w - - 0 19,Qxh7+,-162,-155,7,1
r1b1r1k1/pp5Q/2p2p2/8/3P4/4P3/PP3PPP/R4RK1 b - - 0 19,Kxh7,-131,-134,-3,1
r1b1r3/pp5k/2p2p2/8/3P4/4P3/PP3PPP/R4RK1 w - - 0 20,Rfc1,-131,-161,-30,1
r1b1r3/pp5k/2p2p2/8/3P4/4P3/PP3PPP/R1R3K1 b - - 1 20,Be6,-160,-184,-24,1
r3r3/pp5k/2p1bp2/8/3P4/4P3/PP3PPP/R1R3K1 w - - 2 21,b4,-183,-242,-59,1
r3r3/pp5k/2p1bp2/8/1P1P4/4P3/P4PPP/R1R3K1 b - - 0 21,a6,-232,-150,82,1
r3r3/1p5k/p1p1bp2/8/1P1P4/4P3/P4PPP/R1R3K1 w - - 0 22,a4,-147,-136,11,1
r3r3/1p5k/p1p1bp2/8/PP1P4/4P3/5PPP/R1R3K1 b - - 0 22,Bd5,-130,-148,-18,1
r3r3/1p5k/p1p2p2/3b4/PP1P4/4P3/5PPP/R1R3K1 w - - 1 23,Rc3,-156,-243,-87,1
r3r3/1p5k/p1p2p2/3b4/PP1P4/2R1P3/5PPP/R5K1 b - - 2 23,Rg8,-251,-253,-2,1
r5r1/1p5k/p1p2p2/3b4/PP1P4/2R1P3/5PPP/R5K1 w - - 3 24,g3,-240,-232,8,1
r5r1/1p5k/p1p2p2/3b4/PP1P4/2R1P1P1/5P1P/R5K1 b - - 0 24,b5,-237,-187,50,1
r5r1/7k/p1p2p2/1p1b4/PP1P4/2R1P1P1/5P1P/R5K1 w - - 0 25,a5,-181,-156,25,1
r5r1/7k/p1p2p2/Pp1b4/1P1P4/2R1P1P1/5P1P/R5K1 b - - 0 25,Rae8,-155,-161,-6,1
4r1r1/7k/p1p2p2/Pp1b4/1P1P4/2R1P1P1/5P1P/R5K1 w - - 1 26,Re1,-170,-211,-41,1
4r1r1/7k/p1p2p2/Pp1b4/1P1P4/2R1P1P1/5P1P/4R1K1 b - - 2 26,Rg4,-192,-155,37,1
4r3/7k/p1p2p2/Pp1b4/1P1P2r1/2R1P1P1/5P1P/4R1K1 w - - 3 27,Kf1,-162,-255,-93,1
4r3/7k/p1p2p2/Pp1b4/1P1P2r1/2R1P1P1/5P1P/4RK2 b - - 4 27,f5,-222,-173,49,1
4r3/7k/p1p5/Pp1b1p2/1P1P2r1/2R1P1P1/5P1P/4RK2 w - - 0 28,h3,-157,-187,-30,1
4r3/7k/p1p5/Pp1b1p2/1P1P2r1/2R1P1PP/5P2/4RK2 b - - 0 28,Kg7,-176,397,573,1
4r3/6k1/p1p5/Pp1b1p2/1P1P2r1/2R1P1PP/5P2/4RK2 w - - 1 29,hxg4,425,409,-16,1
4r3/6k1/p1p5/Pp1b1p2/1P1P2P1/2R1P1P1/5P2/4RK2 b - - 0 29,fxg4,411,364,-47,1
4r3/6k1/p1p5/Pp1b4/1P1P2p1/2R1P1P1/5P2/4RK2 w - - 0 30,Ke2,405,389,-16,1
4r3/6k1/p1p5/Pp1b4/1P1P2p1/2R1P1P1/4KP2/4R3 b - - 1 30,Rh8,418,518,100,1
7r/6k1/p1p5/Pp1b4/1P1P2p1/2R1P1P1/4KP2/4R3 w - - 2 31,Kd3,476,457,-19,1
7r/6k1/p1p5/Pp1b4/1P1P2p1/2RKP1P1/5P2/4R3 b - - 3 31,Rh2,438,469,31,1
8/6k1/p1p5/Pp1b4/1P1P2p1/2RKP1P1/5P1r/4R3 w - - 4 32,Rc2,504,478,-26,1
8/6k1/p1p5/Pp1b4/1P1P2p1/3KP1P1/2R2P1r/4R3 b - - 5 32,Kf6,476,492,16,1
8/8/p1p2k2/Pp1b4/1P1P2p1/3KP1P1/2R2P1r/4R3 w - - 6 33,e4,490,511,21,1
8/8/p1p2k2/Pp1b4/1P1PP1p1/3K2P1/2R2P1r/4R3 b - - 0 33,Bc4+,518,522,4,1
8/8/p1p2k2/Pp6/1PbPP1p1/3K2P1/2R2P1r/4R3 w - - 1 34,Ke3,533,505,-28,1
8/8/p1p2k2/Pp6/1PbPP1p1/4K1P1/2R2P1r/4R3 b - - 2 34,Ke6,493,511,18,1
8/8/p1p1k3/Pp6/1PbPP1p1/4K1P1/2R2P1r/4R3 w - - 3 35,Kf4,498,490,-8,1
8/8/p1p1k3/Pp6/1PbPPKp1/6P1/2R2P1r/4R3 b - - 4 35,Rh7,486,514,28,1
8/7r/p1p1k3/Pp6/1PbPPKp1/6P1/2R2P2/4R3 w - - 5 36,Kxg4,529,543,14,1
8/7r/p1p1k3/Pp6/1PbPP1K1/6P1/2R2P2/4R3 b - - 0 36,Rg7+,544,563,19,1
8/6r1/p1p1k3/Pp6/1PbPP1K1/6P1/2R2P2/4R3 w - - 1 37,Kh3,599,524,-75,1
8/6r1/p1p1k3/Pp6/1PbPP3/6PK/2R2P2/4R3 b - - 2 37,Rh7+,577,571,-6,1
8/7r/p1p1k3/Pp6/1PbPP3/6PK/2R2P2/4R3 w - - 3 38,Kg2,567,582,15,1
8/7r/p1p1k3/Pp6/1PbPP3/6P1/2R2PK1/4R3 b - - 4 38,Rf7,575,599,24,1
8/5r2/p1p1k3/Pp6/1PbPP3/6P1/2R2PK1/4R3 w - - 5 39,d5+,601,581,-20,1
8/5r2/p1p1k3/Pp1P4/1Pb1P3/6P1/2R2PK1/4R3 b - - 0 39,Ke7,584,604,20,1
8/4kr2/p1p5/Pp1P4/1Pb1P3/6P1/2R2PK1/4R3 w - - 1 40,dxc6,595,586,-9,1
8/4kr2/p1P5/Pp6/1Pb1P3/6P1/2R2PK1/4R3 b - - 0 40,Kd6,616,626,10,1
8/5r2/p1Pk4/Pp6/1Pb1P3/6P1/2R2PK1/4R3 w - - 1 41,Rd1+,638,627,-11,1
8/5r2/p1Pk4/Pp6/1Pb1P3/6P1/2R2PK1/3R4 b - - 2 41,Kxc6,630,623,-7,1
8/5r2/p1k5/Pp6/1Pb1P3/6P1/2R2PK1/3R4 w - - 0 42,Rdc1,634,606,-28,1
8/5r2/p1k5/Pp6/1Pb1P3/6P1/2R2PK1/2R5 b - - 1 42,Kb7,594,629,35,1
8/1k3r2/p7/Pp6/1Pb1P3/6P1/2R2PK1/2R5 w - - 2 43,Rxc4,653,623,-30,1
8/1k3r2/p7/Pp6/1PR1P3/6P1/5PK1/2R5 b - - 0 43,bxc4,632,657,25,1
8/1k3r2/p7/P7/1Pp1P3/6P1/5PK1/2R5 w - - 0 44,Rxc4,666,633,-33,1
8/1k3r2/p7/P7/1PR1P3/6P1/5PK1/8 b - - 0 44,Re7,635,644,9,1
8/1k2r3/p7/P7/1PR1P3/6P1/5PK1/8 w - - 1 45,f4,648,644,-4,1
8/1k2r3/p7/P7/1PR1PP2/6P1/6K1/8 b - - 0 45,Rxe4,617,749,132,1
8/1k6/p7/P7/1PR1rP2/6P1/6K1/8 w - - 0 46,Rxe4,835,927,92,1
8/1k6/p7/P7/1P2RP2/6P1/6K1/8 b - - 0 46,Kc6,940,934,-6,1
8/8/p1k5/P7/1P2RP2/6P1/6K1/8 w - - 1 47,g4,919,980,61,1
8/8/p1k5/P7/1P2RPP1/8/6K1/8 b - - 0 47,Kb5,1009,1028,19,1
8/8/p7/Pk6/1P2RPP1/8/6K1/8 w - - 1 48,Re6,1051,738,-313,0
rnbqkbnr/pppppppp/8/8/8/8/PPPPPPPP/RNBQKBNR w KQkq - 0 1,e4,39,29,-10,1
rnbqkbnr/pppppppp/8/8/4P3/8/PPPP1PPP/RNBQKBNR b KQkq - 0 1,g6,40,68,28,1
rnbqkbnr/pppppp1p/6p1/8/4P3/8/PPPP1PPP/RNBQKBNR w KQkq - 0 2,d4,65,64,-1,1
rnbqkbnr/pppppp1p/6p1/8/3PP3/8/PPP2PPP/RNBQKBNR b KQkq - 0 2,Bg7,66,62,-4,1
rnbqk1nr/ppppppbp/6p1/8/3PP3/8/PPP2PPP/RNBQKBNR w KQkq - 1 3,Nf3,61,62,1,1
rnbqk1nr/ppppppbp/6p1/8/3PP3/5N2/PPP2PPP/RNBQKB1R b KQkq - 2 3,c6,59,71,12,1
rnbqk1nr/pp1pppbp/2p3p1/8/3PP3/5N2/PPP2PPP/RNBQKB1R w KQkq - 0 4,Bc4,86,40,-46,1
rnbqk1nr/pp1pppbp/2p3p1/8/2BPP3/5N2/PPP2PPP/RNBQK2R b KQkq - 1 4,Nh6,40,104,64,1
rnbqk2r/pp1pppbp/2p3pn/8/2BPP3/5N2/PPP2PPP/RNBQK2R w KQkq - 2 5,h3,105,45,-60,1
rnbqk2r/pp1pppbp/2p3pn/8/2BPP3/5N1P/PPP2PP1/RNBQK2R b KQkq - 0 5,O-O,41,74,33,1
rnbq1rk1/pp1pppbp/2p3pn/8/2BPP3/5N1P/PPP2PP1/RNBQK2R w KQ - 1 6,Be3,78,-32,-110,0
rnbq1rk1/pp1pppbp/2p3pn/8/2BPP3/4BN1P/PPP2PP1/RN1QK2R b KQ - 2 6,d5,-25,-20,5,1
rnbq1rk1/pp2ppbp/2p3pn/3p4/2BPP3/4BN1P/PPP2PP1/RN1QK2R w KQ - 0 7,exd5,-16,-44,-28,1
rnbq1rk1/pp2ppbp/2p3pn/3P4/2BP4/4BN1P/PPP2PP1/RN1QK2R b KQ - 0 7,cxd5,-29,-25,4,1
rnbq1rk1/pp2ppbp/6pn/3p4/2BP4/4BN1P/PPP2PP1/RN1QK2R w KQ - 0 8,Bb3,-32,-45,-13,1
rnbq1rk1/pp2ppbp/6pn/3p4/3P4/1B2BN1P/PPP2PP1/RN1QK2R b KQ - 1 8,Nf5,-17,-1,16,1
rnbq1rk1/pp2ppbp/6p1/3p1n2/3P4/1B2BN1P/PPP2PP1/RN1QK2R w KQ - 2 9,Qd2,13,-35,-48,1
rnbq1rk1/pp2ppbp/6p1/3p1n2/3P4/1B2BN1P/PPPQ1PP1/RN2K2R b KQ - 3 9,Nc6,-41,-34,7,1
r1bq1rk1/pp2ppbp/2n3p1/3p1n2/3P4/1B2BN1P/PPPQ1PP1/RN2K2R w KQ - 4 10,Nc3,-24,-66,-42,1
r1bq1rk1/pp2ppbp/2n3p1/3p1n2/3P4/1BN1BN1P/PPPQ1PP1/R3K2R b KQ - 5 10,Be6,-68,8,76,1
r2q1rk1/pp2ppbp/2n1b1p1/3p1n2/3P4/1BN1BN1P/PPPQ1PP1/R3K2R w KQ - 6 11,O-O-O,-3,-47,-44,1
r2q1rk1/pp2ppbp/2n1b1p1/3p1n2/3P4/1BN1BN1P/PPPQ1PP1/2KR3R b - - 7 11,a6,-32,82,114,1
r2q1rk1/1p2ppbp/p1n1b1p1/3p1n2/3P4/1BN1BN1P/PPPQ1PP1/2KR3R w - - 0 12,g4,32,32,0,1
r2q1rk1/1p2ppbp/p1n1b1p1/3p1n2/3P2P1/1BN1BN1P/PPPQ1P2/2KR3R b - - 0 12,Nxe3,9,30,21,1
r2q1rk1/1p2ppbp/p1n1b1p1/3p4/3P2P1/1BN1nN1P/PPPQ1P2/2KR3R w - - 0 13,Qxe3,26,16,-10,1
r2q1rk1/1p2ppbp/p1n1b1p1/3p4/3P2P1/1BN1QN1P/PPP2P2/2KR3R b - - 0 13,b5,25,25,0,1
r2q1rk1/4ppbp/p1n1b1p1/1p1p4/3P2P1/1BN1QN1P/PPP2P2/2KR3R w - - 0 14,Ng5,42,10,-32,1
r2q1rk1/4ppbp/p1n1b1p1/1p1p2N1/3P2P1/1BN1Q2P/PPP2P2/2KR3R b - - 1 14,Qb6,10,242,232,1
r4rk1/4ppbp/pqn1b1p1/1p1p2N1/3P2P1/1BN1Q2P/PPP2P2/2KR3R w - - 2 15,Nxe6,270,266,-4,1
r4rk1/4ppbp/pqn1N1p1/1p1p4/3P2P1/1BN1Q2P/PPP2P2/2KR3R b - - 0 15,fxe6,242,253,11,1
r4rk1/4p1bp/pqn1p1p1/1p1p4/3P2P1/1BN1Q2P/PPP2P2/2KR3R w - - 0 16,Qxe6+,297,264,-33,1
r4rk1/4p1bp/pqn1Q1p1/1p1p4/3P2P1/1BN4P/PPP2P2/2KR3R b - - 0 16,Rf7,264,449,185,1
r5k1/4prbp/pqn1Q1p1/1p1p4/3P2P1/1BN4P/PPP2P2/2KR3R w - - 1 17,Bxd5,507,510,3,1
r5k1/4prbp/pqn1Q1p1/1p1B4/3P2P1/2N4P/PPP2P2/2KR3R b - - 0 17,Nd8,524,819,295,1
r2n2k1/4prbp/pq2Q1p1/1p1B4/3P2P1/2N4P/PPP2P2/2KR3R w - - 1 18,Qxb6,846,807,-39,1
r2n2k1/4prbp/pQ4p1/1p1B4/3P2P1/2N4P/PPP2P2/2KR3R b - - 0 18,e6,767,859,92,1
r2n2k1/5rbp/pQ2p1p1/1p1B4/3P2P1/2N4P/PPP2P2/2KR3R w - - 0 19,Bxa8,872,825,-47,1
rnbqkbnr/pppppppp/8/8/8/8/PPPPPPPP/RNBQKBNR w KQkq - 0 1,e4,38,36,-2,1
rnbqkbnr/pppppppp/8/8/4P3/8/PPPP1PPP/RNBQKBNR b KQkq - 0 1,e6,37,46,9,1
rnbqkbnr/pppp1ppp/4p3/8/4P3/8/PPPP1PPP/RNBQKBNR w KQkq - 0 2,Nf3,55,27,-28,1
rnbqkbnr/pppp1ppp/4p3/8/4P3/5N2/PPPP1PPP/RNBQKB1R b KQkq - 1 2,d5,27,29,2,1
rnbqkbnr/ppp2ppp/4p3/3p4/4P3/5N2/PPPP1PPP/RNBQKB1R w KQkq - 0 3,Nc3,29,-17,-46,1
rnbqkbnr/ppp2ppp/4p3/3p4/4P3/2N2N2/PPPP1PPP/R1BQKB1R b KQkq - 1 3,dxe4,-10,59,69,1
rnbqkbnr/ppp2ppp/4p3/8/4p3/2N2N2/PPPP1PPP/R1BQKB1R w KQkq - 0 4,Nxe4,59,51,-8,1
rnbqkbnr/ppp2ppp/4p3/8/4N3/5N2/PPPP1PPP/R1BQKB1R b KQkq - 0 4,a6,47,70,23,1
rnbqkbnr/1pp2ppp/p3p3/8/4N3/5N2/PPPP1PPP/R1BQKB1R w KQkq - 0 5,Bc4,81,-4,-85,1
rnbqkbnr/1pp2ppp/p3p3/8/2B1N3/5N2/PPPP1PPP/R1BQK2R b KQkq - 1 5,f5,-6,298,304,1
rnbqkbnr/1pp3pp/p3p3/5p2/2B1N3/5N2/PPPP1PPP/R1BQK2R w KQkq - 0 6,Nc3,342,149,-193,0
rnbqkbnr/1pp3pp/p3p3/5p2/2B5/2N2N2/PPPP1PPP/R1BQK2R b KQkq - 1 6,Nf6,151,163,12,1
rnbqkb1r/1pp3pp/p3pn2/5p2/2B5/2N2N2/PPPP1PPP/R1BQK2R w KQkq - 2 7,O-O,144,117,-27,1
rnbqkb1r/1pp3pp/p3pn2/5p2/2B5/2N2N2/PPPP1PPP/R1BQ1RK1 b kq - 3 7,Bb4,127,168,41,1
rnbqk2r/1pp3pp/p3pn2/5p2/1bB5/2N2N2/PPPP1PPP/R1BQ1RK1 w kq - 4 8,d4,189,156,-33,1
rnbqk2r/1pp3pp/p3pn2/5p2/1bBP4/2N2N2/PPP2PPP/R1BQ1RK1 b kq - 0 8,Bxc3,157,177,20,1
rnbqk2r/1pp3pp/p3pn2/5p2/2BP4/2b2N2/PPP2PPP/R1BQ1RK1 w kq - 0 9,bxc3,178,190,12,1
rnbqk2r/1pp3pp/p3pn2/5p2/2BP4/2P2N2/P1P2PPP/R1BQ1RK1 b kq - 0 9,Ne4,183,179,-4,1
rnbqk2r/1pp3pp/p3p3/5p2/2BPn3/2P2N2/P1P2PPP/R1BQ1RK1 w kq - 1 10,Qd3,180,124,-56,1
rnbqk2r/1pp3pp/p3p3/5p2/2BPn3/2PQ1N2/P1P2PPP/R1B2RK1 b kq - 2 10,Nd7,79,368,289,1
r1bqk2r/1ppn2pp/p3p3/5p2/2BPn3/2PQ1N2/P1P2PPP/R1B2RK1 w kq - 3 11,Bxe6,251,178,-73,1
r1bqk2r/1ppn2pp/p3B3/5p2/3Pn3/2PQ1N2/P1P2PPP/R1B2RK1 b kq - 0 11,Ndc5,177,171,-6,1
r1bqk2r/1pp3pp/p3B3/2n2p2/3Pn3/2PQ1N2/P1P2PPP/R1B2RK1 w kq - 1 12,dxc5,194,145,-49,1
r1bqk2r/1pp3pp/p3B3/2P2p2/4n3/2PQ1N2/P1P2PPP/R1B2RK1 b kq - 0 12,Bxe6,179,191,12,1
r2qk2r/1pp3pp/p3b3/2P2p2/4n3/2PQ1N2/P1P2PPP/R1B2RK1 w kq - 0 13,Qxd8+,189,61,-128,0
r2Qk2r/1pp3pp/p3b3/2P2p2/4n3/2P2N2/P1P2PPP/R1B2RK1 b kq - 0 13,Rxd8,58,52,-6,1
3rk2r/1pp3pp/p3b3/2P2p2/4n3/2P2N2/P1P2PPP/R1B2RK1 w k - 0 14,Bb2,45,16,-29,1
3rk2r/1pp3pp/p3b3/2P2p2/4n3/2P2N2/PBP2PPP/R4RK1 b k - 1 14,Nxc5,23,33,10,1
3rk2r/1pp3pp/p3b3/2n2p2/8/2P2N2/PBP2PPP/R4RK1 w k - 0 15,Rfe1,31,50,19,1
3rk2r/1pp3pp/p3b3/2n2p2/8/2P2N2/PBP2PPP/R3R1K1 b k - 1 15,O-O,45,262,217,1
3r1rk1/1pp3pp/p3b3/2n2p2/8/2P2N2/PBP2PPP/R3R1K1 w - - 2 16,Nd4,272,33,-239,0
3r1rk1/1pp3pp/p3b3/2n2p2/3N4/2P5/PBP2PPP/R3R1K1 b - - 3 16,Rfe8,29,341,312,1
3rr1k1/1pp3pp/p3b3/2n2p2/3N4/2P5/PBP2PPP/R3R1K1 w - - 4 17,Ba3,302,324,22,1
3rr1k1/1pp3pp/p3b3/2n2p2/3N4/B1P5/P1P2PPP/R3R1K1 b - - 5 17,Ne4,335,318,-17,1
3rr1k1/1pp3pp/p3b3/5p2/3Nn3/B1P5/P1P2PPP/R3R1K1 w - - 6 18,f3,340,313,-27,1
3rr1k1/1pp3pp/p3b3/5p2/3Nn3/B1P2P2/P1P3PP/R3R1K1 b - - 0 18,Nxc3,341,319,-22,1
3rr1k1/1pp3pp/p3b3/5p2/3N4/B1n2P2/P1P3PP/R3R1K1 w - - 0 19,Nxe6,314,313,-1,1
3rr1k1/1pp3pp/p3N3/5p2/8/B1n2P2/P1P3PP/R3R1K1 b - - 0 19,Rd2,329,332,3,1
4r1k1/1pp3pp/p3N3/5p2/8/B1n2P2/P1Pr2PP/R3R1K1 w - - 1 20,Nxc7,317,335,18,1
4r1k1/1pN3pp/p7/5p2/8/B1n2P2/P1Pr2PP/R3R1K1 b - - 0 20,Rxe1+,358,346,-12,1
6k1/1pN3pp/p7/5p2/8/B1n2P2/P1Pr2PP/R3r1K1 w - - 0 21,Rxe1,366,359,-7,1
6k1/1pN3pp/p7/5p2/8/B1n2P2/P1Pr2PP/4R1K1 b - - 0 21,Ne2+,380,399,19,1
6k1/1pN3pp/p7/5p2/8/B4P2/P1Prn1PP/4R1K1 w - - 1 22,Kf1,413,424,11,1
6k1/1pN3pp/p7/5p2/8/B4P2/P1Prn1PP/4RK2 b - - 2 22,Nd4,416,395,-21,1
6k1/1pN3pp/p7/5p2/3n4/B4P2/P1Pr2PP/4RK2 w - - 3 23,Re8+,402,408,6,1
4R1k1/1pN3pp/p7/5p2/3n4/B4P2/P1Pr2PP/5K2 b - - 4 23,Kf7,386,386,0,1
4R3/1pN2kpp/p7/5p2/3n4/B4P2/P1Pr2PP/5K2 w - - 5 24,Re7+,441,396,-45,1
8/1pN1Rkpp/p7/5p2/3n4/B4P2/P1Pr2PP/5K2 b - - 6 24,Kf6,403,575,172,1
8/1pN1R1pp/p4k2/5p2/3n4/B4P2/P1Pr2PP/5K2 w - - 7 25,Ne8+,661,696,35,1
4N3/1p2R1pp/p4k2/5p2/3n4/B4P2/P1Pr2PP/5K2 b - - 8 25,Kg6,687,654,-33,1
4N3/1p2R1pp/p5k1/5p2/3n4/B4P2/P1Pr2PP/5K2 w - - 9 26,Rxg7+,749,691,-58,1
4N3/1p4Rp/p5k1/5p2/3n4/B4P2/P1Pr2PP/5K2 b - - 0 26,Kh6,749,849,100,1
4N3/1p4Rp/p6k/5p2/3n4/B4P2/P1Pr2PP/5K2 w - - 1 27,Rxb7,939,402,-537,0
4N3/1R5p/p6k/5p2/3n4/B4P2/P1Pr2PP/5K2 b - - 0 27,Nxc2,403,444,41,1
4N3/1R5p/p6k/5p2/8/B4P2/P1nr2PP/5K2 w - - 0 28,Bc1,461,429,-32,1
4N3/1R5p/p6k/5p2/8/5P2/P1nr2PP/2B2K2 b - - 1 28,Ne3+,451,475,24,1
4N3/1R5p/p6k/5p2/8/4nP2/P2r2PP/2B2K2 w - - 2 29,Ke1,453,457,4,1
4N3/1R5p/p6k/5p2/8/4nP2/P2r2PP/2B1K3 b - - 3 29,Rxg2,458,761,303,1
4N3/1R5p/p6k/5p2/8/4nP2/P5rP/2B1K3 w - - 0 30,Bxe3+,748,746,-2,1
4N3/1R5p/p6k/5p2/8/4BP2/P5rP/4K3 b - - 0 30,Kh5,752,9996,9244,1
4N3/1R5p/p7/5p1k/8/4BP2/P5rP/4K3 w - - 1 31,Rxh7+,9996,9997,1,1
4N3/7R/p7/5p1k/8/4BP2/P5rP/4K3 b - - 0 31,Kg6,9997,9997,0,1
4N3/7R/p5k1/5p2/8/4BP2/P5rP/4K3 w - - 1 32,Rg7+,9997,9998,1,1
4N3/6R1/p5k1/5p2/8/4BP2/P5rP/4K3 b - - 2 32,Kh5,9998,9998,0,1
4N3/6R1/p7/5p1k/8/4BP2/P5rP/4K3 w - - 3 33,Rxg2,9998,912,-9086,0
rnbqkbnr/pppppppp/8/8/8/8/PPPPPPPP/RNBQKBNR w KQkq - 0 1,e4,44,39,-5,1
rnbqkbnr/pppppppp/8/8/4P3/8/PPPP1PPP/RNBQKBNR b KQkq - 0 1,e5,44,50,6,1
rnbqkbnr/pppp1ppp/8/4p3/4P3/8/PPPP1PPP/RNBQKBNR w KQkq - 0 2,Nf3,37,31,-6,1
rnbqkbnr/pppp1ppp/8/4p3/4P3/5N2/PPPP1PPP/RNBQKB1R b KQkq - 1 2,Nc6,32,40,8,1
r1bqkbnr/pppp1ppp/2n5/4p3/4P3/5N2/PPPP1PPP/RNBQKB1R w KQkq - 2 3,Nc3,34,16,-18,1
r1bqkbnr/pppp1ppp/2n5/4p3/4P3/2N2N2/PPPP1PPP/R1BQKB1R b KQkq - 3 3,Bb4,15,57,42,1
r1bqk1nr/pppp1ppp/2n5/4p3/1b2P3/2N2N2/PPPP1PPP/R1BQKB1R w KQkq - 4 4,b3,75,-50,-125,0
r1bqk1nr/pppp1ppp/2n5/4p3/1b2P3/1PN2N2/P1PP1PPP/R1BQKB1R b KQkq - 0 4,Nf6,-53,-39,14,1
r1bqk2r/pppp1ppp/2n2n2/4p3/1b2P3/1PN2N2/P1PP1PPP/R1BQKB1R w KQkq - 1 5,Bb2,-31,-74,-43,1
r1bqk2r/pppp1ppp/2n2n2/4p3/1b2P3/1PN2N2/PBPP1PPP/R2QKB1R b KQkq - 2 5,O-O,-45,-36,9,1
r1bq1rk1/pppp1ppp/2n2n2/4p3/1b2P3/1PN2N2/PBPP1PPP/R2QKB1R w KQ - 3 6,d3,-38,-145,-107,0
r1bq1rk1/pppp1ppp/2n2n2/4p3/1b2P3/1PNP1N2/PBP2PPP/R2QKB1R b KQ - 0 6,d6,-111,-30,81,1
r1bq1rk1/ppp2ppp/2np1n2/4p3/1b2P3/1PNP1N2/PBP2PPP/R2QKB1R w KQ - 0 7,Be2,-35,-45,-10,1
r1bq1rk1/ppp2ppp/2np1n2/4p3/1b2P3/1PNP1N2/PBP1BPPP/R2QK2R b KQ - 1 7,Bg4,-39,-5,34,1
r2q1rk1/ppp2ppp/2np1n2/4p3/1b2P1b1/1PNP1N2/PBP1BPPP/R2QK2R w KQ - 2 8,O-O,-5,-11,-6,1
r2q1rk1/ppp2ppp/2np1n2/4p3/1b2P1b1/1PNP1N2/PBP1BPPP/R2Q1RK1 b - - 3 8,Bh5,-11,18,29,1
r2q1rk1/ppp2ppp/2np1n2/4p2b/1b2P3/1PNP1N2/PBP1BPPP/R2Q1RK1 w - - 4 9,h3,20,5,-15,1
r2q1rk1/ppp2ppp/2np1n2/4p2b/1b2P3/1PNP1N1P/PBP1BPP1/R2Q1RK1 b - - 0 9,d5,8,60,52,1
r2q1rk1/ppp2ppp/2n2n2/3pp2b/1b2P3/1PNP1N1P/PBP1BPP1/R2Q1RK1 w - - 0 10,exd5,83,-82,-165,0
r2q1rk1/ppp2ppp/2n2n2/3Pp2b/1b6/1PNP1N1P/PBP1BPP1/R2Q1RK1 b - - 0 10,Bxf3,-47,36,83,1
r2q1rk1/ppp2ppp/2n2n2/3Pp3/1b6/1PNP1b1P/PBP1BPP1/R2Q1RK1 w - - 0 11,Bxf3,39,31,-8,1
r2q1rk1/ppp2ppp/2n2n2/3Pp3/1b6/1PNP1B1P/PBP2PP1/R2Q1RK1 b - - 0 11,Bxc3,47,56,9,1
r2q1rk1/ppp2ppp/2n2n2/3Pp3/8/1PbP1B1P/PBP2PP1/R2Q1RK1 w - - 0 12,Bxc3,62,34,-28,1
r2q1rk1/ppp2ppp/2n2n2/3Pp3/8/1PBP1B1P/P1P2PP1/R2Q1RK1 b - - 0 12,Nxd5,44,37,-7,1
r2q1rk1/ppp2ppp/2n5/3np3/8/1PBP1B1P/P1P2PP1/R2Q1RK1 w - - 0 13,Bxd5,67,8,-59,1
r2q1rk1/ppp2ppp/2n5/3Bp3/8/1PBP3P/P1P2PP1/R2Q1RK1 b - - 0 13,Qxd5,-4,9,13,1
r4rk1/ppp2ppp/2n5/3qp3/8/1PBP3P/P1P2PP1/R2Q1RK1 w - - 0 14,Re1,26,21,-5,1
r4rk1/ppp2ppp/2n5/3qp3/8/1PBP3P/P1P2PP1/R2QR1K1 b - - 1 14,Nd4,-4,41,45,1
r4rk1/ppp2ppp/8/3qp3/3n4/1PBP3P/P1P2PP1/R2QR1K1 w - - 2 15,Bxd4,28,29,1,1
r4rk1/ppp2ppp/8/3qp3/3B4/1P1P3P/P1P2PP1/R2QR1K1 b - - 0 15,exd4,26,61,35,1
r4rk1/ppp2ppp/8/3q4/3p4/1P1P3P/P1P2PP1/R2QR1K1 w - - 0 16,Qg4,56,9,-47,1
r4rk1/ppp2ppp/8/3q4/3p2Q1/1P1P3P/P1P2PP1/R3R1K1 b - - 1 16,Rfe8,-8,19,27,1
r3r1k1/ppp2ppp/8/3q4/3p2Q1/1P1P3P/P1P2PP1/R3R1K1 w - - 2 17,Rxe8+,20,-42,-62,1
r3R1k1/ppp2ppp/8/3q4/3p2Q1/1P1P3P/P1P2PP1/R5K1 b - - 0 17,Rxe8,-32,-39,-7,1
4r1k1/ppp2ppp/8/3q4/3p2Q1/1P1P3P/P1P2PP1/R5K1 w - - 0 18,a4,-36,-550,-514,0
4r1k1/ppp2ppp/8/3q4/P2p2Q1/1P1P3P/2P2PP1/R5K1 b - - 0 18,Kf8,-38,-16,22,1
4rk2/ppp2ppp/8/3q4/P2p2Q1/1P1P3P/2P2PP1/R5K1 w - - 1 19,b4,-7,-103,-96,1
4rk2/ppp2ppp/8/3q4/PP1p2Q1/3P3P/2P2PP1/R5K1 b - - 0 19,c5,-24,-11,13,1
4rk2/pp3ppp/8/2pq4/PP1p2Q1/3P3P/2P2PP1/R5K1 w - - 0 20,bxc5,-14,-10,4,1
4rk2/pp3ppp/8/2Pq4/P2p2Q1/3P3P/2P2PP1/R5K1 b - - 0 20,Qxc5,-3,-1,2,1
4rk2/pp3ppp/8/2q5/P2p2Q1/3P3P/2P2PP1/R5K1 w - - 0 21,Rb1,3,-33,-36,1
4rk2/pp3ppp/8/2q5/P2p2Q1/3P3P/2P2PP1/1R4K1 b - - 1 21,b6,-27,-14,13,1
4rk2/p4ppp/1p6/2q5/P2p2Q1/3P3P/2P2PP1/1R4K1 w - - 0 22,Rb5,-17,-20,-3,1
4rk2/p4ppp/1p6/1Rq5/P2p2Q1/3P3P/2P2PP1/6K1 b - - 1 22,Qxc2,-21,18,39,1
4rk2/p4ppp/1p6/1R6/P2p2Q1/3P3P/2q2PP1/6K1 w - - 0 23,Qxd4,0,0,0,1
4rk2/p4ppp/1p6/1R6/P2Q4/3P3P/2q2PP1/6K1 b - - 0 23,Qd1+,0,22,22,1
4rk2/p4ppp/1p6/1R6/P2Q4/3P3P/5PP1/3q2K1 w - - 1 24,Kh2,33,28,-5,1
4rk2/p4ppp/1p6/1R6/P2Q4/3P3P/5PPK/3q4 b - - 2 24,Qe2,24,27,3,1
4rk2/p4ppp/1p6/1R6/P2Q4/3P3P/4qPPK/8 w - - 3 25,Rd5,27,27,0,1
4rk2/p4ppp/1p6/3R4/P2Q4/3P3P/4qPPK/8 b - - 4 25,Qe6,21,29,8,1
4rk2/p4ppp/1p2q3/3R4/P2Q4/3P3P/5PPK/8 w - - 5 26,Rd7,29,23,-6,1
4rk2/p2R1ppp/1p2q3/8/P2Q4/3P3P/5PPK/8 b - - 6 26,Qc6,23,126,103,1
4rk2/p2R1ppp/1pq5/8/P2Q4/3P3P/5PPK/8 w - - 7 27,Rxa7,137,145,8,1
4rk2/R4ppp/1pq5/8/P2Q4/3P3P/5PPK/8 b - - 0 27,b5,145,351,206,1
4rk2/R4ppp/2q5/1p6/P2Q4/3P3P/5PPK/8 w - - 0 28,axb5,380,80,-300,0
4rk2/R4ppp/2q5/1P6/3Q4/3P3P/5PPK/8 b - - 0 28,Qxb5,88,85,-3,1
rnbqkbnr/pppppppp/8/8/8/8/PPPPPPPP/RNBQKBNR w KQkq - 0 1,f4,44,-26,-70,1
rnbqkbnr/pppppppp/8/8/5P2/8/PPPPP1PP/RNBQKBNR b KQkq - 0 1,d5,-13,-24,-11,1
rnbqkbnr/ppp1pppp/8/3p4/5P2/8/PPPPP1PP/RNBQKBNR w KQkq - 0 2,Nf3,-16,-16,0,1
rnbqkbnr/ppp1pppp/8/3p4/5P2/5N2/PPPPP1PP/RNBQKB1R b KQkq - 1 2,e6,-26,-19,7,1
rnbqkbnr/ppp2ppp/4p3/3p4/5P2/5N2/PPPPP1PP/RNBQKB1R w KQkq - 0 3,e3,-18,-55,-37,1
rnbqkbnr/ppp2ppp/4p3/3p4/5P2/4PN2/PPPP2PP/RNBQKB1R b KQkq - 0 3,Be7,-16,-12,4,1
rnbqk1nr/ppp1bppp/4p3/3p4/5P2/4PN2/PPPP2PP/RNBQKB1R w KQkq - 1 4,Be2,-16,-35,-19,1
rnbqk1nr/ppp1bppp/4p3/3p4/5P2/4PN2/PPPPB1PP/RNBQK2R b KQkq - 2 4,Bh4+,-29,54,83,1
rnbqk1nr/ppp2ppp/4p3/3p4/5P1b/4PN2/PPPPB1PP/RNBQK2R w KQkq - 3 5,g3,60,-16,-76,1
rnbqk1nr/ppp2ppp/4p3/3p4/5P1b/4PNP1/PPPPB2P/RNBQK2R b KQkq - 0 5,Bf6,-13,17,30,1
rnbqk1nr/ppp2ppp/4pb2/3p4/5P2/4PNP1/PPPPB2P/RNBQK2R w KQkq - 1 6,d4,22,21,-1,1
rnbqk1nr/ppp2ppp/4pb2/3p4/3P1P2/4PNP1/PPP1B2P/RNBQK2R b KQkq - 0 6,c5,17,20,3,1
rnbqk1nr/pp3ppp/4pb2/2pp4/3P1P2/4PNP1/PPP1B2P/RNBQK2R w KQkq - 0 7,c3,18,9,-9,1
rnbqk1nr/pp3ppp/4pb2/2pp4/3P1P2/2P1PNP1/PP2B2P/RNBQK2R b KQkq - 0 7,cxd4,0,41,41,1
rnbqk1nr/pp3ppp/4pb2/3p4/3p1P2/2P1PNP1/PP2B2P/RNBQK2R w KQkq - 0 8,cxd4,31,15,-16,1
rnbqk1nr/pp3ppp/4pb2/3p4/3P1P2/4PNP1/PP2B2P/RNBQK2R b KQkq - 0 8,Nc6,31,38,7,1
r1bqk1nr/pp3ppp/2n1pb2/3p4/3P1P2/4PNP1/PP2B2P/RNBQK2R w KQkq - 1 9,Bd2,34,29,-5,1
r1bqk1nr/pp3ppp/2n1pb2/3p4/3P1P2/4PNP1/PP1BB2P/RN1QK2R b KQkq - 2 9,Nge7,38,71,33,1
r1bqk2r/pp2nppp/2n1pb2/3p4/3P1P2/4PNP1/PP1BB2P/RN1QK2R w KQkq - 3 10,Nc3,25,36,11,1
r1bqk2r/pp2nppp/2n1pb2/3p4/3P1P2/2N1PNP1/PP1BB2P/R2QK2R b KQkq - 4 10,a6,33,57,24,1
r1bqk2r/1p2nppp/p1n1pb2/3p4/3P1P2/2N1PNP1/PP1BB2P/R2QK2R w KQkq - 0 11,Ne5,53,54,1,1
r1bqk2r/1p2nppp/p1n1pb2/3pN3/3P1P2/2N1P1P1/PP1BB2P/R2QK2R b KQkq - 1 11,Ng6,44,147,103,1
r1bqk2r/1p3ppp/p1n1pbn1/3pN3/3P1P2/2N1P1P1/PP1BB2P/R2QK2R w KQkq - 2 12,O-O,149,109,-40,1
r1bqk2r/1p3ppp/p1n1pbn1/3pN3/3P1P2/2N1P1P1/PP1BB2P/R2Q1RK1 b kq - 3 12,Nce7,108,125,17,1
r1bqk2r/1p2nppp/p3pbn1/3pN3/3P1P2/2N1P1P1/PP1BB2P/R2Q1RK1 w kq - 4 13,f5,122,-208,-330,0
r1bqk2r/1p2nppp/p3pbn1/3pNP2/3P4/2N1P1P1/PP1BB2P/R2Q1RK1 b kq - 0 13,exf5,-195,-49,146,1
r1bqk2r/1p2nppp/p4bn1/3pNp2/3P4/2N1P1P1/PP1BB2P/R2Q1RK1 w kq - 0 14,Nxg6,-50,-113,-63,1
r1bqk2r/1p2nppp/p4bN1/3p1p2/3P4/2N1P1P1/PP1BB2P/R2Q1RK1 b kq - 0 14,hxg6,-109,-102,7,1
r1bqk2r/1p2npp1/p4bp1/3p1p2/3P4/2N1P1P1/PP1BB2P/R2Q1RK1 w kq - 0 15,Bf3,-114,-138,-24,1
r1bqk2r/1p2npp1/p4bp1/3p1p2/3P4/2N1PBP1/PP1B3P/R2Q1RK1 b kq - 1 15,Be6,-154,-155,-1,1
r2qk2r/1p2npp1/p3bbp1/3p1p2/3P4/2N1PBP1/PP1B3P/R2Q1RK1 w kq - 2 16,Qb3,-159,-159,0,1
r2qk2r/1p2npp1/p3bbp1/3p1p2/3P4/1QN1PBP1/PP1B3P/R4RK1 b kq - 3 16,Rb8,-156,-152,4,1
1r1qk2r/1p2npp1/p3bbp1/3p1p2/3P4/1QN1PBP1/PP1B3P/R4RK1 w k - 4 17,Na4,-143,-154,-11,1
1r1qk2r/1p2npp1/p3bbp1/3p1p2/N2P4/1Q2PBP1/PP1B3P/R4RK1 b k - 5 17,g5,-165,-116,49,1
1r1qk2r/1p2npp1/p3bb2/3p1pp1/N2P4/1Q2PBP1/PP1B3P/R4RK1 w k - 0 18,Bb4,-102,-143,-41,1
1r1qk2r/1p2npp1/p3bb2/3p1pp1/NB1P4/1Q2PBP1/PP5P/R4RK1 b k - 1 18,b5,-162,-92,70,1
1r1qk2r/4npp1/p3bb2/1p1p1pp1/NB1P4/1Q2PBP1/PP5P/R4RK1 w k - 0 19,Bxe7,-106,-143,-37,1
1r1qk2r/4Bpp1/p3bb2/1p1p1pp1/N2P4/1Q2PBP1/PP5P/R4RK1 b k - 0 19,Bxe7,-154,-164,-10,1
1r1qk2r/4bpp1/p3b3/1p1p1pp1/N2P4/1Q2PBP1/PP5P/R4RK1 w k - 0 20,Nc3,-168,-206,-38,1
1r1qk2r/4bpp1/p3b3/1p1p1pp1/3P4/1QN1PBP1/PP5P/R4RK1 b k - 1 20,f4,-214,-109,105,1
1r1qk2r/4bpp1/p3b3/1p1p2p1/3P1p2/1QN1PBP1/PP5P/R4RK1 w k - 0 21,exf4,-100,-137,-37,1
1r1qk2r/4bpp1/p3b3/1p1p2p1/3P1P2/1QN2BP1/PP5P/R4RK1 b k - 0 21,gxf4,-120,-73,47,1
1r1qk2r/4bpp1/p3b3/1p1p4/3P1p2/1QN2BP1/PP5P/R4RK1 w k - 0 22,gxf4,-66,-196,-130,0
1r1qk2r/4bpp1/p3b3/1p1p4/3P1P2/1QN2B2/PP5P/R4RK1 b k - 0 22,Bh3,-181,-106,75,1
1r1qk2r/4bpp1/p7/1p1p4/3P1P2/1QN2B1b/PP5P/R4RK1 w k - 1 23,Rfe1,-83,-126,-43,1
1r1qk2r/4bpp1/p7/1p1p4/3P1P2/1QN2B1b/PP5P/R3R1K1 b k - 2 23,O-O,-129,-23,106,1
1r1q1rk1/4bpp1/p7/1p1p4/3P1P2/1QN2B1b/PP5P/R3R1K1 w - - 3 24,Bxd5,-32,-86,-54,1
1r1q1rk1/4bpp1/p7/1p1B4/3P1P2/1QN4b/PP5P/R3R1K1 b - - 0 24,Qb6,-100,289,389,1
1r3rk1/4bpp1/pq6/1p1B4/3P1P2/1QN4b/PP5P/R3R1K1 w - - 1 25,Rxe7,295,332,37,1
1r3rk1/4Rpp1/pq6/1p1B4/3P1P2/1QN4b/PP5P/R5K1 b - - 0 25,Qxd4+,307,312,5,1
1r3rk1/4Rpp1/p7/1p1B4/3q1P2/1QN4b/PP5P/R5K1 w - - 0 26,Kh1,332,328,-4,1
1r3rk1/4Rpp1/p7/1p1B4/3q1P2/1QN4b/PP5P/R6K b - - 1 26,Qxf4,330,400,70,1
1r3rk1/4Rpp1/p7/1p1B4/5q2/1QN4b/PP5P/R6K w - - 0 27,Rae1,397,286,-111,0
1r3rk1/4Rpp1/p7/1p1B4/5q2/1QN4b/PP5P/4R2K b - - 1 27,Rbd8,309,309,0,1
3r1rk1/4Rpp1/p7/1p1B4/5q2/1QN4b/PP5P/4R2K w - - 2 28,R7e4,315,-9998,-10313,0
3r1rk1/5pp1/p7/1p1B4/4Rq2/1QN4b/PP5P/4R2K b - - 3 28,Qf3+,-9998,-9999,-1,1
3r1rk1/5pp1/p7/1p1B4/4R3/1QN2q1b/PP5P/4R2K w - - 4 29,Kg1,-9999,-9999,0,1
3r1rk1/5pp1/p7/1p1B4/4R3/1QN2q1b/PP5P/4R1K1 b - - 5 29,Qg2#,-9999,-10000,-1,1
rnbqkbnr/pppppppp/8/8/8/8/PPPPPPPP/RNBQKBNR w KQkq - 0 1,d4,46,30,-16,1
rnbqkbnr/pppppppp/8/8/3P4/8/PPP1PPPP/RNBQKBNR b KQkq - 0 1,d5,24,23,-1,1
rnbqkbnr/ppp1pppp/8/3p4/3P4/8/PPP1PPPP/RNBQKBNR w KQkq - 0 2,Bg5,25,-23,-48,1
rnbqkbnr/ppp1pppp/8/3p2B1/3P4/8/PPP1PPPP/RN1QKBNR b KQkq - 1 2,c5,-28,-20,8,1
rnbqkbnr/pp2pppp/8/2pp2B1/3P4/8/PPP1PPPP/RN1QKBNR w KQkq - 0 3,e3,-10,-12,-2,1
rnbqkbnr/pp2pppp/8/2pp2B1/3P4/4P3/PPP2PPP/RN1QKBNR b KQkq - 0 3,cxd4,-12,-7,5,1
rnbqkbnr/pp2pppp/8/3p2B1/3p4/4P3/PPP2PPP/RN1QKBNR w KQkq - 0 4,exd4,-4,-8,-4,1
rnbqkbnr/pp2pppp/8/3p2B1/3P4/8/PPP2PPP/RN1QKBNR b KQkq - 0 4,Nc6,-9,-15,-6,1
r1bqkbnr/pp2pppp/2n5/3p2B1/3P4/8/PPP2PPP/RN1QKBNR w KQkq - 1 5,c3,-7,-35,-28,1
r1bqkbnr/pp2pppp/2n5/3p2B1/3P4/2P5/PP3PPP/RN1QKBNR b KQkq - 0 5,Qb6,-16,-3,13,1
r1b1kbnr/pp2pppp/1qn5/3p2B1/3P4/2P5/PP3PPP/RN1QKBNR w KQkq - 1 6,Qc1,-18,-56,-38,1
r1b1kbnr/pp2pppp/1qn5/3p2B1/3P4/2P5/PP3PPP/RNQ1KBNR b KQkq - 2 6,Bf5,-81,-52,29,1
r3kbnr/pp2pppp/1qn5/3p1bB1/3P4/2P5/PP3PPP/RNQ1KBNR w KQkq - 3 7,Nf3,-47,-50,-3,1
r3kbnr/pp2pppp/1qn5/3p1bB1/3P4/2P2N2/PP3PPP/RNQ1KB1R b KQkq - 4 7,f6,-52,-1,51,1
r3kbnr/pp2p1pp/1qn2p2/3p1bB1/3P4/2P2N2/PP3PPP/RNQ1KB1R w KQkq - 0 8,Be3,-7,-8,-1,1
r3kbnr/pp2p1pp/1qn2p2/3p1b2/3P4/2P1BN2/PP3PPP/RNQ1KB1R b KQkq - 1 8,g5,-6,-1,5,1
r3kbnr/pp2p2p/1qn2p2/3p1bp1/3P4/2P1BN2/PP3PPP/RNQ1KB1R w KQkq - 0 9,Be2,-3,-16,-13,1
r3kbnr/pp2p2p/1qn2p2/3p1bp1/3P4/2P1BN2/PP2BPPP/RNQ1K2R b KQkq - 1 9,h5,-22,47,69,1
r3kbnr/pp2p3/1qn2p2/3p1bpp/3P4/2P1BN2/PP2BPPP/RNQ1K2R w KQkq - 0 10,Qd2,20,-28,-48,1
r3kbnr/pp2p3/1qn2p2/3p1bpp/3P4/2P1BN2/PP1QBPPP/RN2K2R b KQkq - 1 10,h4,-21,-10,11,1
r3kbnr/pp2p3/1qn2p2/3p1bp1/3P3p/2P1BN2/PP1QBPPP/RN2K2R w KQkq - 0 11,Bd3,4,-95,-99,1
r3kbnr/pp2p3/1qn2p2/3p1bp1/3P3p/2PBBN2/PP1Q1PPP/RN2K2R b KQkq - 1 11,Be4,-90,107,197,1
r3kbnr/pp2p3/1qn2p2/3p2p1/3Pb2p/2PBBN2/PP1Q1PPP/RN2K2R w KQkq - 2 12,Bxe4,99,80,-19,1
r3kbnr/pp2p3/1qn2p2/3p2p1/3PB2p/2P1BN2/PP1Q1PPP/RN2K2R b KQkq - 0 12,dxe4,94,87,-7,1
r3kbnr/pp2p3/1qn2p2/6p1/3Pp2p/2P1BN2/PP1Q1PPP/RN2K2R w KQkq - 0 13,Ng1,90,-77,-167,0
r3kbnr/pp2p3/1qn2p2/6p1/3Pp2p/2P1B3/PP1Q1PPP/RN2K1NR b KQkq - 1 13,O-O-O,-68,10,78,1
2kr1bnr/pp2p3/1qn2p2/6p1/3Pp2p/2P1B3/PP1Q1PPP/RN2K1NR w KQ - 2 14,Qe2,-32,-61,-29,1
2kr1bnr/pp2p3/1qn2p2/6p1/3Pp2p/2P1B3/PP2QPPP/RN2K1NR b KQ - 3 14,Qa5,-77,-58,19,1
2kr1bnr/pp2p3/2n2p2/q5p1/3Pp2p/2P1B3/PP2QPPP/RN2K1NR w KQ - 4 15,Nd2,-32,-29,3,1
2kr1bnr/pp2p3/2n2p2/q5p1/3Pp2p/2P1B3/PP1NQPPP/R3K1NR b KQ - 5 15,e5,-20,7,27,1
2kr1bnr/pp6/2n2p2/q3p1p1/3Pp2p/2P1B3/PP1NQPPP/R3K1NR w KQ - 0 16,Nxe4,5,-347,-352,0
2kr1bnr/pp6/2n2p2/q3p1p1/3PN2p/2P1B3/PP2QPPP/R3K1NR b KQ - 0 16,exd4,-347,-315,32,1
2kr1bnr/pp6/2n2p2/q5p1/3pN2p/2P1B3/PP2QPPP/R3K1NR w KQ - 0 17,Bxd4,-324,-387,-63,1
2kr1bnr/pp6/2n2p2/q5p1/3BN2p/2P5/PP2QPPP/R3K1NR b KQ - 0 17,Nxd4,-400,-410,-10,1
2kr1bnr/pp6/5p2/q5p1/3nN2p/2P5/PP2QPPP/R3K1NR w KQ - 0 18,Qc4+,-424,-401,23,1
2kr1bnr/pp6/5p2/q5p1/2QnN2p/2P5/PP3PPP/R3K1NR b KQ - 1 18,Nc6,-401,-384,17,1
2kr1bnr/pp6/2n2p2/q5p1/2Q1N2p/2P5/PP3PPP/R3K1NR w KQ - 2 19,Qe6+,-384,-401,-17,1
2kr1bnr/pp6/2n1Qp2/q5p1/4N2p/2P5/PP3PPP/R3K1NR b KQ - 3 19,Kb8,-423,-436,-13,1
1k1r1bnr/pp6/2n1Qp2/q5p1/4N2p/2P5/PP3PPP/R3K1NR w KQ - 4 20,Nf3,-424,-434,-10,1
1k1r1bnr/pp6/2n1Qp2/q5p1/4N2p/2P2N2/PP3PPP/R3K2R b KQ - 5 20,Qb5,-415,-417,-2,1
1k1r1bnr/pp6/2n1Qp2/1q4p1/4N2p/2P2N2/PP3PPP/R3K2R w KQ - 6 21,Nxf6,-438,-683,-245,0
1k1r1bnr/pp6/2n1QN2/1q4p1/7p/2P2N2/PP3PPP/R3K2R b KQ - 0 21,Nxf6,-729,-669,60,1
1k1r1b1r/pp6/2n1Qn2/1q4p1/7p/2P2N2/PP3PPP/R3K2R w KQ - 0 22,Qxf6,-688,-735,-47,1
1k1r1b1r/pp6/2n2Q2/1q4p1/7p/2P2N2/PP3PPP/R3K2R b KQ - 0 22,Be7,-838,-584,254,1
1k1r3r/pp2b3/2n2Q2/1q4p1/7p/2P2N2/PP3PPP/R3K2R w KQ - 1 23,Qe6,-621,-681,-60,1
1k1r3r/pp2b3/2n1Q3/1q4p1/7p/2P2N2/PP3PPP/R3K2R b KQ - 2 23,Rhe8,-672,-617,55,1
1k1rr3/pp2b3/2n1Q3/1q4p1/7p/2P2N2/PP3PPP/R3K2R w KQ - 3 24,Qb3,-714,-9997,-9283,0
1k1rr3/pp2b3/2n5/1q4p1/7p/1QP2N2/PP3PPP/R3K2R b KQ - 4 24,Qd3,-9997,-893,9104,1
1k1rr3/pp2b3/2n5/6p1/7p/1QPq1N2/PP3PPP/R3K2R w KQ - 5 25,Rd1,-893,-9998,-9105,0
1k1rr3/pp2b3/2n5/6p1/7p/1QPq1N2/PP3PPP/3RK2R b K - 6 25,Bc5+,-9998,-9999,-1,1
1k1rr3/pp6/2n5/2b3p1/7p/1QPq1N2/PP3PPP/3RK2R w K - 7 26,Qe6,-9999,-9999,0,1
1k1rr3/pp6/2n1Q3/2b3p1/7p/2Pq1N2/PP3PPP/3RK2R b K - 8 26,Rxe6+,-9999,-9999,0,1
1k1r4/pp6/2n1r3/2b3p1/7p/2Pq1N2/PP3PPP/3RK2R w K - 0 27,Ne5,-9999,-9999,0,1
1k1r4/pp6/2n1r3/2b1N1p1/7p/2Pq4/PP3PPP/3RK2R b K - 1 27,Rxe5#,-9999,-10000,-1,1
rnbqkbnr/pppppppp/8/8/8/8/PPPPPPPP/RNBQKBNR w KQkq - 0 1,d4,40,24,-16,1
rnbqkbnr/pppppppp/8/8/3P4/8/PPP1PPPP/RNBQKBNR b KQkq - 0 1,d5,22,27,5,1
rnbqkbnr/ppp1pppp/8/3p4/3P4/8/PPP1PPPP/RNBQKBNR w KQkq - 0 2,c4,21,22,1,1
rnbqkbnr/ppp1pppp/8/3p4/2PP4/8/PP2PPPP/RNBQKBNR b KQkq - 0 2,e6,17,20,3,1
rnbqkbnr/ppp2ppp/4p3/3p4/2PP4/8/PP2PPPP/RNBQKBNR w KQkq - 0 3,Nc3,25,26,1,1
rnbqkbnr/ppp2ppp/4p3/3p4/2PP4/2N5/PP2PPPP/R1BQKBNR b KQkq - 1 3,c6,30,29,-1,1
rnbqkbnr/pp3ppp/2p1p3/3p4/2PP4/2N5/PP2PPPP/R1BQKBNR w KQkq - 0 4,Bf4,57,-78,-135,0
rnbqkbnr/pp3ppp/2p1p3/3p4/2PP1B2/2N5/PP2PPPP/R2QKBNR b KQkq - 1 4,Bd6,-39,86,125,1
rnbqk1nr/pp3ppp/2pbp3/3p4/2PP1B2/2N5/PP2PPPP/R2QKBNR w KQkq - 2 5,Bxd6,61,55,-6,1
rnbqk1nr/pp3ppp/2pBp3/3p4/2PP4/2N5/PP2PPPP/R2QKBNR b KQkq - 0 5,Qxd6,80,74,-6,1
rnb1k1nr/pp3ppp/2pqp3/3p4/2PP4/2N5/PP2PPPP/R2QKBNR w KQkq - 0 6,Nf3,75,12,-63,1
rnb1k1nr/pp3ppp/2pqp3/3p4/2PP4/2N2N2/PP2PPPP/R2QKB1R b KQkq - 1 6,Nf6,10,37,27,1
rnb1k2r/pp3ppp/2pqpn2/3p4/2PP4/2N2N2/PP2PPPP/R2QKB1R w KQkq - 2 7,e3,35,22,-13,1
rnb1k2r/pp3ppp/2pqpn2/3p4/2PP4/2N1PN2/PP3PPP/R2QKB1R b KQkq - 0 7,Nbd7,31,26,-5,1
r1b1k2r/pp1n1ppp/2pqpn2/3p4/2PP4/2N1PN2/PP3PPP/R2QKB1R w KQkq - 1 8,Bd3,40,45,5,1
r1b1k2r/pp1n1ppp/2pqpn2/3p4/2PP4/2NBPN2/PP3PPP/R2QK2R b KQkq - 2 8,e5,43,64,21,1
r1b1k2r/pp1n1ppp/2pq1n2/3pp3/2PP4/2NBPN2/PP3PPP/R2QK2R w KQkq - 0 9,cxd5,54,41,-13,1
r1b1k2r/pp1n1ppp/2pq1n2/3Pp3/3P4/2NBPN2/PP3PPP/R2QK2R b KQkq - 0 9,Nxd5,42,49,7,1
r1b1k2r/pp1n1ppp/2pq4/3np3/3P4/2NBPN2/PP3PPP/R2QK2R w KQkq - 0 10,dxe5,49,6,-43,1
r1b1k2r/pp1n1ppp/2pq4/3nP3/8/2NBPN2/PP3PPP/R2QK2R b KQkq - 0 10,Nxe5,10,25,15,1
r1b1k2r/pp3ppp/2pq4/3nn3/8/2NBPN2/PP3PPP/R2QK2R w KQkq - 0 11,Nxe5,16,-13,-29,1
r1b1k2r/pp3ppp/2pq4/3nN3/8/2NBP3/PP3PPP/R2QK2R b KQkq - 0 11,Qxe5,-7,-15,-8,1
r1b1k2r/pp3ppp/2p5/3nq3/8/2NBP3/PP3PPP/R2QK2R w KQkq - 0 12,Qc2,-8,-46,-38,1
r1b1k2r/pp3ppp/2p5/3nq3/8/2NBP3/PPQ2PPP/R3K2R b KQkq - 1 12,Nxc3,-48,-16,32,1
r1b1k2r/pp3ppp/2p5/4q3/8/2nBP3/PPQ2PPP/R3K2R w KQkq - 0 13,Qxc3,-31,-33,-2,1
r1b1k2r/pp3ppp/2p5/4q3/8/2QBP3/PP3PPP/R3K2R b KQkq - 0 13,Qxc3+,-47,-49,-2,1
r1b1k2r/pp3ppp/2p5/8/8/2qBP3/PP3PPP/R3K2R w KQkq - 0 14,bxc3,-52,-74,-22,1
r1b1k2r/pp3ppp/2p5/8/8/2PBP3/P4PPP/R3K2R b KQkq - 0 14,O-O,-46,3,49,1
r1b2rk1/pp3ppp/2p5/8/8/2PBP3/P4PPP/R3K2R w KQ - 1 15,Rb1,10,-20,-30,1
r1b2rk1/pp3ppp/2p5/8/8/2PBP3/P4PPP/1R2K2R b K - 2 15,b5,-50,-16,34,1
r1b2rk1/p4ppp/2p5/1p6/8/2PBP3/P4PPP/1R2K2R w K - 0 16,c4,-14,-23,-9,1
r1b2rk1/p4ppp/2p5/1p6/2P5/3BP3/P4PPP/1R2K2R b K - 0 16,bxc4,-16,78,94,1
r1b2rk1/p4ppp/2p5/8/2p5/3BP3/P4PPP/1R2K2R w K - 0 17,Bxc4,40,42,2,1
r1b2rk1/p4ppp/2p5/8/2B5/4P3/P4PPP/1R2K2R b K - 0 17,Bf5,42,66,24,1
r4rk1/p4ppp/2p5/5b2/2B5/4P3/P4PPP/1R2K2R w K - 1 18,Rb7,56,53,-3,1
r4rk1/pR3ppp/2p5/5b2/2B5/4P3/P4PPP/4K2R b K - 2 18,a5,46,81,35,1
r4rk1/1R3ppp/2p5/p4b2/2B5/4P3/P4PPP/4K2R w K - 0 19,O-O,82,59,-23,1
r4rk1/1R3ppp/2p5/p4b2/2B5/4P3/P4PPP/5RK1 b - - 1 19,a4,63,89,26,1
r4rk1/1R3ppp/2p5/5b2/p1B5/4P3/P4PPP/5RK1 w - - 0 20,Rc1,87,40,-47,1
r4rk1/1R3ppp/2p5/5b2/p1B5/4P3/P4PPP/2R3K1 b - - 1 20,Be4,75,81,6,1
r4rk1/1R3ppp/2p5/8/p1B1b3/4P3/P4PPP/2R3K1 w - - 2 21,f3,80,46,-34,1
r4rk1/1R3ppp/2p5/8/p1B1b3/4PP2/P5PP/2R3K1 b - - 0 21,Bd5,40,36,-4,1
r4rk1/1R3ppp/2p5/3b4/p1B5/4PP2/P5PP/2R3K1 w - - 1 22,Bxd5,48,37,-11,1
r4rk1/1R3ppp/2p5/3B4/p7/4PP2/P5PP/2R3K1 b - - 0 22,cxd5,24,45,21,1
r4rk1/1R3ppp/8/3p4/p7/4PP2/P5PP/2R3K1 w - - 0 23,Rcc7,35,16,-19,1
r4rk1/1RR2ppp/8/3p4/p7/4PP2/P5PP/6K1 b - - 1 23,a3,10,35,25,1
r4rk1/1RR2ppp/8/3p4/8/p3PP2/P5PP/6K1 w - - 0 24,Ra7,24,35,11,1
r4rk1/R1R2ppp/8/3p4/8/p3PP2/P5PP/6K1 b - - 1 24,Rfb8,28,25,-3,1
rr4k1/R1R2ppp/8/3p4/8/p3PP2/P5PP/6K1 w - - 2 25,Rxa8,23,20,-3,1
Rr4k1/2R2ppp/8/3p4/8/p3PP2/P5PP/6K1 b - - 0 25,Rxa8,15,15,0,1
r5k1/2R2ppp/8/3p4/8/p3PP2/P5PP/6K1 w - - 0 26,Rc5,20,12,-8,1
r5k1/5ppp/8/2Rp4/8/p3PP2/P5PP/6K1 b - - 1 26,h5,0,57,57,1
r5k1/5pp1/8/2Rp3p/8/p3PP2/P5PP/6K1 w - - 0 27,Rxd5,98,60,-38,1
r5k1/5pp1/8/3R3p/8/p3PP2/P5PP/6K1 b - - 0 27,Rc8,87,118,31,1
2r3k1/5pp1/8/3R3p/8/p3PP2/P5PP/6K1 w - - 1 28,Rd2,123,19,-104,0
2r3k1/5pp1/8/7p/8/p3PP2/P2R2PP/6K1 b - - 2 28,f6,8,37,29,1
2r3k1/6p1/5p2/7p/8/p3PP2/P2R2PP/6K1 w - - 0 29,Kf2,43,0,-43,1
2r3k1/6p1/5p2/7p/8/p3PP2/P2R1KPP/8 b - - 1 29,Kf7,0,27,27,1
2r5/5kp1/5p2/7p/8/p3PP2/P2R1KPP/8 w - - 2 30,Ke2,49,0,-49,1
2r5/5kp1/5p2/7p/8/p3PP2/P2RK1PP/8 b - - 3 30,Ke6,0,0,0,1
2r5/6p1/4kp2/7p/8/p3PP2/P2RK1PP/8 w - - 4 31,f4,0,22,22,1
2r5/6p1/4kp2/7p/5P2/p3P3/P2RK1PP/8 b - - 0 31,Ra8,7,136,129,1
r7/6p1/4kp2/7p/5P2/p3P3/P2RK1PP/8 w - - 1 32,Kf3,132,132,0,1
r7/6p1/4kp2/7p/5P2/p3PK2/P2R2PP/8 b - - 2 32,Ke7,128,123,-5,1
r7/4k1p1/5p2/7p/5P2/p3PK2/P2R2PP/8 w - - 3 33,h3,128,111,-17,1
r7/4k1p1/5p2/7p/5P2/p3PK1P/P2R2P1/8 b - - 0 33,Rb8,122,124,2,1
1r6/4k1p1/5p2/7p/5P2/p3PK1P/P2R2P1/8 w - - 1 34,Rd3,139,125,-14,1
1r6/4k1p1/5p2/7p/5P2/p2RPK1P/P5P1/8 b - - 2 34,Ra8,136,146,10,1
r7/4k1p1/5p2/7p/5P2/p2RPK1P/P5P1/8 w - - 3 35,g4,149,144,-5,1
r7/4k1p1/5p2/7p/5PP1/p2RPK1P/P7/8 b - - 0 35,Ke6,139,271,132,1
r7/6p1/4kp2/7p/5PP1/p2RPK1P/P7/8 w - - 1 36,gxh5,288,323,35,1
r7/6p1/4kp2/7P/5P2/p2RPK1P/P7/8 b - - 0 36,Kf7,294,312,18,1
r7/5kp1/5p2/7P/5P2/p2RPK1P/P7/8 w - - 1 37,e4,324,292,-32,1
r7/5kp1/5p2/7P/4PP2/p2R1K1P/P7/8 b - - 0 37,Kg8,334,329,-5,1
r5k1/6p1/5p2/7P/4PP2/p2R1K1P/P7/8 w - - 1 38,Kg4,358,341,-17,1
r5k1/6p1/5p2/7P/4PPK1/p2R3P/P7/8 b - - 2 38,Kh7,332,351,19,1
r7/6pk/5p2/7P/4PPK1/p2R3P/P7/8 w - - 3 39,e5,336,319,-17,1
r7/6pk/5p2/4P2P/5PK1/p2R3P/P7/8 b - - 0 39,Kh6,378,438,60,1
r7/6p1/5p1k/4P2P/5PK1/p2R3P/P7/8 w - - 1 40,e6,372,414,42,1
r7/6p1/4Pp1k/7P/5PK1/p2R3P/P7/8 b - - 0 40,f5+,369,532,163,1
r7/6p1/4P2k/5p1P/5PK1/p2R3P/P7/8 w - - 0 41,Kxf5,574,578,4,1
rnbqkbnr/pppppppp/8/8/8/8/PPPPPPPP/RNBQKBNR w KQkq - 0 1,e4,27,28,1,1
rnbqkbnr/pppppppp/8/8/4P3/8/PPPP1PPP/RNBQKBNR b KQkq - 0 1,e6,27,49,22,1
rnbqkbnr/pppp1ppp/4p3/8/4P3/8/PPPP1PPP/RNBQKBNR w KQkq - 0 2,Nf3,40,22,-18,1
rnbqkbnr/pppp1ppp/4p3/8/4P3/5N2/PPPP1PPP/RNBQKB1R b KQkq - 1 2,d5,30,21,-9,1
rnbqkbnr/ppp2ppp/4p3/3p4/4P3/5N2/PPPP1PPP/RNBQKB1R w KQkq - 0 3,exd5,21,24,3,1
rnbqkbnr/ppp2ppp/4p3/3P4/8/5N2/PPPP1PPP/RNBQKB1R b KQkq - 0 3,exd5,22,19,-3,1
rnbqkbnr/ppp2ppp/8/3p4/8/5N2/PPPP1PPP/RNBQKB1R w KQkq - 0 4,Bb5+,26,-30,-56,1
rnbqkbnr/ppp2ppp/8/1B1p4/8/5N2/PPPP1PPP/RNBQK2R b KQkq - 1 4,c6,-27,-22,5,1
rnbqkbnr/pp3ppp/2p5/1B1p4/8/5N2/PPPP1PPP/RNBQK2R w KQkq - 0 5,Be2,-22,-25,-3,1
rnbqkbnr/pp3ppp/2p5/3p4/8/5N2/PPPPBPPP/RNBQK2R b KQkq - 1 5,Nf6,-21,-17,4,1
rnbqkb1r/pp3ppp/2p2n2/3p4/8/5N2/PPPPBPPP/RNBQK2R w KQkq - 2 6,d4,-23,-25,-2,1
rnbqkb1r/pp3ppp/2p2n2/3p4/3P4/5N2/PPP1BPPP/RNBQK2R b KQkq - 0 6,Be7,-22,-9,13,1
rnbqk2r/pp2bppp/2p2n2/3p4/3P4/5N2/PPP1BPPP/RNBQK2R w KQkq - 1 7,Ng5,1,-55,-56,1
rnbqk2r/pp2bppp/2p2n2/3p2N1/3P4/8/PPP1BPPP/RNBQK2R b KQkq - 2 7,O-O,-52,-55,-3,1
rnbq1rk1/pp2bppp/2p2n2/3p2N1/3P4/8/PPP1BPPP/RNBQK2R w KQ - 3 8,O-O,-49,-48,1,1
rnbq1rk1/pp2bppp/2p2n2/3p2N1/3P4/8/PPP1BPPP/RNBQ1RK1 b - - 4 8,Ne4,-43,16,59,1
rnbq1rk1/pp2bppp/2p5/3p2N1/3Pn3/8/PPP1BPPP/RNBQ1RK1 w - - 5 9,Nxe4,17,13,-4,1
rnbq1rk1/pp2bppp/2p5/3p4/3PN3/8/PPP1BPPP/RNBQ1RK1 b - - 0 9,dxe4,20,14,-6,1
rnbq1rk1/pp2bppp/2p5/8/3Pp3/8/PPP1BPPP/RNBQ1RK1 w - - 0 10,f3,11,-20,-31,1
rnbq1rk1/pp2bppp/2p5/8/3Pp3/5P2/PPP1B1PP/RNBQ1RK1 b - - 0 10,exf3,-22,-13,9,1
rnbq1rk1/pp2bppp/2p5/8/3P4/5p2/PPP1B1PP/RNBQ1RK1 w - - 0 11,Bxf3,-16,-19,-3,1
rnbq1rk1/pp2bppp/2p5/8/3P4/5B2/PPP3PP/RNBQ1RK1 b - - 0 11,Nd7,-24,-16,8,1
r1bq1rk1/pp1nbppp/2p5/8/3P4/5B2/PPP3PP/RNBQ1RK1 w - - 1 12,Nc3,-21,-34,-13,1
r1bq1rk1/pp1nbppp/2p5/8/3P4/2N2B2/PPP3PP/R1BQ1RK1 b - - 2 12,Nf6,-32,-23,9,1
r1bq1rk1/pp2bppp/2p2n2/8/3P4/2N2B2/PPP3PP/R1BQ1RK1 w - - 3 13,Qe1,-25,-121,-96,1
r1bq1rk1/pp2bppp/2p2n2/8/3P4/2N2B2/PPP3PP/R1B1QRK1 b - - 4 13,Re8,-121,-33,88,1
r1bqr1k1/pp2bppp/2p2n2/8/3P4/2N2B2/PPP3PP/R1B1QRK1 w - - 5 14,Qg3,-45,-313,-268,0
r1bqr1k1/pp2bppp/2p2n2/8/3P4/2N2BQ1/PPP3PP/R1B2RK1 b - - 6 14,Bd6,-329,12,341,1
r1bqr1k1/pp3ppp/2pb1n2/8/3P4/2N2BQ1/PPP3PP/R1B2RK1 w - - 7 15,Qh4,-11,-47,-36,1
r1bqr1k1/pp3ppp/2pb1n2/8/3P3Q/2N2B2/PPP3PP/R1B2RK1 b - - 8 15,Be7,-40,-41,-1,1
r1bqr1k1/pp2bppp/2p2n2/8/3P3Q/2N2B2/PPP3PP/R1B2RK1 w - - 9 16,Qg3,-45,-333,-288,0
r1bqr1k1/pp2bppp/2p2n2/8/3P4/2N2BQ1/PPP3PP/R1B2RK1 b - - 10 16,Be6,-362,-39,323,1
r2qr1k1/pp2bppp/2p1bn2/8/3P4/2N2BQ1/PPP3PP/R1B2RK1 w - - 11 17,Bh6,-58,-227,-169,0
r2qr1k1/pp2bppp/2p1bn1B/8/3P4/2N2BQ1/PPP3PP/R4RK1 b - - 12 17,g6,-210,26,236,1
r2qr1k1/pp2bp1p/2p1bnpB/8/3P4/2N2BQ1/PPP3PP/R4RK1 w - - 0 18,Ne4,21,-339,-360,0
r2qr1k1/pp2bp1p/2p1bnpB/8/3PN3/5BQ1/PPP3PP/R4RK1 b - - 1 18,Qxd4+,-355,-246,109,1
r3r1k1/pp2bp1p/2p1bnpB/8/3qN3/5BQ1/PPP3PP/R4RK1 w - - 0 19,Nf2,-231,-213,18,1
r3r1k1/pp2bp1p/2p1bnpB/8/3q4/5BQ1/PPP2NPP/R4RK1 b - - 1 19,Rad8,-227,-212,15,1
3rr1k1/pp2bp1p/2p1bnpB/8/3q4/5BQ1/PPP2NPP/R4RK1 w - - 2 20,c3,-213,-157,56,1
3rr1k1/pp2bp1p/2p1bnpB/8/3q4/2P2BQ1/PP3NPP/R4RK1 b - - 0 20,Qd6,-176,-162,14,1
3rr1k1/pp2bp1p/2pqbnpB/8/8/2P2BQ1/PP3NPP/R4RK1 w - - 1 21,Bf4,-159,-143,16,1
3rr1k1/pp2bp1p/2pqbnp1/8/5B2/2P2BQ1/PP3NPP/R4RK1 b - - 2 21,Qd7,-170,-97,73,1
3rr1k1/pp1qbp1p/2p1bnp1/8/5B2/2P2BQ1/PP3NPP/R4RK1 w - - 3 22,Bh6,-89,-203,-114,0
3rr1k1/pp1qbp1p/2p1bnpB/8/8/2P2BQ1/PP3NPP/R4RK1 b - - 4 22,Qd6,-199,-157,42,1
3rr1k1/pp2bp1p/2pqbnpB/8/8/2P2BQ1/PP3NPP/R4RK1 w - - 5 23,Bf4,-171,-174,-3,1
3rr1k1/pp2bp1p/2pqbnp1/8/5B2/2P2BQ1/PP3NPP/R4RK1 b - - 6 23,Qc5,-170,-167,3,1
3rr1k1/pp2bp1p/2p1bnp1/2q5/5B2/2P2BQ1/PP3NPP/R4RK1 w - - 7 24,Bd1,-171,-270,-99,1
3rr1k1/pp2bp1p/2p1bnp1/2q5/5B2/2P3Q1/PP3NPP/R2B1RK1 b - - 8 24,Nh5,-282,-193,89,1
3rr1k1/pp2bp1p/2p1b1p1/2q4n/5B2/2P3Q1/PP3NPP/R2B1RK1 w - - 9 25,Qf3,-186,-348,-162,0
3rr1k1/pp2bp1p/2p1b1p1/2q4n/5B2/2P2Q2/PP3NPP/R2B1RK1 b - - 10 25,Nxf4,-352,-400,-48,1
3rr1k1/pp2bp1p/2p1b1p1/2q5/5n2/2P2Q2/PP3NPP/R2B1RK1 w - - 0 26,Qxf4,-406,-418,-12,1
3rr1k1/pp2bp1p/2p1b1p1/2q5/5Q2/2P5/PP3NPP/R2B1RK1 b - - 0 26,Bg5,-454,-462,-8,1
3rr1k1/pp3p1p/2p1b1p1/2q3b1/5Q2/2P5/PP3NPP/R2B1RK1 w - - 1 27,Qg3,-435,-499,-64,1
3rr1k1/pp3p1p/2p1b1p1/2q3b1/8/2P3Q1/PP3NPP/R2B1RK1 b - - 2 27,Be3,-487,-411,76,1
3rr1k1/pp3p1p/2p1b1p1/2q5/8/2P1b1Q1/PP3NPP/R2B1RK1 w - - 3 28,Bh5,-412,-516,-104,0
3rr1k1/pp3p1p/2p1b1p1/2q4B/8/2P1b1Q1/PP3NPP/R4RK1 b - - 4 28,Rd2,-514,-492,22,1
4r1k1/pp3p1p/2p1b1p1/2q4B/8/2P1b1Q1/PP1r1NPP/R4RK1 w - - 5 29,Kh1,-506,-552,-46,1
4r1k1/pp3p1p/2p1b1p1/2q4B/8/2P1b1Q1/PP1r1NPP/R4R1K b - - 6 29,Rxf2,-564,-532,32,1
4r1k1/pp3p1p/2p1b1p1/2q4B/8/2P1b1Q1/PP3rPP/R4R1K w - - 0 30,Rxf2,-568,-594,-26,1
4r1k1/pp3p1p/2p1b1p1/2q4B/8/2P1b1Q1/PP3RPP/R6K b - - 0 30,Bxf2,-576,-648,-72,1
4r1k1/pp3p1p/2p1b1p1/2q4B/8/2P3Q1/PP3bPP/R6K w - - 0 31,Qf4,-586,-585,1,1
4r1k1/pp3p1p/2p1b1p1/2q4B/5Q2/2P5/PP3bPP/R6K b - - 1 31,Be3,-576,-600,-24,1
4r1k1/pp3p1p/2p1b1p1/2q4B/5Q2/2P1b3/PP4PP/R6K w - - 2 32,Qf6,-586,-736,-150,0
4r1k1/pp3p1p/2p1bQp1/2q4B/8/2P1b3/PP4PP/R6K b - - 3 32,Qxh5,-770,-727,43,1
4r1k1/pp3p1p/2p1bQp1/7q/8/2P1b3/PP4PP/R6K w - - 0 33,Re1,-770,-751,19,1
rnbqkbnr/pppppppp/8/8/8/8/PPPPPPPP/RNBQKBNR w KQkq - 0 1,d4,28,26,-2,1
rnbqkbnr/pppppppp/8/8/3P4/8/PPP1PPPP/RNBQKBNR b KQkq - 0 1,c5,23,73,50,1
rnbqkbnr/pp1ppppp/8/2p5/3P4/8/PPP1PPPP/RNBQKBNR w KQkq - 0 2,c3,81,13,-68,1
rnbqkbnr/pp1ppppp/8/2p5/3P4/2P5/PP2PPPP/RNBQKBNR b KQkq - 0 2,cxd4,7,27,20,1
rnbqkbnr/pp1ppppp/8/8/3p4/2P5/PP2PPPP/RNBQKBNR w KQkq - 0 3,cxd4,39,30,-9,1
rnbqkbnr/pp1ppppp/8/8/3P4/8/PP2PPPP/RNBQKBNR b KQkq - 0 3,d5,29,19,-10,1
rnbqkbnr/pp2pppp/8/3p4/3P4/8/PP2PPPP/RNBQKBNR w KQkq - 0 4,Nf3,19,16,-3,1
rnbqkbnr/pp2pppp/8/3p4/3P4/5N2/PP2PPPP/RNBQKB1R b KQkq - 1 4,Nc6,19,24,5,1
r1bqkbnr/pp2pppp/2n5/3p4/3P4/5N2/PP2PPPP/RNBQKB1R w KQkq - 2 5,Nc3,20,18,-2,1
r1bqkbnr/pp2pppp/2n5/3p4/3P4/2N2N2/PP2PPPP/R1BQKB1R b KQkq - 3 5,e6,13,30,17,1
r1bqkbnr/pp3ppp/2n1p3/3p4/3P4/2N2N2/PP2PPPP/R1BQKB1R w KQkq - 0 6,Bf4,32,27,-5,1
r1bqkbnr/pp3ppp/2n1p3/3p4/3P1B2/2N2N2/PP2PPPP/R2QKB1R b KQkq - 1 6,Nf6,26,34,8,1
r1bqkb1r/pp3ppp/2n1pn2/3p4/3P1B2/2N2N2/PP2PPPP/R2QKB1R w KQkq - 2 7,e3,34,34,0,1
r1bqkb1r/pp3ppp/2n1pn2/3p4/3P1B2/2N1PN2/PP3PPP/R2QKB1R b KQkq - 0 7,Bd6,28,29,1,1
r1bqk2r/pp3ppp/2nbpn2/3p4/3P1B2/2N1PN2/PP3PPP/R2QKB1R w KQkq - 1 8,Bg5,26,3,-23,1
r1bqk2r/pp3ppp/2nbpn2/3p2B1/3P4/2N1PN2/PP3PPP/R2QKB1R b KQkq - 2 8,Be7,-7,52,59,1
r1bqk2r/pp2bppp/2n1pn2/3p2B1/3P4/2N1PN2/PP3PPP/R2QKB1R w KQkq - 3 9,Qc2,52,8,-44,1
r1bqk2r/pp2bppp/2n1pn2/3p2B1/3P4/2N1PN2/PPQ2PPP/R3KB1R b KQkq - 4 9,O-O,5,26,21,1
r1bq1rk1/pp2bppp/2n1pn2/3p2B1/3P4/2N1PN2/PPQ2PPP/R3KB1R w KQ - 5 10,Bf4,24,-22,-46,1
r1bq1rk1/pp2bppp/2n1pn2/3p4/3P1B2/2N1PN2/PPQ2PPP/R3KB1R b KQ - 6 10,h6,-22,13,35,1
r1bq1rk1/pp2bpp1/2n1pn1p/3p4/3P1B2/2N1PN2/PPQ2PPP/R3KB1R w KQ - 0 11,Bd3,24,-27,-51,1
r1bq1rk1/pp2bpp1/2n1pn1p/3p4/3P1B2/2NBPN2/PPQ2PPP/R3K2R b KQ - 1 11,Bd6,-22,26,48,1
r1bq1rk1/pp3pp1/2nbpn1p/3p4/3P1B2/2NBPN2/PPQ2PPP/R3K2R w KQ - 2 12,Bxd6,29,19,-10,1
r1bq1rk1/pp3pp1/2nBpn1p/3p4/3P4/2NBPN2/PPQ2PPP/R3K2R b KQ - 0 12,Qxd6,21,15,-6,1
r1b2rk1/pp3pp1/2nqpn1p/3p4/3P4/2NBPN2/PPQ2PPP/R3K2R w KQ - 0 13,h3,23,7,-16,1
r1b2rk1/pp3pp1/2nqpn1p/3p4/3P4/2NBPN1P/PPQ2PP1/R3K2R b KQ - 0 13,Nb4,-6,1,7,1
r1b2rk1/pp3pp1/3qpn1p/3p4/1n1P4/2NBPN1P/PPQ2PP1/R3K2R w KQ - 1 14,Qd2,-2,-23,-21,1
r1b2rk1/pp3pp1/3qpn1p/3p4/1n1P4/2NBPN1P/PP1Q1PP1/R3K2R b KQ - 2 14,Nxd3+,-5,0,5,1
r1b2rk1/pp3pp1/3qpn1p/3p4/3P4/2NnPN1P/PP1Q1PP1/R3K2R w KQ - 0 15,Qxd3,-9,-15,-6,1
r1b2rk1/pp3pp1/3qpn1p/3p4/3P4/2NQPN1P/PP3PP1/R3K2R b KQ - 0 15,b6,-9,17,26,1
r1b2rk1/p4pp1/1p1qpn1p/3p4/3P4/2NQPN1P/PP3PP1/R3K2R w KQ - 0 16,a3,1,-35,-36,1
r1b2rk1/p4pp1/1p1qpn1p/3p4/3P4/P1NQPN1P/1P3PP1/R3K2R b KQ - 0 16,a5,-44,-31,13,1
r1b2rk1/5pp1/1p1qpn1p/p2p4/3P4/P1NQPN1P/1P3PP1/R3K2R w KQ - 0 17,O-O,-52,-65,-13,1
r1b2rk1/5pp1/1p1qpn1p/p2p4/3P4/P1NQPN1P/1P3PP1/R4RK1 b - - 1 17,Ba6,-51,-65,-14,1
r4rk1/5pp1/bp1qpn1p/p2p4/3P4/P1NQPN1P/1P3PP1/R4RK1 w - - 2 18,Nb5,-64,-73,-9,1
r4rk1/5pp1/bp1qpn1p/pN1p4/3P4/P2QPN1P/1P3PP1/R4RK1 b - - 3 18,Qd7,-73,-29,44,1
r4rk1/3q1pp1/bp2pn1p/pN1p4/3P4/P2QPN1P/1P3PP1/R4RK1 w - - 4 19,a4,-22,-24,-2,1
r4rk1/3q1pp1/bp2pn1p/pN1p4/P2P4/3QPN1P/1P3PP1/R4RK1 b - - 0 19,Ne4,-21,-9,12,1
r4rk1/3q1pp1/bp2p2p/pN1p4/P2Pn3/3QPN1P/1P3PP1/R4RK1 w - - 1 20,Rfd1,-6,-128,-122,0
r4rk1/3q1pp1/bp2p2p/pN1p4/P2Pn3/3QPN1P/1P3PP1/R2R2K1 b - - 2 20,Nd6,-132,10,142,1
r4rk1/3q1pp1/bp1np2p/pN1p4/P2P4/3QPN1P/1P3PP1/R2R2K1 w - - 3 21,Ne5,1,-6,-7,1
r4rk1/3q1pp1/bp1np2p/pN1pN3/P2P4/3QP2P/1P3PP1/R2R2K1 b - - 4 21,Qe8,-3,489,492,1
r3qrk1/5pp1/bp1np2p/pN1pN3/P2P4/3QP2P/1P3PP1/R2R2K1 w - - 5 22,Nxd6,490,470,-20,1
r3qrk1/5pp1/bp1Np2p/p2pN3/P2P4/3QP2P/1P3PP1/R2R2K1 b - - 0 22,Bxd3,466,448,-18,1
r3qrk1/5pp1/1p1Np2p/p2pN3/P2P4/3bP2P/1P3PP1/R2R2K1 w - - 0 23,Nxe8,450,453,3,1
r3Nrk1/5pp1/1p2p2p/p2pN3/P2P4/3bP2P/1P3PP1/R2R2K1 b - - 0 23,Raxe8,450,509,59,1
4rrk1/5pp1/1p2p2p/p2pN3/P2P4/3bP2P/1P3PP1/R2R2K1 w - - 0 24,Rxd3,515,481,-34,1
4rrk1/5pp1/1p2p2p/p2pN3/P2P4/3RP2P/1P3PP1/R5K1 b - - 0 24,Rc8,452,467,15,1
2r2rk1/5pp1/1p2p2p/p2pN3/P2P4/3RP2P/1P3PP1/R5K1 w - - 1 25,Nd7,457,439,-18,1
2r2rk1/3N1pp1/1p2p2p/p2p4/P2P4/3RP2P/1P3PP1/R5K1 b - - 2 25,Rfd8,424,440,16,1
2rr2k1/3N1pp1/1p2p2p/p2p4/P2P4/3RP2P/1P3PP1/R5K1 w - - 3 26,Nxb6,428,321,-107,0
2rr2k1/5pp1/1N2p2p/p2p4/P2P4/3RP2P/1P3PP1/R5K1 b - - 0 26,Rc2,321,446,125,1
3r2k1/5pp1/1N2p2p/p2p4/P2P4/3RP2P/1Pr2PP1/R5K1 w - - 1 27,b3,475,213,-262,0
3r2k1/5pp1/1N2p2p/p2p4/P2P4/1P1RP2P/2r2PP1/R5K1 b - - 0 27,Rdc8,241,631,390,1
2r3k1/5pp1/1N2p2p/p2p4/P2P4/1P1RP2P/2r2PP1/R5K1 w - - 1 28,Nd7,617,456,-161,0
2r3k1/3N1pp1/4p2p/p2p4/P2P4/1P1RP2P/2r2PP1/R5K1 b - - 2 28,Kh7,441,481,40,1
2r5/3N1ppk/4p2p/p2p4/P2P4/1P1RP2P/2r2PP1/R5K1 w - - 3 29,Ne5,488,431,-57,1
2r5/5ppk/4p2p/p2pN3/P2P4/1P1RP2P/2r2PP1/R5K1 b - - 4 29,f6,438,435,-3,1
2r5/6pk/4pp1p/p2pN3/P2P4/1P1RP2P/2r2PP1/R5K1 w - - 0 30,Nf3,432,417,-15,1
2r5/6pk/4pp1p/p2p4/P2P4/1P1RPN1P/2r2PP1/R5K1 b - - 1 30,Kg6,370,407,37,1
2r5/6p1/4ppkp/p2p4/P2P4/1P1RPN1P/2r2PP1/R5K1 w - - 2 31,Kf1,431,443,12,1
2r5/6p1/4ppkp/p2p4/P2P4/1P1RPN1P/2r2PP1/R4K2 b - - 3 31,Re8,415,544,129,1
4r3/6p1/4ppkp/p2p4/P2P4/1P1RPN1P/2r2PP1/R4K2 w - - 4 32,Ke1,540,492,-48,1
4r3/6p1/4ppkp/p2p4/P2P4/1P1RPN1P/2r2PP1/R3K3 b - - 5 32,Rcc8,462,546,84,1
2r1r3/6p1/4ppkp/p2p4/P2P4/1P1RPN1P/5PP1/R3K3 w - - 6 33,Rad1,505,494,-11,1
2r1r3/6p1/4ppkp/p2p4/P2P4/1P1RPN1P/5PP1/3RK3 b - - 7 33,Rcd8,475,593,118,1
3rr3/6p1/4ppkp/p2p4/P2P4/1P1RPN1P/5PP1/3RK3 w - - 8 34,Ke2,515,513,-2,1
3rr3/6p1/4ppkp/p2p4/P2P4/1P1RPN1P/4KPP1/3R4 b - - 9 34,f5,509,596,87,1
3rr3/6p1/4p1kp/p2p1p2/P2P4/1P1RPN1P/4KPP1/3R4 w - - 0 35,g4,597,509,-88,1
3rr3/6p1/4p1kp/p2p1p2/P2P2P1/1P1RPN1P/4KP2/3R4 b - - 0 35,fxg4,487,572,85,1
3rr3/6p1/4p1kp/p2p4/P2P2p1/1P1RPN1P/4KP2/3R4 w - - 0 36,hxg4,518,529,11,1
3rr3/6p1/4p1kp/p2p4/P2P2P1/1P1RPN2/4KP2/3R4 b - - 0 36,h5,491,626,135,1
3rr3/6p1/4p1k1/p2p3p/P2P2P1/1P1RPN2/4KP2/3R4 w - - 0 37,Nh2,612,459,-153,0
3rr3/6p1/4p1k1/p2p3p/P2P2P1/1P1RP3/4KP1N/3R4 b - - 1 37,h4,437,478,41,1
3rr3/6p1/4p1k1/p2p4/P2P2Pp/1P1RP3/4KP1N/3R4 w - - 0 38,Rh1,494,484,-10,1
3rr3/6p1/4p1k1/p2p4/P2P2Pp/1P1RP3/4KP1N/7R b - - 1 38,Kh6,424,471,47,1
3rr3/6p1/4p2k/p2p4/P2P2Pp/1P1RP3/4KP1N/7R w - - 2 39,Nf1,465,390,-75,1
3rr3/6p1/4p2k/p2p4/P2P2Pp/1P1RP3/4KP2/5N1R b - - 3 39,g5,381,386,5,1
3rr3/8/4p2k/p2p2p1/P2P2Pp/1P1RP3/4KP2/5N1R w - - 0 40,Rh3,385,301,-84,1
3rr3/8/4p2k/p2p2p1/P2P2Pp/1P1RP2R/4KP2/5N2 b - - 1 40,Kg6,289,378,89,1
3rr3/8/4p1k1/p2p2p1/P2P2Pp/1P1RP2R/4KP2/5N2 w - - 2 41,f3,366,258,-108,0
3rr3/8/4p1k1/p2p2p1/P2P2Pp/1P1RPP1R/4K3/5N2 b - - 0 41,Rf8,269,349,80,1
3r1r2/8/4p1k1/p2p2p1/P2P2Pp/1P1RPP1R/4K3/5N2 w - - 1 42,Nd2,344,241,-103,0
3r1r2/8/4p1k1/p2p2p1/P2P2Pp/1P1RPP1R/3NK3/8 b - - 2 42,Rf6,251,404,153,1
3r4/8/4prk1/p2p2p1/P2P2Pp/1P1RPP1R/3NK3/8 w - - 3 43,Rc3,399,417,18,1
3r4/8/4prk1/p2p2p1/P2P2Pp/1PR1PP1R/3NK3/8 b - - 4 43,Rdf8,427,477,50,1
5r2/8/4prk1/p2p2p1/P2P2Pp/1PR1PP1R/3NK3/8 w - - 5 44,Rc1,484,448,-36,1
5r2/8/4prk1/p2p2p1/P2P2Pp/1P2PP1R/3NK3/2R5 b - - 6 44,R6f7,451,451,0,1
5r2/5r2/4p1k1/p2p2p1/P2P2Pp/1P2PP1R/3NK3/2R5 w - - 7 45,Rf1,427,284,-143,0
5r2/5r2/4p1k1/p2p2p1/P2P2Pp/1P2PP1R/3NK3/5R2 b - - 8 45,Re7,279,432,153,1
5r2/4r3/4p1k1/p2p2p1/P2P2Pp/1P2PP1R/3NK3/5R2 w - - 9 46,Rf2,448,300,-148,0
5r2/4r3/4p1k1/p2p2p1/P2P2Pp/1P2PP1R/3NKR2/8 b - - 10 46,e5,299,393,94,1
5r2/4r3/6k1/p2pp1p1/P2P2Pp/1P2PP1R/3NKR2/8 w - - 0 47,Nf1,371,258,-113,0
5r2/4r3/6k1/p2pp1p1/P2P2Pp/1P2PP1R/4KR2/5N2 b - - 1 47,exd4,257,248,-9,1
5r2/4r3/6k1/p2p2p1/P2p2Pp/1P2PP1R/4KR2/5N2 w - - 0 48,Kd3,227,236,9,1
5r2/4r3/6k1/p2p2p1/P2p2Pp/1P1KPP1R/5R2/5N2 b - - 1 48,dxe3,244,242,-2,1
5r2/4r3/6k1/p2p2p1/P5Pp/1P1KpP1R/5R2/5N2 w - - 0 49,Nxe3,261,290,29,1
5r2/4r3/6k1/p2p2p1/P5Pp/1P1KNP1R/5R2/8 b - - 0 49,d4,244,310,66,1
rnbqkbnr/pppppppp/8/8/8/8/PPPPPPPP/RNBQKBNR w KQkq - 0 1,g3,35,-25,-60,1
rnbqkbnr/pppppppp/8/8/8/6P1/PPPPPP1P/RNBQKBNR b KQkq - 0 1,e5,-5,34,39,1
rnbqkbnr/pppp1ppp/8/4p3/8/6P1/PPPPPP1P/RNBQKBNR w KQkq - 0 2,Bg2,31,-19,-50,1
rnbqkbnr/pppp1ppp/8/4p3/8/6P1/PPPPPPBP/RNBQK1NR b KQkq - 1 2,Bc5,-25,29,54,1
rnbqk1nr/pppp1ppp/8/2b1p3/8/6P1/PPPPPPBP/RNBQK1NR w KQkq - 2 3,e4,25,5,-20,1
rnbqk1nr/pppp1ppp/8/2b1p3/4P3/6P1/PPPP1PBP/RNBQK1NR b KQkq - 0 3,d6,12,10,-2,1
rnbqk1nr/ppp2ppp/3p4/2b1p3/4P3/6P1/PPPP1PBP/RNBQK1NR w KQkq - 0 4,d3,7,-6,-13,1
rnbqk1nr/ppp2ppp/3p4/2b1p3/4P3/3P2P1/PPP2PBP/RNBQK1NR b KQkq - 0 4,Nf6,-25,-16,9,1
rnbqk2r/ppp2ppp/3p1n2/2b1p3/4P3/3P2P1/PPP2PBP/RNBQK1NR w KQkq - 1 5,Qe2,-17,-38,-21,1
rnbqk2r/ppp2ppp/3p1n2/2b1p3/4P3/3P2P1/PPP1QPBP/RNB1K1NR b KQkq - 2 5,O-O,-40,-33,7,1
rnbq1rk1/ppp2ppp/3p1n2/2b1p3/4P3/3P2P1/PPP1QPBP/RNB1K1NR w KQ - 3 6,Be3,-36,-35,1,1
rnbq1rk1/ppp2ppp/3p1n2/2b1p3/4P3/3PB1P1/PPP1QPBP/RN2K1NR b KQ - 4 6,Nbd7,-40,-20,20,1
r1bq1rk1/pppn1ppp/3p1n2/2b1p3/4P3/3PB1P1/PPP1QPBP/RN2K1NR w KQ - 5 7,Nc3,-25,-35,-10,1
r1bq1rk1/pppn1ppp/3p1n2/2b1p3/4P3/2NPB1P1/PPP1QPBP/R3K1NR b KQ - 6 7,a6,-34,-8,26,1
r1bq1rk1/1ppn1ppp/p2p1n2/2b1p3/4P3/2NPB1P1/PPP1QPBP/R3K1NR w KQ - 0 8,Nd5,-13,-60,-47,1
r1bq1rk1/1ppn1ppp/p2p1n2/2bNp3/4P3/3PB1P1/PPP1QPBP/R3K1NR b KQ - 1 8,Nxd5,-64,-49,15,1
r1bq1rk1/1ppn1ppp/p2p4/2bnp3/4P3/3PB1P1/PPP1QPBP/R3K1NR w KQ - 0 9,exd5,-59,-66,-7,1
r1bq1rk1/1ppn1ppp/p2p4/2bPp3/8/3PB1P1/PPP1QPBP/R3K1NR b KQ - 0 9,f5,-60,-65,-5,1
r1bq1rk1/1ppn2pp/p2p4/2bPpp2/8/3PB1P1/PPP1QPBP/R3K1NR w KQ - 0 10,O-O-O,-64,-62,2,1
r1bq1rk1/1ppn2pp/p2p4/2bPpp2/8/3PB1P1/PPP1QPBP/2KR2NR b - - 1 10,b5,-62,-56,6,1
r1bq1rk1/2pn2pp/p2p4/1pbPpp2/8/3PB1P1/PPP1QPBP/2KR2NR w - - 0 11,g4,-41,-180,-139,0
r1bq1rk1/2pn2pp/p2p4/1pbPpp2/6P1/3PB3/PPP1QPBP/2KR2NR b - - 0 11,f4,-184,-39,145,1
r1bq1rk1/2pn2pp/p2p4/1pbPp3/5pP1/3PB3/PPP1QPBP/2KR2NR w - - 0 12,Bxc5,-67,-95,-28,1
r1bq1rk1/2pn2pp/p2p4/1pBPp3/5pP1/3P4/PPP1QPBP/2KR2NR b - - 0 12,Nxc5,-65,-25,40,1
r1bq1rk1/2p3pp/p2p4/1pnPp3/5pP1/3P4/PPP1QPBP/2KR2NR w - - 0 13,d4,-61,-97,-36,1
r1bq1rk1/2p3pp/p2p4/1pnPp3/3P1pP1/8/PPP1QPBP/2KR2NR b - - 0 13,Nd7,-110,31,141,1
r1bq1rk1/2pn2pp/p2p4/1p1Pp3/3P1pP1/8/PPP1QPBP/2KR2NR w - - 1 14,Be4,22,-33,-55,1
r1bq1rk1/2pn2pp/p2p4/1p1Pp3/3PBpP1/8/PPP1QP1P/2KR2NR b - - 2 14,Nf6,-10,11,21,1
r1bq1rk1/2p3pp/p2p1n2/1p1Pp3/3PBpP1/8/PPP1QP1P/2KR2NR w - - 3 15,h3,56,-19,-75,1
r1bq1rk1/2p3pp/p2p1n2/1p1Pp3/3PBpP1/7P/PPP1QP2/2KR2NR b - - 0 15,Bd7,-13,123,136,1
r2q1rk1/2pb2pp/p2p1n2/1p1Pp3/3PBpP1/7P/PPP1QP2/2KR2NR w - - 1 16,g5,116,-272,-388,0
r2q1rk1/2pb2pp/p2p1n2/1p1Pp1P1/3PBp2/7P/PPP1QP2/2KR2NR b - - 0 16,Nxe4,-291,-286,5,1
r2q1rk1/2pb2pp/p2p4/1p1Pp1P1/3Pnp2/7P/PPP1QP2/2KR2NR w - - 0 17,Qxe4,-277,-281,-4,1
r2q1rk1/2pb2pp/p2p4/1p1Pp1P1/3PQp2/7P/PPP2P2/2KR2NR b - - 0 17,Qxg5,-243,-250,-7,1
r4rk1/2pb2pp/p2p4/1p1Pp1q1/3PQp2/7P/PPP2P2/2KR2NR w - - 0 18,Nf3,-270,-289,-19,1
r4rk1/2pb2pp/p2p4/1p1Pp1q1/3PQp2/5N1P/PPP2P2/2KR3R b - - 1 18,Qh5,-269,-198,71,1
r4rk1/2pb2pp/p2p4/1p1Pp2q/3PQp2/5N1P/PPP2P2/2KR3R w - - 2 19,Rdg1,-197,-509,-312,0
r4rk1/2pb2pp/p2p4/1p1Pp2q/3PQp2/5N1P/PPP2P2/2K3RR b - - 3 19,Bf5,-520,-523,-3,1
r4rk1/2p3pp/p2p4/1p1Ppb1q/3PQp2/5N1P/PPP2P2/2K3RR w - - 4 20,Qe2,-517,-485,32,1
r4rk1/2p3pp/p2p4/1p1Ppb1q/3P1p2/5N1P/PPP1QP2/2K3RR b - - 5 20,e4,-570,-560,10,1
r4rk1/2p3pp/p2p4/1p1P1b1q/3Ppp2/5N1P/PPP1QP2/2K3RR w - - 0 21,Rg5,-525,-574,-49,1
r4rk1/2p3pp/p2p4/1p1P1bRq/3Ppp2/5N1P/PPP1QP2/2K4R b - - 1 21,Qxf3,-573,-574,-1,1
r4rk1/2p3pp/p2p4/1p1P1bR1/3Ppp2/5q1P/PPP1QP2/2K4R w - - 0 22,Qf1,-601,-638,-37,1
r4rk1/2p3pp/p2p4/1p1P1bR1/3Ppp2/5q1P/PPP2P2/2K2Q1R b - - 1 22,e3,-597,-603,-6,1
r4rk1/2p3pp/p2p4/1p1P1bR1/3P1p2/4pq1P/PPP2P2/2K2Q1R w - - 0 23,Rhg1,-564,-587,-23,1
r4rk1/2p3pp/p2p4/1p1P1bR1/3P1p2/4pq1P/PPP2P2/2K2QR1 b - - 1 23,g6,-583,-612,-29,1
r4rk1/2p4p/p2p2p1/1p1P1bR1/3P1p2/4pq1P/PPP2P2/2K2QR1 w - - 0 24,h4,-575,-760,-185,0
r4rk1/2p4p/p2p2p1/1p1P1bR1/3P1p1P/4pq2/PPP2P2/2K2QR1 b - - 0 24,exf2,-797,-752,45,1
r4rk1/2p4p/p2p2p1/1p1P1bR1/3P1p1P/5q2/PPP2p2/2K2QR1 w - - 0 25,R1g2,-676,-670,6,1
r4rk1/2p4p/p2p2p1/1p1P1bR1/3P1p1P/5q2/PPP2pR1/2K2Q2 b - - 1 25,Qe3+,-683,-674,9,1
rnbqkbnr/pppppppp/8/8/8/8/PPPPPPPP/RNBQKBNR w KQkq - 0 1,d4,38,30,-8,1
rnbqkbnr/pppppppp/8/8/3P4/8/PPP1PPPP/RNBQKBNR b KQkq - 0 1,d5,9,30,21,1
rnbqkbnr/ppp1pppp/8/3p4/3P4/8/PPP1PPPP/RNBQKBNR w KQkq - 0 2,e3,29,12,-17,1
rnbqkbnr/ppp1pppp/8/3p4/3P4/4P3/PPP2PPP/RNBQKBNR b KQkq - 0 2,Nc6,11,41,30,1
r1bqkbnr/ppp1pppp/2n5/3p4/3P4/4P3/PPP2PPP/RNBQKBNR w KQkq - 1 3,Nf3,47,50,3,1
r1bqkbnr/ppp1pppp/2n5/3p4/3P4/4PN2/PPP2PPP/RNBQKB1R b KQkq - 2 3,Qd6,51,121,70,1
r1b1kbnr/ppp1pppp/2nq4/3p4/3P4/4PN2/PPP2PPP/RNBQKB1R w KQkq - 3 4,Be2,102,-1,-103,0
r1b1kbnr/ppp1pppp/2nq4/3p4/3P4/4PN2/PPP1BPPP/RNBQK2R b KQkq - 4 4,e5,-3,63,66,1
r1b1kbnr/ppp2ppp/2nq4/3pp3/3P4/4PN2/PPP1BPPP/RNBQK2R w KQkq - 0 5,Nc3,67,-27,-94,1
r1b1kbnr/ppp2ppp/2nq4/3pp3/3P4/2N1PN2/PPP1BPPP/R1BQK2R b KQkq - 1 5,Bf5,-22,176,198,1
r3kbnr/ppp2ppp/2nq4/3ppb2/3P4/2N1PN2/PPP1BPPP/R1BQK2R w KQkq - 2 6,Bd3,160,-273,-433,0
r3kbnr/ppp2ppp/2nq4/3ppb2/3P4/2NBPN2/PPP2PPP/R1BQK2R b KQkq - 3 6,Bxd3,-271,-12,259,1
r3kbnr/ppp2ppp/2nq4/3pp3/3P4/2NbPN2/PPP2PPP/R1BQK2R w KQkq - 0 7,Qxd3,-51,-242,-191,0
r3kbnr/ppp2ppp/2nq4/3pp3/3P4/2NQPN2/PPP2PPP/R1B1K2R b KQkq - 0 7,a6,-231,153,384,1
r3kbnr/1pp2ppp/p1nq4/3pp3/3P4/2NQPN2/PPP2PPP/R1B1K2R w KQkq - 0 8,O-O,178,-196,-374,0
r3kbnr/1pp2ppp/p1nq4/3pp3/3P4/2NQPN2/PPP2PPP/R1B2RK1 b kq - 1 8,e4,-226,-214,12,1
r3kbnr/1pp2ppp/p1nq4/3p4/3Pp3/2NQPN2/PPP2PPP/R1B2RK1 w kq - 0 9,Qe2,-217,-412,-195,0
r3kbnr/1pp2ppp/p1nq4/3p4/3Pp3/2N1PN2/PPP1QPPP/R1B2RK1 b kq - 1 9,O-O-O,-375,-92,283,1
2kr1bnr/1pp2ppp/p1nq4/3p4/3Pp3/2N1PN2/PPP1QPPP/R1B2RK1 w - - 2 10,Ne5,-91,-319,-228,0
2kr1bnr/1pp2ppp/p1nq4/3pN3/3Pp3/2N1P3/PPP1QPPP/R1B2RK1 b - - 3 10,Nxe5,-292,-272,20,1
2kr1bnr/1pp2ppp/p2q4/3pn3/3Pp3/2N1P3/PPP1QPPP/R1B2RK1 w - - 0 11,dxe5,-289,-276,13,1
2kr1bnr/1pp2ppp/p2q4/3pP3/4p3/2N1P3/PPP1QPPP/R1B2RK1 b - - 0 11,Qxe5,-273,-274,-1,1
2kr1bnr/1pp2ppp/p7/3pq3/4p3/2N1P3/PPP1QPPP/R1B2RK1 w - - 0 12,f4,-278,-315,-37,1
2kr1bnr/1pp2ppp/p7/3pq3/4pP2/2N1P3/PPP1Q1PP/R1B2RK1 b - f3 0 12,Qf5,-320,-220,100,1
2kr1bnr/1pp2ppp/p7/3p1q2/4pP2/2N1P3/PPP1Q1PP/R1B2RK1 w - - 1 13,g3,-222,-421,-199,0
2kr1bnr/1pp2ppp/p7/3p1q2/4pP2/2N1P1P1/PPP1Q2P/R1B2RK1 b - - 0 13,d4,-384,-163,221,1
2kr1bnr/1pp2ppp/p7/5q2/3ppP2/2N1P1P1/PPP1Q2P/R1B2RK1 w - - 0 14,exd4,-177,-199,-22,1
2kr1bnr/1pp2ppp/p7/5q2/3PpP2/2N3P1/PPP1Q2P/R1B2RK1 b - - 0 14,Rxd4,-186,-98,88,1
2k2bnr/1pp2ppp/p7/5q2/3rpP2/2N3P1/PPP1Q2P/R1B2RK1 w - - 0 15,Be3,-102,-97,5,1
2k2bnr/1pp2ppp/p7/5q2/3rpP2/2N1B1P1/PPP1Q2P/R4RK1 b - - 1 15,Rd6,-97,-152,-55,1
2k2bnr/1pp2ppp/p2r4/5q2/4pP2/2N1B1P1/PPP1Q2P/R4RK1 w - - 2 16,Qc4,-144,-201,-57,1
2k2bnr/1pp2ppp/p2r4/5q2/2Q1pP2/2N1B1P1/PPP4P/R4RK1 b - - 3 16,Nf6,-187,-218,-31,1
2k2b1r/1pp2ppp/p2r1n2/5q2/2Q1pP2/2N1B1P1/PPP4P/R4RK1 w - - 4 17,Qxf7,-240,-308,-68,1
2k2b1r/1pp2Qpp/p2r1n2/5q2/4pP2/2N1B1P1/PPP4P/R4RK1 b - - 0 17,Qh3,-274,44,318,1
2k2b1r/1pp2Qpp/p2r1n2/8/4pP2/2N1B1Pq/PPP4P/R4RK1 w - - 1 18,Qc4,37,-350,-387,0
2k2b1r/1pp3pp/p2r1n2/8/2Q1pP2/2N1B1Pq/PPP4P/R4RK1 b - - 2 18,Ng4,-370,-392,-22,1
2k2b1r/1pp3pp/p2r4/8/2Q1pPn1/2N1B1Pq/PPP4P/R4RK1 w - - 3 19,Rf2,-294,-397,-103,0
2k2b1r/1pp3pp/p2r4/8/2Q1pPn1/2N1B1Pq/PPP2R1P/R5K1 b - - 4 19,Nxf2,-406,-405,1,1
2k2b1r/1pp3pp/p2r4/8/2Q1pP2/2N1B1Pq/PPP2n1P/R5K1 w - - 0 20,Bxf2,-391,-347,44,1
2k2b1r/1pp3pp/p2r4/8/2Q1pP2/2N3Pq/PPP2B1P/R5K1 b - - 0 20,Rd2,-393,-137,256,1
2k2b1r/1pp3pp/p7/8/2Q1pP2/2N3Pq/PPPr1B1P/R5K1 w - - 1 21,Rd1,-137,-343,-206,0
2k2b1r/1pp3pp/p7/8/2Q1pP2/2N3Pq/PPPr1B1P/3R2K1 b - - 2 21,Bd6,-411,462,873,1
2k4r/1pp3pp/p2b4/8/2Q1pP2/2N3Pq/PPPr1B1P/3R2K1 w - - 3 22,Rxd2,509,490,-19,1
2k4r/1pp3pp/p2b4/8/2Q1pP2/2N3Pq/PPPR1B1P/6K1 b - - 0 22,Re8,471,541,70,1
2k1r3/1pp3pp/p2b4/8/2Q1pP2/2N3Pq/PPPR1B1P/6K1 w - - 1 23,Bc5,503,350,-153,0
2k1r3/1pp3pp/p2b4/2B5/2Q1pP2/2N3Pq/PPPR3P/6K1 b - - 2 23,e3,479,517,38,1
2k1r3/1pp3pp/p2b4/2B5/2Q2P2/2N1p1Pq/PPPR3P/6K1 w - - 0 24,Rd5,482,375,-107,0
2k1r3/1pp3pp/p2b4/2BR4/2Q2P2/2N1p1Pq/PPP4P/6K1 b - - 1 24,e2,428,430,2,1
2k1r3/1pp3pp/p2b4/2BR4/2Q2P2/2N3Pq/PPP1p2P/6K1 w - - 0 25,Bxd6,414,-9999,-10413,0
2k1r3/1pp3pp/p2B4/3R4/2Q2P2/2N3Pq/PPP1p2P/6K1 b - - 0 25,e1=Q+,-9999,-9999,0,1
2k1r3/1pp3pp/p2B4/3R4/2Q2P2/2N3Pq/PPP4P/4q1K1 w - - 0 26,Qf1,-9999,-9999,0,1
2k1r3/1pp3pp/p2B4/3R4/5P2/2N3Pq/PPP4P/4qQK1 b - - 1 26,Qe3+,-9999,-9997,2,1
2k1r3/1pp3pp/p2B4/3R4/5P2/2N1q1Pq/PPP4P/5QK1 w - - 2 27,Qf2,-9997,-9997,0,1
2k1r3/1pp3pp/p2B4/3R4/5P2/2N1q1Pq/PPP2Q1P/6K1 b - - 3 27,Qe1+,-9997,-9998,-1,1
2k1r3/1pp3pp/p2B4/3R4/5P2/2N3Pq/PPP2Q1P/4q1K1 w - - 4 28,Qxe1,-9998,-9998,0,1
2k1r3/1pp3pp/p2B4/3R4/5P2/2N3Pq/PPP4P/4Q1K1 b - - 0 28,Rxe1+,-9998,-9999,-1,1
2k5/1pp3pp/p2B4/3R4/5P2/2N3Pq/PPP4P/4r1K1 w - - 0 29,Kf2,-9999,-9999,0,1
2k5/1pp3pp/p2B4/3R4/5P2/2N3Pq/PPP2K1P/4r3 b - - 1 29,Qf1#,-9999,-10000,-1,1
rnbqkbnr/pppppppp/8/8/8/8/PPPPPPPP/RNBQKBNR w KQkq - 0 1,Nf3,39,19,-20,1
rnbqkbnr/pppppppp/8/8/8/5N2/PPPPPPPP/RNBQKB1R b KQkq - 1 1,d5,22,25,3,1
rnbqkbnr/ppp1pppp/8/3p4/8/5N2/PPPPPPPP/RNBQKB1R w KQkq - 0 2,c4,23,-25,-48,1
rnbqkbnr/ppp1pppp/8/3p4/2P5/5N2/PP1PPPPP/RNBQKB1R b KQkq - 0 2,d4,-23,-4,19,1
rnbqkbnr/ppp1pppp/8/8/2Pp4/5N2/PP1PPPPP/RNBQKB1R w KQkq - 0 3,g3,-9,-25,-16,1
rnbqkbnr/ppp1pppp/8/8/2Pp4/5NP1/PP1PPP1P/RNBQKB1R b KQkq - 0 3,c5,-36,14,50,1
rnbqkbnr/pp2pppp/8/2p5/2Pp4/5NP1/PP1PPP1P/RNBQKB1R w KQkq - 0 4,Bg2,4,-12,-16,1
rnbqkbnr/pp2pppp/8/2p5/2Pp4/5NP1/PP1PPPBP/RNBQK2R b KQkq - 1 4,Nc6,-13,-14,-1,1
r1bqkbnr/pp2pppp/2n5/2p5/2Pp4/5NP1/PP1PPPBP/RNBQK2R w KQkq - 2 5,e3,-8,-20,-12,1
r1bqkbnr/pp2pppp/2n5/2p5/2Pp4/4PNP1/PP1P1PBP/RNBQK2R b KQkq - 0 5,e5,-15,-11,4,1
r1bqkbnr/pp3ppp/2n5/2p1p3/2Pp4/4PNP1/PP1P1PBP/RNBQK2R w KQkq - 0 6,d3,-21,-23,-2,1
r1bqkbnr/pp3ppp/2n5/2p1p3/2Pp4/3PPNP1/PP3PBP/RNBQK2R b KQkq - 0 6,Bd6,-29,-21,8,1
r1bqk1nr/pp3ppp/2nb4/2p1p3/2Pp4/3PPNP1/PP3PBP/RNBQK2R w KQkq - 1 7,O-O,-3,-14,-11,1
r1bqk1nr/pp3ppp/2nb4/2p1p3/2Pp4/3PPNP1/PP3PBP/RNBQ1RK1 b kq - 2 7,Nge7,-7,2,9,1
r1bqk2r/pp2nppp/2nb4/2p1p3/2Pp4/3PPNP1/PP3PBP/RNBQ1RK1 w kq - 3 8,exd4,6,13,7,1
r1bqk2r/pp2nppp/2nb4/2p1p3/2PP4/3P1NP1/PP3PBP/RNBQ1RK1 b kq - 0 8,exd4,8,24,16,1
r1bqk2r/pp2nppp/2nb4/2p5/2Pp4/3P1NP1/PP3PBP/RNBQ1RK1 w kq - 0 9,Re1,22,-17,-39,1
r1bqk2r/pp2nppp/2nb4/2p5/2Pp4/3P1NP1/PP3PBP/RNBQR1K1 b kq - 1 9,O-O,-26,-26,0,1
r1bq1rk1/pp2nppp/2nb4/2p5/2Pp4/3P1NP1/PP3PBP/RNBQR1K1 w - - 2 10,Bd2,-22,-133,-111,0
r1bq1rk1/pp2nppp/2nb4/2p5/2Pp4/3P1NP1/PP1B1PBP/RN1QR1K1 b - - 3 10,Ng6,-119,-107,12,1
r1bq1rk1/pp3ppp/2nb2n1/2p5/2Pp4/3P1NP1/PP1B1PBP/RN1QR1K1 w - - 4 11,a3,-78,-160,-82,1
r1bq1rk1/pp3ppp/2nb2n1/2p5/2Pp4/P2P1NP1/1P1B1PBP/RN1QR1K1 b - - 0 11,a5,-115,-140,-25,1
r1bq1rk1/1p3ppp/2nb2n1/p1p5/2Pp4/P2P1NP1/1P1B1PBP/RN1QR1K1 w - - 0 12,a4,-127,-178,-51,1
r1bq1rk1/1p3ppp/2nb2n1/p1p5/P1Pp4/3P1NP1/1P1B1PBP/RN1QR1K1 b - - 0 12,Bg4,-161,-134,27,1
r2q1rk1/1p3ppp/2nb2n1/p1p5/P1Pp2b1/3P1NP1/1P1B1PBP/RN1QR1K1 w - - 1 13,Na3,-138,-147,-9,1
r2q1rk1/1p3ppp/2nb2n1/p1p5/P1Pp2b1/N2P1NP1/1P1B1PBP/R2QR1K1 b - - 2 13,Qd7,-178,-167,11,1
r4rk1/1p1q1ppp/2nb2n1/p1p5/P1Pp2b1/N2P1NP1/1P1B1PBP/R2QR1K1 w - - 3 14,Nb5,-164,-127,37,1
r4rk1/1p1q1ppp/2nb2n1/pNp5/P1Pp2b1/3P1NP1/1P1B1PBP/R2QR1K1 b - - 4 14,Rfe8,-135,-24,111,1
r3r1k1/1p1q1ppp/2nb2n1/pNp5/P1Pp2b1/3P1NP1/1P1B1PBP/R2QR1K1 w - - 5 15,Nxd6,-24,-29,-5,1
r3r1k1/1p1q1ppp/2nN2n1/p1p5/P1Pp2b1/3P1NP1/1P1B1PBP/R2QR1K1 b - - 0 15,Qxd6,-29,-20,9,1
r3r1k1/1p3ppp/2nq2n1/p1p5/P1Pp2b1/3P1NP1/1P1B1PBP/R2QR1K1 w - - 0 16,h3,-31,-33,-2,1
r3r1k1/1p3ppp/2nq2n1/p1p5/P1Pp2b1/3P1NPP/1P1B1PB1/R2QR1K1 b - - 0 16,Bf5,-40,-13,27,1
r3r1k1/1p3ppp/2nq2n1/p1p2b2/P1Pp4/3P1NPP/1P1B1PB1/R2QR1K1 w - - 1 17,Rxe8+,-27,-36,-9,1
r3R1k1/1p3ppp/2nq2n1/p1p2b2/P1Pp4/3P1NPP/1P1B1PB1/R2Q2K1 b - - 0 17,Rxe8,-43,-36,7,1
4r1k1/1p3ppp/2nq2n1/p1p2b2/P1Pp4/3P1NPP/1P1B1PB1/R2Q2K1 w - - 0 18,Be1,-37,-146,-109,0
4r1k1/1p3ppp/2nq2n1/p1p2b2/P1Pp4/3P1NPP/1P3PB1/R2QB1K1 b - - 1 18,Nb4,-153,-22,131,1
4r1k1/1p3ppp/3q2n1/p1p2b2/PnPp4/3P1NPP/1P3PB1/R2QB1K1 w - - 2 19,Bxb4,-50,-49,1,1
4r1k1/1p3ppp/3q2n1/p1p2b2/PBPp4/3P1NPP/1P3PB1/R2Q2K1 b - - 0 19,axb4,-54,-4,50,1
4r1k1/1p3ppp/3q2n1/2p2b2/PpPp4/3P1NPP/1P3PB1/R2Q2K1 w - - 0 20,Qd2,-11,-37,-26,1
4r1k1/1p3ppp/3q2n1/2p2b2/PpPp4/3P1NPP/1P1Q1PB1/R5K1 b - - 1 20,b6,-34,-46,-12,1
4r1k1/5ppp/1p1q2n1/2p2b2/PpPp4/3P1NPP/1P1Q1PB1/R5K1 w - - 0 21,b3,-37,-58,-21,1
4r1k1/5ppp/1p1q2n1/2p2b2/PpPp4/1P1P1NPP/3Q1PB1/R5K1 b - - 0 21,Ne5,-40,2,42,1
4r1k1/5ppp/1p1q4/2p1nb2/PpPp4/1P1P1NPP/3Q1PB1/R5K1 w - - 1 22,Nxe5,-11,-15,-4,1
4r1k1/5ppp/1p1q4/2p1Nb2/PpPp4/1P1P2PP/3Q1PB1/R5K1 b - - 0 22,Qxe5,-16,18,34,1
4r1k1/5ppp/1p6/2p1qb2/PpPp4/1P1P2PP/3Q1PB1/R5K1 w - - 0 23,g4,18,10,-8,1
4r1k1/5ppp/1p6/2p1qb2/PpPp2P1/1P1P3P/3Q1PB1/R5K1 b - - 0 23,Bg6,-11,218,229,1
4r1k1/5ppp/1p4b1/2p1q3/PpPp2P1/1P1P3P/3Q1PB1/R5K1 w - - 1 24,Kf1,214,-32,-246,0
4r1k1/5ppp/1p4b1/2p1q3/PpPp2P1/1P1P3P/3Q1PB1/R4K2 b - - 2 24,h5,-30,0,30,1
4r1k1/5pp1/1p4b1/2p1q2p/PpPp2P1/1P1P3P/3Q1PB1/R4K2 w - - 0 25,f4,0,1,1,1
4r1k1/5pp1/1p4b1/2p1q2p/PpPp1PP1/1P1P3P/3Q2B1/R4K2 b - - 0 25,Qe3,0,150,150,1
4r1k1/5pp1/1p4b1/2p4p/PpPp1PP1/1P1Pq2P/3Q2B1/R4K2 w - - 1 26,Rd1,127,-147,-274,0
4r1k1/5pp1/1p4b1/2p4p/PpPp1PP1/1P1Pq2P/3Q2B1/3R1K2 b - - 2 26,hxg4,-153,-154,-1,1
4r1k1/5pp1/1p4b1/2p5/PpPp1Pp1/1P1Pq2P/3Q2B1/3R1K2 w - - 0 27,hxg4,-105,-166,-61,1
4r1k1/5pp1/1p4b1/2p5/PpPp1PP1/1P1Pq3/3Q2B1/3R1K2 b - - 0 27,Qg3,-159,-65,94,1
4r1k1/5pp1/1p4b1/2p5/PpPp1PP1/1P1P2q1/3Q2B1/3R1K2 w - - 1 28,f5,-55,-80,-25,1
4r1k1/5pp1/1p4b1/2p2P2/PpPp2P1/1P1P2q1/3Q2B1/3R1K2 b - - 0 28,Bh7,-74,-72,2,1
4r1k1/5ppb/1p6/2p2P2/PpPp2P1/1P1P2q1/3Q2B1/3R1K2 w - - 1 29,Re1,-47,-48,-1,1
4r1k1/5ppb/1p6/2p2P2/PpPp2P1/1P1P2q1/3Q2B1/4RK2 b - - 2 29,Rf8,-38,45,83,1
5rk1/5ppb/1p6/2p2P2/PpPp2P1/1P1P2q1/3Q2B1/4RK2 w - - 3 30,Rd1,33,-335,-368,0
5rk1/5ppb/1p6/2p2P2/PpPp2P1/1P1P2q1/3Q2B1/3R1K2 b - - 4 30,Qxg4,-350,-367,-17,1
5rk1/5ppb/1p6/2p2P2/PpPp2q1/1P1P4/3Q2B1/3R1K2 w - - 0 31,Qf2,-374,-679,-305,0
5rk1/5ppb/1p6/2p2P2/PpPp2q1/1P1P4/5QB1/3R1K2 b - - 1 31,Qxf5,-683,-385,298,1
5rk1/5ppb/1p6/2p2q2/PpPp4/1P1P4/5QB1/3R1K2 w - - 0 32,Qxf5,-364,-376,-12,1
5rk1/5ppb/1p6/2p2Q2/PpPp4/1P1P4/6B1/3R1K2 b - - 0 32,Bxf5,-376,-390,-14,1
5rk1/5pp1/1p6/2p2b2/PpPp4/1P1P4/6B1/3R1K2 w - - 0 33,Kf2,-384,-368,16,1
5rk1/5pp1/1p6/2p2b2/PpPp4/1P1P4/5KB1/3R4 b - - 1 33,Be6,-395,-257,138,1
5rk1/5pp1/1p2b3/2p5/PpPp4/1P1P4/5KB1/3R4 w - - 2 34,Be4,-276,-318,-42,1
5rk1/5pp1/1p2b3/2p5/PpPpB3/1P1P4/5K2/3R4 b - - 3 34,f5,-335,-317,18,1
5rk1/6p1/1p2b3/2p2p2/PpPpB3/1P1P4/5K2/3R4 w - - 0 35,Bc6,-314,-328,-14,1
5rk1/6p1/1pB1b3/2p2p2/PpPp4/1P1P4/5K2/3R4 b - - 1 35,g5,-363,-320,43,1
5rk1/8/1pB1b3/2p2pp1/PpPp4/1P1P4/5K2/3R4 w - - 0 36,Rg1,-291,-336,-45,1
5rk1/8/1pB1b3/2p2pp1/PpPp4/1P1P4/5K2/6R1 b - - 1 36,g4,-282,-316,-34,1
5rk1/8/1pB1b3/2p2p2/PpPp2p1/1P1P4/5K2/6R1 w - - 0 37,Kg3,-288,-392,-104,0
5rk1/8/1pB1b3/2p2p2/PpPp2p1/1P1P2K1/8/6R1 b - - 1 37,Kg7,-433,-269,164,1
5r2/6k1/1pB1b3/2p2p2/PpPp2p1/1P1P2K1/8/6R1 w - - 2 38,Kf4,-249,-210,39,1
5r2/6k1/1pB1b3/2p2p2/PpPp1Kp1/1P1P4/8/6R1 b - - 3 38,Kf6,-248,-269,-21,1
5r2/8/1pB1bk2/2p2p2/PpPp1Kp1/1P1P4/8/6R1 w - - 4 39,Bg2,-307,-332,-25,1
5r2/8/1p2bk2/2p2p2/PpPp1Kp1/1P1P4/6B1/6R1 b - - 5 39,Rh8,-324,-301,23,1
7r/8/1p2bk2/2p2p2/PpPp1Kp1/1P1P4/6B1/6R1 w - - 6 40,Bc6,-281,-404,-123,0
7r/8/1pB1bk2/2p2p2/PpPp1Kp1/1P1P4/8/6R1 b - - 7 40,Rh3,-414,-417,-3,1
8/8/1pB1bk2/2p2p2/PpPp1Kp1/1P1P3r/8/6R1 w - - 8 41,Bb7,-409,-443,-34,1
8/1B6/1p2bk2/2p2p2/PpPp1Kp1/1P1P3r/8/6R1 b - - 9 41,Rxd3,-504,-509,-5,1
8/1B6/1p2bk2/2p2p2/PpPp1Kp1/1P1r4/8/6R1 w - - 0 42,Bc6,-522,-532,-10,1
8/8/1pB1bk2/2p2p2/PpPp1Kp1/1P1r4/8/6R1 b - - 1 42,Rxb3,-566,-547,19,1
rnbqkbnr/pppppppp/8/8/8/8/PPPPPPPP/RNBQKBNR w KQkq - 0 1,e4,36,35,-1,1
rnbqkbnr/pppppppp/8/8/4P3/8/PPPP1PPP/RNBQKBNR b KQkq - 0 1,c5,34,22,-12,1
rnbqkbnr/pp1ppppp/8/2p5/4P3/8/PPPP1PPP/RNBQKBNR w KQkq - 0 2,f4,25,-1,-26,1
rnbqkbnr/pp1ppppp/8/2p5/4PP2/8/PPPP2PP/RNBQKBNR b KQkq - 0 2,e6,4,10,6,1
rnbqkbnr/pp1p1ppp/4p3/2p5/4PP2/8/PPPP2PP/RNBQKBNR w KQkq - 0 3,Nf3,6,3,-3,1
rnbqkbnr/pp1p1ppp/4p3/2p5/4PP2/5N2/PPPP2PP/RNBQKB1R b KQkq - 1 3,h6,-1,45,46,1
rnbqkbnr/pp1p1pp1/4p2p/2p5/4PP2/5N2/PPPP2PP/RNBQKB1R w KQkq - 0 4,Bc4,52,-21,-73,1
rnbqkbnr/pp1p1pp1/4p2p/2p5/2B1PP2/5N2/PPPP2PP/RNBQK2R b KQkq - 1 4,a6,-16,15,31,1
rnbqkbnr/1p1p1pp1/p3p2p/2p5/2B1PP2/5N2/PPPP2PP/RNBQK2R w KQkq - 0 5,a4,27,-63,-90,1
rnbqkbnr/1p1p1pp1/p3p2p/2p5/P1B1PP2/5N2/1PPP2PP/RNBQK2R b KQkq - 0 5,Nc6,-55,33,88,1
r1bqkbnr/1p1p1pp1/p1n1p2p/2p5/P1B1PP2/5N2/1PPP2PP/RNBQK2R w KQkq - 1 6,d4,22,-111,-133,0
r1bqkbnr/1p1p1pp1/p1n1p2p/2p5/P1BPPP2/5N2/1PP3PP/RNBQK2R b KQkq - 0 6,cxd4,-117,-43,74,1
r1bqkbnr/1p1p1pp1/p1n1p2p/8/P1BpPP2/5N2/1PP3PP/RNBQK2R w KQkq - 0 7,Nxd4,-40,-46,-6,1
r1bqkbnr/1p1p1pp1/p1n1p2p/8/P1BNPP2/8/1PP3PP/RNBQK2R b KQkq - 0 7,Nxd4,-50,20,70,1
r1bqkbnr/1p1p1pp1/p3p2p/8/P1BnPP2/8/1PP3PP/RNBQK2R w KQkq - 0 8,Qxd4,31,7,-24,1
r1bqkbnr/1p1p1pp1/p3p2p/8/P1BQPP2/8/1PP3PP/RNB1K2R b KQkq - 0 8,Ne7,6,51,45,1
r1bqkb1r/1p1pnpp1/p3p2p/8/P1BQPP2/8/1PP3PP/RNB1K2R w KQkq - 1 9,O-O,82,4,-78,1
r1bqkb1r/1p1pnpp1/p3p2p/8/P1BQPP2/8/1PP3PP/RNB2RK1 b kq - 2 9,b6,24,106,82,1
r1bqkb1r/3pnpp1/pp2p2p/8/P1BQPP2/8/1PP3PP/RNB2RK1 w kq - 0 10,f5,105,-130,-235,0
r1bqkb1r/3pnpp1/pp2p2p/5P2/P1BQP3/8/1PP3PP/RNB2RK1 b kq - 0 10,Nxf5,-128,-151,-23,1
r1bqkb1r/3p1pp1/pp2p2p/5n2/P1BQP3/8/1PP3PP/RNB2RK1 w kq - 0 11,Qc3,-153,-137,16,1
r1bqkb1r/3p1pp1/pp2p2p/5n2/P1B1P3/2Q5/1PP3PP/RNB2RK1 b kq - 1 11,Bc5+,-98,6,104,1
r1bqk2r/3p1pp1/pp2p2p/2b2n2/P1B1P3/2Q5/1PP3PP/RNB2RK1 w kq - 2 12,Kh1,0,0,0,1
r1bqk2r/3p1pp1/pp2p2p/2b2n2/P1B1P3/2Q5/1PP3PP/RNB2R1K b kq - 3 12,Nd6,0,256,256,1
r1bqk2r/3p1pp1/pp1np2p/2b5/P1B1P3/2Q5/1PP3PP/RNB2R1K w kq - 4 13,Qxg7,279,145,-134,0
r1bqk2r/3p1pQ1/pp1np2p/2b5/P1B1P3/8/1PP3PP/RNB2R1K b kq - 0 13,Rf8,152,162,10,1
r1bqkr2/3p1pQ1/pp1np2p/2b5/P1B1P3/8/1PP3PP/RNB2R1K w q - 1 14,Bd3,191,168,-23,1
r1bqkr2/3p1pQ1/pp1np2p/2b5/P3P3/3B4/1PP3PP/RNB2R1K b q - 2 14,Bb7,184,179,-5,1
r2qkr2/1b1p1pQ1/pp1np2p/2b5/P3P3/3B4/1PP3PP/RNB2R1K w q - 3 15,Bxh6,177,169,-8,1
r2qkr2/1b1p1pQ1/pp1np2B/2b5/P3P3/3B4/1PP3PP/RN3R1K b q - 0 15,Qe7,157,283,126,1
r3kr2/1b1pqpQ1/pp1np2B/2b5/P3P3/3B4/1PP3PP/RN3R1K w q - 1 16,b4,321,99,-222,0
r3kr2/1b1pqpQ1/pp1np2B/2b5/PP2P3/3B4/2P3PP/RN3R1K b q - 0 16,Bxb4,115,105,-10,1
r3kr2/1b1pqpQ1/pp1np2B/8/Pb2P3/3B4/2P3PP/RN3R1K w q - 0 17,c3,99,180,81,1
r3kr2/1b1pqpQ1/pp1np2B/8/Pb2P3/2PB4/6PP/RN3R1K b q - 0 17,Bc5,154,150,-4,1
r3kr2/1b1pqpQ1/pp1np2B/2b5/P3P3/2PB4/6PP/RN3R1K w q - 1 18,e5,130,-138,-268,0
r3kr2/1b1pqpQ1/pp1np2B/2b1P3/P7/2PB4/6PP/RN3R1K b q - 0 18,Nf5,-134,147,281,1
r3kr2/1b1pqpQ1/pp2p2B/2b1Pn2/P7/2PB4/6PP/RN3R1K w q - 1 19,Bxf5,186,181,-5,1
r3kr2/1b1pqpQ1/pp2p2B/2b1PB2/P7/2P5/6PP/RN3R1K b q - 0 19,exf5,176,181,5,1
r3kr2/1b1pqpQ1/pp5B/2b1Pp2/P7/2P5/6PP/RN3R1K w q - 0 20,Bf4,185,-422,-607,0
r3kr2/1b1pqpQ1/pp6/2b1Pp2/P4B2/2P5/6PP/RN3R1K b q - 1 20,O-O-O,-410,-415,-5,1
2kr1r2/1b1pqpQ1/pp6/2b1Pp2/P4B2/2P5/6PP/RN3R1K w - - 2 21,Nd2,-449,-548,-99,1
2kr1r2/1b1pqpQ1/pp6/2b1Pp2/P4B2/2P5/3N2PP/R4R1K b - - 3 21,Rg8,-577,-573,4,1
rnbqkbnr/pppppppp/8/8/8/8/PPPPPPPP/RNBQKBNR w KQkq - 0 1,e4,32,35,3,1
rnbqkbnr/pppppppp/8/8/4P3/8/PPPP1PPP/RNBQKBNR b KQkq - 0 1,e6,29,38,9,1
rnbqkbnr/pppp1ppp/4p3/8/4P3/8/PPPP1PPP/RNBQKBNR w KQkq - 0 2,d4,34,30,-4,1
rnbqkbnr/pppp1ppp/4p3/8/3PP3/8/PPP2PPP/RNBQKBNR b KQkq - 0 2,d5,30,41,11,1
rnbqkbnr/ppp2ppp/4p3/3p4/3PP3/8/PPP2PPP/RNBQKBNR w KQkq - 0 3,exd5,45,2,-43,1
rnbqkbnr/ppp2ppp/4p3/3P4/3P4/8/PPP2PPP/RNBQKBNR b KQkq - 0 3,exd5,20,14,-6,1
rnbqkbnr/ppp2ppp/8/3p4/3P4/8/PPP2PPP/RNBQKBNR w KQkq - 0 4,c4,18,-19,-37,1
rnbqkbnr/ppp2ppp/8/3p4/2PP4/8/PP3PPP/RNBQKBNR b KQkq - 0 4,Nf6,-11,-8,3,1
rnbqkb1r/ppp2ppp/5n2/3p4/2PP4/8/PP3PPP/RNBQKBNR w KQkq - 1 5,Nc3,-3,-9,-6,1
rnbqkb1r/ppp2ppp/5n2/3p4/2PP4/2N5/PP3PPP/R1BQKBNR b KQkq - 2 5,dxc4,-9,60,69,1
rnbqkb1r/ppp2ppp/5n2/8/2pP4/2N5/PP3PPP/R1BQKBNR w KQkq - 0 6,Bxc4,42,39,-3,1
rnbqkb1r/ppp2ppp/5n2/8/2BP4/2N5/PP3PPP/R1BQK1NR b KQkq - 0 6,Be7,38,65,27,1
rnbqk2r/ppp1bppp/5n2/8/2BP4/2N5/PP3PPP/R1BQK1NR w KQkq - 1 7,Qb3,53,-46,-99,1
rnbqk2r/ppp1bppp/5n2/8/2BP4/1QN5/PP3PPP/R1B1K1NR b KQkq - 2 7,O-O,-48,-35,13,1
rnbq1rk1/ppp1bppp/5n2/8/2BP4/1QN5/PP3PPP/R1B1K1NR w KQ - 3 8,Nf3,-29,-19,10,1
rnbq1rk1/ppp1bppp/5n2/8/2BP4/1QN2N2/PP3PPP/R1B1K2R b KQ - 4 8,c6,-34,58,92,1
rnbq1rk1/pp2bppp/2p2n2/8/2BP4/1QN2N2/PP3PPP/R1B1K2R w KQ - 0 9,O-O,77,25,-52,1
rnbq1rk1/pp2bppp/2p2n2/8/2BP4/1QN2N2/PP3PPP/R1B2RK1 b - - 1 9,Nbd7,16,84,68,1
r1bq1rk1/pp1nbppp/2p2n2/8/2BP4/1QN2N2/PP3PPP/R1B2RK1 w - - 2 10,Bg5,86,-32,-118,0
r1bq1rk1/pp1nbppp/2p2n2/6B1/2BP4/1QN2N2/PP3PPP/R4RK1 b - - 3 10,Nb6,-34,-24,10,1
r1bq1rk1/pp2bppp/1np2n2/6B1/2BP4/1QN2N2/PP3PPP/R4RK1 w - - 4 11,Bd3,-21,-38,-17,1
r1bq1rk1/pp2bppp/1np2n2/6B1/3P4/1QNB1N2/PP3PPP/R4RK1 b - - 5 11,Be6,-32,-25,7,1
r2q1rk1/pp2bppp/1np1bn2/6B1/3P4/1QNB1N2/PP3PPP/R4RK1 w - - 6 12,Qc2,-24,-21,3,1
r2q1rk1/pp2bppp/1np1bn2/6B1/3P4/2NB1N2/PPQ2PPP/R4RK1 b - - 7 12,h6,-31,-22,9,1
r2q1rk1/pp2bpp1/1np1bn1p/6B1/3P4/2NB1N2/PPQ2PPP/R4RK1 w - - 0 13,Bh4,-16,-52,-36,1
r2q1rk1/pp2bpp1/1np1bn1p/8/3P3B/2NB1N2/PPQ2PPP/R4RK1 b - - 1 13,Nfd5,-33,-8,25,1
r2q1rk1/pp2bpp1/1np1b2p/3n4/3P3B/2NB1N2/PPQ2PPP/R4RK1 w - - 2 14,Bxe7,-7,-8,-1,1
r2q1rk1/pp2Bpp1/1np1b2p/3n4/3P4/2NB1N2/PPQ2PPP/R4RK1 b - - 0 14,Qxe7,-6,-9,-3,1
r4rk1/pp2qpp1/1np1b2p/3n4/3P4/2NB1N2/PPQ2PPP/R4RK1 w - - 0 15,Rfe1,-16,-32,-16,1
r4rk1/pp2qpp1/1np1b2p/3n4/3P4/2NB1N2/PPQ2PPP/R3R1K1 b - - 1 15,Nb4,-44,-27,17,1
r4rk1/pp2qpp1/1np1b2p/8/1n1P4/2NB1N2/PPQ2PPP/R3R1K1 w - - 2 16,Qb1,-41,-38,3,1
r4rk1/pp2qpp1/1np1b2p/8/1n1P4/2NB1N2/PP3PPP/RQ2R1K1 b - - 3 16,Nxd3,-32,-28,4,1
r4rk1/pp2qpp1/1np1b2p/8/3P4/2Nn1N2/PP3PPP/RQ2R1K1 w - - 0 17,Qxd3,-21,-29,-8,1
r4rk1/pp2qpp1/1np1b2p/8/3P4/2NQ1N2/PP3PPP/R3R1K1 b - - 0 17,Qd6,-30,-10,20,1
r4rk1/pp3pp1/1npqb2p/8/3P4/2NQ1N2/PP3PPP/R3R1K1 w - - 1 18,Ne4,4,0,-4,1
r4rk1/pp3pp1/1npqb2p/8/3PN3/3Q1N2/PP3PPP/R3R1K1 b - - 2 18,Qc7,0,50,50,1
r4rk1/ppq2pp1/1np1b2p/8/3PN3/3Q1N2/PP3PPP/R3R1K1 w - - 3 19,Nc5,139,-16,-155,0
r4rk1/ppq2pp1/1np1b2p/2N5/3P4/3Q1N2/PP3PPP/R3R1K1 b - - 4 19,Bd5,-27,-24,3,1
r4rk1/ppq2pp1/1np4p/2Nb4/3P4/3Q1N2/PP3PPP/R3R1K1 w - - 5 20,Ne5,-20,-25,-5,1
r4rk1/ppq2pp1/1np4p/2NbN3/3P4/3Q4/PP3PPP/R3R1K1 b - - 6 20,Nd7,-25,405,430,1
r4rk1/ppqn1pp1/2p4p/2NbN3/3P4/3Q4/PP3PPP/R3R1K1 w - - 7 21,Ncxd7,379,463,84,1
r4rk1/ppqN1pp1/2p4p/3bN3/3P4/3Q4/PP3PPP/R3R1K1 b - - 0 21,g6,455,632,177,1
r4rk1/ppqN1p2/2p3pp/3bN3/3P4/3Q4/PP3PPP/R3R1K1 w - - 0 22,Nxf8,564,581,17,1
r4Nk1/ppq2p2/2p3pp/3bN3/3P4/3Q4/PP3PPP/R3R1K1 b - - 0 22,Rxf8,525,523,-2,1
5rk1/ppq2p2/2p3pp/3bN3/3P4/3Q4/PP3PPP/R3R1K1 w - - 0 23,Qe3,513,511,-2,1
5rk1/ppq2p2/2p3pp/3bN3/3P4/4Q3/PP3PPP/R3R1K1 b - - 1 23,Kg7,531,547,16,1
5r2/ppq2pk1/2p3pp/3bN3/3P4/4Q3/PP3PPP/R3R1K1 w - - 2 24,Qf4,548,502,-46,1
5r2/ppq2pk1/2p3pp/3bN3/3P1Q2/8/PP3PPP/R3R1K1 b - - 3 24,f6,501,628,127,1
5r2/ppq3k1/2p2ppp/3bN3/3P1Q2/8/PP3PPP/R3R1K1 w - - 0 25,Nd3,644,522,-122,0
5r2/ppq3k1/2p2ppp/3b4/3P1Q2/3N4/PP3PPP/R3R1K1 b - - 1 25,Qxf4,486,577,91,1
5r2/pp4k1/2p2ppp/3b4/3P1q2/3N4/PP3PPP/R3R1K1 w - - 0 26,Nxf4,606,578,-28,1
5r2/pp4k1/2p2ppp/3b4/3P1N2/8/PP3PPP/R3R1K1 b - - 0 26,Bc4,562,583,21,1
5r2/pp4k1/2p2ppp/8/2bP1N2/8/PP3PPP/R3R1K1 w - - 1 27,Ne6+,570,597,27,1
5r2/pp4k1/2p1Nppp/8/2bP4/8/PP3PPP/R3R1K1 b - - 2 27,Bxe6,605,610,5,1
5r2/pp4k1/2p1bppp/8/3P4/8/PP3PPP/R3R1K1 w - - 0 28,Rxe6,609,578,-31,1
5r2/pp4k1/2p1Rppp/8/3P4/8/PP3PPP/R5K1 b - - 0 28,Rf7,578,598,20,1
8/pp3rk1/2p1Rppp/8/3P4/8/PP3PPP/R5K1 w - - 1 29,Rae1,588,592,4,1
8/pp3rk1/2p1Rppp/8/3P4/8/PP3PPP/4R1K1 b - - 2 29,g5,578,610,32,1
8/pp3rk1/2p1Rp1p/6p1/3P4/8/PP3PPP/4R1K1 w - - 0 30,Re7,588,551,-37,1
8/pp2Rrk1/2p2p1p/6p1/3P4/8/PP3PPP/4R1K1 b - - 1 30,Kg6,579,624,45,1
8/pp2Rr2/2p2pkp/6p1/3P4/8/PP3PPP/4R1K1 w - - 2 31,Rxf7,603,586,-17,1
8/pp3R2/2p2pkp/6p1/3P4/8/PP3PPP/4R1K1 b - - 0 31,Kxf7,598,571,-27,1
8/pp3k2/2p2p1p/6p1/3P4/8/PP3PPP/4R1K1 w - - 0 32,Rc1,572,542,-30,1
8/pp3k2/2p2p1p/6p1/3P4/8/PP3PPP/2R3K1 b - - 1 32,b6,569,643,74,1
8/p4k2/1pp2p1p/6p1/3P4/8/PP3PPP/2R3K1 w - - 0 33,d5,653,535,-118,0
rnbqkbnr/pppppppp/8/8/8/8/PPPPPPPP/RNBQKBNR w KQkq - 0 1,d4,26,28,2,1
rnbqkbnr/pppppppp/8/8/3P4/8/PPP1PPPP/RNBQKBNR b KQkq - 0 1,Nc6,25,63,38,1
r1bqkbnr/pppppppp/2n5/8/3P4/8/PPP1PPPP/RNBQKBNR w KQkq - 1 2,c4,68,53,-15,1
r1bqkbnr/pppppppp/2n5/8/2PP4/8/PP2PPPP/RNBQKBNR b KQkq - 0 2,Nf6,60,64,4,1
r1bqkb1r/pppppppp/2n2n2/8/2PP4/8/PP2PPPP/RNBQKBNR w KQkq - 1 3,Nc3,60,53,-7,1
r1bqkb1r/pppppppp/2n2n2/8/2PP4/2N5/PP2PPPP/R1BQKBNR b KQkq - 2 3,a6,61,119,58,1
r1bqkb1r/1ppppppp/p1n2n2/8/2PP4/2N5/PP2PPPP/R1BQKBNR w KQkq - 0 4,Nf3,139,89,-50,1
r1bqkb1r/1ppppppp/p1n2n2/8/2PP4/2N2N2/PP2PPPP/R1BQKB1R b KQkq - 1 4,h6,106,137,31,1
r1bqkb1r/1pppppp1/p1n2n1p/8/2PP4/2N2N2/PP2PPPP/R1BQKB1R w KQkq - 0 5,e4,144,122,-22,1
r1bqkb1r/1pppppp1/p1n2n1p/8/2PPP3/2N2N2/PP3PPP/R1BQKB1R b KQkq - 0 5,d5,123,376,253,1
r1bqkb1r/1pp1ppp1/p1n2n1p/3p4/2PPP3/2N2N2/PP3PPP/R1BQKB1R w KQkq - 0 6,e5,357,200,-157,0
r1bqkb1r/1pp1ppp1/p1n2n1p/3pP3/2PP4/2N2N2/PP3PPP/R1BQKB1R b KQkq - 0 6,Ne4,219,207,-12,1
r1bqkb1r/1pp1ppp1/p1n4p/3pP3/2PPn3/2N2N2/PP3PPP/R1BQKB1R w KQkq - 1 7,Nxd5,203,180,-23,1
r1bqkb1r/1pp1ppp1/p1n4p/3NP3/2PPn3/5N2/PP3PPP/R1BQKB1R b KQkq - 0 7,e6,207,199,-8,1
r1bqkb1r/1pp2pp1/p1n1p2p/3NP3/2PPn3/5N2/PP3PPP/R1BQKB1R w KQkq - 0 8,Nc3,235,214,-21,1
r1bqkb1r/1pp2pp1/p1n1p2p/4P3/2PPn3/2N2N2/PP3PPP/R1BQKB1R b KQkq - 1 8,Bb4,241,252,11,1
r1bqk2r/1pp2pp1/p1n1p2p/4P3/1bPPn3/2N2N2/PP3PPP/R1BQKB1R w KQkq - 2 9,Bd2,248,172,-76,1
r1bqk2r/1pp2pp1/p1n1p2p/4P3/1bPPn3/2N2N2/PP1B1PPP/R2QKB1R b KQkq - 3 9,Qf6,165,759,594,1
r1b1k2r/1pp2pp1/p1n1pq1p/4P3/1bPPn3/2N2N2/PP1B1PPP/R2QKB1R w KQkq - 4 10,exf6,750,729,-21,1
r1b1k2r/1pp2pp1/p1n1pP1p/8/1bPPn3/2N2N2/PP1B1PPP/R2QKB1R b KQkq - 0 10,gxf6,715,862,147,1
r1b1k2r/1pp2p2/p1n1pp1p/8/1bPPn3/2N2N2/PP1B1PPP/R2QKB1R w KQkq - 0 11,Nxe4,852,850,-2,1
r1b1k2r/1pp2p2/p1n1pp1p/8/1bPPN3/5N2/PP1B1PPP/R2QKB1R b KQkq - 0 11,Rg8,861,942,81,1
r1b1k1r1/1pp2p2/p1n1pp1p/8/1bPPN3/5N2/PP1B1PPP/R2QKB1R w KQq - 1 12,Nxf6+,930,939,9,1
rnbqkbnr/pppppppp/8/8/8/8/PPPPPPPP/RNBQKBNR w KQkq - 0 1,d4,31,26,-5,1
rnbqkbnr/pppppppp/8/8/3P4/8/PPP1PPPP/RNBQKBNR b KQkq - 0 1,d5,27,29,2,1
rnbqkbnr/ppp1pppp/8/3p4/3P4/8/PPP1PPPP/RNBQKBNR w KQkq - 0 2,c4,27,24,-3,1
rnbqkbnr/ppp1pppp/8/3p4/2PP4/8/PP2PPPP/RNBQKBNR b KQkq - 0 2,c6,25,35,10,1
rnbqkbnr/pp2pppp/2p5/3p4/2PP4/8/PP2PPPP/RNBQKBNR w KQkq - 0 3,Nc3,36,13,-23,1
rnbqkbnr/pp2pppp/2p5/3p4/2PP4/2N5/PP2PPPP/R1BQKBNR b KQkq - 1 3,Nf6,19,37,18,1
rnbqkb1r/pp2pppp/2p2n2/3p4/2PP4/2N5/PP2PPPP/R1BQKBNR w KQkq - 2 4,Nf3,42,26,-16,1
rnbqkb1r/pp2pppp/2p2n2/3p4/2PP4/2N2N2/PP2PPPP/R1BQKB1R b KQkq - 3 4,Bf5,19,69,50,1
rn1qkb1r/pp2pppp/2p2n2/3p1b2/2PP4/2N2N2/PP2PPPP/R1BQKB1R w KQkq - 4 5,Qb3,58,50,-8,1
rn1qkb1r/pp2pppp/2p2n2/3p1b2/2PP4/1QN2N2/PP2PPPP/R1B1KB1R b KQkq - 5 5,Qd7,50,261,211,1
rn2kb1r/pp1qpppp/2p2n2/3p1b2/2PP4/1QN2N2/PP2PPPP/R1B1KB1R w KQkq - 6 6,cxd5,232,176,-56,1
rn2kb1r/pp1qpppp/2p2n2/3P1b2/3P4/1QN2N2/PP2PPPP/R1B1KB1R b KQkq - 0 6,cxd5,196,201,5,1
rn2kb1r/pp1qpppp/5n2/3p1b2/3P4/1QN2N2/PP2PPPP/R1B1KB1R w KQkq - 0 7,Ne5,230,192,-38,1
rn2kb1r/pp1qpppp/5n2/3pNb2/3P4/1QN5/PP2PPPP/R1B1KB1R b KQkq - 1 7,Qc8,211,220,9,1
rnq1kb1r/pp2pppp/5n2/3pNb2/3P4/1QN5/PP2PPPP/R1B1KB1R w KQkq - 2 8,e4,191,207,16,1
rnq1kb1r/pp2pppp/5n2/3pNb2/3PP3/1QN5/PP3PPP/R1B1KB1R b KQkq - 0 8,Nxe4,230,185,-45,1
rnq1kb1r/pp2pppp/8/3pNb2/3Pn3/1QN5/PP3PPP/R1B1KB1R w KQkq - 0 9,Nxe4,225,216,-9,1
rnq1kb1r/pp2pppp/8/3pNb2/3PN3/1Q6/PP3PPP/R1B1KB1R b KQkq - 0 9,Bxe4,132,168,36,1
rnq1kb1r/pp2pppp/8/3pN3/3Pb3/1Q6/PP3PPP/R1B1KB1R w KQkq - 0 10,Bf4,170,187,17,1
rnq1kb1r/pp2pppp/8/3pN3/3PbB2/1Q6/PP3PPP/R3KB1R b KQkq - 1 10,a6,207,195,-12,1
rnq1kb1r/1p2pppp/p7/3pN3/3PbB2/1Q6/PP3PPP/R3KB1R w KQkq - 0 11,Rc1,191,181,-10,1
rnq1kb1r/1p2pppp/p7/3pN3/3PbB2/1Q6/PP3PPP/2R1KB1R b Kkq - 1 11,Nc6,175,157,-18,1
r1q1kb1r/1p2pppp/p1n5/3pN3/3PbB2/1Q6/PP3PPP/2R1KB1R w Kkq - 2 12,f3,162,102,-60,1
r1q1kb1r/1p2pppp/p1n5/3pN3/3PbB2/1Q3P2/PP4PP/2R1KB1R b Kkq - 0 12,Bf5,93,113,20,1
r1q1kb1r/1p2pppp/p1n5/3pNb2/3P1B2/1Q3P2/PP4PP/2R1KB1R w Kkq - 1 13,Qb6,98,-41,-139,0
r1q1kb1r/1p2pppp/pQn5/3pNb2/3P1B2/5P2/PP4PP/2R1KB1R b Kkq - 2 13,Bd7,-53,-71,-18,1
r1q1kb1r/1p1bpppp/pQn5/3pN3/3P1B2/5P2/PP4PP/2R1KB1R w Kkq - 3 14,Nxd7,-49,-140,-91,1
r1q1kb1r/1p1Npppp/pQn5/3p4/3P1B2/5P2/PP4PP/2R1KB1R b Kkq - 0 14,Kxd7,-169,-87,82,1
r1q2b1r/1p1kpppp/pQn5/3p4/3P1B2/5P2/PP4PP/2R1KB1R w K - 0 15,Bd3,-108,-96,12,1
r1q2b1r/1p1kpppp/pQn5/3p4/3P1B2/3B1P2/PP4PP/2R1K2R b K - 1 15,e6,-109,-69,40,1
r1q2b1r/1p1k1ppp/pQn1p3/3p4/3P1B2/3B1P2/PP4PP/2R1K2R w K - 0 16,O-O,-77,-80,-3,1
r1q2b1r/1p1k1ppp/pQn1p3/3p4/3P1B2/3B1P2/PP4PP/2R2RK1 b - - 1 16,Bd6,-65,7,72,1
r1q4r/1p1k1ppp/pQnbp3/3p4/3P1B2/3B1P2/PP4PP/2R2RK1 w - - 2 17,Bxd6,25,18,-7,1
r1q4r/1p1k1ppp/pQnBp3/3p4/3P4/3B1P2/PP4PP/2R2RK1 b - - 0 17,Kxd6,0,0,0,1
r1q4r/1p3ppp/pQnkp3/3p4/3P4/3B1P2/PP4PP/2R2RK1 w - - 0 18,Qc5+,0,-5,-5,1
r1q4r/1p3ppp/p1nkp3/2Qp4/3P4/3B1P2/PP4PP/2R2RK1 b - - 1 18,Kd7,-10,37,47,1
r1q4r/1p1k1ppp/p1n1p3/2Qp4/3P4/3B1P2/PP4PP/2R2RK1 w - - 2 19,b4,55,-114,-169,0
r1q4r/1p1k1ppp/p1n1p3/2Qp4/1P1P4/3B1P2/P5PP/2R2RK1 b - - 0 19,Qc7,-142,-109,33,1
r6r/1pqk1ppp/p1n1p3/2Qp4/1P1P4/3B1P2/P5PP/2R2RK1 w - - 1 20,b5,-113,-118,-5,1
r6r/1pqk1ppp/p1n1p3/1PQp4/3P4/3B1P2/P5PP/2R2RK1 b - - 0 20,axb5,-107,-100,7,1
r6r/1pqk1ppp/2n1p3/1pQp4/3P4/3B1P2/P5PP/2R2RK1 w - - 0 21,Bxb5,-86,-94,-8,1
r6r/1pqk1ppp/2n1p3/1BQp4/3P4/5P2/P5PP/2R2RK1 b - - 0 21,Qd6,-99,-73,26,1
r6r/1p1k1ppp/2nqp3/1BQp4/3P4/5P2/P5PP/2R2RK1 w - - 1 22,Qb6,-84,-89,-5,1
r6r/1p1k1ppp/1Qnqp3/1B1p4/3P4/5P2/P5PP/2R2RK1 b - - 2 22,Rab8,-98,0,98,1
1r5r/1p1k1ppp/1Qnqp3/1B1p4/3P4/5P2/P5PP/2R2RK1 w - - 3 23,Rc5,0,-129,-129,0
1r5r/1p1k1ppp/1Qnqp3/1BRp4/3P4/5P2/P5PP/5RK1 b - - 4 23,Rhc8,-138,-145,-7,1
1rr5/1p1k1ppp/1Qnqp3/1BRp4/3P4/5P2/P5PP/5RK1 w - - 5 24,Rfc1,-150,-242,-92,1
1rr5/1p1k1ppp/1Qnqp3/1BRp4/3P4/5P2/P5PP/2R3K1 b - - 6 24,Qc7,-217,-159,58,1
1rr5/1pqk1ppp/1Qn1p3/1BRp4/3P4/5P2/P5PP/2R3K1 w - - 7 25,Qxc7+,-162,-238,-76,1
1rr5/1pQk1ppp/2n1p3/1BRp4/3P4/5P2/P5PP/2R3K1 b - - 0 25,Rxc7,-218,-218,0,1
1r6/1prk1ppp/2n1p3/1BRp4/3P4/5P2/P5PP/2R3K1 w - - 0 26,a4,-212,-257,-45,1
1r6/1prk1ppp/2n1p3/1BRp4/P2P4/5P2/6PP/2R3K1 b - - 0 26,Kd6,-240,-209,31,1
1r6/1pr2ppp/2nkp3/1BRp4/P2P4/5P2/6PP/2R3K1 w - - 1 27,Bxc6,-228,-255,-27,1
1r6/1pr2ppp/2Bkp3/2Rp4/P2P4/5P2/6PP/2R3K1 b - - 0 27,bxc6,-259,-258,1,1
1r6/2r2ppp/2pkp3/2Rp4/P2P4/5P2/6PP/2R3K1 w - - 0 28,Kf2,-264,-411,-147,0
1r6/2r2ppp/2pkp3/2Rp4/P2P4/5P2/5KPP/2R5 b - - 1 28,Ra8,-417,-219,198,1
r7/2r2ppp/2pkp3/2Rp4/P2P4/5P2/5KPP/2R5 w - - 2 29,a5,-225,-218,7,1
r7/2r2ppp/2pkp3/P1Rp4/3P4/5P2/5KPP/2R5 b - - 0 29,Ra6,-202,-289,-87,1
8/2r2ppp/r1pkp3/P1Rp4/3P4/5P2/5KPP/2R5 w - - 1 30,Ra1,-270,-355,-85,1
8/2r2ppp/r1pkp3/P1Rp4/3P4/5P2/5KPP/R7 b - - 2 30,f5,-346,-126,220,1
8/2r3pp/r1pkp3/P1Rp1p2/3P4/5P2/5KPP/R7 w - - 0 31,Ke3,-128,-290,-162,0
8/2r3pp/r1pkp3/P1Rp1p2/3P4/4KP2/6PP/R7 b - - 1 31,g5,-284,-211,73,1
8/2r4p/r1pkp3/P1Rp1pp1/3P4/4KP2/6PP/R7 w - - 0 32,g4,-240,-243,-3,1
8/2r4p/r1pkp3/P1Rp1pp1/3P2P1/4KP2/7P/R7 b - - 0 32,f4+,-273,-286,-13,1
8/2r4p/r1pkp3/P1Rp2p1/3P1pP1/4KP2/7P/R7 w - - 0 33,Kd3,-274,-271,3,1
8/2r4p/r1pkp3/P1Rp2p1/3P1pP1/3K1P2/7P/R7 b - - 1 33,h6,-268,-255,13,1
8/2r5/r1pkp2p/P1Rp2p1/3P1pP1/3K1P2/7P/R7 w - - 0 34,Kc3,-286,-308,-22,1
8/2r5/r1pkp2p/P1Rp2p1/3P1pP1/2K2P2/7P/R7 b - - 1 34,e5,-335,-340,-5,1
8/2r5/r1pk3p/P1Rpp1p1/3P1pP1/2K2P2/7P/R7 w - - 0 35,Rb1,-359,-329,30,1
rnbqkbnr/pppppppp/8/8/8/8/PPPPPPPP/RNBQKBNR w KQkq - 0 1,e4,30,32,2,1
rnbqkbnr/pppppppp/8/8/4P3/8/PPPP1PPP/RNBQKBNR b KQkq - 0 1,e5,34,29,-5,1
rnbqkbnr/pppp1ppp/8/4p3/4P3/8/PPPP1PPP/RNBQKBNR w KQkq - 0 2,Nf3,31,30,-1,1
rnbqkbnr/pppp1ppp/8/4p3/4P3/5N2/PPPP1PPP/RNBQKB1R b KQkq - 1 2,Nc6,46,56,10,1
r1bqkbnr/pppp1ppp/2n5/4p3/4P3/5N2/PPPP1PPP/RNBQKB1R w KQkq - 2 3,Bc4,46,18,-28,1
r1bqkbnr/pppp1ppp/2n5/4p3/2B1P3/5N2/PPPP1PPP/RNBQK2R b KQkq - 3 3,Be7,19,44,25,1
r1bqk1nr/ppppbppp/2n5/4p3/2B1P3/5N2/PPPP1PPP/RNBQK2R w KQkq - 4 4,O-O,46,26,-20,1
r1bqk1nr/ppppbppp/2n5/4p3/2B1P3/5N2/PPPP1PPP/RNBQ1RK1 b kq - 5 4,Nf6,27,40,13,1
r1bqk2r/ppppbppp/2n2n2/4p3/2B1P3/5N2/PPPP1PPP/RNBQ1RK1 w kq - 6 5,Re1,35,6,-29,1
r1bqk2r/ppppbppp/2n2n2/4p3/2B1P3/5N2/PPPP1PPP/RNBQR1K1 b kq - 7 5,d6,-4,27,31,1
r1bqk2r/ppp1bppp/2np1n2/4p3/2B1P3/5N2/PPPP1PPP/RNBQR1K1 w kq - 0 6,h3,35,29,-6,1
r1bqk2r/ppp1bppp/2np1n2/4p3/2B1P3/5N1P/PPPP1PP1/RNBQR1K1 b kq - 0 6,O-O,25,33,8,1
r1bq1rk1/ppp1bppp/2np1n2/4p3/2B1P3/5N1P/PPPP1PP1/RNBQR1K1 w - - 1 7,d4,29,23,-6,1
r1bq1rk1/ppp1bppp/2np1n2/4p3/2BPP3/5N1P/PPP2PP1/RNBQR1K1 b - - 0 7,exd4,18,20,2,1
r1bq1rk1/ppp1bppp/2np1n2/8/2BpP3/5N1P/PPP2PP1/RNBQR1K1 w - - 0 8,Nxd4,19,12,-7,1
r1bq1rk1/ppp1bppp/2np1n2/8/2BNP3/7P/PPP2PP1/RNBQR1K1 b - - 0 8,Ne5,6,66,60,1
r1bq1rk1/ppp1bppp/3p1n2/4n3/2BNP3/7P/PPP2PP1/RNBQR1K1 w - - 1 9,Bb3,77,-9,-86,1
r1bq1rk1/ppp1bppp/3p1n2/4n3/3NP3/1B5P/PPP2PP1/RNBQR1K1 b - - 2 9,c5,5,15,10,1
r1bq1rk1/pp2bppp/3p1n2/2p1n3/3NP3/1B5P/PPP2PP1/RNBQR1K1 w - - 0 10,Nf3,21,15,-6,1
r1bq1rk1/pp2bppp/3p1n2/2p1n3/4P3/1B3N1P/PPP2PP1/RNBQR1K1 b - - 1 10,Ng6,6,52,46,1
r1bq1rk1/pp2bppp/3p1nn1/2p5/4P3/1B3N1P/PPP2PP1/RNBQR1K1 w - - 2 11,Nc3,51,46,-5,1
r1bq1rk1/pp2bppp/3p1nn1/2p5/4P3/1BN2N1P/PPP2PP1/R1BQR1K1 b - - 3 11,a6,49,64,15,1
r1bq1rk1/1p2bppp/p2p1nn1/2p5/4P3/1BN2N1P/PPP2PP1/R1BQR1K1 w - - 0 12,a3,73,-31,-104,0
r1bq1rk1/1p2bppp/p2p1nn1/2p5/4P3/PBN2N1P/1PP2PP1/R1BQR1K1 b - - 0 12,b5,-22,-16,6,1
r1bq1rk1/4bppp/p2p1nn1/1pp5/4P3/PBN2N1P/1PP2PP1/R1BQR1K1 w - - 0 13,Bd5,-5,-8,-3,1
r1bq1rk1/4bppp/p2p1nn1/1ppB4/4P3/P1N2N1P/1PP2PP1/R1BQR1K1 b - - 1 13,Nxd5,-9,-11,-2,1
r1bq1rk1/4bppp/p2p2n1/1ppn4/4P3/P1N2N1P/1PP2PP1/R1BQR1K1 w - - 0 14,exd5,-10,-60,-50,1
r1bq1rk1/4bppp/p2p2n1/1ppP4/8/P1N2N1P/1PP2PP1/R1BQR1K1 b - - 0 14,Bf6,-43,-12,31,1
r1bq1rk1/5ppp/p2p1bn1/1ppP4/8/P1N2N1P/1PP2PP1/R1BQR1K1 w - - 1 15,Ne4,-25,-30,-5,1
r1bq1rk1/5ppp/p2p1bn1/1ppP4/4N3/P4N1P/1PP2PP1/R1BQR1K1 b - - 2 15,Re8,-47,187,234,1
r1bqr1k1/5ppp/p2p1bn1/1ppP4/4N3/P4N1P/1PP2PP1/R1BQR1K1 w - - 3 16,Nxf6+,177,197,20,1
r1bqr1k1/5ppp/p2p1Nn1/1ppP4/8/P4N1P/1PP2PP1/R1BQR1K1 b - - 0 16,gxf6,170,194,24,1
r1bqr1k1/5p1p/p2p1pn1/1ppP4/8/P4N1P/1PP2PP1/R1BQR1K1 w - - 0 17,Rxe8+,206,123,-83,1
r1bqR1k1/5p1p/p2p1pn1/1ppP4/8/P4N1P/1PP2PP1/R1BQ2K1 b - - 0 17,Qxe8,126,123,-3,1
r1b1q1k1/5p1p/p2p1pn1/1ppP4/8/P4N1P/1PP2PP1/R1BQ2K1 w - - 0 18,Bh6,104,56,-48,1
r1b1q1k1/5p1p/p2p1pnB/1ppP4/8/P4N1P/1PP2PP1/R2Q2K1 b - - 1 18,Qe4,70,65,-5,1
r1b3k1/5p1p/p2p1pnB/1ppP4/4q3/P4N1P/1PP2PP1/R2Q2K1 w - - 2 19,Qd2,60,-68,-128,0
r1b3k1/5p1p/p2p1pnB/1ppP4/4q3/P4N1P/1PPQ1PP1/R5K1 b - - 3 19,Bf5,-65,174,239,1
r5k1/5p1p/p2p1pnB/1ppP1b2/4q3/P4N1P/1PPQ1PP1/R5K1 w - - 4 20,c3,188,-31,-219,0
r5k1/5p1p/p2p1pnB/1ppP1b2/4q3/P1P2N1P/1P1Q1PP1/R5K1 b - - 0 20,Ne5,-41,146,187,1
r5k1/5p1p/p2p1p1B/1ppPnb2/4q3/P1P2N1P/1P1Q1PP1/R5K1 w - - 1 21,Nxe5,180,228,48,1
r5k1/5p1p/p2p1p1B/1ppPNb2/4q3/P1P4P/1P1Q1PP1/R5K1 b - - 0 21,fxe5,217,9995,9778,1
r5k1/5p1p/p2p3B/1ppPpb2/4q3/P1P4P/1P1Q1PP1/R5K1 w - - 0 22,Re1,9995,266,-9729,0
r5k1/5p1p/p2p3B/1ppPpb2/4q3/P1P4P/1P1Q1PP1/4R1K1 b - - 1 22,Qh4,235,254,19,1
r5k1/5p1p/p2p3B/1ppPpb2/7q/P1P4P/1P1Q1PP1/4R1K1 w - - 2 23,Re3,267,38,-229,0
r5k1/5p1p/p2p3B/1ppPpb2/7q/P1P1R2P/1P1Q1PP1/6K1 b - - 3 23,Kh8,46,304,258,1
r6k/5p1p/p2p3B/1ppPpb2/7q/P1P1R2P/1P1Q1PP1/6K1 w - - 4 24,Rg3,338,321,-17,1
r6k/5p1p/p2p3B/1ppPpb2/7q/P1P3RP/1P1Q1PP1/6K1 b - - 5 24,Rg8,339,348,9,1
6rk/5p1p/p2p3B/1ppPpb2/7q/P1P3RP/1P1Q1PP1/6K1 w - - 6 25,Bg5,332,358,26,1
6rk/5p1p/p2p4/1ppPpbB1/7q/P1P3RP/1P1Q1PP1/6K1 b - - 7 25,Rxg5,351,350,-1,1
7k/5p1p/p2p4/1ppPpbr1/7q/P1P3RP/1P1Q1PP1/6K1 w - - 0 26,Rxg5,334,310,-24,1
7k/5p1p/p2p4/1ppPpbR1/7q/P1P4P/1P1Q1PP1/6K1 b - - 0 26,Bg6,340,338,-2,1
7k/5p1p/p2p2b1/1ppPp1R1/7q/P1P4P/1P1Q1PP1/6K1 w - - 1 27,Rg4,345,371,26,1
7k/5p1p/p2p2b1/1ppPp3/6Rq/P1P4P/1P1Q1PP1/6K1 b - - 2 27,Qe7,329,377,48,1
7k/4qp1p/p2p2b1/1ppPp3/6R1/P1P4P/1P1Q1PP1/6K1 w - - 3 28,Qe3,351,224,-127,0
7k/4qp1p/p2p2b1/1ppPp3/6R1/P1P1Q2P/1P3PP1/6K1 b - - 4 28,f5,266,288,22,1
7k/4q2p/p2p2b1/1ppPpp2/6R1/P1P1Q2P/1P3PP1/6K1 w - - 0 29,Qg5,265,188,-77,1
7k/4q2p/p2p2b1/1ppPppQ1/6R1/P1P4P/1P3PP1/6K1 b - - 1 29,Qxg5,189,169,-20,1
7k/7p/p2p2b1/1ppPppq1/6R1/P1P4P/1P3PP1/6K1 w - - 0 30,Rxg5,154,158,4,1
7k/7p/p2p2b1/1ppPppR1/8/P1P4P/1P3PP1/6K1 b - - 0 30,Kg7,183,200,17,1
8/6kp/p2p2b1/1ppPppR1/8/P1P4P/1P3PP1/6K1 w - - 1 31,h4,187,187,0,1
8/6kp/p2p2b1/1ppPppR1/7P/P1P5/1P3PP1/6K1 b - - 0 31,Kf6,150,211,61,1
8/7p/p2p1kb1/1ppPppR1/7P/P1P5/1P3PP1/6K1 w - - 1 32,Rg3,237,194,-43,1
8/7p/p2p1kb1/1ppPpp2/7P/P1P3R1/1P3PP1/6K1 b - - 2 32,f4,211,207,-4,1
8/7p/p2p1kb1/1ppPp3/5p1P/P1P3R1/1P3PP1/6K1 w - - 0 33,Rh3,226,150,-76,1
8/7p/p2p1kb1/1ppPp3/5p1P/P1P4R/1P3PP1/6K1 b - - 1 33,Bf5,128,184,56,1
8/7p/p2p1k2/1ppPpb2/5p1P/P1P4R/1P3PP1/6K1 w - - 2 34,Rh2,157,142,-15,1
8/7p/p2p1k2/1ppPpb2/5p1P/P1P5/1P3PPR/6K1 b - - 3 34,c4,144,278,134,1
8/7p/p2p1k2/1p1Ppb2/2p2p1P/P1P5/1P3PPR/6K1 w - - 0 35,g3,302,99,-203,0
8/7p/p2p1k2/1p1Ppb2/2p2p1P/P1P3P1/1P3P1R/6K1 b - - 0 35,f3,103,143,40,1
8/7p/p2p1k2/1p1Ppb2/2p4P/P1P2pP1/1P3P1R/6K1 w - - 0 36,Kf1,178,119,-59,1
8/7p/p2p1k2/1p1Ppb2/2p4P/P1P2pP1/1P3P1R/5K2 b - - 1 36,h5,88,158,70,1
8/8/p2p1k2/1p1Ppb1p/2p4P/P1P2pP1/1P3P1R/5K2 w - - 0 37,Ke1,183,176,-7,1
8/8/p2p1k2/1p1Ppb1p/2p4P/P1P2pP1/1P3P1R/4K3 b - - 1 37,Be4,198,174,-24,1
8/8/p2p1k2/1p1Pp2p/2p1b2P/P1P2pP1/1P3P1R/4K3 w - - 2 38,Kd2,201,208,7,1
8/8/p2p1k2/1p1Pp2p/2p1b2P/P1P2pP1/1P1K1P1R/8 b - - 3 38,Bxd5,201,192,-9,1
8/8/p2p1k2/1p1bp2p/2p4P/P1P2pP1/1P1K1P1R/8 w - - 0 39,Rh1,172,141,-31,1
8/8/p2p1k2/1p1bp2p/2p4P/P1P2pP1/1P1K1P2/7R b - - 1 39,e4,226,294,68,1
8/8/p2p1k2/1p1b3p/2p1p2P/P1P2pP1/1P1K1P2/7R w - - 0 40,Re1,310,97,-213,0
8/8/p2p1k2/1p1b3p/2p1p2P/P1P2pP1/1P1K1P2/4R3 b - - 1 40,Kf5,158,102,-56,1
8/8/p2p4/1p1b1k1p/2p1p2P/P1P2pP1/1P1K1P2/4R3 w - - 2 41,Re3,142,27,-115,0
8/8/p2p4/1p1b1k1p/2p1p2P/P1P1RpP1/1P1K1P2/8 b - - 3 41,Be6,2,23,21,1
8/8/p2pb3/1p3k1p/2p1p2P/P1P1RpP1/1P1K1P2/8 w - - 4 42,Kc1,32,0,-32,1
8/8/p2pb3/1p3k1p/2p1p2P/P1P1RpP1/1P3P2/2K5 b - - 5 42,d5,0,0,0,1
8/8/p3b3/1p1p1k1p/2p1p2P/P1P1RpP1/1P3P2/2K5 w - - 0 43,Kd2,0,0,0,1
8/8/p3b3/1p1p1k1p/2p1p2P/P1P1RpP1/1P1K1P2/8 b - - 1 43,Ke5,0,3,3,1
8/8/p3b3/1p1pk2p/2p1p2P/P1P1RpP1/1P1K1P2/8 w - - 2 44,Kc1,0,0,0,1
8/8/p3b3/1p1pk2p/2p1p2P/P1P1RpP1/1P3P2/2K5 b - - 3 44,d4,0,0,0,1
8/8/p3b3/1p2k2p/2ppp2P/P1P1RpP1/1P3P2/2K5 w - - 0 45,cxd4+,0,0,0,1
8/8/p3b3/1p2k2p/2pPp2P/P3RpP1/1P3P2/2K5 b - - 0 45,Kxd4,0,0,0,1
8/8/p3b3/1p5p/2pkp2P/P3RpP1/1P3P2/2K5 w - - 0 46,Kd2,0,0,0,1
8/8/p3b3/1p5p/2pkp2P/P3RpP1/1P1K1P2/8 b - - 1 46,Bf5,0,0,0,1
rnbqkbnr/pppppppp/8/8/8/8/PPPPPPPP/RNBQKBNR w KQkq - 0 1,e4,32,33,1,1
rnbqkbnr/pppppppp/8/8/4P3/8/PPPP1PPP/RNBQKBNR b KQkq - 0 1,e6,30,30,0,1
rnbqkbnr/pppp1ppp/4p3/8/4P3/8/PPPP1PPP/RNBQKBNR w KQkq - 0 2,d4,40,29,-11,1
rnbqkbnr/pppp1ppp/4p3/8/3PP3/8/PPP2PPP/RNBQKBNR b KQkq - 0 2,d5,33,26,-7,1
rnbqkbnr/ppp2ppp/4p3/3p4/3PP3/8/PPP2PPP/RNBQKBNR w KQkq - 0 3,e5,36,18,-18,1
rnbqkbnr/ppp2ppp/4p3/3pP3/3P4/8/PPP2PPP/RNBQKBNR b KQkq - 0 3,Bd7,18,25,7,1
rn1qkbnr/pppb1ppp/4p3/3pP3/3P4/8/PPP2PPP/RNBQKBNR w KQkq - 1 4,Nf3,29,22,-7,1
rn1qkbnr/pppb1ppp/4p3/3pP3/3P4/5N2/PPP2PPP/RNBQKB1R b KQkq - 2 4,a6,24,54,30,1
rn1qkbnr/1ppb1ppp/p3p3/3pP3/3P4/5N2/PPP2PPP/RNBQKB1R w KQkq - 0 5,c3,53,53,0,1
rn1qkbnr/1ppb1ppp/p3p3/3pP3/3P4/2P2N2/PP3PPP/RNBQKB1R b KQkq - 0 5,Bb5,53,53,0,1
rn1qkbnr/1pp2ppp/p3p3/1b1pP3/3P4/2P2N2/PP3PPP/RNBQKB1R w KQkq - 1 6,Bxb5+,52,52,0,1
rn1qkbnr/1pp2ppp/p3p3/1B1pP3/3P4/2P2N2/PP3PPP/RNBQK2R b KQkq - 0 6,axb5,57,50,-7,1
rn1qkbnr/1pp2ppp/4p3/1p1pP3/3P4/2P2N2/PP3PPP/RNBQK2R w KQkq - 0 7,O-O,49,59,10,1
rn1qkbnr/1pp2ppp/4p3/1p1pP3/3P4/2P2N2/PP3PPP/RNBQ1RK1 b kq - 1 7,Ne7,54,75,21,1
rn1qkb1r/1pp1nppp/4p3/1p1pP3/3P4/2P2N2/PP3PPP/RNBQ1RK1 w kq - 2 8,Bg5,83,15,-68,1
rn1qkb1r/1pp1nppp/4p3/1p1pP1B1/3P4/2P2N2/PP3PPP/RN1Q1RK1 b kq - 3 8,h6,15,16,1,1
rn1qkb1r/1pp1npp1/4p2p/1p1pP1B1/3P4/2P2N2/PP3PPP/RN1Q1RK1 w kq - 0 9,Bh4,13,-121,-134,0
rn1qkb1r/1pp1npp1/4p2p/1p1pP3/3P3B/2P2N2/PP3PPP/RN1Q1RK1 b kq - 1 9,Qd7,-103,-11,92,1
rn2kb1r/1ppqnpp1/4p2p/1p1pP3/3P3B/2P2N2/PP3PPP/RN1Q1RK1 w kq - 2 10,Nbd2,-24,-49,-25,1
rn2kb1r/1ppqnpp1/4p2p/1p1pP3/3P3B/2P2N2/PP1N1PPP/R2Q1RK1 b kq - 3 10,Nf5,-38,-25,13,1
rn2kb1r/1ppq1pp1/4p2p/1p1pPn2/3P3B/2P2N2/PP1N1PPP/R2Q1RK1 w kq - 4 11,Bg3,-27,-61,-34,1
rn2kb1r/1ppq1pp1/4p2p/1p1pPn2/3P4/2P2NB1/PP1N1PPP/R2Q1RK1 b kq - 5 11,Nxg3,-57,-13,44,1
rn2kb1r/1ppq1pp1/4p2p/1p1pP3/3P4/2P2Nn1/PP1N1PPP/R2Q1RK1 w kq - 0 12,fxg3,-6,-35,-29,1
rn2kb1r/1ppq1pp1/4p2p/1p1pP3/3P4/2P2NP1/PP1N2PP/R2Q1RK1 b kq - 0 12,b4,-43,-41,2,1
rn2kb1r/1ppq1pp1/4p2p/3pP3/1p1P4/2P2NP1/PP1N2PP/R2Q1RK1 w kq - 0 13,Nb3,-55,-87,-32,1
rn2kb1r/1ppq1pp1/4p2p/3pP3/1p1P4/1NP2NP1/PP4PP/R2Q1RK1 b kq - 1 13,bxc3,-71,-63,8,1
rn2kb1r/1ppq1pp1/4p2p/3pP3/3P4/1Np2NP1/PP4PP/R2Q1RK1 w kq - 0 14,bxc3,-68,-47,21,1
rn2kb1r/1ppq1pp1/4p2p/3pP3/3P4/1NP2NP1/P5PP/R2Q1RK1 b kq - 0 14,b6,-60,-32,28,1
rn2kb1r/2pq1pp1/1p2p2p/3pP3/3P4/1NP2NP1/P5PP/R2Q1RK1 w kq - 0 15,Ne1,-47,-52,-5,1
rn2kb1r/2pq1pp1/1p2p2p/3pP3/3P4/1NP3P1/P5PP/R2QNRK1 b kq - 1 15,Nc6,-52,8,60,1
r3kb1r/2pq1pp1/1pn1p2p/3pP3/3P4/1NP3P1/P5PP/R2QNRK1 w kq - 2 16,Nd3,26,-29,-55,1
r3kb1r/2pq1pp1/1pn1p2p/3pP3/3P4/1NPN2P1/P5PP/R2Q1RK1 b kq - 3 16,Be7,3,30,27,1
r3k2r/2pqbpp1/1pn1p2p/3pP3/3P4/1NPN2P1/P5PP/R2Q1RK1 w kq - 4 17,h4,39,25,-14,1
r3k2r/2pqbpp1/1pn1p2p/3pP3/3P3P/1NPN2P1/P5P1/R2Q1RK1 b kq - 0 17,O-O,24,74,50,1
r4rk1/2pqbpp1/1pn1p2p/3pP3/3P3P/1NPN2P1/P5P1/R2Q1RK1 w - - 1 18,Qg4,85,40,-45,1
r4rk1/2pqbpp1/1pn1p2p/3pP3/3P2QP/1NPN2P1/P5P1/R4RK1 b - - 2 18,Na5,61,146,85,1
r4rk1/2pqbpp1/1p2p2p/n2pP3/3P2QP/1NPN2P1/P5P1/R4RK1 w - - 3 19,Nd2,142,9,-133,0
r4rk1/2pqbpp1/1p2p2p/n2pP3/3P2QP/2PN2P1/P2N2P1/R4RK1 b - - 4 19,Qa4,18,26,8,1
r4rk1/2p1bpp1/1p2p2p/n2pP3/q2P2QP/2PN2P1/P2N2P1/R4RK1 w - - 5 20,Rf6,30,-209,-239,0
r4rk1/2p1bpp1/1p2pR1p/n2pP3/q2P2QP/2PN2P1/P2N2P1/R5K1 b - - 6 20,Kh7,-225,73,298,1
r4r2/2p1bppk/1p2pR1p/n2pP3/q2P2QP/2PN2P1/P2N2P1/R5K1 w - - 7 21,Rf2,61,-147,-208,0
r4r2/2p1bppk/1p2p2p/n2pP3/q2P2QP/2PN2P1/P2N1RP1/R5K1 b - - 8 21,Nc4,-129,-14,115,1
r4r2/2p1bppk/1p2p2p/3pP3/q1nP2QP/2PN2P1/P2N1RP1/R5K1 w - - 9 22,Nxc4,-44,-71,-27,1
r4r2/2p1bppk/1p2p2p/3pP3/q1NP2QP/2PN2P1/P4RP1/R5K1 b - - 0 22,Qxc4,-131,-77,54,1
r4r2/2p1bppk/1p2p2p/3pP3/2qP2QP/2PN2P1/P4RP1/R5K1 w - - 0 23,Rf3,-109,-98,11,1
r4r2/2p1bppk/1p2p2p/3pP3/2qP2QP/2PN1RP1/P5P1/R5K1 b - - 1 23,Rxa2,-113,101,214,1
5r2/2p1bppk/1p2p2p/3pP3/2qP2QP/2PN1RP1/r5P1/R5K1 w - - 0 24,Rc1,91,-93,-184,0
5r2/2p1bppk/1p2p2p/3pP3/2qP2QP/2PN1RP1/r5P1/2R3K1 b - - 1 24,Qa6,-119,-98,21,1
5r2/2p1bppk/qp2p2p/3pP3/3P2QP/2PN1RP1/r5P1/2R3K1 w - - 2 25,Rcf1,-117,-134,-17,1
5r2/2p1bppk/qp2p2p/3pP3/3P2QP/2PN1RP1/r5P1/5RK1 b - - 3 25,Ra1,-138,-140,-2,1
5r2/2p1bppk/qp2p2p/3pP3/3P2QP/2PN1RP1/6P1/r4RK1 w - - 4 26,Kh2,-127,-451,-324,0
5r2/2p1bppk/qp2p2p/3pP3/3P2QP/2PN1RP1/6PK/r4R2 b - - 5 26,Rxf1,-456,-436,20,1
5r2/2p1bppk/qp2p2p/3pP3/3P2QP/2PN1RP1/6PK/5r2 w - - 0 27,Rxf1,-478,-465,13,1
5r2/2p1bppk/qp2p2p/3pP3/3P2QP/2PN2P1/6PK/5R2 b - - 0 27,Qxd3,-488,-464,24,1
5r2/2p1bppk/1p2p2p/3pP3/3P2QP/2Pq2P1/6PK/5R2 w - - 0 28,Rf3,-475,-560,-85,1
5r2/2p1bppk/1p2p2p/3pP3/3P2QP/2Pq1RP1/6PK/8 b - - 1 28,Qe4,-536,-452,84,1
5r2/2p1bppk/1p2p2p/3pP3/3Pq1QP/2P2RP1/6PK/8 w - - 2 29,Rf4,-477,-472,5,1
5r2/2p1bppk/1p2p2p/3pP3/3PqRQP/2P3P1/6PK/8 b - - 3 29,Qg6,-478,-382,96,1
5r2/2p1bppk/1p2p1qp/3pP3/3P1RQP/2P3P1/6PK/8 w - - 4 30,Qf3,-435,-450,-15,1
5r2/2p1bppk/1p2p1qp/3pP3/3P1R1P/2P2QP1/6PK/8 b - - 5 30,f5,-438,-436,2,1
5r2/2p1b1pk/1p2p1qp/3pPp2/3P1R1P/2P2QP1/6PK/8 w - f6 0 31,h5,-434,-532,-98,1
5r2/2p1b1pk/1p2p1qp/3pPp1P/3P1R2/2P2QP1/6PK/8 b - - 0 31,Qe8,-515,-503,12,1
4qr2/2p1b1pk/1p2p2p/3pPp1P/3P1R2/2P2QP1/6PK/8 w - - 1 32,Qd3,-478,-508,-30,1
4qr2/2p1b1pk/1p2p2p/3pPp1P/3P1R2/2PQ2P1/6PK/8 b - - 2 32,Qa4,-515,-388,127,1
5r2/2p1b1pk/1p2p2p/3pPp1P/q2P1R2/2PQ2P1/6PK/8 w - - 3 33,g4,-419,-435,-16,1
5r2/2p1b1pk/1p2p2p/3pPp1P/q2P1RP1/2PQ4/6PK/8 b - - 0 33,Bg5,-409,-412,-3,1
5r2/2p3pk/1p2p2p/3pPpbP/q2P1RP1/2PQ4/6PK/8 w - - 1 34,Rf3,-440,-434,6,1
5r2/2p3pk/1p2p2p/3pPpbP/q2P2P1/2PQ1R2/6PK/8 b - - 2 34,Qd7,-420,-409,11,1
5r2/2pq2pk/1p2p2p/3pPpbP/3P2P1/2PQ1R2/6PK/8 w - - 3 35,gxf5,-415,-418,-3,1
5r2/2pq2pk/1p2p2p/3pPPbP/3P4/2PQ1R2/6PK/8 b - - 0 35,exf5,-393,-417,-24,1
5r2/2pq2pk/1p5p/3pPpbP/3P4/2PQ1R2/6PK/8 w - - 0 36,g4,-389,-384,5,1
5r2/2pq2pk/1p5p/3pPpbP/3P2P1/2PQ1R2/7K/8 b - - 0 36,Kh8,-419,-409,10,1
5r1k/2pq2p1/1p5p/3pPpbP/3P2P1/2PQ1R2/7K/8 w - - 1 37,gxf5,-378,-392,-14,1
5r1k/2pq2p1/1p5p/3pPPbP/3P4/2PQ1R2/7K/8 b - - 0 37,Qf7,-370,-390,-20,1
5r1k/2p2qp1/1p5p/3pPPbP/3P4/2PQ1R2/7K/8 w - - 1 38,f6,-373,-474,-101,0
5r1k/2p2qp1/1p3P1p/3pP1bP/3P4/2PQ1R2/7K/8 b - - 0 38,Qxh5+,-458,-405,53,1
5r1k/2p3p1/1p3P1p/3pP1bq/3P4/2PQ1R2/7K/8 w - - 0 39,Kg2,-431,-453,-22,1
5r1k/2p3p1/1p3P1p/3pP1bq/3P4/2PQ1R2/6K1/8 b - - 1 39,gxf6,-423,-468,-45,1
5r1k/2p5/1p3p1p/3pP1bq/3P4/2PQ1R2/6K1/8 w - - 0 40,exf6,-434,-493,-59,1
5r1k/2p5/1p3P1p/3p2bq/3P4/2PQ1R2/6K1/8 b - - 0 40,Rxf6,-518,-491,27,1
7k/2p5/1p3r1p/3p2bq/3P4/2PQ1R2/6K1/8 w - - 0 41,Rxf6,-453,-487,-34,1
7k/2p5/1p3R1p/3p2bq/3P4/2PQ4/6K1/8 b - - 0 41,Bxf6,-455,-490,-35,1
7k/2p5/1p3b1p/3p3q/3P4/2PQ4/6K1/8 w - - 0 42,Qe3,-464,-608,-144,0
7k/2p5/1p3b1p/3p3q/3P4/2P1Q3/6K1/8 b - - 1 42,Qg5+,-584,-551,33,1
7k/2p5/1p3b1p/3p2q1/3P4/2P1Q3/6K1/8 w - - 2 43,Qxg5,-536,-617,-81,1
7k/2p5/1p3b1p/3p2Q1/3P4/2P5/6K1/8 b - - 0 43,hxg5,-644,-607,37,1
7k/2p5/1p3b2/3p2p1/3P4/2P5/6K1/8 w - - 0 44,Kf3,-661,-657,4,1
7k/2p5/1p3b2/3p2p1/3P4/2P2K2/8/8 b - - 1 44,Kg7,-686,-674,12,1
8/2p3k1/1p3b2/3p2p1/3P4/2P2K2/8/8 w - - 2 45,Kg4,-696,-710,-14,1
8/2p3k1/1p3b2/3p2p1/3P2K1/2P5/8/8 b - - 3 45,Kg6,-714,-734,-20,1
rnbqkbnr/pppppppp/8/8/8/8/PPPPPPPP/RNBQKBNR w KQkq - 0 1,Nf3,32,12,-20,1
rnbqkbnr/pppppppp/8/8/8/5N2/PPPPPPPP/RNBQKB1R b KQkq - 1 1,c5,12,28,16,1
rnbqkbnr/pp1ppppp/8/2p5/8/5N2/PPPPPPPP/RNBQKB1R w KQkq - 0 2,d4,36,-4,-40,1
rnbqkbnr/pp1ppppp/8/2p5/3P4/5N2/PPP1PPPP/RNBQKB1R b KQkq - 0 2,d6,-6,108,114,1
rnbqkbnr/pp2pppp/3p4/2p5/3P4/5N2/PPP1PPPP/RNBQKB1R w KQkq - 0 3,dxc5,101,114,13,1
rnbqkbnr/pp2pppp/3p4/2P5/8/5N2/PPP1PPPP/RNBQKB1R b KQkq - 0 3,e5,85,174,89,1
rnbqkbnr/pp3ppp/3p4/2P1p3/8/5N2/PPP1PPPP/RNBQKB1R w KQkq - 0 4,cxd6,169,120,-49,1
rnbqkbnr/pp3ppp/3P4/4p3/8/5N2/PPP1PPPP/RNBQKB1R b KQkq - 0 4,Bxd6,118,125,7,1
rnbqk1nr/pp3ppp/3b4/4p3/8/5N2/PPP1PPPP/RNBQKB1R w KQkq - 0 5,e3,118,85,-33,1
rnbqk1nr/pp3ppp/3b4/4p3/8/4PN2/PPP2PPP/RNBQKB1R b KQkq - 0 5,Nc6,69,100,31,1
r1bqk1nr/pp3ppp/2nb4/4p3/8/4PN2/PPP2PPP/RNBQKB1R w KQkq - 1 6,Bb5,89,36,-53,1
r1bqk1nr/pp3ppp/2nb4/1B2p3/8/4PN2/PPP2PPP/RNBQK2R b KQkq - 2 6,Ne7,57,96,39,1
r1bqk2r/pp2nppp/2nb4/1B2p3/8/4PN2/PPP2PPP/RNBQK2R w KQkq - 3 7,O-O,93,90,-3,1
r1bqk2r/pp2nppp/2nb4/1B2p3/8/4PN2/PPP2PPP/RNBQ1RK1 b kq - 4 7,O-O,87,82,-5,1
r1bq1rk1/pp2nppp/2nb4/1B2p3/8/4PN2/PPP2PPP/RNBQ1RK1 w - - 5 8,h3,76,62,-14,1
r1bq1rk1/pp2nppp/2nb4/1B2p3/8/4PN1P/PPP2PP1/RNBQ1RK1 b - - 0 8,Bd7,75,398,323,1
r2q1rk1/pp1bnppp/2nb4/1B2p3/8/4PN1P/PPP2PP1/RNBQ1RK1 w - - 1 9,Nc3,374,127,-247,0
r2q1rk1/pp1bnppp/2nb4/1B2p3/8/2N1PN1P/PPP2PP1/R1BQ1RK1 b - - 2 9,a6,140,166,26,1
r2q1rk1/1p1bnppp/p1nb4/1B2p3/8/2N1PN1P/PPP2PP1/R1BQ1RK1 w - - 0 10,Bd3,124,143,19,1
r2q1rk1/1p1bnppp/p1nb4/4p3/8/2NBPN1P/PPP2PP1/R1BQ1RK1 b - - 1 10,Nb4,143,175,32,1
r2q1rk1/1p1bnppp/p2b4/4p3/1n6/2NBPN1P/PPP2PP1/R1BQ1RK1 w - - 2 11,Bxh7+,134,177,43,1
r2q1rk1/1p1bnppB/p2b4/4p3/1n6/2N1PN1P/PPP2PP1/R1BQ1RK1 b - - 0 11,Kxh7,165,162,-3,1
r2q1r2/1p1bnppk/p2b4/4p3/1n6/2N1PN1P/PPP2PP1/R1BQ1RK1 w - - 0 12,Qxd6,164,147,-17,1
r2q1r2/1p1bnppk/p2Q4/4p3/1n6/2N1PN1P/PPP2PP1/R1B2RK1 b - - 0 12,e4,159,398,239,1
r2q1r2/1p1bnppk/p2Q4/8/1n2p3/2N1PN1P/PPP2PP1/R1B2RK1 w - - 0 13,Ng5+,419,395,-24,1
r2q1r2/1p1bnppk/p2Q4/6N1/1n2p3/2N1P2P/PPP2PP1/R1B2RK1 b - - 1 13,Kg8,402,421,19,1
r2q1rk1/1p1bnpp1/p2Q4/6N1/1n2p3/2N1P2P/PPP2PP1/R1B2RK1 w - - 2 14,Qxb4,410,409,-1,1
r2q1rk1/1p1bnpp1/p7/6N1/1Q2p3/2N1P2P/PPP2PP1/R1B2RK1 b - - 0 14,Bb5,385,551,166,1
r2q1rk1/1p2npp1/p7/1b4N1/1Q2p3/2N1P2P/PPP2PP1/R1B2RK1 w - - 1 15,Nxb5,554,537,-17,1
r2q1rk1/1p2npp1/p7/1N4N1/1Q2p3/4P2P/PPP2PP1/R1B2RK1 b - - 0 15,axb5,530,532,2,1
r2q1rk1/1p2npp1/8/1p4N1/1Q2p3/4P2P/PPP2PP1/R1B2RK1 w - - 0 16,Qxe4,528,570,42,1
r2q1rk1/1p2npp1/8/1p4N1/4Q3/4P2P/PPP2PP1/R1B2RK1 b - - 0 16,Nc6,531,9999,9468,1
r2q1rk1/1p3pp1/2n5/1p4N1/4Q3/4P2P/PPP2PP1/R1B2RK1 w - - 1 17,Qh7#,9999,10000,1,1
rnbqkbnr/pppppppp/8/8/8/8/PPPPPPPP/RNBQKBNR w KQkq - 0 1,e4,32,35,3,1
rnbqkbnr/pppppppp/8/8/4P3/8/PPPP1PPP/RNBQKBNR b KQkq - 0 1,e5,33,47,14,1
rnbqkbnr/pppp1ppp/8/4p3/4P3/8/PPPP1PPP/RNBQKBNR w KQkq - 0 2,Bc4,48,-12,-60,1
rnbqkbnr/pppp1ppp/8/4p3/2B1P3/8/PPPP1PPP/RNBQK1NR b KQkq - 1 2,Nc6,-7,38,45,1
r1bqkbnr/pppp1ppp/2n5/4p3/2B1P3/8/PPPP1PPP/RNBQK1NR w KQkq - 2 3,c3,31,-20,-51,1
r1bqkbnr/pppp1ppp/2n5/4p3/2B1P3/2P5/PP1P1PPP/RNBQK1NR b KQkq - 0 3,Nf6,-16,-19,-3,1
r1bqkb1r/pppp1ppp/2n2n2/4p3/2B1P3/2P5/PP1P1PPP/RNBQK1NR w KQkq - 1 4,Qf3,-13,-80,-67,1
r1bqkb1r/pppp1ppp/2n2n2/4p3/2B1P3/2P2Q2/PP1P1PPP/RNB1K1NR b KQkq - 2 4,Bc5,-63,-10,53,1
r1bqk2r/pppp1ppp/2n2n2/2b1p3/2B1P3/2P2Q2/PP1P1PPP/RNB1K1NR w KQkq - 3 5,g4,-2,-238,-236,0
r1bqk2r/pppp1ppp/2n2n2/2b1p3/2B1P1P1/2P2Q2/PP1P1P1P/RNB1K1NR b KQkq - 0 5,d6,-207,-76,131,1
r1bqk2r/ppp2ppp/2np1n2/2b1p3/2B1P1P1/2P2Q2/PP1P1P1P/RNB1K1NR w KQkq - 0 6,g5,-30,-42,-12,1
r1bqk2r/ppp2ppp/2np1n2/2b1p1P1/2B1P3/2P2Q2/PP1P1P1P/RNB1K1NR b KQkq - 0 6,Bg4,-46,87,133,1
r2qk2r/ppp2ppp/2np1n2/2b1p1P1/2B1P1b1/2P2Q2/PP1P1P1P/RNB1K1NR w KQkq - 1 7,Qg3,86,-71,-157,0
r2qk2r/ppp2ppp/2np1n2/2b1p1P1/2B1P1b1/2P3Q1/PP1P1P1P/RNB1K1NR b KQkq - 2 7,Nxe4,-71,-46,25,1
r2qk2r/ppp2ppp/2np4/2b1p1P1/2B1n1b1/2P3Q1/PP1P1P1P/RNB1K1NR w KQkq - 0 8,Qxg4,-32,-70,-38,1
r2qk2r/ppp2ppp/2np4/2b1p1P1/2B1n1Q1/2P5/PP1P1P1P/RNB1K1NR b KQkq - 0 8,Nxf2,-50,22,72,1
r2qk2r/ppp2ppp/2np4/2b1p1P1/2B3Q1/2P5/PP1P1n1P/RNB1K1NR w KQkq - 0 9,Qg2,16,-240,-256,0
r2qk2r/ppp2ppp/2np4/2b1p1P1/2B5/2P5/PP1P1nQP/RNB1K1NR b KQkq - 1 9,Nxh1,-262,-258,4,1
r2qk2r/ppp2ppp/2np4/2b1p1P1/2B5/2P5/PP1P2QP/RNB1K1Nn w Qkq - 0 10,Qxh1,-244,-333,-89,1
r2qk2r/ppp2ppp/2np4/2b1p1P1/2B5/2P5/PP1P3P/RNB1K1NQ b Qkq - 0 10,Qxg5,-327,-352,-25,1
r3k2r/ppp2ppp/2np4/2b1p1q1/2B5/2P5/PP1P3P/RNB1K1NQ w Qkq - 0 11,Nf3,-336,-333,3,1
r3k2r/ppp2ppp/2np4/2b1p1q1/2B5/2P2N2/PP1P3P/RNB1K2Q b Qkq - 1 11,Qe7,-336,-248,88,1
r3k2r/ppp1qppp/2np4/2b1p3/2B5/2P2N2/PP1P3P/RNB1K2Q w Qkq - 2 12,d3,-215,-336,-121,0
r3k2r/ppp1qppp/2np4/2b1p3/2B5/2PP1N2/PP5P/RNB1K2Q b Qkq - 0 12,O-O,-288,-207,81,1
r4rk1/ppp1qppp/2np4/2b1p3/2B5/2PP1N2/PP5P/RNB1K2Q w Q - 1 13,Qg1,-241,-603,-362,0
r4rk1/ppp1qppp/2np4/2b1p3/2B5/2PP1N2/PP5P/RNB1K1Q1 b Q - 2 13,Bxg1,-658,-662,-4,1
r4rk1/ppp1qppp/2np4/4p3/2B5/2PP1N2/PP5P/RNB1K1b1 w Q - 0 14,Nxg1,-699,-776,-77,1
r4rk1/ppp1qppp/2np4/4p3/2B5/2PP4/PP5P/RNB1K1N1 b Q - 0 14,Na5,-756,-730,26,1
r4rk1/ppp1qppp/3p4/n3p3/2B5/2PP4/PP5P/RNB1K1N1 w Q - 1 15,Bd2,-750,-826,-76,1
r4rk1/ppp1qppp/3p4/n3p3/2B5/2PP4/PP1B3P/RN2K1N1 b Q - 2 15,Nxc4,-824,-816,8,1
r4rk1/ppp1qppp/3p4/4p3/2n5/2PP4/PP1B3P/RN2K1N1 w Q - 0 16,dxc4,-805,-816,-11,1
rnbqkbnr/pppppppp/8/8/8/8/PPPPPPPP/RNBQKBNR w KQkq - 0 1,e4,36,41,5,1
rnbqkbnr/pppppppp/8/8/4P3/8/PPPP1PPP/RNBQKBNR b KQkq - 0 1,e5,32,44,12,1
rnbqkbnr/pppp1ppp/8/4p3/4P3/8/PPPP1PPP/RNBQKBNR w KQkq - 0 2,Nf3,36,48,12,1
rnbqkbnr/pppp1ppp/8/4p3/4P3/5N2/PPPP1PPP/RNBQKB1R b KQkq - 1 2,Nc6,54,51,-3,1
r1bqkbnr/pppp1ppp/2n5/4p3/4P3/5N2/PPPP1PPP/RNBQKB1R w KQkq - 2 3,Bb5,55,47,-8,1
r1bqkbnr/pppp1ppp/2n5/1B2p3/4P3/5N2/PPPP1PPP/RNBQK2R b KQkq - 3 3,Bc5,47,49,2,1
r1bqk1nr/pppp1ppp/2n5/1Bb1p3/4P3/5N2/PPPP1PPP/RNBQK2R w KQkq - 4 4,O-O,57,36,-21,1
r1bqk1nr/pppp1ppp/2n5/1Bb1p3/4P3/5N2/PPPP1PPP/RNBQ1RK1 b kq - 5 4,d6,51,45,-6,1
r1bqk1nr/ppp2ppp/2np4/1Bb1p3/4P3/5N2/PPPP1PPP/RNBQ1RK1 w kq - 0 5,h3,50,23,-27,1
r1bqk1nr/ppp2ppp/2np4/1Bb1p3/4P3/5N1P/PPPP1PP1/RNBQ1RK1 b kq - 0 5,Bd7,4,43,39,1
r2qk1nr/pppb1ppp/2np4/1Bb1p3/4P3/5N1P/PPPP1PP1/RNBQ1RK1 w kq - 1 6,c3,40,42,2,1
r2qk1nr/pppb1ppp/2np4/1Bb1p3/4P3/2P2N1P/PP1P1PP1/RNBQ1RK1 b kq - 0 6,a6,55,70,15,1
r2qk1nr/1ppb1ppp/p1np4/1Bb1p3/4P3/2P2N1P/PP1P1PP1/RNBQ1RK1 w kq - 0 7,Ba4,48,53,5,1
r2qk1nr/1ppb1ppp/p1np4/2b1p3/B3P3/2P2N1P/PP1P1PP1/RNBQ1RK1 b kq - 1 7,b5,50,72,22,1
r2qk1nr/2pb1ppp/p1np4/1pb1p3/B3P3/2P2N1P/PP1P1PP1/RNBQ1RK1 w kq - 0 8,Bc2,71,69,-2,1
r2qk1nr/2pb1ppp/p1np4/1pb1p3/4P3/2P2N1P/PPBP1PP1/RNBQ1RK1 b kq - 1 8,Nf6,54,72,18,1
r2qk2r/2pb1ppp/p1np1n2/1pb1p3/4P3/2P2N1P/PPBP1PP1/RNBQ1RK1 w kq - 2 9,Re1,56,64,8,1
r2qk2r/2pb1ppp/p1np1n2/1pb1p3/4P3/2P2N1P/PPBP1PP1/RNBQR1K1 b kq - 3 9,h6,62,53,-9,1
r2qk2r/2pb1pp1/p1np1n1p/1pb1p3/4P3/2P2N1P/PPBP1PP1/RNBQR1K1 w kq - 0 10,d4,57,63,6,1
r2qk2r/2pb1pp1/p1np1n1p/1pb1p3/3PP3/2P2N1P/PPB2PP1/RNBQR1K1 b kq - 0 10,Bb6,58,65,7,1
r2qk2r/2pb1pp1/pbnp1n1p/1p2p3/3PP3/2P2N1P/PPB2PP1/RNBQR1K1 w kq - 1 11,d5,62,-31,-93,1
r2qk2r/2pb1pp1/pbnp1n1p/1p1Pp3/4P3/2P2N1P/PPB2PP1/RNBQR1K1 b kq - 0 11,Na5,-63,6,69,1
r2qk2r/2pb1pp1/pb1p1n1p/np1Pp3/4P3/2P2N1P/PPB2PP1/RNBQR1K1 w kq - 1 12,Nbd2,-14,-35,-21,1
r2qk2r/2pb1pp1/pb1p1n1p/np1Pp3/4P3/2P2N1P/PPBN1PP1/R1BQR1K1 b kq - 2 12,g5,-57,-38,19,1
r2qk2r/2pb1p2/pb1p1n1p/np1Pp1p1/4P3/2P2N1P/PPBN1PP1/R1BQR1K1 w kq - 0 13,b3,-25,-137,-112,0
r2qk2r/2pb1p2/pb1p1n1p/np1Pp1p1/4P3/1PP2N1P/P1BN1PP1/R1BQR1K1 b kq - 0 13,g4,-130,-166,-36,1
r2qk2r/2pb1p2/pb1p1n1p/np1Pp3/4P1p1/1PP2N1P/P1BN1PP1/R1BQR1K1 w kq - 0 14,hxg4,-167,-157,10,1
r2qk2r/2pb1p2/pb1p1n1p/np1Pp3/4P1P1/1PP2N2/P1BN1PP1/R1BQR1K1 b kq - 0 14,Bxg4,-124,61,185,1
r2qk2r/2p2p2/pb1p1n1p/np1Pp3/4P1b1/1PP2N2/P1BN1PP1/R1BQR1K1 w kq - 0 15,Nf1,54,64,10,1
r2qk2r/2p2p2/pb1p1n1p/np1Pp3/4P1b1/1PP2N2/P1B2PP1/R1BQRNK1 b kq - 1 15,Rg8,60,48,-12,1
r2qk1r1/2p2p2/pb1p1n1p/np1Pp3/4P1b1/1PP2N2/P1B2PP1/R1BQRNK1 w q - 2 16,Ng3,57,-21,-78,1
r2qk1r1/2p2p2/pb1p1n1p/np1Pp3/4P1b1/1PP2NN1/P1B2PP1/R1BQR1K1 b q - 3 16,h5,-20,8,28,1
r2qk1r1/2p2p2/pb1p1n2/np1Pp2p/4P1b1/1PP2NN1/P1B2PP1/R1BQR1K1 w q - 0 17,Qd3,26,-337,-363,0
r2qk1r1/2p2p2/pb1p1n2/np1Pp2p/4P1b1/1PPQ1NN1/P1B2PP1/R1B1R1K1 b q - 1 17,Qd7,-24,220,244,1
r3k1r1/2pq1p2/pb1p1n2/np1Pp2p/4P1b1/1PPQ1NN1/P1B2PP1/R1B1R1K1 w q - 2 18,Nh4,234,191,-43,1
r3k1r1/2pq1p2/pb1p1n2/np1Pp2p/4P1bN/1PPQ2N1/P1B2PP1/R1B1R1K1 b q - 3 18,O-O-O,184,236,52,1
2kr2r1/2pq1p2/pb1p1n2/np1Pp2p/4P1bN/1PPQ2N1/P1B2PP1/R1B1R1K1 w - - 4 19,Ngf5,231,9,-222,0
2kr2r1/2pq1p2/pb1p1n2/np1PpN1p/4P1bN/1PPQ4/P1B2PP1/R1B1R1K1 b - - 5 19,Bxf5,-18,31,49,1
2kr2r1/2pq1p2/pb1p1n2/np1Ppb1p/4P2N/1PPQ4/P1B2PP1/R1B1R1K1 w - - 0 20,Nxf5,44,31,-13,1
2kr2r1/2pq1p2/pb1p1n2/np1PpN1p/4P3/1PPQ4/P1B2PP1/R1B1R1K1 b - - 0 20,Rg4,13,29,16,1
2kr4/2pq1p2/pb1p1n2/np1PpN1p/4P1r1/1PPQ4/P1B2PP1/R1B1R1K1 w - - 1 21,Qf3,21,-7,-28,1
2kr4/2pq1p2/pb1p1n2/np1PpN1p/4P1r1/1PP2Q2/P1B2PP1/R1B1R1K1 b - - 2 21,Rdg8,-44,-28,16,1
2k3r1/2pq1p2/pb1p1n2/np1PpN1p/4P1r1/1PP2Q2/P1B2PP1/R1B1R1K1 w - - 3 22,Nh6,-28,-377,-349,0
2k3r1/2pq1p2/pb1p1n1N/np1Pp2p/4P1r1/1PP2Q2/P1B2PP1/R1B1R1K1 b - - 4 22,Rxg2+,-365,-125,240,1
2k3r1/2pq1p2/pb1p1n1N/np1Pp2p/4P3/1PP2Q2/P1B2Pr1/R1B1R1K1 w - - 0 23,Qxg2,-68,-69,-1,1
2k3r1/2pq1p2/pb1p1n1N/np1Pp2p/4P3/1PP5/P1B2PQ1/R1B1R1K1 b - - 0 23,Rxg2+,-84,-76,8,1
2k5/2pq1p2/pb1p1n1N/np1Pp2p/4P3/1PP5/P1B2Pr1/R1B1R1K1 w - - 0 24,Kxg2,-88,-103,-15,1
2k5/2pq1p2/pb1p1n1N/np1Pp2p/4P3/1PP5/P1B2PK1/R1B1R3 b - - 0 24,Nb7,-110,-58,52,1
2k5/1npq1p2/pb1p1n1N/1p1Pp2p/4P3/1PP5/P1B2PK1/R1B1R3 w - - 1 25,Nf5,-47,-56,-9,1
2k5/1npq1p2/pb1p1n2/1p1PpN1p/4P3/1PP5/P1B2PK1/R1B1R3 b - - 2 25,Qe8,-56,-37,19,1
2k1q3/1np2p2/pb1p1n2/1p1PpN1p/4P3/1PP5/P1B2PK1/R1B1R3 w - - 3 26,Rg1,-43,-84,-41,1
2k1q3/1np2p2/pb1p1n2/1p1PpN1p/4P3/1PP5/P1B2PK1/R1B3R1 b - - 4 26,Nc5,-90,-73,17,1
2k1q3/2p2p2/pb1p1n2/1pnPpN1p/4P3/1PP5/P1B2PK1/R1B3R1 w - - 5 27,Be3,-92,-178,-86,1
2k1q3/2p2p2/pb1p1n2/1pnPpN1p/4P3/1PP1B3/P1B2PK1/R5R1 b - - 6 27,Ncxe4,-158,-153,5,1
2k1q3/2p2p2/pb1p1n2/1p1PpN1p/4n3/1PP1B3/P1B2PK1/R5R1 w - - 0 28,Bxb6,-169,-166,3,1
2k1q3/2p2p2/pB1p1n2/1p1PpN1p/4n3/1PP5/P1B2PK1/R5R1 b - - 0 28,Qg8+,-194,92,286,1
2k3q1/2p2p2/pB1p1n2/1p1PpN1p/4n3/1PP5/P1B2PK1/R5R1 w - - 1 29,Kf1,96,-242,-338,0
2k3q1/2p2p2/pB1p1n2/1p1PpN1p/4n3/1PP5/P1B2P2/R4KR1 b - - 2 29,Qh7,-268,-194,74,1
2k5/2p2p1q/pB1p1n2/1p1PpN1p/4n3/1PP5/P1B2P2/R4KR1 w - - 3 30,Ne7+,-230,-389,-159,0
2k5/2p1Np1q/pB1p1n2/1p1Pp2p/4n3/1PP5/P1B2P2/R4KR1 b - - 4 30,Kd7,-410,-401,9,1
8/2pkNp1q/pB1p1n2/1p1Pp2p/4n3/1PP5/P1B2P2/R4KR1 w - - 5 31,Nc6,-358,-449,-91,1
8/2pk1p1q/pBNp1n2/1p1Pp2p/4n3/1PP5/P1B2P2/R4KR1 b - - 6 31,cxb6,-463,-391,72,1
8/3k1p1q/ppNp1n2/1p1Pp2p/4n3/1PP5/P1B2P2/R4KR1 w - - 0 32,Re1,-432,-538,-106,0
rnbqkbnr/pppppppp/8/8/8/8/PPPPPPPP/RNBQKBNR w KQkq - 0 1,e4,32,32,0,1
rnbqkbnr/pppppppp/8/8/4P3/8/PPPP1PPP/RNBQKBNR b KQkq - 0 1,e5,28,35,7,1
rnbqkbnr/pppp1ppp/8/4p3/4P3/8/PPPP1PPP/RNBQKBNR w KQkq - 0 2,Nf3,41,41,0,1
rnbqkbnr/pppp1ppp/8/4p3/4P3/5N2/PPPP1PPP/RNBQKB1R b KQkq - 1 2,d6,43,41,-2,1
rnbqkbnr/ppp2ppp/3p4/4p3/4P3/5N2/PPPP1PPP/RNBQKB1R w KQkq - 0 3,Bc4,48,29,-19,1
rnbqkbnr/ppp2ppp/3p4/4p3/2B1P3/5N2/PPPP1PPP/RNBQK2R b KQkq - 1 3,Be7,31,36,5,1
rnbqk1nr/ppp1bppp/3p4/4p3/2B1P3/5N2/PPPP1PPP/RNBQK2R w KQkq - 2 4,d4,40,31,-9,1
rnbqk1nr/ppp1bppp/3p4/4p3/2BPP3/5N2/PPP2PPP/RNBQK2R b KQkq - 0 4,Nf6,35,156,121,1
rnbqk2r/ppp1bppp/3p1n2/4p3/2BPP3/5N2/PPP2PPP/RNBQK2R w KQkq - 1 5,dxe5,169,195,26,1
rnbqk2r/ppp1bppp/3p1n2/4P3/2B1P3/5N2/PPP2PPP/RNBQK2R b KQkq - 0 5,Nxe4,166,222,56,1
rnbqk2r/ppp1bppp/3p4/4P3/2B1n3/5N2/PPP2PPP/RNBQK2R w KQkq - 0 6,exd6,190,33,-157,0
rnbqk2r/ppp1bppp/3P4/8/2B1n3/5N2/PPP2PPP/RNBQK2R b KQkq - 0 6,Bxd6,24,158,134,1
rnbqk2r/ppp2ppp/3b4/8/2B1n3/5N2/PPP2PPP/RNBQK2R w KQkq - 0 7,O-O,157,7,-150,0
rnbqk2r/ppp2ppp/3b4/8/2B1n3/5N2/PPP2PPP/RNBQ1RK1 b kq - 1 7,O-O,14,16,2,1
rnbq1rk1/ppp2ppp/3b4/8/2B1n3/5N2/PPP2PPP/RNBQ1RK1 w - - 2 8,a3,17,-24,-41,1
rnbq1rk1/ppp2ppp/3b4/8/2B1n3/P4N2/1PP2PPP/RNBQ1RK1 b - - 0 8,Bg4,-12,-21,-9,1
rn1q1rk1/ppp2ppp/3b4/8/2B1n1b1/P4N2/1PP2PPP/RNBQ1RK1 w - - 1 9,Qd3,-26,-163,-137,0
rn1q1rk1/ppp2ppp/3b4/8/2B1n1b1/P2Q1N2/1PP2PPP/RNB2RK1 b - - 2 9,Nc5,-170,-174,-4,1
rn1q1rk1/ppp2ppp/3b4/2n5/2B3b1/P2Q1N2/1PP2PPP/RNB2RK1 w - - 3 10,Qc3,-170,-217,-47,1
rn1q1rk1/ppp2ppp/3b4/2n5/2B3b1/P1Q2N2/1PP2PPP/RNB2RK1 b - - 4 10,Nc6,-214,-57,157,1
r2q1rk1/ppp2ppp/2nb4/2n5/2B3b1/P1Q2N2/1PP2PPP/RNB2RK1 w - - 5 11,b4,-42,-312,-270,0
r2q1rk1/ppp2ppp/2nb4/2n5/1PB3b1/P1Q2N2/2P2PPP/RNB2RK1 b - - 0 11,Ne4,-302,-163,139,1
r2q1rk1/ppp2ppp/2nb4/8/1PB1n1b1/P1Q2N2/2P2PPP/RNB2RK1 w - - 1 12,Qd3,-153,-207,-54,1
r2q1rk1/ppp2ppp/2nb4/8/1PB1n1b1/P2Q1N2/2P2PPP/RNB2RK1 b - - 2 12,Bxf3,-224,-133,91,1
r2q1rk1/ppp2ppp/2nb4/8/1PB1n3/P2Q1b2/2P2PPP/RNB2RK1 w - - 0 13,Qxf3,-112,-242,-130,0
r2q1rk1/ppp2ppp/2nb4/8/1PB1n3/P4Q2/2P2PPP/RNB2RK1 b - - 0 13,Qh4,-142,-16,126,1
r4rk1/ppp2ppp/2nb4/8/1PB1n2q/P4Q2/2P2PPP/RNB2RK1 w - - 1 14,g3,-65,-85,-20,1
r4rk1/ppp2ppp/2nb4/8/1PB1n2q/P4QP1/2P2P1P/RNB2RK1 b - - 0 14,Nxg3,-115,-40,75,1
r4rk1/ppp2ppp/2nb4/8/1PB4q/P4Qn1/2P2P1P/RNB2RK1 w - - 0 15,fxg3,-51,-305,-254,0
r4rk1/ppp2ppp/2nb4/8/1PB4q/P4QP1/2P4P/RNB2RK1 b - - 0 15,Qxc4,-314,-297,17,1
r4rk1/ppp2ppp/2nb4/8/1Pq5/P4QP1/2P4P/RNB2RK1 w - - 0 16,Nc3,-305,-318,-13,1
r4rk1/ppp2ppp/2nb4/8/1Pq5/P1N2QP1/2P4P/R1B2RK1 b - - 1 16,Ne5,-315,-348,-33,1
r4rk1/ppp2ppp/3b4/4n3/1Pq5/P1N2QP1/2P4P/R1B2RK1 w - - 2 17,Qe3,-351,-339,12,1
r4rk1/ppp2ppp/3b4/4n3/1Pq5/P1N1Q1P1/2P4P/R1B2RK1 b - - 3 17,c5,-343,-192,151,1
r4rk1/pp3ppp/3b4/2p1n3/1Pq5/P1N1Q1P1/2P4P/R1B2RK1 w - - 0 18,Ne4,-194,-181,13,1
r4rk1/pp3ppp/3b4/2p1n3/1Pq1N3/P3Q1P1/2P4P/R1B2RK1 b - - 1 18,Be7,-198,-116,82,1
r4rk1/pp2bppp/8/2p1n3/1Pq1N3/P3Q1P1/2P4P/R1B2RK1 w - - 2 19,Nxc5,-138,-190,-52,1
r4rk1/pp2bppp/8/2N1n3/1Pq5/P3Q1P1/2P4P/R1B2RK1 b - - 0 19,Bd6,-235,-28,207,1
r4rk1/pp3ppp/3b4/2N1n3/1Pq5/P3Q1P1/2P4P/R1B2RK1 w - - 1 20,Bb2,-10,-50,-40,1
r4rk1/pp3ppp/3b4/2N1n3/1Pq5/P3Q1P1/1BP4P/R4RK1 b - - 2 20,Rfe8,-19,13,32,1
r3r1k1/pp3ppp/3b4/2N1n3/1Pq5/P3Q1P1/1BP4P/R4RK1 w - - 3 21,Nxb7,6,0,-6,1
r3r1k1/pN3ppp/3b4/4n3/1Pq5/P3Q1P1/1BP4P/R4RK1 b - - 0 21,Bc7,0,2,2,1
r3r1k1/pNb2ppp/8/4n3/1Pq5/P3Q1P1/1BP4P/R4RK1 w - - 1 22,Nc5,2,-18,-20,1
r3r1k1/p1b2ppp/8/2N1n3/1Pq5/P3Q1P1/1BP4P/R4RK1 b - - 2 22,Qxc2,-23,-11,12,1
r3r1k1/p1b2ppp/8/2N1n3/1P6/P3Q1P1/1Bq4P/R4RK1 w - - 0 23,Bd4,-12,-529,-517,0
r3r1k1/p1b2ppp/8/2N1n3/1P1B4/P3Q1P1/2q4P/R4RK1 b - - 1 23,Ng4,-523,-495,28,1
r3r1k1/p1b2ppp/8/2N5/1P1B2n1/P3Q1P1/2q4P/R4RK1 w - - 2 24,Qxe8+,-474,-519,-45,1
r3Q1k1/p1b2ppp/8/2N5/1P1B2n1/P5P1/2q4P/R4RK1 b - - 0 24,Rxe8,-557,-574,-17,1
4r1k1/p1b2ppp/8/2N5/1P1B2n1/P5P1/2q4P/R4RK1 w - - 0 25,Bf2,-520,-526,-6,1
4r1k1/p1b2ppp/8/2N5/1P4n1/P5P1/2q2B1P/R4RK1 b - - 1 25,Be5,-532,-535,-3,1
4r1k1/p4ppp/8/2N1b3/1P4n1/P5P1/2q2B1P/R4RK1 w - - 2 26,Rab1,-511,-652,-141,0
4r1k1/p4ppp/8/2N1b3/1P4n1/P5P1/2q2B1P/1R3RK1 b - - 3 26,Bd4,-537,-681,-144,0
4r1k1/p4ppp/8/2N5/1P1b2n1/P5P1/2q2B1P/1R3RK1 w - - 4 27,h3,-763,-884,-121,0
4r1k1/p4ppp/8/2N5/1P1b2n1/P5PP/2q2B2/1R3RK1 b - - 0 27,Bxf2+,-868,-887,-19,1
4r1k1/p4ppp/8/2N5/1P4n1/P5PP/2q2b2/1R3RK1 w - - 0 28,Rxf2,-943,-9998,-9055,0
4r1k1/p4ppp/8/2N5/1P4n1/P5PP/2q2R2/1R4K1 b - - 0 28,Qxf2+,-9998,-9999,-1,1
rnbqkbnr/pppppppp/8/8/8/8/PPPPPPPP/RNBQKBNR w KQkq - 0 1,e4,29,23,-6,1
rnbqkbnr/pppppppp/8/8/4P3/8/PPPP1PPP/RNBQKBNR b KQkq - 0 1,e5,27,41,14,1
rnbqkbnr/pppp1ppp/8/4p3/4P3/8/PPPP1PPP/RNBQKBNR w KQkq - 0 2,f4,36,-41,-77,1
rnbqkbnr/pppp1ppp/8/4p3/4PP2/8/PPPP2PP/RNBQKBNR b KQkq - 0 2,exf4,-44,-26,18,1
rnbqkbnr/pppp1ppp/8/8/4Pp2/8/PPPP2PP/RNBQKBNR w KQkq - 0 3,Nf3,-36,-41,-5,1
rnbqkbnr/pppp1ppp/8/8/4Pp2/5N2/PPPP2PP/RNBQKB1R b KQkq - 1 3,f6,-105,136,241,1
rnbqkbnr/pppp2pp/5p2/8/4Pp2/5N2/PPPP2PP/RNBQKB1R w KQkq - 0 4,Bc4,131,99,-32,1
rnbqkbnr/pppp2pp/5p2/8/2B1Pp2/5N2/PPPP2PP/RNBQK2R b KQkq - 1 4,Ne7,47,117,70,1
rnbqkb1r/ppppn1pp/5p2/8/2B1Pp2/5N2/PPPP2PP/RNBQK2R w KQkq - 2 5,O-O,125,89,-36,1
rnbqkb1r/ppppn1pp/5p2/8/2B1Pp2/5N2/PPPP2PP/RNBQ1RK1 b kq - 3 5,d6,103,95,-8,1
rnbqkb1r/ppp1n1pp/3p1p2/8/2B1Pp2/5N2/PPPP2PP/RNBQ1RK1 w kq - 0 6,d4,88,84,-4,1
rnbqkb1r/ppp1n1pp/3p1p2/8/2BPPp2/5N2/PPP3PP/RNBQ1RK1 b kq - 0 6,g5,78,57,-21,1
rnbqkb1r/ppp1n2p/3p1p2/6p1/2BPPp2/5N2/PPP3PP/RNBQ1RK1 w kq - 0 7,c3,61,14,-47,1
rnbqkb1r/ppp1n2p/3p1p2/6p1/2BPPp2/2P2N2/PP4PP/RNBQ1RK1 b kq - 0 7,Bg4,50,69,19,1
rn1qkb1r/ppp1n2p/3p1p2/6p1/2BPPpb1/2P2N2/PP4PP/RNBQ1RK1 w kq - 1 8,Qb3,68,72,4,1
rn1qkb1r/ppp1n2p/3p1p2/6p1/2BPPpb1/1QP2N2/PP4PP/RNB2RK1 b kq - 2 8,Kd7,64,293,229,1
rn1q1b1r/pppkn2p/3p1p2/6p1/2BPPpb1/1QP2N2/PP4PP/RNB2RK1 w - - 3 9,Qxb7,342,364,22,1
rn1q1b1r/pQpkn2p/3p1p2/6p1/2BPPpb1/2P2N2/PP4PP/RNB2RK1 b - - 0 9,Nbc6,354,324,-30,1
r2q1b1r/pQpkn2p/2np1p2/6p1/2BPPpb1/2P2N2/PP4PP/RNB2RK1 w - - 1 10,Bb5,343,78,-265,0
r2q1b1r/pQpkn2p/2np1p2/1B4p1/3PPpb1/2P2N2/PP4PP/RNB2RK1 b - - 2 10,a6,82,264,182,1
r2q1b1r/1Qpkn2p/p1np1p2/1B4p1/3PPpb1/2P2N2/PP4PP/RNB2RK1 w - - 0 11,Bxc6+,277,-30,-307,0
r2q1b1r/1Qpkn2p/p1Bp1p2/6p1/3PPpb1/2P2N2/PP4PP/RNB2RK1 b - - 0 11,Nxc6,11,27,16,1
r2q1b1r/1Qpk3p/p1np1p2/6p1/3PPpb1/2P2N2/PP4PP/RNB2RK1 w - - 0 12,d5,25,-59,-84,1
r2q1b1r/1Qpk3p/p1np1p2/3P2p1/4Ppb1/2P2N2/PP4PP/RNB2RK1 b - - 0 12,Rb8,-46,584,630,1
1r1q1b1r/1Qpk3p/p1np1p2/3P2p1/4Ppb1/2P2N2/PP4PP/RNB2RK1 w - - 1 13,dxc6+,499,326,-173,0
1r1q1b1r/1Qpk3p/p1Pp1p2/6p1/4Ppb1/2P2N2/PP4PP/RNB2RK1 b - - 0 13,Ke7,303,350,47,1
1r1q1b1r/1Qp1k2p/p1Pp1p2/6p1/4Ppb1/2P2N2/PP4PP/RNB2RK1 w - - 1 14,Qxa6,372,331,-41,1
1r1q1b1r/2p1k2p/Q1Pp1p2/6p1/4Ppb1/2P2N2/PP4PP/RNB2RK1 b - - 0 14,Rb6,361,426,65,1
3q1b1r/2p1k2p/QrPp1p2/6p1/4Ppb1/2P2N2/PP4PP/RNB2RK1 w - - 1 15,Qc4,388,399,11,1
3q1b1r/2p1k2p/1rPp1p2/6p1/2Q1Ppb1/2P2N2/PP4PP/RNB2RK1 b - - 2 15,Be6,381,503,122,1
3q1b1r/2p1k2p/1rPpbp2/6p1/2Q1Pp2/2P2N2/PP4PP/RNB2RK1 w - - 3 16,Qd3,526,504,-22,1
3q1b1r/2p1k2p/1rPpbp2/6p1/4Pp2/2PQ1N2/PP4PP/RNB2RK1 b - - 4 16,h5,475,588,113,1
3q1b1r/2p1k3/1rPpbp2/6pp/4Pp2/2PQ1N2/PP4PP/RNB2RK1 w - - 0 17,Nd4,598,515,-83,1
3q1b1r/2p1k3/1rPpbp2/6pp/3NPp2/2PQ4/PP4PP/RNB2RK1 b - - 1 17,Bc8,479,513,34,1
2bq1b1r/2p1k3/1rPp1p2/6pp/3NPp2/2PQ4/PP4PP/RNB2RK1 w - - 2 18,b4,471,484,13,1
2bq1b1r/2p1k3/1rPp1p2/6pp/1P1NPp2/2PQ4/P5PP/RNB2RK1 b - - 0 18,h4,491,481,-10,1
2bq1b1r/2p1k3/1rPp1p2/6p1/1P1NPp1p/2PQ4/P5PP/RNB2RK1 w - - 0 19,Nf5+,486,352,-134,0
2bq1b1r/2p1k3/1rPp1p2/5Np1/1P2Pp1p/2PQ4/P5PP/RNB2RK1 b - - 1 19,Ke8,364,435,71,1
2bqkb1r/2p5/1rPp1p2/5Np1/1P2Pp1p/2PQ4/P5PP/RNB2RK1 w - - 2 20,Qd5,418,385,-33,1
2bqkb1r/2p5/1rPp1p2/3Q1Np1/1P2Pp1p/2P5/P5PP/RNB2RK1 b - - 3 20,h3,396,377,-19,1
2bqkb1r/2p5/1rPp1p2/3Q1Np1/1P2Pp2/2P4p/P5PP/RNB2RK1 w - - 0 21,g3,398,380,-18,1
2bqkb1r/2p5/1rPp1p2/3Q1Np1/1P2Pp2/2P3Pp/P6P/RNB2RK1 b - - 0 21,Bxf5,405,380,-25,1
3qkb1r/2p5/1rPp1p2/3Q1bp1/1P2Pp2/2P3Pp/P6P/RNB2RK1 w - - 0 22,exf5,406,304,-102,0
3qkb1r/2p5/1rPp1p2/3Q1Pp1/1P3p2/2P3Pp/P6P/RNB2RK1 b - - 0 22,Be7,346,416,70,1
3qk2r/2p1b3/1rPp1p2/3Q1Pp1/1P3p2/2P3Pp/P6P/RNB2RK1 w - - 1 23,gxf4,420,381,-39,1
3qk2r/2p1b3/1rPp1p2/3Q1Pp1/1P3P2/2P4p/P6P/RNB2RK1 b - - 0 23,gxf4,413,407,-6,1
3qk2r/2p1b3/1rPp1p2/3Q1P2/1P3p2/2P4p/P6P/RNB2RK1 w - - 0 24,Bxf4,406,423,17,1
3qk2r/2p1b3/1rPp1p2/3Q1P2/1P3B2/2P4p/P6P/RN3RK1 b - - 0 24,Qa8,416,422,6,1
q3k2r/2p1b3/1rPp1p2/3Q1P2/1P3B2/2P4p/P6P/RN3RK1 w - - 1 25,Nd2,414,425,11,1
q3k2r/2p1b3/1rPp1p2/3Q1P2/1P3B2/2P4p/P2N3P/R4RK1 b - - 2 25,Qxc6,408,432,24,1
4k2r/2p1b3/1rqp1p2/3Q1P2/1P3B2/2P4p/P2N3P/R4RK1 w - - 0 26,Qxc6+,413,418,5,1
4k2r/2p1b3/1rQp1p2/5P2/1P3B2/2P4p/P2N3P/R4RK1 b - - 0 26,Rxc6,384,422,38,1
4k2r/2p1b3/2rp1p2/5P2/1P3B2/2P4p/P2N3P/R4RK1 w - - 0 27,c4,416,373,-43,1
4k2r/2p1b3/2rp1p2/5P2/1PP2B2/7p/P2N3P/R4RK1 b - - 0 27,Rh5,418,470,52,1
4k3/2p1b3/2rp1p2/5P1r/1PP2B2/7p/P2N3P/R4RK1 w - - 1 28,Bg3,479,481,2,1
4k3/2p1b3/2rp1p2/5P1r/1PP5/6Bp/P2N3P/R4RK1 b - - 2 28,d5,488,457,-31,1
4k3/2p1b3/2r2p2/3p1P1r/1PP5/6Bp/P2N3P/R4RK1 w - - 0 29,c5,481,450,-31,1
4k3/2p1b3/2r2p2/2Pp1P1r/1P6/6Bp/P2N3P/R4RK1 b - - 0 29,Ra6,444,474,30,1
4k3/2p1b3/r4p2/2Pp1P1r/1P6/6Bp/P2N3P/R4RK1 w - - 1 30,a4,470,464,-6,1
4k3/2p1b3/r4p2/2Pp1P1r/PP6/6Bp/3N3P/R4RK1 b - - 0 30,Kd7,493,530,37,1
8/2pkb3/r4p2/2Pp1P1r/PP6/6Bp/3N3P/R4RK1 w - - 1 31,Kh1,544,524,-20,1
8/2pkb3/r4p2/2Pp1P1r/PP6/6Bp/3N3P/R4R1K b - - 2 31,Bf8,530,552,22,1
5b2/2pk4/r4p2/2Pp1P1r/PP6/6Bp/3N3P/R4R1K w - - 3 32,b5,558,563,5,1
5b2/2pk4/r4p2/1PPp1P1r/P7/6Bp/3N3P/R4R1K b - - 0 32,Ra8,547,559,12,1
r4b2/2pk4/5p2/1PPp1P1r/P7/6Bp/3N3P/R4R1K w - - 1 33,c6+,555,576,21,1
r4b2/2pk4/2P2p2/1P1p1P1r/P7/6Bp/3N3P/R4R1K b - - 0 33,Ke7,609,573,-36,1
r4b2/2p1k3/2P2p2/1P1p1P1r/P7/6Bp/3N3P/R4R1K w - - 1 34,Nb3,615,556,-59,1
r4b2/2p1k3/2P2p2/1P1p1P1r/P7/1N4Bp/7P/R4R1K b - - 2 34,Kf7,565,585,20,1
r4b2/2p2k2/2P2p2/1P1p1P1r/P7/1N4Bp/7P/R4R1K w - - 3 35,Bxc7,557,557,0,1
r4b2/2B2k2/2P2p2/1P1p1P1r/P7/1N5p/7P/R4R1K b - - 0 35,Re8,554,567,13,1
4rb2/2B2k2/2P2p2/1P1p1P1r/P7/1N5p/7P/R4R1K w - - 1 36,Bg3,568,594,26,1
4rb2/5k2/2P2p2/1P1p1P1r/P7/1N4Bp/7P/R4R1K b - - 2 36,Bb4,580,600,20,1
4r3/5k2/2P2p2/1P1p1P1r/Pb6/1N4Bp/7P/R4R1K w - - 3 37,b6,636,581,-55,1
4r3/5k2/1PP2p2/3p1P1r/Pb6/1N4Bp/7P/R4R1K b - - 0 37,Bc3,563,638,75,1
4r3/5k2/1PP2p2/3p1P1r/P7/1Nb3Bp/7P/R4R1K w - - 1 38,Rad1,639,588,-51,1
4r3/5k2/1PP2p2/3p1P1r/P7/1Nb3Bp/7P/3R1R1K b - - 2 38,Be5,630,696,66,1
4r3/5k2/1PP2p2/3pbP1r/P7/1N4Bp/7P/3R1R1K w - - 3 39,Bxe5,640,584,-56,1
4r3/5k2/1PP2p2/3pBP1r/P7/1N5p/7P/3R1R1K b - - 0 39,fxe5,572,583,11,1
4r3/5k2/1PP5/3ppP1r/P7/1N5p/7P/3R1R1K w - - 0 40,b7,590,602,12,1
4r3/1P3k2/2P5/3ppP1r/P7/1N5p/7P/3R1R1K b - - 0 40,Rhh8,584,644,60,1
4r2r/1P3k2/2P5/3ppP2/P7/1N5p/7P/3R1R1K w - - 1 41,c7,645,608,-37,1
4r2r/1PP2k2/8/3ppP2/P7/1N5p/7P/3R1R1K b - - 0 41,Kf6,608,729,121,1
4r2r/1PP5/5k2/3ppP2/P7/1N5p/7P/3R1R1K w - - 1 42,Nc5,668,657,-11,1
4r2r/1PP5/5k2/2NppP2/P7/7p/7P/3R1R1K b - - 2 42,d4,698,740,42,1
4r2r/1PP5/5k2/2N1pP2/P2p4/7p/7P/3R1R1K w - - 0 43,Nd7+,748,654,-94,1
4r2r/1PPN4/5k2/4pP2/P2p4/7p/7P/3R1R1K b - - 1 43,Kg5,700,718,18,1
4r2r/1PPN4/8/4pPk1/P2p4/7p/7P/3R1R1K w - - 2 44,b8=Q,791,684,-107,0
1Q2r2r/2PN4/8/4pPk1/P2p4/7p/7P/3R1R1K b - - 0 44,Rxb8,690,714,24,1
1r5r/2PN4/8/4pPk1/P2p4/7p/7P/3R1R1K w - - 0 45,cxb8=Q,731,728,-3,1
1Q5r/3N4/8/4pPk1/P2p4/7p/7P/3R1R1K b - - 0 45,Rc8,742,940,198,1
1Qr5/3N4/8/4pPk1/P2p4/7p/7P/3R1R1K w - - 1 46,Qxc8,9994,1110,-8884,0
rnbqkbnr/pppppppp/8/8/8/8/PPPPPPPP/RNBQKBNR w KQkq - 0 1,e4,34,26,-8,1
rnbqkbnr/pppppppp/8/8/4P3/8/PPPP1PPP/RNBQKBNR b KQkq - 0 1,d5,28,71,43,1
rnbqkbnr/ppp1pppp/8/3p4/4P3/8/PPPP1PPP/RNBQKBNR w KQkq - 0 2,exd5,61,68,7,1
rnbqkbnr/ppp1pppp/8/3P4/8/8/PPPP1PPP/RNBQKBNR b KQkq - 0 2,Qxd5,72,73,1,1
rnb1kbnr/ppp1pppp/8/3q4/8/8/PPPP1PPP/RNBQKBNR w KQkq - 0 3,Nc3,71,67,-4,1
rnb1kbnr/ppp1pppp/8/3q4/8/2N5/PPPP1PPP/R1BQKBNR b KQkq - 1 3,Qd8,69,78,9,1
rnbqkbnr/ppp1pppp/8/8/8/2N5/PPPP1PPP/R1BQKBNR w KQkq - 2 4,d4,82,73,-9,1
rnbqkbnr/ppp1pppp/8/8/3P4/2N5/PPP2PPP/R1BQKBNR b KQkq - 0 4,c6,71,83,12,1
rnbqkbnr/pp2pppp/2p5/8/3P4/2N5/PPP2PPP/R1BQKBNR w KQkq - 0 5,Bf4,83,51,-32,1
rnbqkbnr/pp2pppp/2p5/8/3P1B2/2N5/PPP2PPP/R2QKBNR b KQkq - 1 5,Bf5,62,84,22,1
rn1qkbnr/pp2pppp/2p5/5b2/3P1B2/2N5/PPP2PPP/R2QKBNR w KQkq - 2 6,Bc4,98,10,-88,1
rn1qkbnr/pp2pppp/2p5/5b2/2BP1B2/2N5/PPP2PPP/R2QK1NR b KQkq - 3 6,e6,20,52,32,1
rn1qkbnr/pp3ppp/2p1p3/5b2/2BP1B2/2N5/PPP2PPP/R2QK1NR w KQkq - 0 7,Nf3,17,11,-6,1
rn1qkbnr/pp3ppp/2p1p3/5b2/2BP1B2/2N2N2/PPP2PPP/R2QK2R b KQkq - 1 7,Bg4,16,100,84,1
rn1qkbnr/pp3ppp/2p1p3/8/2BP1Bb1/2N2N2/PPP2PPP/R2QK2R w KQkq - 2 8,O-O,101,50,-51,1
rn1qkbnr/pp3ppp/2p1p3/8/2BP1Bb1/2N2N2/PPP2PPP/R2Q1RK1 b kq - 3 8,Bd6,42,40,-2,1
rn1qk1nr/pp3ppp/2pbp3/8/2BP1Bb1/2N2N2/PPP2PPP/R2Q1RK1 w kq - 4 9,Bxd6,34,33,-1,1
rn1qk1nr/pp3ppp/2pBp3/8/2BP2b1/2N2N2/PPP2PPP/R2Q1RK1 b kq - 0 9,Qxd6,25,34,9,1
rn2k1nr/pp3ppp/2pqp3/8/2BP2b1/2N2N2/PPP2PPP/R2Q1RK1 w kq - 0 10,Qe2,42,6,-36,1
rn2k1nr/pp3ppp/2pqp3/8/2BP2b1/2N2N2/PPP1QPPP/R4RK1 b kq - 1 10,Bxf3,16,19,3,1
rn2k1nr/pp3ppp/2pqp3/8/2BP4/2N2b2/PPP1QPPP/R4RK1 w kq - 0 11,Qxf3,17,11,-6,1
rn2k1nr/pp3ppp/2pqp3/8/2BP4/2N2Q2/PPP2PPP/R4RK1 b kq - 0 11,Qxd4,14,285,271,1
rn2k1nr/pp3ppp/2p1p3/8/2Bq4/2N2Q2/PPP2PPP/R4RK1 w kq - 0 12,Bb3,293,-111,-404,0
rn2k1nr/pp3ppp/2p1p3/8/3q4/1BN2Q2/PPP2PPP/R4RK1 b kq - 1 12,Nf6,-97,9,106,1
rn2k2r/pp3ppp/2p1pn2/8/3q4/1BN2Q2/PPP2PPP/R4RK1 w kq - 2 13,Rad1,-60,-78,-18,1
rn2k2r/pp3ppp/2p1pn2/8/3q4/1BN2Q2/PPP2PPP/3R1RK1 b kq - 3 13,Qe5,-94,84,178,1
rn2k2r/pp3ppp/2p1pn2/4q3/8/1BN2Q2/PPP2PPP/3R1RK1 w kq - 4 14,Rfe1,130,125,-5,1
rn2k2r/pp3ppp/2p1pn2/4q3/8/1BN2Q2/PPP2PPP/3RR1K1 b kq - 5 14,Qg5,117,319,202,1
rn2k2r/pp3ppp/2p1pn2/6q1/8/1BN2Q2/PPP2PPP/3RR1K1 w kq - 6 15,Ne4,271,54,-217,0
rn2k2r/pp3ppp/2p1pn2/6q1/4N3/1B3Q2/PPP2PPP/3RR1K1 b kq - 7 15,Nxe4,90,94,4,1
rn2k2r/pp3ppp/2p1p3/6q1/4n3/1B3Q2/PPP2PPP/3RR1K1 w kq - 0 16,Qxe4,107,-21,-128,0
rn2k2r/pp3ppp/2p1p3/6q1/4Q3/1B6/PPP2PPP/3RR1K1 b kq - 0 16,O-O,-69,-34,35,1
rn3rk1/pp3ppp/2p1p3/6q1/4Q3/1B6/PPP2PPP/3RR1K1 w - - 1 17,Re3,-38,-103,-65,1
rn3rk1/pp3ppp/2p1p3/6q1/4Q3/1B2R3/PPP2PPP/3R2K1 b - - 2 17,Nd7,-103,413,516,1
r4rk1/pp1n1ppp/2p1p3/6q1/4Q3/1B2R3/PPP2PPP/3R2K1 w - - 3 18,Rg3,394,-155,-549,0
r4rk1/pp1n1ppp/2p1p3/6q1/4Q3/1B4R1/PPP2PPP/3R2K1 b - - 4 18,Qf6,-156,438,594,1
r4rk1/pp1n1ppp/2p1pq2/8/4Q3/1B4R1/PPP2PPP/3R2K1 w - - 5 19,Rdd3,409,-309,-718,0
r4rk1/pp1n1ppp/2p1pq2/8/4Q3/1B1R2R1/PPP2PPP/6K1 b - - 6 19,Ne5,-270,-184,86,1
r4rk1/pp3ppp/2p1pq2/4n3/4Q3/1B1R2R1/PPP2PPP/6K1 w - - 7 20,Rh3,-158,-188,-30,1
r4rk1/pp3ppp/2p1pq2/4n3/4Q3/1B1R3R/PPP2PPP/6K1 b - - 8 20,h6,-212,-192,20,1
r4rk1/pp3pp1/2p1pq1p/4n3/4Q3/1B1R3R/PPP2PPP/6K1 w - - 0 21,Rh5,-189,-527,-338,0
r4rk1/pp3pp1/2p1pq1p/4n2R/4Q3/1B1R4/PPP2PPP/6K1 b - - 1 21,g5,-501,-91,410,1
r4rk1/pp3p2/2p1pq1p/4n1pR/4Q3/1B1R4/PPP2PPP/6K1 w - - 0 22,Rdh3,-89,-152,-63,1
r4rk1/pp3p2/2p1pq1p/4n1pR/4Q3/1B5R/PPP2PPP/6K1 b - - 1 22,Rad8,-130,-139,-9,1
3r1rk1/pp3p2/2p1pq1p/4n1pR/4Q3/1B5R/PPP2PPP/6K1 w - - 2 23,c3,-135,-192,-57,1
3r1rk1/pp3p2/2p1pq1p/4n1pR/4Q3/1BP4R/PP3PPP/6K1 b - - 0 23,Ng6,-157,71,228,1
3r1rk1/pp3p2/2p1pqnp/6pR/4Q3/1BP4R/PP3PPP/6K1 w - - 1 24,Rxh6,133,147,14,1
3r1rk1/pp3p2/2p1pqnR/6p1/4Q3/1BP4R/PP3PPP/6K1 b - - 0 24,Nh4,149,9999,9850,1
3r1rk1/pp3p2/2p1pq1R/6p1/4Q2n/1BP4R/PP3PPP/6K1 w - - 1 25,Qh7#,9999,10000,1,1
rnbqkbnr/pppppppp/8/8/8/8/PPPPPPPP/RNBQKBNR w KQkq - 0 1,h4,18,-52,-70,1
rnbqkbnr/pppppppp/8/8/7P/8/PPPPPPP1/RNBQKBNR b KQkq - 0 1,e5,-56,-53,3,1
rnbqkbnr/pppp1ppp/8/4p3/7P/8/PPPPPPP1/RNBQKBNR w KQkq - 0 2,a4,-47,-131,-84,1
rnbqkbnr/pppp1ppp/8/4p3/P6P/8/1PPPPPP1/RNBQKBNR b KQkq - 0 2,Bc5,-149,-44,105,1
rnbqk1nr/pppp1ppp/8/2b1p3/P6P/8/1PPPPPP1/RNBQKBNR w KQkq - 1 3,b3,-84,-125,-41,1
rnbqk1nr/pppp1ppp/8/2b1p3/P6P/1P6/2PPPPP1/RNBQKBNR b KQkq - 0 3,Qf6,-143,4,147,1
rnb1k1nr/pppp1ppp/5q2/2b1p3/P6P/1P6/2PPPPP1/RNBQKBNR w KQkq - 1 4,e3,-62,-69,-7,1
rnb1k1nr/pppp1ppp/5q2/2b1p3/P6P/1P2P3/2PP1PP1/RNBQKBNR b KQkq - 0 4,Nc6,-81,-11,70,1
r1b1k1nr/pppp1ppp/2n2q2/2b1p3/P6P/1P2P3/2PP1PP1/RNBQKBNR w KQkq - 1 5,Na3,-40,-119,-79,1
r1b1k1nr/pppp1ppp/2n2q2/2b1p3/P6P/NP2P3/2PP1PP1/R1BQKBNR b KQkq - 2 5,Nh6,-129,45,174,1
r1b1k2r/pppp1ppp/2n2q1n/2b1p3/P6P/NP2P3/2PP1PP1/R1BQKBNR w KQkq - 3 6,Nb5,11,11,0,1
r1b1k2r/pppp1ppp/2n2q1n/1Nb1p3/P6P/1P2P3/2PP1PP1/R1BQKBNR b KQkq - 4 6,Kd8,19,29,10,1
r1bk3r/pppp1ppp/2n2q1n/1Nb1p3/P6P/1P2P3/2PP1PP1/R1BQKBNR w KQ - 5 7,Ba3,32,-101,-133,0
r1bk3r/pppp1ppp/2n2q1n/1Nb1p3/P6P/BP2P3/2PP1PP1/R2QKBNR b KQ - 6 7,Bxa3,-77,-72,5,1
r1bk3r/pppp1ppp/2n2q1n/1N2p3/P6P/bP2P3/2PP1PP1/R2QKBNR w KQ - 0 8,Rxa3,-70,-144,-74,1
r1bk3r/pppp1ppp/2n2q1n/1N2p3/P6P/RP2P3/2PP1PP1/3QKBNR b K - 0 8,Nb4,-129,-79,50,1
r1bk3r/pppp1ppp/5q1n/1N2p3/Pn5P/RP2P3/2PP1PP1/3QKBNR w K - 1 9,g3,-73,-410,-337,0
r1bk3r/pppp1ppp/5q1n/1N2p3/Pn5P/RP2P1P1/2PP1P2/3QKBNR b K - 0 9,Ng4,-406,54,460,1
r1bk3r/pppp1ppp/5q2/1N2p3/Pn4nP/RP2P1P1/2PP1P2/3QKBNR w K - 1 10,Bh3,68,-9999,-10067,0
r1bk3r/pppp1ppp/5q2/1N2p3/Pn4nP/RP2P1PB/2PP1P2/3QK1NR b K - 2 10,Qxf2#,-9999,-10000,-1,1
rnbqkbnr/pppppppp/8/8/8/8/PPPPPPPP/RNBQKBNR w KQkq - 0 1,e4,12,22,10,1
rnbqkbnr/pppppppp/8/8/4P3/8/PPPP1PPP/RNBQKBNR b KQkq - 0 1,e5,20,35,15,1
rnbqkbnr/pppp1ppp/8/4p3/4P3/8/PPPP1PPP/RNBQKBNR w KQkq - 0 2,Nf3,37,33,-4,1
rnbqkbnr/pppp1ppp/8/4p3/4P3/5N2/PPPP1PPP/RNBQKB1R b KQkq - 1 2,d6,34,47,13,1
rnbqkbnr/ppp2ppp/3p4/4p3/4P3/5N2/PPPP1PPP/RNBQKB1R w KQkq - 0 3,d4,48,55,7,1
rnbqkbnr/ppp2ppp/3p4/4p3/3PP3/5N2/PPP2PPP/RNBQKB1R b KQkq - 0 3,Nd7,48,47,-1,1
r1bqkbnr/pppn1ppp/3p4/4p3/3PP3/5N2/PPP2PPP/RNBQKB1R w KQkq - 1 4,Bc4,60,57,-3,1
r1bqkbnr/pppn1ppp/3p4/4p3/2BPP3/5N2/PPP2PPP/RNBQK2R b KQkq - 2 4,exd4,60,76,16,1
r1bqkbnr/pppn1ppp/3p4/8/2BpP3/5N2/PPP2PPP/RNBQK2R w KQkq - 0 5,Nxd4,75,52,-23,1
r1bqkbnr/pppn1ppp/3p4/8/2BNP3/8/PPP2PPP/RNBQK2R b KQkq - 0 5,Ngf6,51,57,6,1
r1bqkb1r/pppn1ppp/3p1n2/8/2BNP3/8/PPP2PPP/RNBQK2R w KQkq - 1 6,Nc3,68,74,6,1
r1bqkb1r/pppn1ppp/3p1n2/8/2BNP3/2N5/PPP2PPP/R1BQK2R b KQkq - 2 6,Be7,71,72,1,1
r1bqk2r/pppnbppp/3p1n2/8/2BNP3/2N5/PPP2PPP/R1BQK2R w KQkq - 3 7,Be3,87,10,-77,1
r1bqk2r/pppnbppp/3p1n2/8/2BNP3/2N1B3/PPP2PPP/R2QK2R b KQkq - 4 7,O-O,22,23,1,1
r1bq1rk1/pppnbppp/3p1n2/8/2BNP3/2N1B3/PPP2PPP/R2QK2R w KQ - 5 8,f3,18,-43,-61,1
r1bq1rk1/pppnbppp/3p1n2/8/2BNP3/2N1BP2/PPP3PP/R2QK2R b KQ - 0 8,c6,-34,12,46,1
r1bq1rk1/pp1nbppp/2pp1n2/8/2BNP3/2N1BP2/PPP3PP/R2QK2R w KQ - 0 9,Qd2,23,-61,-84,1
r1bq1rk1/pp1nbppp/2pp1n2/8/2BNP3/2N1BP2/PPPQ2PP/R3K2R b KQ - 1 9,Ne5,-22,-7,15,1
r1bq1rk1/pp2bppp/2pp1n2/4n3/2BNP3/2N1BP2/PPPQ2PP/R3K2R w KQ - 2 10,Bb3,-10,-91,-81,1
r1bq1rk1/pp2bppp/2pp1n2/4n3/3NP3/1BN1BP2/PPPQ2PP/R3K2R b KQ - 3 10,b5,-87,95,182,1
r1bq1rk1/p3bppp/2pp1n2/1p2n3/3NP3/1BN1BP2/PPPQ2PP/R3K2R w KQ - 0 11,O-O-O,146,-140,-286,0
r1bq1rk1/p3bppp/2pp1n2/1p2n3/3NP3/1BN1BP2/PPPQ2PP/2KR3R b - - 1 11,b4,-168,-182,-14,1
r1bq1rk1/p3bppp/2pp1n2/4n3/1p1NP3/1BN1BP2/PPPQ2PP/2KR3R w - - 0 12,Nce2,-127,-161,-34,1
r1bq1rk1/p3bppp/2pp1n2/4n3/1p1NP3/1B2BP2/PPPQN1PP/2KR3R b - - 1 12,a5,-172,-94,78,1
r1bq1rk1/4bppp/2pp1n2/p3n3/1p1NP3/1B2BP2/PPPQN1PP/2KR3R w - - 0 13,a3,-65,-238,-173,0
r1bq1rk1/4bppp/2pp1n2/p3n3/1p1NP3/PB2BP2/1PPQN1PP/2KR3R b - - 0 13,a4,-229,-206,23,1
r1bq1rk1/4bppp/2pp1n2/4n3/pp1NP3/PB2BP2/1PPQN1PP/2KR3R w - - 0 14,Ba2,-229,-205,24,1
r1bq1rk1/4bppp/2pp1n2/4n3/pp1NP3/P3BP2/BPPQN1PP/2KR3R b - - 1 14,bxa3,-238,-184,54,1
r1bq1rk1/4bppp/2pp1n2/4n3/p2NP3/p3BP2/BPPQN1PP/2KR3R w - - 0 15,bxa3,-216,-209,7,1
r1bq1rk1/4bppp/2pp1n2/4n3/p2NP3/P3BP2/B1PQN1PP/2KR3R b - - 0 15,d5,-221,-157,64,1
r1bq1rk1/4bppp/2p2n2/3pn3/p2NP3/P3BP2/B1PQN1PP/2KR3R w - - 0 16,f4,-217,-652,-435,0
r1bq1rk1/4bppp/2p2n2/3pn3/p2NPP2/P3B3/B1PQN1PP/2KR3R b - - 0 16,Bxa3+,-654,-643,11,1
r1bq1rk1/5ppp/2p2n2/3pn3/p2NPP2/b3B3/B1PQN1PP/2KR3R w - - 0 17,Kb1,-689,-650,39,1
r1bq1rk1/5ppp/2p2n2/3pn3/p2NPP2/b3B3/B1PQN1PP/1K1R3R b - - 1 17,Rb8+,-640,-605,35,1
1rbq1rk1/5ppp/2p2n2/3pn3/p2NPP2/b3B3/B1PQN1PP/1K1R3R w - - 2 18,Bb3,-603,-621,-18,1
1rbq1rk1/5ppp/2p2n2/3pn3/p2NPP2/bB2B3/2PQN1PP/1K1R3R b - - 3 18,axb3,-645,-656,-11,1
1rbq1rk1/5ppp/2p2n2/3pn3/3NPP2/bp2B3/2PQN1PP/1K1R3R w - - 0 19,fxe5,-591,-617,-26,1
1rbq1rk1/5ppp/2p2n2/3pP3/3NP3/bp2B3/2PQN1PP/1K1R3R b - - 0 19,bxc2+,-608,-619,-11,1
1rbq1rk1/5ppp/2p2n2/3pP3/3NP3/b3B3/2pQN1PP/1K1R3R w - - 0 20,Ka2,-607,-711,-104,0
1rbq1rk1/5ppp/2p2n2/3pP3/3NP3/b3B3/K1pQN1PP/3R3R b - - 1 20,cxd1=Q,-708,-594,114,1
rnbqkbnr/pppppppp/8/8/8/8/PPPPPPPP/RNBQKBNR w KQkq - 0 1,e4,20,26,6,1
rnbqkbnr/pppppppp/8/8/4P3/8/PPPP1PPP/RNBQKBNR b KQkq - 0 1,c5,25,26,1,1
rnbqkbnr/pp1ppppp/8/2p5/4P3/8/PPPP1PPP/RNBQKBNR w KQkq - 0 2,Nf3,37,22,-15,1
rnbqkbnr/pp1ppppp/8/2p5/4P3/5N2/PPPP1PPP/RNBQKB1R b KQkq - 1 2,d5,15,121,106,1
rnbqkbnr/pp2pppp/8/2pp4/4P3/5N2/PPPP1PPP/RNBQKB1R w KQkq - 0 3,exd5,125,110,-15,1
rnbqkbnr/pp2pppp/8/2pP4/8/5N2/PPPP1PPP/RNBQKB1R b KQkq - 0 3,Nf6,107,107,0,1
rnbqkb1r/pp2pppp/5n2/2pP4/8/5N2/PPPP1PPP/RNBQKB1R w KQkq - 1 4,d4,117,70,-47,1
rnbqkb1r/pp2pppp/5n2/2pP4/3P4/5N2/PPP2PPP/RNBQKB1R b KQkq - 0 4,Nxd5,61,96,35,1
rnbqkb1r/pp2pppp/8/2pn4/3P4/5N2/PPP2PPP/RNBQKB1R w KQkq - 0 5,dxc5,82,71,-11,1
rnbqkb1r/pp2pppp/8/2Pn4/8/5N2/PPP2PPP/RNBQKB1R b KQkq - 0 5,e6,97,126,29,1
rnbqkb1r/pp3ppp/4p3/2Pn4/8/5N2/PPP2PPP/RNBQKB1R w KQkq - 0 6,Nc3,94,-4,-98,1
rnbqkb1r/pp3ppp/4p3/2Pn4/8/2N2N2/PPP2PPP/R1BQKB1R b KQkq - 1 6,Nxc3,-46,13,59,1
rnbqkb1r/pp3ppp/4p3/2P5/8/2n2N2/PPP2PPP/R1BQKB1R w KQkq - 0 7,bxc3,5,-58,-63,1
rnbqkb1r/pp3ppp/4p3/2P5/8/2P2N2/P1P2PPP/R1BQKB1R b KQkq - 0 7,Qxd1+,-58,-63,-5,1
rnb1kb1r/pp3ppp/4p3/2P5/8/2P2N2/P1P2PPP/R1BqKB1R w KQkq - 0 8,Kxd1,-52,-50,2,1
rnb1kb1r/pp3ppp/4p3/2P5/8/2P2N2/P1P2PPP/R1BK1B1R b kq - 0 8,Bxc5,-54,-52,2,1
rnb1k2r/pp3ppp/4p3/2b5/8/2P2N2/P1P2PPP/R1BK1B1R w kq - 0 9,Bd3,-62,-139,-77,1
rnb1k2r/pp3ppp/4p3/2b5/8/2PB1N2/P1P2PPP/R1BK3R b kq - 1 9,Bxf2,-137,-134,3,1
rnb1k2r/pp3ppp/4p3/8/8/2PB1N2/P1P2bPP/R1BK3R w kq - 0 10,Ke2,-128,-145,-17,1
rnb1k2r/pp3ppp/4p3/8/8/2PB1N2/P1P1KbPP/R1B4R b kq - 1 10,Bc5,-155,-136,19,1
rnb1k2r/pp3ppp/4p3/2b5/8/2PB1N2/P1P1K1PP/R1B4R w kq - 2 11,Ne5,-129,-235,-106,0
rnb1k2r/pp3ppp/4p3/2b1N3/8/2PB4/P1P1K1PP/R1B4R b kq - 3 11,Nc6,-239,-152,87,1
r1b1k2r/pp3ppp/2n1p3/2b1N3/8/2PB4/P1P1K1PP/R1B4R w kq - 4 12,Nc4,-174,-209,-35,1
r1b1k2r/pp3ppp/2n1p3/2b5/2N5/2PB4/P1P1K1PP/R1B4R b kq - 5 12,O-O,-236,-174,62,1
r1b2rk1/pp3ppp/2n1p3/2b5/2N5/2PB4/P1P1K1PP/R1B4R w - - 6 13,Be4,-186,-191,-5,1
r1b2rk1/pp3ppp/2n1p3/2b5/2N1B3/2P5/P1P1K1PP/R1B4R b - - 7 13,Bd7,-195,-144,51,1
r4rk1/pp1b1ppp/2n1p3/2b5/2N1B3/2P5/P1P1K1PP/R1B4R w - - 8 14,Bg5,-140,-233,-93,1
r4rk1/pp1b1ppp/2n1p3/2b3B1/2N1B3/2P5/P1P1K1PP/R6R b - - 9 14,f6,-234,-163,71,1
r4rk1/pp1b2pp/2n1pp2/2b3B1/2N1B3/2P5/P1P1K1PP/R6R w - - 0 15,Bf4,-171,-211,-40,1
r4rk1/pp1b2pp/2n1pp2/2b5/2N1BB2/2P5/P1P1K1PP/R6R b - - 1 15,e5,-214,-193,21,1
r4rk1/pp1b2pp/2n2p2/2b1p3/2N1BB2/2P5/P1P1K1PP/R6R w - - 0 16,Bg3,-189,-353,-164,0
r4rk1/pp1b2pp/2n2p2/2b1p3/2N1B3/2P3B1/P1P1K1PP/R6R b - - 1 16,b5,-373,-261,112,1
r4rk1/p2b2pp/2n2p2/1pb1p3/2N1B3/2P3B1/P1P1K1PP/R6R w - - 0 17,Ne3,-216,-214,2,1
r4rk1/p2b2pp/2n2p2/1pb1p3/4B3/2P1N1B1/P1P1K1PP/R6R b - - 1 17,Bxe3,-219,-200,19,1
r4rk1/p2b2pp/2n2p2/1p2p3/4B3/2P1b1B1/P1P1K1PP/R6R w - - 0 18,Kxe3,-141,-167,-26,1
r4rk1/p2b2pp/2n2p2/1p2p3/4B3/2P1K1B1/P1P3PP/R6R b - - 0 18,Rac8,-154,-132,22,1
2r2rk1/p2b2pp/2n2p2/1p2p3/4B3/2P1K1B1/P1P3PP/R6R w - - 1 19,Rhd1,-184,-188,-4,1
2r2rk1/p2b2pp/2n2p2/1p2p3/4B3/2P1K1B1/P1P3PP/R2R4 b - - 2 19,Be6,-182,-118,64,1
2r2rk1/p5pp/2n1bp2/1p2p3/4B3/2P1K1B1/P1P3PP/R2R4 w - - 3 20,Rd6,-102,-118,-16,1
2r2rk1/p5pp/2nRbp2/1p2p3/4B3/2P1K1B1/P1P3PP/R7 b - - 4 20,Nd8,-113,-102,11,1
2rn1rk1/p5pp/3Rbp2/1p2p3/4B3/2P1K1B1/P1P3PP/R7 w - - 5 21,Rad1,-107,-209,-102,0
2rn1rk1/p5pp/3Rbp2/1p2p3/4B3/2P1K1B1/P1P3PP/3R4 b - - 6 21,Bf7,-241,-124,117,1
2rn1rk1/p4bpp/3R1p2/1p2p3/4B3/2P1K1B1/P1P3PP/3R4 w - - 7 22,Ra6,-132,-128,4,1
2rn1rk1/p4bpp/R4p2/1p2p3/4B3/2P1K1B1/P1P3PP/3R4 b - - 8 22,Ne6,-129,-126,3,1
2r2rk1/p4bpp/R3np2/1p2p3/4B3/2P1K1B1/P1P3PP/3R4 w - - 9 23,Rxa7,-132,-143,-11,1
2r2rk1/R4bpp/4np2/1p2p3/4B3/2P1K1B1/P1P3PP/3R4 b - - 0 23,Nc5,-151,-97,54,1
2r2rk1/R4bpp/5p2/1pn1p3/4B3/2P1K1B1/P1P3PP/3R4 w - - 1 24,Bd3,-53,-208,-155,0
2r2rk1/R4bpp/5p2/1pn1p3/8/2PBK1B1/P1P3PP/3R4 b - - 2 24,Nxd3,-201,-176,25,1
2r2rk1/R4bpp/5p2/1p2p3/8/2PnK1B1/P1P3PP/3R4 w - - 0 25,Rxd3,-173,-241,-68,1
2r2rk1/R4bpp/5p2/1p2p3/8/2PRK1B1/P1P3PP/8 b - - 0 25,Bc4,-233,-145,88,1
2r2rk1/R5pp/5p2/1p2p3/2b5/2PRK1B1/P1P3PP/8 w - - 1 26,Rdd7,-155,-158,-3,1
2r2rk1/R2R2pp/5p2/1p2p3/2b5/2P1K1B1/P1P3PP/8 b - - 2 26,Rf7,-168,-181,-13,1
2r3k1/R2R1rpp/5p2/1p2p3/2b5/2P1K1B1/P1P3PP/8 w - - 3 27,Rxf7,-184,-192,-8,1
2r3k1/R4Rpp/5p2/1p2p3/2b5/2P1K1B1/P1P3PP/8 b - - 0 27,Bxf7,-181,-189,-8,1
2r3k1/R4bpp/5p2/1p2p3/8/2P1K1B1/P1P3PP/8 w - - 0 28,Kd2,-164,-286,-122,0
2r3k1/R4bpp/5p2/1p2p3/8/2P3B1/P1PK2PP/8 b - - 1 28,Rd8+,-271,-233,38,1
3r2k1/R4bpp/5p2/1p2p3/8/2P3B1/P1PK2PP/8 w - - 2 29,Kc1,-235,-224,11,1
3r2k1/R4bpp/5p2/1p2p3/8/2P3B1/P1P3PP/2K5 b - - 3 29,Bc4,-191,-200,-9,1
3r2k1/R5pp/5p2/1p2p3/2b5/2P3B1/P1P3PP/2K5 w - - 4 30,Bf2,-200,-199,1,1
3r2k1/R5pp/5p2/1p2p3/2b5/2P5/P1P2BPP/2K5 b - - 5 30,h5,-178,-165,13,1
3r2k1/R5p1/5p2/1p2p2p/2b5/2P5/P1P2BPP/2K5 w - - 0 31,Be3,-168,-195,-27,1
3r2k1/R5p1/5p2/1p2p2p/2b5/2P1B3/P1P3PP/2K5 b - - 1 31,Re8,-206,-173,33,1
4r1k1/R5p1/5p2/1p2p2p/2b5/2P1B3/P1P3PP/2K5 w - - 2 32,Kb2,-160,-183,-23,1
4r1k1/R5p1/5p2/1p2p2p/2b5/2P1B3/PKP3PP/8 b - - 3 32,Kh7,-173,-184,-11,1
4r3/R5pk/5p2/1p2p2p/2b5/2P1B3/PKP3PP/8 w - - 4 33,Ka3,-164,-176,-12,1
4r3/R5pk/5p2/1p2p2p/2b5/K1P1B3/P1P3PP/8 b - - 5 33,Kg6,-171,-93,78,1
4r3/R5p1/5pk1/1p2p2p/2b5/K1P1B3/P1P3PP/8 w - - 6 34,Kb4,-95,-93,2,1
4r3/R5p1/5pk1/1p2p2p/1Kb5/2P1B3/P1P3PP/8 b - - 7 34,Rg8,-109,131,240,1
6r1/R5p1/5pk1/1p2p2p/1Kb5/2P1B3/P1P3PP/8 w - - 8 35,a4,123,186,63,1
6r1/R5p1/5pk1/1p2p2p/PKb5/2P1B3/2P3PP/8 b - - 0 35,Kf5,179,314,135,1
6r1/R5p1/5p2/1p2pk1p/PKb5/2P1B3/2P3PP/8 w - - 1 36,axb5,337,342,5,1
6r1/R5p1/5p2/1P2pk1p/1Kb5/2P1B3/2P3PP/8 b - - 0 36,Be2,302,366,64,1
6r1/R5p1/5p2/1P2pk1p/1K6/2P1B3/2P1b1PP/8 w - - 1 37,b6,378,339,-39,1
6r1/R5p1/1P3p2/4pk1p/1K6/2P1B3/2P1b1PP/8 b - - 0 37,Rb8,344,402,58,1
1r6/R5p1/1P3p2/4pk1p/1K6/2P1B3/2P1b1PP/8 w - - 1 38,b7,424,105,-319,0
1r6/RP4p1/5p2/4pk1p/1K6/2P1B3/2P1b1PP/8 b - - 0 38,Bf1,90,135,45,1
1r6/RP4p1/5p2/4pk1p/1K6/2P1B3/2P3PP/5b2 w - - 1 39,Bb6,185,-304,-489,0
1r6/RP4p1/1B3p2/4pk1p/1K6/2P5/2P3PP/5b2 b - - 2 39,Bxg2,-304,-299,5,1
1r6/RP4p1/1B3p2/4pk1p/1K6/2P5/2P3bP/8 w - - 0 40,Bc7,-287,-338,-51,1
1r6/RPB3p1/5p2/4pk1p/1K6/2P5/2P3bP/8 b - - 1 40,Rxb7+,-329,-395,-66,1
8/RrB3p1/5p2/4pk1p/1K6/2P5/2P3bP/8 w - - 0 41,Rxb7,-409,-385,24,1
8/1RB3p1/5p2/4pk1p/1K6/2P5/2P3bP/8 b - - 0 41,Bxb7,-417,-387,30,1
8/1bB3p1/5p2/4pk1p/1K6/2P5/2P4P/8 w - - 0 42,c4,-397,-430,-33,1
8/1bB3p1/5p2/4pk1p/1KP5/8/2P4P/8 b - - 0 42,Be4,-420,-329,91,1
8/2B3p1/5p2/4pk1p/1KP1b3/8/2P4P/8 w - - 1 43,Bb6,-346,-367,-21,1
8/6p1/1B3p2/4pk1p/1KP1b3/8/2P4P/8 b - - 2 43,Bxc2,-390,-358,32,1
8/6p1/1B3p2/4pk1p/1KP5/8/2b4P/8 w - - 0 44,Bf2,-395,-400,-5,1
8/6p1/5p2/4pk1p/1KP5/8/2b2B1P/8 b - - 1 44,Be4,-437,-405,32,1
8/6p1/5p2/4pk1p/1KP1b3/8/5B1P/8 w - - 2 45,c5,-417,-450,-33,1
8/6p1/5p2/2P1pk1p/1K2b3/8/5B1P/8 b - - 0 45,Bc6,-482,-415,67,1
8/6p1/2b2p2/2P1pk1p/1K6/8/5B1P/8 w - - 1 46,Ka5,-452,-417,35,1
8/6p1/2b2p2/K1P1pk1p/8/8/5B1P/8 b - - 2 46,Ke4,-453,-457,-4,1
8/6p1/2b2p2/K1P1p2p/4k3/8/5B1P/8 w - - 3 47,Kb6,-441,-471,-30,1
8/6p1/1Kb2p2/2P1p2p/4k3/8/5B1P/8 b - - 4 47,Kd5,-443,-463,-20,1
8/6p1/1Kb2p2/2Pkp2p/8/8/5B1P/8 w - - 5 48,Kc7,-434,-434,0,1
8/2K3p1/2b2p2/2Pkp2p/8/8/5B1P/8 b - - 6 48,f5,-468,-456,12,1
8/2K3p1/2b5/2Pkpp1p/8/8/5B1P/8 w - - 0 49,Be3,-460,-537,-77,1
8/2K3p1/2b5/2Pkpp1p/8/4B3/7P/8 b - - 1 49,f4,-569,-547,22,1
8/2K3p1/2b5/2Pkp2p/5p2/4B3/7P/8 w - - 0 50,Bf2,-559,-618,-59,1
8/2K3p1/2b5/2Pkp2p/5p2/8/5B1P/8 b - - 1 50,g5,-626,-641,-15,1
8/2K5/2b5/2Pkp1pp/5p2/8/5B1P/8 w - - 0 51,Be1,-592,-619,-27,1
8/2K5/2b5/2Pkp1pp/5p2/8/7P/4B3 b - - 1 51,e4,-536,-648,-112,0
8/2K5/2b5/2Pk2pp/4pp2/8/7P/4B3 w - - 0 52,Bd2,-617,-621,-4,1
8/2K5/2b5/2Pk2pp/4pp2/8/3B3P/8 b - - 1 52,e3,-612,-646,-34,1
8/2K5/2b5/2Pk2pp/5p2/4p3/3B3P/8 w - - 0 53,Be1,-661,-757,-96,1
8/2K5/2b5/2Pk2pp/5p2/4p3/7P/4B3 b - - 1 53,f3,-751,-808,-57,1
8/2K5/2b5/2Pk2pp/8/4pp2/7P/4B3 w - - 0 54,Bc3,-816,-858,-42,1
8/2K5/2b5/2Pk2pp/8/2B1pp2/7P/8 b - - 1 54,f2,-900,-844,56,1
8/2K5/2b5/2Pk2pp/8/2B1p3/5p1P/8 w - - 0 55,Be5,-854,-9994,-9140,0
8/2K5/2b5/2PkB1pp/8/4p3/5p1P/8 b - - 1 55,f1=Q,-9994,-9995,-1,1
8/2K5/2b5/2PkB1pp/8/4p3/7P/5q2 w - - 0 56,Kd8,-9995,-9996,-1,1
3K4/8/2b5/2PkB1pp/8/4p3/7P/5q2 b - - 1 56,Qc4,-9996,-933,9063,1
3K4/8/2b5/2PkB1pp/2q5/4p3/7P/8 w - - 2 57,Kc8,-915,-9995,-9080,0
2K5/8/2b5/2PkB1pp/2q5/4p3/7P/8 b - - 3 57,Qxc5,-9995,-937,9058,1
2K5/8/2b5/2qkB1pp/8/4p3/7P/8 w - - 0 58,Kd8,-1378,-9996,-8618,0
3K4/8/2b5/2qkB1pp/8/4p3/7P/8 b - - 1 58,Kxe5,-9996,-9993,3,1
rnbqkbnr/pppppppp/8/8/8/8/PPPPPPPP/RNBQKBNR w KQkq - 0 1,e4,22,25,3,1
rnbqkbnr/pppppppp/8/8/4P3/8/PPPP1PPP/RNBQKBNR b KQkq - 0 1,c5,28,41,13,1
rnbqkbnr/pp1ppppp/8/2p5/4P3/8/PPPP1PPP/RNBQKBNR w KQkq - 0 2,d3,28,-6,-34,1
rnbqkbnr/pp1ppppp/8/2p5/4P3/3P4/PPP2PPP/RNBQKBNR b KQkq - 0 2,Nc6,-11,-19,-8,1
r1bqkbnr/pp1ppppp/2n5/2p5/4P3/3P4/PPP2PPP/RNBQKBNR w KQkq - 1 3,Nf3,-24,-24,0,1
r1bqkbnr/pp1ppppp/2n5/2p5/4P3/3P1N2/PPP2PPP/RNBQKB1R b KQkq - 2 3,d6,-24,-15,9,1
r1bqkbnr/pp2pppp/2np4/2p5/4P3/3P1N2/PPP2PPP/RNBQKB1R w KQkq - 0 4,Nc3,-5,-3,2,1
r1bqkbnr/pp2pppp/2np4/2p5/4P3/2NP1N2/PPP2PPP/R1BQKB1R b KQkq - 1 4,e6,-6,3,9,1
r1bqkbnr/pp3ppp/2npp3/2p5/4P3/2NP1N2/PPP2PPP/R1BQKB1R w KQkq - 0 5,Bg5,9,-17,-26,1
r1bqkbnr/pp3ppp/2npp3/2p3B1/4P3/2NP1N2/PPP2PPP/R2QKB1R b KQkq - 1 5,g6,-15,667,682,1
r1bqkbnr/pp3p1p/2npp1p1/2p3B1/4P3/2NP1N2/PPP2PPP/R2QKB1R w KQkq - 0 6,Bxd8,612,649,37,1
r1bBkbnr/pp3p1p/2npp1p1/2p5/4P3/2NP1N2/PPP2PPP/R2QKB1R b KQkq - 0 6,Nxd8,648,668,20,1
r1bnkbnr/pp3p1p/3pp1p1/2p5/4P3/2NP1N2/PPP2PPP/R2QKB1R w KQkq - 0 7,h3,663,617,-46,1
r1bnkbnr/pp3p1p/3pp1p1/2p5/4P3/2NP1N1P/PPP2PP1/R2QKB1R b KQkq - 0 7,Be7,613,666,53,1
r1bnk1nr/pp2bp1p/3pp1p1/2p5/4P3/2NP1N1P/PPP2PP1/R2QKB1R w KQkq - 1 8,Be2,655,617,-38,1
r1bnk1nr/pp2bp1p/3pp1p1/2p5/4P3/2NP1N1P/PPP1BPP1/R2QK2R b KQkq - 2 8,f6,621,701,80,1
r1bnk1nr/pp2b2p/3pppp1/2p5/4P3/2NP1N1P/PPP1BPP1/R2QK2R w KQkq - 0 9,O-O,698,661,-37,1
r1bnk1nr/pp2b2p/3pppp1/2p5/4P3/2NP1N1P/PPP1BPP1/R2Q1RK1 b kq - 1 9,Kf7,666,748,82,1
r1bn2nr/pp2bk1p/3pppp1/2p5/4P3/2NP1N1P/PPP1BPP1/R2Q1RK1 w - - 2 10,d4,744,730,-14,1
r1bn2nr/pp2bk1p/3pppp1/2p5/3PP3/2N2N1P/PPP1BPP1/R2Q1RK1 b - - 0 10,Kg7,708,712,4,1
r1bn2nr/pp2b1kp/3pppp1/2p5/3PP3/2N2N1P/PPP1BPP1/R2Q1RK1 w - - 1 11,dxc5,701,698,-3,1
r1bn2nr/pp2b1kp/3pppp1/2P5/4P3/2N2N1P/PPP1BPP1/R2Q1RK1 b - - 0 11,dxc5,689,680,-9,1
r1bn2nr/pp2b1kp/4ppp1/2p5/4P3/2N2N1P/PPP1BPP1/R2Q1RK1 w - - 0 12,Qd2,678,629,-49,1
r1bn2nr/pp2b1kp/4ppp1/2p5/4P3/2N2N1P/PPPQBPP1/R4RK1 b - - 1 12,Nh6,641,636,-5,1
r1bn3r/pp2b1kp/4pppn/2p5/4P3/2N2N1P/PPPQBPP1/R4RK1 w - - 2 13,Rfd1,630,621,-9,1
r1bn3r/pp2b1kp/4pppn/2p5/4P3/2N2N1P/PPPQBPP1/R2R2K1 b - - 3 13,Nhf7,620,637,17,1
r1bn3r/pp2bnkp/4ppp1/2p5/4P3/2N2N1P/PPPQBPP1/R2R2K1 w - - 4 14,Qe3,618,611,-7,1
r1bn3r/pp2bnkp/4ppp1/2p5/4P3/2N1QN1P/PPP1BPP1/R2R2K1 b - - 5 14,Nc6,599,616,17,1
r1b4r/pp2bnkp/2n1ppp1/2p5/4P3/2N1QN1P/PPP1BPP1/R2R2K1 w - - 6 15,Nb5,615,569,-46,1
r1b4r/pp2bnkp/2n1ppp1/1Np5/4P3/4QN1P/PPP1BPP1/R2R2K1 b - - 7 15,a6,569,589,20,1
r1b4r/1p2bnkp/p1n1ppp1/1Np5/4P3/4QN1P/PPP1BPP1/R2R2K1 w - - 0 16,Nc7,632,547,-85,1
r1b4r/1pN1bnkp/p1n1ppp1/2p5/4P3/4QN1P/PPP1BPP1/R2R2K1 b - - 1 16,Rb8,584,584,0,1
1rb4r/1pN1bnkp/p1n1ppp1/2p5/4P3/4QN1P/PPP1BPP1/R2R2K1 w - - 2 17,Nxe6+,575,380,-195,0
1rb4r/1p2bnkp/p1n1Npp1/2p5/4P3/4QN1P/PPP1BPP1/R2R2K1 b - - 0 17,Bxe6,398,378,-20,1
1r5r/1p2bnkp/p1n1bpp1/2p5/4P3/4QN1P/PPP1BPP1/R2R2K1 w - - 0 18,e5,385,365,-20,1
1r5r/1p2bnkp/p1n1bpp1/2p1P3/8/4QN1P/PPP1BPP1/R2R2K1 b - - 0 18,Ncxe5,351,490,139,1
1r5r/1p2bnkp/p3bpp1/2p1n3/8/4QN1P/PPP1BPP1/R2R2K1 w - - 0 19,Nxe5,463,439,-24,1
1r5r/1p2bnkp/p3bpp1/2p1N3/8/4Q2P/PPP1BPP1/R2R2K1 b - - 0 19,Nxe5,457,465,8,1
1r5r/1p2b1kp/p3bpp1/2p1n3/8/4Q2P/PPP1BPP1/R2R2K1 w - - 0 20,f4,510,509,-1,1
1r5r/1p2b1kp/p3bpp1/2p1n3/5P2/4Q2P/PPP1B1P1/R2R2K1 b - - 0 20,b6,507,543,36,1
1r5r/4b1kp/pp2bpp1/2p1n3/5P2/4Q2P/PPP1B1P1/R2R2K1 w - - 0 21,fxe5,531,503,-28,1
1r5r/4b1kp/pp2bpp1/2p1P3/8/4Q2P/PPP1B1P1/R2R2K1 b - - 0 21,c4,586,652,66,1
1r5r/4b1kp/pp2bpp1/4P3/2p5/4Q2P/PPP1B1P1/R2R2K1 w - - 0 22,exf6+,650,644,-6,1
1r5r/4b1kp/pp2bPp1/8/2p5/4Q2P/PPP1B1P1/R2R2K1 b - - 0 22,Kxf6,668,749,81,1
1r5r/4b2p/pp2bkp1/8/2p5/4Q2P/PPP1B1P1/R2R2K1 w - - 0 23,Rf1+,763,650,-113,0
1r5r/4b2p/pp2bkp1/8/2p5/4Q2P/PPP1B1P1/R4RK1 b - - 1 23,Kg7,703,691,-12,1
1r5r/4b1kp/pp2b1p1/8/2p5/4Q2P/PPP1B1P1/R4RK1 w - - 2 24,Qc3+,702,584,-118,0
1r5r/4b1kp/pp2b1p1/8/2p5/2Q4P/PPP1B1P1/R4RK1 b - - 3 24,Kh6,717,630,-87,1
1r5r/4b2p/pp2b1pk/8/2p5/2Q4P/PPP1B1P1/R4RK1 w - - 4 25,Bxc4,633,623,-10,1
1r5r/4b2p/pp2b1pk/8/2B5/2Q4P/PPP3P1/R4RK1 b - - 0 25,Bc5+,558,619,61,1
1r5r/7p/pp2b1pk/2b5/2B5/2Q4P/PPP3P1/R4RK1 w - - 1 26,Kh1,666,654,-12,1
1r5r/7p/pp2b1pk/2b5/2B5/2Q4P/PPP3P1/R4R1K b - - 2 26,Bd7,658,931,273,1
1r5r/3b3p/pp4pk/2b5/2B5/2Q4P/PPP3P1/R4R1K w - - 3 27,Rad1,9994,696,-9298,0
1r5r/3b3p/pp4pk/2b5/2B5/2Q4P/PPP3P1/3R1R1K b - - 4 27,Bc6,762,9993,9231,1
1r5r/7p/ppb3pk/2b5/2B5/2Q4P/PPP3P1/3R1R1K w - - 5 28,Bxa6,9993,581,-9412,0
1r5r/7p/Bpb3pk/2b5/8/2Q4P/PPP3P1/3R1R1K b - - 0 28,Rhf8,588,588,0,1
1r3r2/7p/Bpb3pk/2b5/8/2Q4P/PPP3P1/3R1R1K w - - 1 29,Rxf8,617,538,-79,1
1r3R2/7p/Bpb3pk/2b5/8/2Q4P/PPP3P1/3R3K b - - 0 29,Rxf8,550,583,33,1
5r2/7p/Bpb3pk/2b5/8/2Q4P/PPP3P1/3R3K w - - 0 30,Kh2,634,537,-97,1
5r2/7p/Bpb3pk/2b5/8/2Q4P/PPP3PK/3R4 b - - 1 30,Be7,522,683,161,1
5r2/4b2p/Bpb3pk/8/8/2Q4P/PPP3PK/3R4 w - - 2 31,Qd2+,685,520,-165,0
5r2/4b2p/Bpb3pk/8/8/7P/PPPQ2PK/3R4 b - - 3 31,Bg5,574,581,7,1
5r2/7p/Bpb3pk/6b1/8/7P/PPPQ2PK/3R4 w - - 4 32,Qd6,556,421,-135,0
5r2/7p/BpbQ2pk/6b1/8/7P/PPP3PK/3R4 b - - 5 32,Bf4+,433,446,13,1
5r2/7p/BpbQ2pk/8/5b2/7P/PPP3PK/3R4 w - - 6 33,g3,445,45,-400,0
5r2/7p/BpbQ2pk/8/5b2/6PP/PPP4K/3R4 b - - 0 33,Bxd6,88,82,-6,1
5r2/7p/Bpbb2pk/8/8/6PP/PPP4K/3R4 w - - 0 34,Rxd6,85,98,13,1
5r2/7p/BpbR2pk/8/8/6PP/PPP4K/8 b - - 0 34,Bf3,86,329,243,1
5r2/7p/Bp1R2pk/8/8/5bPP/PPP4K/8 w - - 1 35,Rxb6,397,377,-20,1
5r2/7p/BR4pk/8/8/5bPP/PPP4K/8 b - - 0 35,Be2,380,521,141,1
5r2/7p/BR4pk/8/8/6PP/PPP1b2K/8 w - - 1 36,Bxe2,528,499,-29,1
5r2/7p/1R4pk/8/8/6PP/PPP1B2K/8 b - - 0 36,Rf2+,512,506,-6,1
8/7p/1R4pk/8/8/6PP/PPP1Br1K/8 w - - 1 37,Kg1,486,512,26,1
8/7p/1R4pk/8/8/6PP/PPP1Br2/6K1 b - - 2 37,Rxe2,500,497,-3,1
8/7p/1R4pk/8/8/6PP/PPP1r3/6K1 w - - 0 38,Rc6,499,472,-27,1
8/7p/2R3pk/8/8/6PP/PPP1r3/6K1 b - - 1 38,Rd2,479,517,38,1
8/7p/2R3pk/8/8/6PP/PPPr4/6K1 w - - 2 39,c3,524,160,-364,0
8/7p/2R3pk/8/8/2P3PP/PP1r4/6K1 b - - 0 39,Rd1+,119,315,196,1
8/7p/2R3pk/8/8/2P3PP/PP6/3r2K1 w - - 1 40,Kf2,305,310,5,1
8/7p/2R3pk/8/8/2P3PP/PP3K2/3r4 b - - 2 40,Rd2+,357,360,3,1
8/7p/2R3pk/8/8/2P3PP/PP1r1K2/8 w - - 3 41,Ke3,339,341,2,1
8/7p/2R3pk/8/8/2P1K1PP/PP1r4/8 b - - 4 41,Rxb2,336,367,31,1
8/7p/2R3pk/8/8/2P1K1PP/Pr6/8 w - - 0 42,Kd4,353,195,-158,0
8/7p/2R3pk/8/3K4/2P3PP/Pr6/8 b - - 1 42,Rxa2,174,161,-13,1
8/7p/2R3pk/8/3K4/2P3PP/r7/8 w - - 0 43,Kc4,176,0,-176,0
8/7p/2R3pk/8/2K5/2P3PP/r7/8 b - - 1 43,Rc2,-1,205,206,1
8/7p/2R3pk/8/2K5/2P3PP/2r5/8 w - - 2 44,Kb4,213,1,-212,0
8/7p/2R3pk/8/1K6/2P3PP/2r5/8 b - - 3 44,Rc1,2,204,202,1
8/7p/2R3pk/8/1K6/2P3PP/8/2r5 w - - 4 45,c4,229,26,-203,0
8/7p/2R3pk/8/1KP5/6PP/8/2r5 b - - 0 45,Rb1+,17,13,-4,1
8/7p/2R3pk/8/1KP5/6PP/8/1r6 w - - 1 46,Kc3,16,13,-3,1
8/7p/2R3pk/8/2P5/2K3PP/8/1r6 b - - 2 46,Ra1,12,182,170,1
8/7p/2R3pk/8/2P5/2K3PP/8/r7 w - - 3 47,Kd4,211,47,-164,0
8/7p/2R3pk/8/2PK4/6PP/8/r7 b - - 4 47,Rc1,66,273,207,1
8/7p/2R3pk/8/2PK4/6PP/8/2r5 w - - 5 48,Kd5,295,14,-281,0
8/7p/2R3pk/3K4/2P5/6PP/8/2r5 b - - 6 48,Rd1+,13,95,82,1
8/7p/2R3pk/3K4/2P5/6PP/8/3r4 w - - 7 49,Kc5,79,5,-74,1
8/7p/2R3pk/2K5/2P5/6PP/8/3r4 b - - 8 49,Rc1,4,152,148,1
8/7p/2R3pk/2K5/2P5/6PP/8/2r5 w - - 9 50,Kb5,230,22,-208,0
8/7p/2R3pk/1K6/2P5/6PP/8/2r5 b - - 10 50,Rb1+,23,24,1,1
8/7p/2R3pk/1K6/2P5/6PP/8/1r6 w - - 11 51,Kc5,24,0,-24,1
8/7p/2R3pk/2K5/2P5/6PP/8/1r6 b - - 12 51,Rc1,0,251,251,1
rnbqkbnr/pppppppp/8/8/8/8/PPPPPPPP/RNBQKBNR w KQkq - 0 1,f4,26,-28,-54,1
rnbqkbnr/pppppppp/8/8/5P2/8/PPPPP1PP/RNBQKBNR b KQkq - 0 1,d5,-45,-18,27,1
rnbqkbnr/ppp1pppp/8/3p4/5P2/8/PPPPP1PP/RNBQKBNR w KQkq - 0 2,e4,-20,-156,-136,0
rnbqkbnr/ppp1pppp/8/3p4/4PP2/8/PPPP2PP/RNBQKBNR b KQkq - 0 2,dxe4,-165,-173,-8,1
rnbqkbnr/ppp1pppp/8/8/4pP2/8/PPPP2PP/RNBQKBNR w KQkq - 0 3,Nc3,-142,-159,-17,1
rnbqkbnr/ppp1pppp/8/8/4pP2/2N5/PPPP2PP/R1BQKBNR b KQkq - 1 3,Nf6,-170,-169,1,1
rnbqkb1r/ppp1pppp/5n2/8/4pP2/2N5/PPPP2PP/R1BQKBNR w KQkq - 2 4,d4,-152,-220,-68,1
rnbqkb1r/ppp1pppp/5n2/8/3PpP2/2N5/PPP3PP/R1BQKBNR b KQkq d3 0 4,exd3,-212,-104,108,1
rnbqkb1r/ppp1pppp/5n2/8/5P2/2Np4/PPP3PP/R1BQKBNR w KQkq - 0 5,Qxd3,-94,-128,-34,1
rnbqkb1r/ppp1pppp/5n2/8/5P2/2NQ4/PPP3PP/R1B1KBNR b KQkq - 0 5,Qxd3,-121,-140,-19,1
rnb1kb1r/ppp1pppp/5n2/8/5P2/2Nq4/PPP3PP/R1B1KBNR w KQkq - 0 6,cxd3,-118,-247,-129,0
rnb1kb1r/ppp1pppp/5n2/8/5P2/2NP4/PP4PP/R1B1KBNR b KQkq - 0 6,Nc6,-223,-244,-21,1
r1b1kb1r/ppp1pppp/2n2n2/8/5P2/2NP4/PP4PP/R1B1KBNR w KQkq - 1 7,Be2,-231,-270,-39,1
r1b1kb1r/ppp1pppp/2n2n2/8/5P2/2NP4/PP2B1PP/R1B1K1NR b KQkq - 2 7,Nd4,-234,-261,-27,1
r1b1kb1r/ppp1pppp/5n2/8/3n1P2/2NP4/PP2B1PP/R1B1K1NR w KQkq - 3 8,Nf3,-260,-381,-121,0
r1b1kb1r/ppp1pppp/5n2/8/3n1P2/2NP1N2/PP2B1PP/R1B1K2R b KQkq - 4 8,Nc2+,-360,-361,-1,1
r1b1kb1r/ppp1pppp/5n2/8/5P2/2NP1N2/PPn1B1PP/R1B1K2R w KQkq - 5 9,Kd1,-348,-349,-1,1
r1b1kb1r/ppp1pppp/5n2/8/5P2/2NP1N2/PPn1B1PP/R1BK3R b kq - 6 9,Nxa1,-331,-346,-15,1
r1b1kb1r/ppp1pppp/5n2/8/5P2/2NP1N2/PP2B1PP/n1BK3R w kq - 0 10,Ne5,-362,-375,-13,1
r1b1kb1r/ppp1pppp/5n2/4N3/5P2/2NP4/PP2B1PP/n1BK3R b kq - 1 10,Bf5,-353,-292,61,1
r3kb1r/ppp1pppp/5n2/4Nb2/5P2/2NP4/PP2B1PP/n1BK3R w kq - 2 11,Kd2,-319,-376,-57,1
r3kb1r/ppp1pppp/5n2/4Nb2/5P2/2NP4/PP1KB1PP/n1B4R b kq - 3 11,e6,-373,-245,128,1
r3kb1r/ppp2ppp/4pn2/4Nb2/5P2/2NP4/PP1KB1PP/n1B4R w kq - 0 12,b3,-230,-420,-190,0
r3kb1r/ppp2ppp/4pn2/4Nb2/5P2/1PNP4/P2KB1PP/n1B4R b kq - 0 12,Nd7,-430,-447,-17,1
r3kb1r/pppn1ppp/4p3/4Nb2/5P2/1PNP4/P2KB1PP/n1B4R w kq - 1 13,Bb2,-464,-518,-54,1
r3kb1r/pppn1ppp/4p3/4Nb2/5P2/1PNP4/PB1KB1PP/n6R b kq - 2 13,Nxb3+,-514,-482,32,1
r3kb1r/pppn1ppp/4p3/4Nb2/5P2/1nNP4/PB1KB1PP/7R w kq - 0 14,axb3,-516,-462,54,1
r3kb1r/pppn1ppp/4p3/4Nb2/5P2/1PNP4/1B1KB1PP/7R b kq - 0 14,Nxe5,-514,-498,16,1
r3kb1r/ppp2ppp/4p3/4nb2/5P2/1PNP4/1B1KB1PP/7R w kq - 0 15,Re1,-509,-611,-102,0
r3kb1r/ppp2ppp/4p3/4nb2/5P2/1PNP4/1B1KB1PP/4R3 b kq - 1 15,Nc6,-632,-602,30,1
r3kb1r/ppp2ppp/2n1p3/5b2/5P2/1PNP4/1B1KB1PP/4R3 w kq - 2 16,Bf3,-583,-680,-97,1
r3kb1r/ppp2ppp/2n1p3/5b2/5P2/1PNP1B2/1B1K2PP/4R3 b kq - 3 16,O-O-O,-659,-631,28,1
2kr1b1r/ppp2ppp/2n1p3/5b2/5P2/1PNP1B2/1B1K2PP/4R3 w - - 4 17,Bxc6,-636,-662,-26,1
2kr1b1r/ppp2ppp/2B1p3/5b2/5P2/1PNP4/1B1K2PP/4R3 b - - 0 17,Rxd3+,-673,-628,45,1
2k2b1r/ppp2ppp/2B1p3/5b2/5P2/1PNr4/1B1K2PP/4R3 w - - 0 18,Ke2,-647,-640,7,1
2k2b1r/ppp2ppp/2B1p3/5b2/5P2/1PNr4/1B2K1PP/4R3 b - - 1 18,bxc6,-635,-660,-25,1
2k2b1r/p1p2ppp/2p1p3/5b2/5P2/1PNr4/1B2K1PP/4R3 w - - 0 19,Ra1,-625,-648,-23,1
2k2b1r/p1p2ppp/2p1p3/5b2/5P2/1PNr4/1B2K1PP/R7 b - - 1 19,Bc5,-617,-600,17,1
2k4r/p1p2ppp/2p1p3/2b2b2/5P2/1PNr4/1B2K1PP/R7 w - - 2 20,Bc1,-644,-863,-219,0
2k4r/p1p2ppp/2p1p3/2b2b2/5P2/1PNr4/4K1PP/R1B5 b - - 3 20,Rxc3,-829,-830,-1,1
rnbqkbnr/pppppppp/8/8/8/8/PPPPPPPP/RNBQKBNR w KQkq - 0 1,d4,20,17,-3,1
rnbqkbnr/pppppppp/8/8/3P4/8/PPP1PPPP/RNBQKBNR b KQkq - 0 1,e6,20,48,28,1
rnbqkbnr/pppp1ppp/4p3/8/3P4/8/PPP1PPPP/RNBQKBNR w KQkq - 0 2,c4,44,19,-25,1
rnbqkbnr/pppp1ppp/4p3/8/2PP4/8/PP2PPPP/RNBQKBNR b KQkq - 0 2,c6,17,61,44,1
rnbqkbnr/pp1p1ppp/2p1p3/8/2PP4/8/PP2PPPP/RNBQKBNR w KQkq - 0 3,Nc3,47,69,22,1
rnbqkbnr/pp1p1ppp/2p1p3/8/2PP4/2N5/PP2PPPP/R1BQKBNR b KQkq - 1 3,Nf6,63,98,35,1
rnbqkb1r/pp1p1ppp/2p1pn2/8/2PP4/2N5/PP2PPPP/R1BQKBNR w KQkq - 2 4,Bg5,113,41,-72,1
rnbqkb1r/pp1p1ppp/2p1pn2/6B1/2PP4/2N5/PP2PPPP/R2QKBNR b KQkq - 3 4,Bb4,41,61,20,1
rnbqk2r/pp1p1ppp/2p1pn2/6B1/1bPP4/2N5/PP2PPPP/R2QKBNR w KQkq - 4 5,e4,50,35,-15,1
rnbqk2r/pp1p1ppp/2p1pn2/6B1/1bPPP3/2N5/PP3PPP/R2QKBNR b KQkq - 0 5,Bxc3+,31,21,-10,1
rnbqk2r/pp1p1ppp/2p1pn2/6B1/2PPP3/2b5/PP3PPP/R2QKBNR w KQkq - 0 6,bxc3,18,15,-3,1
rnbqk2r/pp1p1ppp/2p1pn2/6B1/2PPP3/2P5/P4PPP/R2QKBNR b KQkq - 0 6,d6,19,91,72,1
rnbqk2r/pp3ppp/2pppn2/6B1/2PPP3/2P5/P4PPP/R2QKBNR w KQkq - 0 7,Bd3,94,96,2,1
rnbqk2r/pp3ppp/2pppn2/6B1/2PPP3/2PB4/P4PPP/R2QK1NR b KQkq - 1 7,Nbd7,93,114,21,1
r1bqk2r/pp1n1ppp/2pppn2/6B1/2PPP3/2PB4/P4PPP/R2QK1NR w KQkq - 2 8,Nf3,143,94,-49,1
r1bqk2r/pp1n1ppp/2pppn2/6B1/2PPP3/2PB1N2/P4PPP/R2QK2R b KQkq - 3 8,h6,85,98,13,1
r1bqk2r/pp1n1pp1/2pppn1p/6B1/2PPP3/2PB1N2/P4PPP/R2QK2R w KQkq - 0 9,Bh4,109,110,1,1
r1bqk2r/pp1n1pp1/2pppn1p/8/2PPP2B/2PB1N2/P4PPP/R2QK2R b KQkq - 1 9,O-O,103,135,32,1
r1bq1rk1/pp1n1pp1/2pppn1p/8/2PPP2B/2PB1N2/P4PPP/R2QK2R w KQ - 2 10,O-O,120,133,13,1
r1bq1rk1/pp1n1pp1/2pppn1p/8/2PPP2B/2PB1N2/P4PPP/R2Q1RK1 b - - 3 10,Qe8,124,214,90,1
r1b1qrk1/pp1n1pp1/2pppn1p/8/2PPP2B/2PB1N2/P4PPP/R2Q1RK1 w - - 4 11,Qd2,212,140,-72,1
r1b1qrk1/pp1n1pp1/2pppn1p/8/2PPP2B/2PB1N2/P2Q1PPP/R4RK1 b - - 5 11,a6,128,265,137,1
r1b1qrk1/1p1n1pp1/p1pppn1p/8/2PPP2B/2PB1N2/P2Q1PPP/R4RK1 w - - 0 12,Rfe1,314,200,-114,0
r1b1qrk1/1p1n1pp1/p1pppn1p/8/2PPP2B/2PB1N2/P2Q1PPP/R3R1K1 b - - 1 12,Nh7,182,303,121,1
r1b1qrk1/1p1n1ppn/p1ppp2p/8/2PPP2B/2PB1N2/P2Q1PPP/R3R1K1 w - - 2 13,h3,301,186,-115,0
r1b1qrk1/1p1n1ppn/p1ppp2p/8/2PPP2B/2PB1N1P/P2Q1PP1/R3R1K1 b - - 0 13,b5,188,262,74,1
r1b1qrk1/3n1ppn/p1ppp2p/1p6/2PPP2B/2PB1N1P/P2Q1PP1/R3R1K1 w - - 0 14,cxb5,283,223,-60,1
r1b1qrk1/3n1ppn/p1ppp2p/1P6/3PP2B/2PB1N1P/P2Q1PP1/R3R1K1 b - - 0 14,axb5,225,246,21,1
r1b1qrk1/3n1ppn/2ppp2p/1p6/3PP2B/2PB1N1P/P2Q1PP1/R3R1K1 w - - 0 15,Bc2,262,146,-116,0
r1b1qrk1/3n1ppn/2ppp2p/1p6/3PP2B/2P2N1P/P1BQ1PP1/R3R1K1 b - - 1 15,f5,123,395,272,1
r1b1qrk1/3n2pn/2ppp2p/1p3p2/3PP2B/2P2N1P/P1BQ1PP1/R3R1K1 w - - 0 16,exf5,379,319,-60,1
r1b1qrk1/3n2pn/2ppp2p/1p3P2/3P3B/2P2N1P/P1BQ1PP1/R3R1K1 b - - 0 16,Ndf6,360,318,-42,1
r1b1qrk1/6pn/2pppn1p/1p3P2/3P3B/2P2N1P/P1BQ1PP1/R3R1K1 w - - 1 17,fxe6,321,385,64,1
r1b1qrk1/6pn/2ppPn1p/1p6/3P3B/2P2N1P/P1BQ1PP1/R3R1K1 b - - 0 17,Bxe6,394,443,49,1
r3qrk1/6pn/2ppbn1p/1p6/3P3B/2P2N1P/P1BQ1PP1/R3R1K1 w - - 0 18,Bf5,420,279,-141,0
r3qrk1/6pn/2ppbn1p/1p3B2/3P3B/2P2N1P/P2Q1PP1/R3R1K1 b - - 1 18,Ng5,273,460,187,1
r3qrk1/6p1/2ppbn1p/1p3Bn1/3P3B/2P2N1P/P2Q1PP1/R3R1K1 w - - 2 19,Bxg5,475,462,-13,1
r3qrk1/6p1/2ppbn1p/1p3BB1/3P4/2P2N1P/P2Q1PP1/R3R1K1 b - - 0 19,hxg5,448,516,68,1
r3qrk1/6p1/2ppbn2/1p3Bp1/3P4/2P2N1P/P2Q1PP1/R3R1K1 w - - 0 20,Bxe6+,531,537,6,1
r3qrk1/6p1/2ppBn2/1p4p1/3P4/2P2N1P/P2Q1PP1/R3R1K1 b - - 0 20,Kh8,575,530,-45,1
r3qr1k/6p1/2ppBn2/1p4p1/3P4/2P2N1P/P2Q1PP1/R3R1K1 w - - 1 21,Qxg5,541,553,12,1
r3qr1k/6p1/2ppBn2/1p4Q1/3P4/2P2N1P/P4PP1/R3R1K1 b - - 0 21,Qd8,594,608,14,1
r2q1r1k/6p1/2ppBn2/1p4Q1/3P4/2P2N1P/P4PP1/R3R1K1 w - - 1 22,Qh4+,646,609,-37,1
r2q1r1k/6p1/2ppBn2/1p6/3P3Q/2P2N1P/P4PP1/R3R1K1 b - - 2 22,Nh7,608,569,-39,1
r2q1r1k/6pn/2ppB3/1p6/3P3Q/2P2N1P/P4PP1/R3R1K1 w - - 3 23,Qh5,596,509,-87,1
r2q1r1k/6pn/2ppB3/1p5Q/3P4/2P2N1P/P4PP1/R3R1K1 b - - 4 23,Rf6,504,910,406,1
r2q3k/6pn/2ppBr2/1p5Q/3P4/2P2N1P/P4PP1/R3R1K1 w - - 5 24,Ng5,932,1000,68,1
r2q3k/6pn/2ppBr2/1p4NQ/3P4/2P4P/P4PP1/R3R1K1 b - - 6 24,Rxe6,972,9999,9027,1
r2q3k/6pn/2ppr3/1p4NQ/3P4/2P4P/P4PP1/R3R1K1 w - - 0 25,Qxh7#,9999,10000,1,1
rnbqkbnr/pppppppp/8/8/8/8/PPPPPPPP/RNBQKBNR w KQkq - 0 1,e4,31,23,-8,1
rnbqkbnr/pppppppp/8/8/4P3/8/PPPP1PPP/RNBQKBNR b KQkq - 0 1,e5,26,34,8,1
rnbqkbnr/pppp1ppp/8/4p3/4P3/8/PPPP1PPP/RNBQKBNR w KQkq - 0 2,Nf3,37,41,4,1
rnbqkbnr/pppp1ppp/8/4p3/4P3/5N2/PPPP1PPP/RNBQKB1R b KQkq - 1 2,d6,34,51,17,1
rnbqkbnr/ppp2ppp/3p4/4p3/4P3/5N2/PPPP1PPP/RNBQKB1R w KQkq - 0 3,Bc4,62,22,-40,1
rnbqkbnr/ppp2ppp/3p4/4p3/2B1P3/5N2/PPPP1PPP/RNBQK2R b KQkq - 1 3,Bg4,26,89,63,1
rn1qkbnr/ppp2ppp/3p4/4p3/2B1P1b1/5N2/PPPP1PPP/RNBQK2R w KQkq - 2 4,Nc3,89,33,-56,1
rn1qkbnr/ppp2ppp/3p4/4p3/2B1P1b1/2N2N2/PPPP1PPP/R1BQK2R b KQkq - 3 4,Nf6,32,51,19,1
rn1qkb1r/ppp2ppp/3p1n2/4p3/2B1P1b1/2N2N2/PPPP1PPP/R1BQK2R w KQkq - 4 5,O-O,53,27,-26,1
rn1qkb1r/ppp2ppp/3p1n2/4p3/2B1P1b1/2N2N2/PPPP1PPP/R1BQ1RK1 b kq - 5 5,Nxe4,26,173,147,1
rn1qkb1r/ppp2ppp/3p4/4p3/2B1n1b1/2N2N2/PPPP1PPP/R1BQ1RK1 w kq - 0 6,Nxe4,175,199,24,1
rn1qkb1r/ppp2ppp/3p4/4p3/2B1N1b1/5N2/PPPP1PPP/R1BQ1RK1 b kq - 0 6,d5,176,170,-6,1
rn1qkb1r/ppp2ppp/8/3pp3/2B1N1b1/5N2/PPPP1PPP/R1BQ1RK1 w kq - 0 7,Bxd5,172,-33,-205,0
rn1qkb1r/ppp2ppp/8/3Bp3/4N1b1/5N2/PPPP1PPP/R1BQ1RK1 b kq - 0 7,Qxd5,-13,-8,5,1
rn2kb1r/ppp2ppp/8/3qp3/4N1b1/5N2/PPPP1PPP/R1BQ1RK1 w kq - 0 8,Nc3,-13,-39,-26,1
rn2kb1r/ppp2ppp/8/3qp3/6b1/2N2N2/PPPP1PPP/R1BQ1RK1 b kq - 1 8,Qd6,-30,48,78,1
rn2kb1r/ppp2ppp/3q4/4p3/6b1/2N2N2/PPPP1PPP/R1BQ1RK1 w kq - 2 9,h3,41,-9,-50,1
rn2kb1r/ppp2ppp/3q4/4p3/6b1/2N2N1P/PPPP1PP1/R1BQ1RK1 b kq - 0 9,Bxf3,-20,-31,-11,1
rn2kb1r/ppp2ppp/3q4/4p3/8/2N2b1P/PPPP1PP1/R1BQ1RK1 w kq - 0 10,Qxf3,-34,-37,-3,1
rn2kb1r/ppp2ppp/3q4/4p3/8/2N2Q1P/PPPP1PP1/R1B2RK1 b kq - 0 10,Nc6,-30,-22,8,1
r3kb1r/ppp2ppp/2nq4/4p3/8/2N2Q1P/PPPP1PP1/R1B2RK1 w kq - 1 11,d3,-17,-60,-43,1
r3kb1r/ppp2ppp/2nq4/4p3/8/2NP1Q1P/PPP2PP1/R1B2RK1 b kq - 0 11,Be7,-40,-25,15,1
r3k2r/ppp1bppp/2nq4/4p3/8/2NP1Q1P/PPP2PP1/R1B2RK1 w kq - 1 12,Be3,-27,-24,3,1
r3k2r/ppp1bppp/2nq4/4p3/8/2NPBQ1P/PPP2PP1/R4RK1 b kq - 2 12,O-O,-29,-21,8,1
r4rk1/ppp1bppp/2nq4/4p3/8/2NPBQ1P/PPP2PP1/R4RK1 w - - 3 13,Rfe1,-15,-48,-33,1
r4rk1/ppp1bppp/2nq4/4p3/8/2NPBQ1P/PPP2PP1/R3R1K1 b - - 4 13,Rae8,-46,-16,30,1
4rrk1/ppp1bppp/2nq4/4p3/8/2NPBQ1P/PPP2PP1/R3R1K1 w - - 5 14,Rad1,-16,-28,-12,1
4rrk1/ppp1bppp/2nq4/4p3/8/2NPBQ1P/PPP2PP1/3RR1K1 b - - 6 14,Nb4,-28,7,35,1
4rrk1/ppp1bppp/3q4/4p3/1n6/2NPBQ1P/PPP2PP1/3RR1K1 w - - 7 15,Qxb7,-8,-31,-23,1
4rrk1/pQp1bppp/3q4/4p3/1n6/2NPB2P/PPP2PP1/3RR1K1 b - - 0 15,Nxc2,-15,-11,4,1
4rrk1/pQp1bppp/3q4/4p3/8/2NPB2P/PPn2PP1/3RR1K1 w - - 0 16,Re2,0,-13,-13,1
4rrk1/pQp1bppp/3q4/4p3/8/2NPB2P/PPn1RPP1/3R2K1 b - - 1 16,Nxe3,0,0,0,1
4rrk1/pQp1bppp/3q4/4p3/8/2NPn2P/PP2RPP1/3R2K1 w - - 0 17,Rxe3,3,-33,-36,1
4rrk1/pQp1bppp/3q4/4p3/8/2NPR2P/PP3PP1/3R2K1 b - - 0 17,Bf6,-25,129,154,1
4rrk1/pQp2ppp/3q1b2/4p3/8/2NPR2P/PP3PP1/3R2K1 w - - 1 18,Nb5,133,-37,-170,0
4rrk1/pQp2ppp/3q1b2/1N2p3/8/3PR2P/PP3PP1/3R2K1 b - - 2 18,Qd7,-35,28,63,1
4rrk1/pQpq1ppp/5b2/1N2p3/8/3PR2P/PP3PP1/3R2K1 w - - 3 19,Qxc7,29,-507,-536,0
4rrk1/p1Qq1ppp/5b2/1N2p3/8/3PR2P/PP3PP1/3R2K1 b - - 0 19,Qxb5,-465,-452,13,1
4rrk1/p1Q2ppp/5b2/1q2p3/8/3PR2P/PP3PP1/3R2K1 w - - 0 20,Qxa7,-467,-499,-32,1
4rrk1/Q4ppp/5b2/1q2p3/8/3PR2P/PP3PP1/3R2K1 b - - 0 20,Qxb2,-492,-490,2,1
4rrk1/Q4ppp/5b2/4p3/8/3PR2P/Pq3PP1/3R2K1 w - - 0 21,Ree1,-474,-492,-18,1
4rrk1/Q4ppp/5b2/4p3/8/3P3P/Pq3PP1/3RR1K1 b - - 1 21,Ra8,-508,-485,23,1
r4rk1/Q4ppp/5b2/4p3/8/3P3P/Pq3PP1/3RR1K1 w - - 2 22,Qc5,-496,-510,-14,1
r4rk1/5ppp/5b2/2Q1p3/8/3P3P/Pq3PP1/3RR1K1 b - - 3 22,Rxa2,-485,-459,26,1
5rk1/5ppp/5b2/2Q1p3/8/3P3P/rq3PP1/3RR1K1 w - - 0 23,Re4,-468,-508,-40,1
5rk1/5ppp/5b2/2Q1p3/4R3/3P3P/rq3PP1/3R2K1 b - - 1 23,Qxf2+,-504,14,518,1
5rk1/5ppp/5b2/2Q1p3/4R3/3P3P/r4qP1/3R2K1 w - - 0 24,Qxf2,25,25,0,1
5rk1/5ppp/5b2/4p3/4R3/3P3P/r4QP1/3R2K1 b - - 0 24,Rxf2,17,19,2,1
5rk1/5ppp/5b2/4p3/4R3/3P3P/5rP1/3R2K1 w - - 0 25,Kxf2,27,28,1,1
5rk1/5ppp/5b2/4p3/4R3/3P3P/5KP1/3R4 b - - 0 25,Bh4+,27,440,413,1
5rk1/5ppp/8/4p3/4R2b/3P3P/5KP1/3R4 w - - 1 26,g3,462,48,-414,0
5rk1/5ppp/8/4p3/4R2b/3P2PP/5K2/3R4 b - - 0 26,Bf6,42,51,9,1
5rk1/5ppp/5b2/4p3/4R3/3P2PP/5K2/3R4 w - - 1 27,Ke3,46,11,-35,1
5rk1/5ppp/5b2/4p3/4R3/3PK1PP/8/3R4 b - - 2 27,h5,19,25,6,1
5rk1/5pp1/5b2/4p2p/4R3/3PK1PP/8/3R4 w - - 0 28,g4,31,-1,-32,1
5rk1/5pp1/5b2/4p2p/4R1P1/3PK2P/8/3R4 b - - 0 28,h4,6,33,27,1
5rk1/5pp1/5b2/4p3/4R1Pp/3PK2P/8/3R4 w - - 0 29,Rc4,67,-12,-79,1
5rk1/5pp1/5b2/4p3/2R3Pp/3PK2P/8/3R4 b - - 1 29,Re8,0,108,108,1
4r1k1/5pp1/5b2/4p3/2R3Pp/3PK2P/8/3R4 w - - 2 30,Rc7,113,69,-44,1
4r1k1/2R2pp1/5b2/4p3/6Pp/3PK2P/8/3R4 b - - 3 30,Bg5+,50,45,-5,1
4r1k1/2R2pp1/8/4p1b1/6Pp/3PK2P/8/3R4 w - - 4 31,Ke4,87,59,-28,1
4r1k1/2R2pp1/8/4p1b1/4K1Pp/3P3P/8/3R4 b - - 5 31,g6,35,191,156,1
4r1k1/2R2p2/6p1/4p1b1/4K1Pp/3P3P/8/3R4 w - - 0 32,Rb1,216,239,23,1
4r1k1/2R2p2/6p1/4p1b1/4K1Pp/3P3P/8/1R6 b - - 1 32,Kh7,217,405,188,1
4r3/2R2p1k/6p1/4p1b1/4K1Pp/3P3P/8/1R6 w - - 2 33,Rbb7,378,350,-28,1
4r3/1RR2p1k/6p1/4p1b1/4K1Pp/3P3P/8/8 b - - 3 33,Kh8,381,492,111,1
4r2k/1RR2p2/6p1/4p1b1/4K1Pp/3P3P/8/8 w - - 4 34,Rxf7,512,513,1,1
4r2k/1R3R2/6p1/4p1b1/4K1Pp/3P3P/8/8 b - - 0 34,Bh6,502,660,158,1
4r2k/1R3R2/6pb/4p3/4K1Pp/3P3P/8/8 w - - 1 35,Rh7+,679,670,-9,1
4r2k/1R5R/6pb/4p3/4K1Pp/3P3P/8/8 b - - 2 35,Kg8,610,609,-1,1
4r1k1/1R5R/6pb/4p3/4K1Pp/3P3P/8/8 w - - 3 36,Rxh6,624,606,-18,1
4r1k1/1R6/6pR/4p3/4K1Pp/3P3P/8/8 b - - 0 36,Kf8,622,9999,9377,1
4rk2/1R6/6pR/4p3/4K1Pp/3P3P/8/8 w - - 1 37,Rxg6,9999,680,-9319,0
4rk2/1R6/6R1/4p3/4K1Pp/3P3P/8/8 b - - 0 37,Re7,665,765,100,1
5k2/1R2r3/6R1/4p3/4K1Pp/3P3P/8/8 w - - 1 38,Rxe7,754,732,-22,1
5k2/4R3/6R1/4p3/4K1Pp/3P3P/8/8 b - - 0 38,Kxe7,745,775,30,1
8/4k3/6R1/4p3/4K1Pp/3P3P/8/8 w - - 0 39,Rg5,758,681,-77,1
8/4k3/8/4p1R1/4K1Pp/3P3P/8/8 b - - 1 39,Ke6,692,787,95,1
rnbqkbnr/pppppppp/8/8/8/8/PPPPPPPP/RNBQKBNR w KQkq - 0 1,d4,21,14,-7,1
rnbqkbnr/pppppppp/8/8/3P4/8/PPP1PPPP/RNBQKBNR b KQkq - 0 1,e6,20,44,24,1
rnbqkbnr/pppp1ppp/4p3/8/3P4/8/PPP1PPPP/RNBQKBNR w KQkq - 0 2,c4,39,21,-18,1
rnbqkbnr/pppp1ppp/4p3/8/2PP4/8/PP2PPPP/RNBQKBNR b KQkq - 0 2,c5,19,83,64,1
rnbqkbnr/pp1p1ppp/4p3/2p5/2PP4/8/PP2PPPP/RNBQKBNR w KQkq - 0 3,Nf3,99,12,-87,1
rnbqkbnr/pp1p1ppp/4p3/2p5/2PP4/5N2/PP2PPPP/RNBQKB1R b KQkq - 1 3,Qb6,9,138,129,1
rnb1kbnr/pp1p1ppp/1q2p3/2p5/2PP4/5N2/PP2PPPP/RNBQKB1R w KQkq - 2 4,Nc3,126,65,-61,1
rnb1kbnr/pp1p1ppp/1q2p3/2p5/2PP4/2N2N2/PP2PPPP/R1BQKB1R b KQkq - 3 4,Nf6,69,146,77,1
rnb1kb1r/pp1p1ppp/1q2pn2/2p5/2PP4/2N2N2/PP2PPPP/R1BQKB1R w KQkq - 4 5,Qc2,133,-174,-307,0
rnb1kb1r/pp1p1ppp/1q2pn2/2p5/2PP4/2N2N2/PPQ1PPPP/R1B1KB1R b KQkq - 5 5,d6,-190,115,305,1
rnb1kb1r/pp3ppp/1q1ppn2/2p5/2PP4/2N2N2/PPQ1PPPP/R1B1KB1R w KQkq - 0 6,d5,109,128,19,1
rnb1kb1r/pp3ppp/1q1ppn2/2pP4/2P5/2N2N2/PPQ1PPPP/R1B1KB1R b KQkq - 0 6,Qb4,116,165,49,1
rnb1kb1r/pp3ppp/3ppn2/2pP4/1qP5/2N2N2/PPQ1PPPP/R1B1KB1R w KQkq - 1 7,b3,168,128,-40,1
rnb1kb1r/pp3ppp/3ppn2/2pP4/1qP5/1PN2N2/P1Q1PPPP/R1B1KB1R b KQkq - 0 7,e5,120,145,25,1
rnb1kb1r/pp3ppp/3p1n2/2pPp3/1qP5/1PN2N2/P1Q1PPPP/R1B1KB1R w KQkq - 0 8,e4,136,37,-99,1
rnb1kb1r/pp3ppp/3p1n2/2pPp3/1qP1P3/1PN2N2/P1Q2PPP/R1B1KB1R b KQkq - 0 8,a6,50,145,95,1
rnb1kb1r/1p3ppp/p2p1n2/2pPp3/1qP1P3/1PN2N2/P1Q2PPP/R1B1KB1R w KQkq - 0 9,a3,159,159,0,1
rnb1kb1r/1p3ppp/p2p1n2/2pPp3/1qP1P3/PPN2N2/2Q2PPP/R1B1KB1R b KQkq - 0 9,Qb6,165,168,3,1
rnb1kb1r/1p3ppp/pq1p1n2/2pPp3/2P1P3/PPN2N2/2Q2PPP/R1B1KB1R w KQkq - 1 10,h3,171,147,-24,1
rnb1kb1r/1p3ppp/pq1p1n2/2pPp3/2P1P3/PPN2N1P/2Q2PP1/R1B1KB1R b KQkq - 0 10,h6,151,152,1,1
rnb1kb1r/1p3pp1/pq1p1n1p/2pPp3/2P1P3/PPN2N1P/2Q2PP1/R1B1KB1R w KQkq - 0 11,Be2,140,149,9,1
rnb1kb1r/1p3pp1/pq1p1n1p/2pPp3/2P1P3/PPN2N1P/2Q1BPP1/R1B1K2R b KQkq - 1 11,Qd8,148,155,7,1
rnbqkb1r/1p3pp1/p2p1n1p/2pPp3/2P1P3/PPN2N1P/2Q1BPP1/R1B1K2R w KQkq - 2 12,Bb2,148,119,-29,1
rnbqkb1r/1p3pp1/p2p1n1p/2pPp3/2P1P3/PPN2N1P/1BQ1BPP1/R3K2R b KQkq - 3 12,Bd7,136,159,23,1
rn1qkb1r/1p1b1pp1/p2p1n1p/2pPp3/2P1P3/PPN2N1P/1BQ1BPP1/R3K2R w KQkq - 4 13,O-O,178,149,-29,1
rn1qkb1r/1p1b1pp1/p2p1n1p/2pPp3/2P1P3/PPN2N1P/1BQ1BPP1/R4RK1 b kq - 5 13,b5,167,297,130,1
rn1qkb1r/3b1pp1/p2p1n1p/1ppPp3/2P1P3/PPN2N1P/1BQ1BPP1/R4RK1 w kq - 0 14,a4,272,191,-81,1
rn1qkb1r/3b1pp1/p2p1n1p/1ppPp3/P1P1P3/1PN2N1P/1BQ1BPP1/R4RK1 b kq - 0 14,b4,184,212,28,1
rn1qkb1r/3b1pp1/p2p1n1p/2pPp3/PpP1P3/1PN2N1P/1BQ1BPP1/R4RK1 w kq - 0 15,Nd1,199,199,0,1
rn1qkb1r/3b1pp1/p2p1n1p/2pPp3/PpP1P3/1P3N1P/1BQ1BPP1/R2N1RK1 b kq - 1 15,a5,198,240,42,1
rn1qkb1r/3b1pp1/3p1n1p/p1pPp3/PpP1P3/1P3N1P/1BQ1BPP1/R2N1RK1 w kq - 0 16,Nh4,268,10,-258,0
rn1qkb1r/3b1pp1/3p1n1p/p1pPp3/PpP1P2N/1P5P/1BQ1BPP1/R2N1RK1 b kq - 1 16,Be7,26,183,157,1
rn1qk2r/3bbpp1/3p1n1p/p1pPp3/PpP1P2N/1P5P/1BQ1BPP1/R2N1RK1 w kq - 2 17,Nf5,175,87,-88,1
rn1qk2r/3bbpp1/3p1n1p/p1pPpN2/PpP1P3/1P5P/1BQ1BPP1/R2N1RK1 b kq - 3 17,Bxf5,85,83,-2,1
rn1qk2r/4bpp1/3p1n1p/p1pPpb2/PpP1P3/1P5P/1BQ1BPP1/R2N1RK1 w kq - 0 18,exf5,81,85,4,1
rn1qk2r/4bpp1/3p1n1p/p1pPpP2/PpP5/1P5P/1BQ1BPP1/R2N1RK1 b kq - 0 18,Nbd7,61,71,10,1
r2qk2r/3nbpp1/3p1n1p/p1pPpP2/PpP5/1P5P/1BQ1BPP1/R2N1RK1 w kq - 1 19,Re1,66,59,-7,1
r2qk2r/3nbpp1/3p1n1p/p1pPpP2/PpP5/1P5P/1BQ1BPP1/R2NR1K1 b kq - 2 19,O-O,55,130,75,1
r2q1rk1/3nbpp1/3p1n1p/p1pPpP2/PpP5/1P5P/1BQ1BPP1/R2NR1K1 w - - 3 20,f3,123,-119,-242,0
r2q1rk1/3nbpp1/3p1n1p/p1pPpP2/PpP5/1P3P1P/1BQ1B1P1/R2NR1K1 b - - 0 20,Nh7,-106,56,162,1
r2q1rk1/3nbppn/3p3p/p1pPpP2/PpP5/1P3P1P/1BQ1B1P1/R2NR1K1 w - - 1 21,Ne3,102,-26,-128,0
r2q1rk1/3nbppn/3p3p/p1pPpP2/PpP5/1P2NP1P/1BQ1B1P1/R3R1K1 b - - 2 21,f6,-22,296,318,1
r2q1rk1/3nb1pn/3p1p1p/p1pPpP2/PpP5/1P2NP1P/1BQ1B1P1/R3R1K1 w - - 0 22,Ng4,300,279,-21,1
r2q1rk1/3nb1pn/3p1p1p/p1pPpP2/PpP3N1/1P3P1P/1BQ1B1P1/R3R1K1 b - - 1 22,Rf7,255,302,47,1
r2q2k1/3nbrpn/3p1p1p/p1pPpP2/PpP3N1/1P3P1P/1BQ1B1P1/R3R1K1 w - - 2 23,Bd3,290,260,-30,1
r2q2k1/3nbrpn/3p1p1p/p1pPpP2/PpP3N1/1P1B1P1P/1BQ3P1/R3R1K1 b - - 3 23,Qe8,252,242,-10,1
r3q1k1/3nbrpn/3p1p1p/p1pPpP2/PpP3N1/1P1B1P1P/1BQ3P1/R3R1K1 w - - 4 24,Qe2,244,215,-29,1
r3q1k1/3nbrpn/3p1p1p/p1pPpP2/PpP3N1/1P1B1P1P/1B2Q1P1/R3R1K1 b - - 5 24,Rf8,213,271,58,1
r3qrk1/3nb1pn/3p1p1p/p1pPpP2/PpP3N1/1P1B1P1P/1B2Q1P1/R3R1K1 w - - 6 25,Qf2,257,224,-33,1
r3qrk1/3nb1pn/3p1p1p/p1pPpP2/PpP3N1/1P1B1P1P/1B3QP1/R3R1K1 b - - 7 25,h5,230,243,13,1
r3qrk1/3nb1pn/3p1p2/p1pPpP1p/PpP3N1/1P1B1P1P/1B3QP1/R3R1K1 w - - 0 26,Ne3,244,239,-5,1
r3qrk1/3nb1pn/3p1p2/p1pPpP1p/PpP5/1P1BNP1P/1B3QP1/R3R1K1 b - - 1 26,g6,242,555,313,1
r3qrk1/3nb2n/3p1pp1/p1pPpP1p/PpP5/1P1BNP1P/1B3QP1/R3R1K1 w - - 0 27,f4,481,225,-256,0
r3qrk1/3nb2n/3p1pp1/p1pPpP1p/PpP2P2/1P1BN2P/1B3QP1/R3R1K1 b - - 0 27,Kh8,238,511,273,1
r3qr1k/3nb2n/3p1pp1/p1pPpP1p/PpP2P2/1P1BN2P/1B3QP1/R3R1K1 w - - 1 28,g3,497,176,-321,0
r3qr1k/3nb2n/3p1pp1/p1pPpP1p/PpP2P2/1P1BN1PP/1B3Q2/R3R1K1 b - - 0 28,Rg8,177,432,255,1
r3q1rk/3nb2n/3p1pp1/p1pPpP1p/PpP2P2/1P1BN1PP/1B3Q2/R3R1K1 w - - 1 29,Rad1,416,170,-246,0
r3q1rk/3nb2n/3p1pp1/p1pPpP1p/PpP2P2/1P1BN1PP/1B3Q2/3RR1K1 b - - 2 29,Ndf8,168,340,172,1
r3qnrk/4b2n/3p1pp1/p1pPpP1p/PpP2P2/1P1BN1PP/1B3Q2/3RR1K1 w - - 3 30,Ng2,354,220,-134,0
r3qnrk/4b2n/3p1pp1/p1pPpP1p/PpP2P2/1P1B2PP/1B3QN1/3RR1K1 b - - 4 30,Ra7,180,360,180,1
4qnrk/r3b2n/3p1pp1/p1pPpP1p/PpP2P2/1P1B2PP/1B3QN1/3RR1K1 w - - 5 31,Nh4,338,139,-199,0
4qnrk/r3b2n/3p1pp1/p1pPpP1p/PpP2P1N/1P1B2PP/1B3Q2/3RR1K1 b - - 6 31,g5,124,132,8,1
4qnrk/r3b2n/3p1p2/p1pPpPpp/PpP2P1N/1P1B2PP/1B3Q2/3RR1K1 w - - 0 32,fxg5,97,103,6,1
4qnrk/r3b2n/3p1p2/p1pPpPPp/PpP4N/1P1B2PP/1B3Q2/3RR1K1 b - - 0 32,fxg5,83,101,18,1
4qnrk/r3b2n/3p4/p1pPpPpp/PpP4N/1P1B2PP/1B3Q2/3RR1K1 w - - 0 33,Nf3,101,93,-8,1
4qnrk/r3b2n/3p4/p1pPpPpp/PpP5/1P1B1NPP/1B3Q2/3RR1K1 b - - 1 33,g4,83,405,322,1
4qnrk/r3b2n/3p4/p1pPpP1p/PpP3p1/1P1B1NPP/1B3Q2/3RR1K1 w - - 0 34,f6,342,-31,-373,0
4qnrk/r3b2n/3p1P2/p1pPp2p/PpP3p1/1P1B1NPP/1B3Q2/3RR1K1 b - - 0 34,Bxf6,-49,-66,-17,1
4qnrk/r6n/3p1b2/p1pPp2p/PpP3p1/1P1B1NPP/1B3Q2/3RR1K1 w - - 0 35,h4,-73,-375,-302,0
4qnrk/r6n/3p1b2/p1pPp2p/PpP3pP/1P1B1NP1/1B3Q2/3RR1K1 b - - 0 35,gxf3,-368,-395,-27,1
4qnrk/r6n/3p1b2/p1pPp2p/PpP4P/1P1B1pP1/1B3Q2/3RR1K1 w - - 0 36,Qxf3,-411,-455,-44,1
4qnrk/r6n/3p1b2/p1pPp2p/PpP4P/1P1B1QP1/1B6/3RR1K1 b - - 0 36,Bxh4,-452,-450,2,1
4qnrk/r6n/3p4/p1pPp2p/PpP4b/1P1B1QP1/1B6/3RR1K1 w - - 0 37,Bxe5+,-463,-560,-97,1
4qnrk/r6n/3p4/p1pPB2p/PpP4b/1P1B1QP1/8/3RR1K1 b - - 0 37,dxe5,-590,-552,38,1
4qnrk/r6n/8/p1pPp2p/PpP4b/1P1B1QP1/8/3RR1K1 w - - 0 38,Bxh7,-595,-630,-35,1
4qnrk/r6B/8/p1pPp2p/PpP4b/1P3QP1/8/3RR1K1 b - - 0 38,Rxg3+,-626,-654,-28,1
4qn1k/r6B/8/p1pPp2p/PpP4b/1P3Qr1/8/3RR1K1 w - - 0 39,Kf2,-655,-835,-180,0
4qn1k/r6B/8/p1pPp2p/PpP4b/1P3Qr1/5K2/3RR3 b - - 1 39,Rxf3+,-832,-820,12,1
4qn1k/r6B/8/p1pPp2p/PpP4b/1P3r2/5K2/3RR3 w - - 0 40,Kxf3,-808,-857,-49,1
4qn1k/r6B/8/p1pPp2p/PpP4b/1P3K2/8/3RR3 b - - 0 40,Nxh7,-893,-752,141,1
rnbqkbnr/pppppppp/8/8/8/8/PPPPPPPP/RNBQKBNR w KQkq - 0 1,d4,19,3,-16,1
rnbqkbnr/pppppppp/8/8/3P4/8/PPP1PPPP/RNBQKBNR b KQkq - 0 1,d5,15,17,2,1
rnbqkbnr/ppp1pppp/8/3p4/3P4/8/PPP1PPPP/RNBQKBNR w KQkq - 0 2,Nd2,26,-16,-42,1
rnbqkbnr/ppp1pppp/8/3p4/3P4/8/PPPNPPPP/R1BQKBNR b KQkq - 1 2,e6,-2,24,26,1
rnbqkbnr/ppp2ppp/4p3/3p4/3P4/8/PPPNPPPP/R1BQKBNR w KQkq - 0 3,Nb3,38,-41,-79,1
rnbqkbnr/ppp2ppp/4p3/3p4/3P4/1N6/PPP1PPPP/R1BQKBNR b KQkq - 1 3,Bb4+,-48,7,55,1
rnbqk1nr/ppp2ppp/4p3/3p4/1b1P4/1N6/PPP1PPPP/R1BQKBNR w KQkq - 2 4,Bd2,-2,-23,-21,1
rnbqk1nr/ppp2ppp/4p3/3p4/1b1P4/1N6/PPPBPPPP/R2QKBNR b KQkq - 3 4,Bxd2+,-22,4,26,1
rnbqk1nr/ppp2ppp/4p3/3p4/3P4/1N6/PPPbPPPP/R2QKBNR w KQkq - 0 5,Qxd2,0,-23,-23,1
rnbqk1nr/ppp2ppp/4p3/3p4/3P4/1N6/PPPQPPPP/R3KBNR b KQkq - 0 5,Nf6,-26,-29,-3,1
rnbqk2r/ppp2ppp/4pn2/3p4/3P4/1N6/PPPQPPPP/R3KBNR w KQkq - 1 6,e3,-18,-24,-6,1
rnbqk2r/ppp2ppp/4pn2/3p4/3P4/1N2P3/PPPQ1PPP/R3KBNR b KQkq - 0 6,Ne4,-17,-15,2,1
rnbqk2r/ppp2ppp/4p3/3p4/3Pn3/1N2P3/PPPQ1PPP/R3KBNR w KQkq - 1 7,Qe2,-14,-31,-17,1
rnbqk2r/ppp2ppp/4p3/3p4/3Pn3/1N2P3/PPP1QPPP/R3KBNR b KQkq - 2 7,Nc6,-26,-11,15,1
r1bqk2r/ppp2ppp/2n1p3/3p4/3Pn3/1N2P3/PPP1QPPP/R3KBNR w KQkq - 3 8,Qg4,-13,-93,-80,1
r1bqk2r/ppp2ppp/2n1p3/3p4/3Pn1Q1/1N2P3/PPP2PPP/R3KBNR b KQkq - 4 8,a6,-103,192,295,1
r1bqk2r/1pp2ppp/p1n1p3/3p4/3Pn1Q1/1N2P3/PPP2PPP/R3KBNR w KQkq - 0 9,f3,188,147,-41,1
r1bqk2r/1pp2ppp/p1n1p3/3p4/3Pn1Q1/1N2PP2/PPP3PP/R3KBNR b KQkq - 0 9,Nb4,144,186,42,1
r1bqk2r/1pp2ppp/p3p3/3p4/1n1Pn1Q1/1N2PP2/PPP3PP/R3KBNR w KQkq - 1 10,O-O-O,182,-88,-270,0
r1bqk2r/1pp2ppp/p3p3/3p4/1n1Pn1Q1/1N2PP2/PPP3PP/2KR1BNR b kq - 2 10,Nxa2+,-92,-17,75,1
r1bqk2r/1pp2ppp/p3p3/3p4/3Pn1Q1/1N2PP2/nPP3PP/2KR1BNR w kq - 0 11,Kb1,13,6,-7,1
r1bqk2r/1pp2ppp/p3p3/3p4/3Pn1Q1/1N2PP2/nPP3PP/1K1R1BNR b kq - 1 11,Nb4,0,254,254,1
r1bqk2r/1pp2ppp/p3p3/3p4/1n1Pn1Q1/1N2PP2/1PP3PP/1K1R1BNR w kq - 2 12,Qxg7,250,48,-202,0
r1bqk2r/1pp2pQp/p3p3/3p4/1n1Pn3/1N2PP2/1PP3PP/1K1R1BNR b kq - 0 12,Qf6,44,34,-10,1
r1b1k2r/1pp2pQp/p3pq2/3p4/1n1Pn3/1N2PP2/1PP3PP/1K1R1BNR w kq - 1 13,Qg4,40,-314,-354,0
r1b1k2r/1pp2p1p/p3pq2/3p4/1n1Pn1Q1/1N2PP2/1PP3PP/1K1R1BNR b kq - 2 13,Nf2,-336,-290,46,1
r1b1k2r/1pp2p1p/p3pq2/3p4/1n1P2Q1/1N2PP2/1PP2nPP/1K1R1BNR w kq - 3 14,Bd3,-305,-603,-298,0
r1b1k2r/1pp2p1p/p3pq2/3p4/1n1P2Q1/1N1BPP2/1PP2nPP/1K1R2NR b kq - 4 14,Nxg4,-612,-600,12,1
rnbqkbnr/pppppppp/8/8/8/8/PPPPPPPP/RNBQKBNR w KQkq - 0 1,h3,21,-30,-51,1
rnbqkbnr/pppppppp/8/8/8/7P/PPPPPPP1/RNBQKBNR b KQkq - 0 1,e5,-32,-21,11,1
rnbqkbnr/pppp1ppp/8/4p3/8/7P/PPPPPPP1/RNBQKBNR w KQkq - 0 2,e4,-20,-47,-27,1
rnbqkbnr/pppp1ppp/8/4p3/4P3/7P/PPPP1PP1/RNBQKBNR b KQkq - 0 2,d5,-41,23,64,1
rnbqkbnr/ppp2ppp/8/3pp3/4P3/7P/PPPP1PP1/RNBQKBNR w KQkq - 0 3,b3,18,-158,-176,0
rnbqkbnr/ppp2ppp/8/3pp3/4P3/1P5P/P1PP1PP1/RNBQKBNR b KQkq - 0 3,dxe4,-129,-154,-25,1
rnbqkbnr/ppp2ppp/8/4p3/4p3/1P5P/P1PP1PP1/RNBQKBNR w KQkq - 0 4,c4,-172,-271,-99,1
rnbqkbnr/ppp2ppp/8/4p3/2P1p3/1P5P/P2P1PP1/RNBQKBNR b KQkq - 0 4,Qf6,-268,-213,55,1
rnb1kbnr/ppp2ppp/5q2/4p3/2P1p3/1P5P/P2P1PP1/RNBQKBNR w KQkq - 1 5,Qg4,-223,-638,-415,0
rnb1kbnr/ppp2ppp/5q2/4p3/2P1p1Q1/1P5P/P2P1PP1/RNB1KBNR b KQkq - 2 5,Nh6,-593,486,1079,1
rnb1kb1r/ppp2ppp/5q1n/4p3/2P1p1Q1/1P5P/P2P1PP1/RNB1KBNR w KQkq - 3 6,Qg3,489,-339,-828,0
rnb1kb1r/ppp2ppp/5q1n/4p3/2P1p3/1P4QP/P2P1PP1/RNB1KBNR b KQkq - 4 6,Bc5,-348,-223,125,1
rnb1k2r/ppp2ppp/5q1n/2b1p3/2P1p3/1P4QP/P2P1PP1/RNB1KBNR w KQkq - 5 7,Nc3,-236,-218,18,1
rnb1k2r/ppp2ppp/5q1n/2b1p3/2P1p3/1PN3QP/P2P1PP1/R1B1KBNR b KQkq - 6 7,Nf5,-215,-240,-25,1
rnb1k2r/ppp2ppp/5q2/2b1pn2/2P1p3/1PN3QP/P2P1PP1/R1B1KBNR w KQkq - 7 8,Nxe4,-210,-196,14,1
rnb1k2r/ppp2ppp/5q2/2b1pn2/2P1N3/1P4QP/P2P1PP1/R1B1KBNR b KQkq - 0 8,Qh4,-213,455,668,1
rnb1k2r/ppp2ppp/8/2b1pn2/2P1N2q/1P4QP/P2P1PP1/R1B1KBNR w KQkq - 1 9,Qh2,429,-653,-1082,0
rnb1k2r/ppp2ppp/8/2b1pn2/2P1N2q/1P5P/P2P1PPQ/R1B1KBNR b KQkq - 2 9,Qxf2+,-619,444,1063,1
rnb1k2r/ppp2ppp/8/2b1pn2/2P1N3/1P5P/P2P1qPQ/R1B1KBNR w KQkq - 0 10,Nxf2,471,486,15,1
rnbqkbnr/pppppppp/8/8/8/8/PPPPPPPP/RNBQKBNR w KQkq - 0 1,e4,23,39,16,1
rnbqkbnr/pppppppp/8/8/4P3/8/PPPP1PPP/RNBQKBNR b KQkq - 0 1,e6,33,58,25,1
rnbqkbnr/pppp1ppp/4p3/8/4P3/8/PPPP1PPP/RNBQKBNR w KQkq - 0 2,Qf3,53,-54,-107,0
rnbqkbnr/pppp1ppp/4p3/8/4P3/5Q2/PPPP1PPP/RNB1KBNR b KQkq - 1 2,d6,-37,30,67,1
rnbqkbnr/ppp2ppp/3pp3/8/4P3/5Q2/PPPP1PPP/RNB1KBNR w KQkq - 0 3,Bc4,42,-34,-76,1
rnbqkbnr/ppp2ppp/3pp3/8/2B1P3/5Q2/PPPP1PPP/RNB1K1NR b KQkq - 1 3,Be7,-35,58,93,1
rnbqk1nr/ppp1bppp/3pp3/8/2B1P3/5Q2/PPPP1PPP/RNB1K1NR w KQkq - 2 4,Nh3,53,-74,-127,0
rnbqk1nr/ppp1bppp/3pp3/8/2B1P3/5Q1N/PPPP1PPP/RNB1K2R b KQkq - 3 4,Nf6,-78,-85,-7,1
rnbqk2r/ppp1bppp/3ppn2/8/2B1P3/5Q1N/PPPP1PPP/RNB1K2R w KQkq - 4 5,Ng5,-79,-231,-152,0
rnbqk2r/ppp1bppp/3ppn2/6N1/2B1P3/5Q2/PPPP1PPP/RNB1K2R b KQkq - 5 5,O-O,-228,-108,120,1
rnbq1rk1/ppp1bppp/3ppn2/6N1/2B1P3/5Q2/PPPP1PPP/RNB1K2R w KQ - 6 6,Qh3,-111,-297,-186,0
rnbq1rk1/ppp1bppp/3ppn2/6N1/2B1P3/7Q/PPPP1PPP/RNB1K2R b KQ - 7 6,h6,-283,-293,-10,1
rnbq1rk1/ppp1bpp1/3ppn1p/6N1/2B1P3/7Q/PPPP1PPP/RNB1K2R w KQ - 0 7,e5,-301,-292,9,1
rnbq1rk1/ppp1bpp1/3ppn1p/4P1N1/2B5/7Q/PPPP1PPP/RNB1K2R b KQ - 0 7,dxe5,-309,-304,5,1
rnbq1rk1/ppp1bpp1/4pn1p/4p1N1/2B5/7Q/PPPP1PPP/RNB1K2R w KQ - 0 8,Nf3,-310,-304,6,1
rnbq1rk1/ppp1bpp1/4pn1p/4p3/2B5/5N1Q/PPPP1PPP/RNB1K2R b KQ - 1 8,e4,-289,-258,31,1
rnbq1rk1/ppp1bpp1/4pn1p/8/2B1p3/5N1Q/PPPP1PPP/RNB1K2R w KQ - 0 9,Ne5,-284,-269,15,1
rnbq1rk1/ppp1bpp1/4pn1p/4N3/2B1p3/7Q/PPPP1PPP/RNB1K2R b KQ - 1 9,Nc6,-281,-134,147,1
r1bq1rk1/ppp1bpp1/2n1pn1p/4N3/2B1p3/7Q/PPPP1PPP/RNB1K2R w KQ - 2 10,d4,-115,-375,-260,0
r1bq1rk1/ppp1bpp1/2n1pn1p/4N3/2BPp3/7Q/PPP2PPP/RNB1K2R b KQ d3 0 10,Nxd4,-392,-364,28,1
r1bq1rk1/ppp1bpp1/4pn1p/4N3/2Bnp3/7Q/PPP2PPP/RNB1K2R w KQ - 0 11,Qh5,-359,-922,-563,0
r1bq1rk1/ppp1bpp1/4pn1p/4N2Q/2Bnp3/8/PPP2PPP/RNB1K2R b KQ - 1 11,Nxc2+,-902,-868,34,1
r1bq1rk1/ppp1bpp1/4pn1p/4N2Q/2B1p3/8/PPn2PPP/RNB1K2R w KQ - 0 12,Kf1,-882,-879,3,1
r1bq1rk1/ppp1bpp1/4pn1p/4N2Q/2B1p3/8/PPn2PPP/RNB2K1R b - - 1 12,Nxh5,-862,-882,-20,1
r1bq1rk1/ppp1bpp1/4p2p/4N2n/2B1p3/8/PPn2PPP/RNB2K1R w - - 0 13,Bxe6,-861,-9999,-9138,0
r1bq1rk1/ppp1bpp1/4B2p/4N2n/4p3/8/PPn2PPP/RNB2K1R b - - 0 13,Bxe6,-9999,-1047,8952,1
r2q1rk1/ppp1bpp1/4b2p/4N2n/4p3/8/PPn2PPP/RNB2K1R w - - 0 14,Nd7,-1053,-1151,-98,1
r2q1rk1/pppNbpp1/4b2p/7n/4p3/8/PPn2PPP/RNB2K1R b - - 1 14,Qxd7,-1140,-1158,-18,1
r4rk1/pppqbpp1/4b2p/7n/4p3/8/PPn2PPP/RNB2K1R w - - 0 15,Be3,-1153,-9999,-8846,0
r4rk1/pppqbpp1/4b2p/7n/4p3/4B3/PPn2PPP/RN3K1R b - - 1 15,Nxa1,-9999,-1210,8789,1
r4rk1/pppqbpp1/4b2p/7n/4p3/4B3/PP3PPP/nN3K1R w - - 0 16,Bg5,-1202,-9999,-8797,0
r4rk1/pppqbpp1/4b2p/6Bn/4p3/8/PP3PPP/nN3K1R b - - 1 16,Qd1#,-9999,-10000,-1,1
rnbqkbnr/pppppppp/8/8/8/8/PPPPPPPP/RNBQKBNR w KQkq - 0 1,e4,35,29,-6,1
rnbqkbnr/pppppppp/8/8/4P3/8/PPPP1PPP/RNBQKBNR b KQkq - 0 1,e5,34,36,2,1
rnbqkbnr/pppp1ppp/8/4p3/4P3/8/PPPP1PPP/RNBQKBNR w KQkq - 0 2,Nf3,32,24,-8,1
rnbqkbnr/pppp1ppp/8/4p3/4P3/5N2/PPPP1PPP/RNBQKB1R b KQkq - 1 2,d6,25,40,15,1
rnbqkbnr/ppp2ppp/3p4/4p3/4P3/5N2/PPPP1PPP/RNBQKB1R w KQkq - 0 3,d4,40,38,-2,1
rnbqkbnr/ppp2ppp/3p4/4p3/3PP3/5N2/PPP2PPP/RNBQKB1R b KQkq - 0 3,Nd7,38,63,25,1
r1bqkbnr/pppn1ppp/3p4/4p3/3PP3/5N2/PPP2PPP/RNBQKB1R w KQkq - 1 4,dxe5,52,26,-26,1
r1bqkbnr/pppn1ppp/3p4/4P3/4P3/5N2/PPP2PPP/RNBQKB1R b KQkq - 0 4,Nxe5,23,55,32,1
r1bqkbnr/ppp2ppp/3p4/4n3/4P3/5N2/PPP2PPP/RNBQKB1R w KQkq - 0 5,Nxe5,44,34,-10,1
r1bqkbnr/ppp2ppp/3p4/4N3/4P3/8/PPP2PPP/RNBQKB1R b KQkq - 0 5,dxe5,38,39,1,1
r1bqkbnr/ppp2ppp/8/4p3/4P3/8/PPP2PPP/RNBQKB1R w KQkq - 0 6,Qf3,35,10,-25,1
r1bqkbnr/ppp2ppp/8/4p3/4P3/5Q2/PPP2PPP/RNB1KB1R b KQkq - 1 6,f6,15,129,114,1
r1bqkbnr/ppp3pp/5p2/4p3/4P3/5Q2/PPP2PPP/RNB1KB1R w KQkq - 0 7,Bc4,93,116,23,1
r1bqkbnr/ppp3pp/5p2/4p3/2B1P3/5Q2/PPP2PPP/RNB1K2R b KQkq - 1 7,Qe7,112,169,57,1
r1b1kbnr/ppp1q1pp/5p2/4p3/2B1P3/5Q2/PPP2PPP/RNB1K2R w KQkq - 2 8,O-O,199,200,1,1
r1b1kbnr/ppp1q1pp/5p2/4p3/2B1P3/5Q2/PPP2PPP/RNB2RK1 b kq - 3 8,Be6,174,210,36,1
r3kbnr/ppp1q1pp/4bp2/4p3/2B1P3/5Q2/PPP2PPP/RNB2RK1 w kq - 4 9,Bxe6,229,51,-178,0
r3kbnr/ppp1q1pp/4Bp2/4p3/4P3/5Q2/PPP2PPP/RNB2RK1 b kq - 0 9,Qxe6,47,46,-1,1
r3kbnr/ppp3pp/4qp2/4p3/4P3/5Q2/PPP2PPP/RNB2RK1 w kq - 0 10,Rd1,55,38,-17,1
r3kbnr/ppp3pp/4qp2/4p3/4P3/5Q2/PPP2PPP/RNBR2K1 b kq - 1 10,Bd6,30,33,3,1
r3k1nr/ppp3pp/3bqp2/4p3/4P3/5Q2/PPP2PPP/RNBR2K1 w kq - 2 11,Qh5+,32,26,-6,1
r3k1nr/ppp3pp/3bqp2/4p2Q/4P3/8/PPP2PPP/RNBR2K1 b kq - 3 11,g6,27,18,-9,1
r3k1nr/ppp4p/3bqpp1/4p2Q/4P3/8/PPP2PPP/RNBR2K1 w kq - 0 12,Qf3,33,-28,-61,1
r3k1nr/ppp4p/3bqpp1/4p3/4P3/5Q2/PPP2PPP/RNBR2K1 b kq - 1 12,O-O-O,-29,-8,21,1
2kr2nr/ppp4p/3bqpp1/4p3/4P3/5Q2/PPP2PPP/RNBR2K1 w - - 2 13,Be3,12,-33,-45,1
2kr2nr/ppp4p/3bqpp1/4p3/4P3/4BQ2/PPP2PPP/RN1R2K1 b - - 3 13,Ne7,-29,-36,-7,1
2kr3r/ppp1n2p/3bqpp1/4p3/4P3/4BQ2/PPP2PPP/RN1R2K1 w - - 4 14,Bxa7,-17,2,19,1
2kr3r/Bpp1n2p/3bqpp1/4p3/4P3/5Q2/PPP2PPP/RN1R2K1 b - - 0 14,Kd7,-15,249,264,1
3r3r/Bppkn2p/3bqpp1/4p3/4P3/5Q2/PPP2PPP/RN1R2K1 w - - 1 15,Nc3,228,181,-47,1
3r3r/Bppkn2p/3bqpp1/4p3/4P3/2N2Q2/PPP2PPP/R2R2K1 b - - 2 15,f5,161,366,205,1
3r3r/Bppkn2p/3bq1p1/4pp2/4P3/2N2Q2/PPP2PPP/R2R2K1 w - - 0 16,exf5,342,381,39,1
3r3r/Bppkn2p/3bq1p1/4pP2/8/2N2Q2/PPP2PPP/R2R2K1 b - - 0 16,Nxf5,366,374,8,1
3r3r/Bppk3p/3bq1p1/4pn2/8/2N2Q2/PPP2PPP/R2R2K1 w - - 0 17,Nb5,385,179,-206,0
3r3r/Bppk3p/3bq1p1/1N2pn2/8/5Q2/PPP2PPP/R2R2K1 b - - 1 17,Nd4,160,415,255,1
3r3r/Bppk3p/3bq1p1/1N2p3/3n4/5Q2/PPP2PPP/R2R2K1 w - - 2 18,Qxb7,414,430,16,1
3r3r/BQpk3p/3bq1p1/1N2p3/3n4/8/PPP2PPP/R2R2K1 b - - 0 18,Nxb5,402,378,-24,1
3r3r/BQpk3p/3bq1p1/1n2p3/8/8/PPP2PPP/R2R2K1 w - - 0 19,Qxb5+,404,400,-4,1
3r3r/B1pk3p/3bq1p1/1Q2p3/8/8/PPP2PPP/R2R2K1 b - - 0 19,Ke7,420,399,-21,1
3r3r/B1p1k2p/3bq1p1/1Q2p3/8/8/PPP2PPP/R2R2K1 w - - 1 20,Re1,423,379,-44,1
3r3r/B1p1k2p/3bq1p1/1Q2p3/8/8/PPP2PPP/R3R1K1 b - - 2 20,Rd7,329,445,116,1
7r/B1prk2p/3bq1p1/1Q2p3/8/8/PPP2PPP/R3R1K1 w - - 3 21,f4,435,363,-72,1
7r/B1prk2p/3bq1p1/1Q2p3/5P2/8/PPP3PP/R3R1K1 b - - 0 21,e4,340,480,140,1
7r/B1prk2p/3bq1p1/1Q6/4pP2/8/PPP3PP/R3R1K1 w - - 0 22,Rad1,508,302,-206,0
7r/B1prk2p/3bq1p1/1Q6/4pP2/8/PPP3PP/3RR1K1 b - - 1 22,Rhd8,313,317,4,1
3r4/B1prk2p/3bq1p1/1Q6/4pP2/8/PPP3PP/3RR1K1 w - - 2 23,Rd4,366,300,-66,1
3r4/B1prk2p/3bq1p1/1Q6/3RpP2/8/PPP3PP/4R1K1 b - - 3 23,Bxf4,304,493,189,1
3r4/B1prk2p/4q1p1/1Q6/3Rpb2/8/PPP3PP/4R1K1 w - - 0 24,Rexe4,624,309,-315,0
3r4/B1prk2p/4q1p1/1Q6/3RRb2/8/PPP3PP/6K1 b - - 0 24,Be3+,266,270,4,1
3r4/B1prk2p/4q1p1/1Q6/3RR3/4b3/PPP3PP/6K1 w - - 1 25,Kf1,275,271,-4,1
3r4/B1prk2p/4q1p1/1Q6/3RR3/4b3/PPP3PP/5K2 b - - 2 25,Rf8+,263,527,264,1
5r2/B1prk2p/4q1p1/1Q6/3RR3/4b3/PPP3PP/5K2 w - - 3 26,Ke2,496,474,-22,1
5r2/B1prk2p/4q1p1/1Q6/3RR3/4b3/PPP1K1PP/8 b - - 4 26,Rd5,527,939,412,1
5r2/B1p1k2p/4q1p1/1Q1r4/3RR3/4b3/PPP1K1PP/8 w - - 5 27,Qb4+,947,632,-315,0
5r2/B1p1k2p/4q1p1/3r4/1Q1RR3/4b3/PPP1K1PP/8 b - - 6 27,Kf7,666,676,10,1
5r2/B1p2k1p/4q1p1/3r4/1Q1RR3/4b3/PPP1K1PP/8 w - - 7 28,Rxe6,650,691,41,1
5r2/B1p2k1p/4R1p1/3r4/1Q1R4/4b3/PPP1K1PP/8 b - - 0 28,Kxe6,737,844,107,1
5r2/B1p4p/4k1p1/3r4/1Q1R4/4b3/PPP1K1PP/8 w - - 0 29,Rxd5,873,842,-31,1
5r2/B1p4p/4k1p1/3R4/1Q6/4b3/PPP1K1PP/8 b - - 0 29,Kxd5,841,819,-22,1
5r2/B1p4p/6p1/3k4/1Q6/4b3/PPP1K1PP/8 w - - 0 30,Bxe3,859,849,-10,1
5r2/2p4p/6p1/3k4/1Q6/4B3/PPP1K1PP/8 b - - 0 30,Re8,854,891,37,1
4r3/2p4p/6p1/3k4/1Q6/4B3/PPP1K1PP/8 w - - 1 31,Qb3+,938,796,-142,0
4r3/2p4p/6p1/3k4/8/1Q2B3/PPP1K1PP/8 b - - 2 31,Kd6,756,802,46,1
4r3/2p4p/3k2p1/8/8/1Q2B3/PPP1K1PP/8 w - - 3 32,Qd3+,808,820,12,1
rnbqkbnr/pppppppp/8/8/8/8/PPPPPPPP/RNBQKBNR w KQkq - 0 1,d4,38,22,-16,1
rnbqkbnr/pppppppp/8/8/3P4/8/PPP1PPPP/RNBQKBNR b KQkq - 0 1,Nf6,18,18,0,1
rnbqkb1r/pppppppp/5n2/8/3P4/8/PPP1PPPP/RNBQKBNR w KQkq - 1 2,c4,22,19,-3,1
rnbqkb1r/pppppppp/5n2/8/2PP4/8/PP2PPPP/RNBQKBNR b KQkq - 0 2,e6,17,21,4,1
rnbqkb1r/pppp1ppp/4pn2/8/2PP4/8/PP2PPPP/RNBQKBNR w KQkq - 0 3,Nc3,21,17,-4,1
rnbqkb1r/pppp1ppp/4pn2/8/2PP4/2N5/PP2PPPP/R1BQKBNR b KQkq - 1 3,d5,20,21,1,1
rnbqkb1r/ppp2ppp/4pn2/3p4/2PP4/2N5/PP2PPPP/R1BQKBNR w KQkq - 0 4,Bg5,25,24,-1,1
rnbqkb1r/ppp2ppp/4pn2/3p2B1/2PP4/2N5/PP2PPPP/R2QKBNR b KQkq - 1 4,Be7,31,36,5,1
rnbqk2r/ppp1bppp/4pn2/3p2B1/2PP4/2N5/PP2PPPP/R2QKBNR w KQkq - 2 5,cxd5,31,13,-18,1
rnbqk2r/ppp1bppp/4pn2/3P2B1/3P4/2N5/PP2PPPP/R2QKBNR b KQkq - 0 5,Nxd5,7,6,-1,1
rnbqk2r/ppp1bppp/4p3/3n2B1/3P4/2N5/PP2PPPP/R2QKBNR w KQkq - 0 6,Bxe7,27,16,-11,1
rnbqk2r/ppp1Bppp/4p3/3n4/3P4/2N5/PP2PPPP/R2QKBNR b KQkq - 0 6,Qxe7,3,6,3,1
rnb1k2r/ppp1qppp/4p3/3n4/3P4/2N5/PP2PPPP/R2QKBNR w KQkq - 0 7,e4,7,-34,-41,1
rnb1k2r/ppp1qppp/4p3/3n4/3PP3/2N5/PP3PPP/R2QKBNR b KQkq - 0 7,Nf6,-28,58,86,1
rnb1k2r/ppp1qppp/4pn2/8/3PP3/2N5/PP3PPP/R2QKBNR w KQkq - 1 8,Bc4,59,27,-32,1
rnb1k2r/ppp1qppp/4pn2/8/2BPP3/2N5/PP3PPP/R2QK1NR b KQkq - 2 8,Nxe4,25,365,340,1
rnb1k2r/ppp1qppp/4p3/8/2BPn3/2N5/PP3PPP/R2QK1NR w KQkq - 0 9,Nxe4,383,384,1,1
rnb1k2r/ppp1qppp/4p3/8/2BPN3/8/PP3PPP/R2QK1NR b KQkq - 0 9,Qb4+,390,405,15,1
rnb1k2r/ppp2ppp/4p3/8/1qBPN3/8/PP3PPP/R2QK1NR w KQkq - 1 10,Nd2,393,420,27,1
rnb1k2r/ppp2ppp/4p3/8/1qBP4/8/PP1N1PPP/R2QK1NR b KQkq - 2 10,Qxb2,393,368,-25,1
rnb1k2r/ppp2ppp/4p3/8/2BP4/8/Pq1N1PPP/R2QK1NR w KQkq - 0 11,Rb1,402,294,-108,0
rnb1k2r/ppp2ppp/4p3/8/2BP4/8/Pq1N1PPP/1R1QK1NR b Kkq - 1 11,Qxd4,327,315,-12,1
rnb1k2r/ppp2ppp/4p3/8/2Bq4/8/P2N1PPP/1R1QK1NR w Kkq - 0 12,Ngf3,310,316,6,1
rnb1k2r/ppp2ppp/4p3/8/2Bq4/5N2/P2N1PPP/1R1QK2R b Kkq - 1 12,Qf6,328,367,39,1
rnb1k2r/ppp2ppp/4pq2/8/2B5/5N2/P2N1PPP/1R1QK2R w Kkq - 2 13,O-O,336,322,-14,1
rnb1k2r/ppp2ppp/4pq2/8/2B5/5N2/P2N1PPP/1R1Q1RK1 b kq - 3 13,O-O,334,342,8,1
rnb2rk1/ppp2ppp/4pq2/8/2B5/5N2/P2N1PPP/1R1Q1RK1 w - - 4 14,Ne4,342,275,-67,1
rnb2rk1/ppp2ppp/4pq2/8/2B1N3/5N2/P4PPP/1R1Q1RK1 b - - 5 14,Qe7,302,309,7,1
rnb2rk1/ppp1qppp/4p3/8/2B1N3/5N2/P4PPP/1R1Q1RK1 w - - 6 15,Bd3,299,270,-29,1
rnb2rk1/ppp1qppp/4p3/8/4N3/3B1N2/P4PPP/1R1Q1RK1 b - - 7 15,b6,260,269,9,1
rnb2rk1/p1p1qppp/1p2p3/8/4N3/3B1N2/P4PPP/1R1Q1RK1 w - - 0 16,Ng3,248,212,-36,1
rnb2rk1/p1p1qppp/1p2p3/8/8/3B1NN1/P4PPP/1R1Q1RK1 b - - 1 16,Bb7,218,260,42,1
rn3rk1/pbp1qppp/1p2p3/8/8/3B1NN1/P4PPP/1R1Q1RK1 w - - 2 17,h4,251,182,-69,1
rn3rk1/pbp1qppp/1p2p3/8/7P/3B1NN1/P4PP1/1R1Q1RK1 b - - 0 17,c5,171,247,76,1
rn3rk1/pb2qppp/1p2p3/2p5/7P/3B1NN1/P4PP1/1R1Q1RK1 w - - 0 18,Bxh7+,387,383,-4,1
rn3rk1/pb2qppB/1p2p3/2p5/7P/5NN1/P4PP1/1R1Q1RK1 b - - 0 18,Kxh7,374,928,554,1
rn3r2/pb2qppk/1p2p3/2p5/7P/5NN1/P4PP1/1R1Q1RK1 w - - 0 19,Ng5+,457,445,-12,1
rn3r2/pb2qppk/1p2p3/2p3N1/7P/6N1/P4PP1/1R1Q1RK1 b - - 1 19,Kg8,472,471,-1,1
rn3rk1/pb2qpp1/1p2p3/2p3N1/7P/6N1/P4PP1/1R1Q1RK1 w - - 2 20,Qh5,493,487,-6,1
rnbqkbnr/pppppppp/8/8/8/8/PPPPPPPP/RNBQKBNR w KQkq - 0 1,d4,39,20,-19,1
rnbqkbnr/pppppppp/8/8/3P4/8/PPP1PPPP/RNBQKBNR b KQkq - 0 1,d5,16,31,15,1
rnbqkbnr/ppp1pppp/8/3p4/3P4/8/PPP1PPPP/RNBQKBNR w KQkq - 0 2,Nc3,21,3,-18,1
rnbqkbnr/ppp1pppp/8/3p4/3P4/2N5/PPP1PPPP/R1BQKBNR b KQkq - 1 2,Nc6,-9,43,52,1
r1bqkbnr/ppp1pppp/2n5/3p4/3P4/2N5/PPP1PPPP/R1BQKBNR w KQkq - 2 3,e4,32,35,3,1
r1bqkbnr/ppp1pppp/2n5/3p4/3PP3/2N5/PPP2PPP/R1BQKBNR b KQkq - 0 3,Nf6,34,169,135,1
r1bqkb1r/ppp1pppp/2n2n2/3p4/3PP3/2N5/PPP2PPP/R1BQKBNR w KQkq - 1 4,e5,162,154,-8,1
r1bqkb1r/ppp1pppp/2n2n2/3pP3/3P4/2N5/PPP2PPP/R1BQKBNR b KQkq - 0 4,Ne4,142,176,34,1
r1bqkb1r/ppp1pppp/2n5/3pP3/3Pn3/2N5/PPP2PPP/R1BQKBNR w KQkq - 1 5,Nxe4,149,174,25,1
r1bqkb1r/ppp1pppp/2n5/3pP3/3PN3/8/PPP2PPP/R1BQKBNR b KQkq - 0 5,dxe4,151,140,-11,1
r1bqkb1r/ppp1pppp/2n5/4P3/3Pp3/8/PPP2PPP/R1BQKBNR w KQkq - 0 6,Bb5,157,72,-85,1
r1bqkb1r/ppp1pppp/2n5/1B2P3/3Pp3/8/PPP2PPP/R1BQK1NR b KQkq - 1 6,a6,77,98,21,1
r1bqkb1r/1pp1pppp/p1n5/1B2P3/3Pp3/8/PPP2PPP/R1BQK1NR w KQkq - 0 7,Bc4,114,-177,-291,0
r1bqkb1r/1pp1pppp/p1n5/4P3/2BPp3/8/PPP2PPP/R1BQK1NR b KQkq - 1 7,Nxd4,-200,-32,168,1
r1bqkb1r/1pp1pppp/p7/4P3/2Bnp3/8/PPP2PPP/R1BQK1NR w KQkq - 0 8,c3,-34,-96,-62,1
r1bqkb1r/1pp1pppp/p7/4P3/2Bnp3/2P5/PP3PPP/R1BQK1NR b KQkq - 0 8,Nc6,-86,-63,23,1
r1bqkb1r/1pp1pppp/p1n5/4P3/2B1p3/2P5/PP3PPP/R1BQK1NR w KQkq - 1 9,Qb3,-86,-276,-190,0
r1bqkb1r/1pp1pppp/p1n5/4P3/2B1p3/1QP5/PP3PPP/R1B1K1NR b KQkq - 2 9,Nxe5,-265,-265,0,1
r1bqkb1r/1pp1pppp/p7/4n3/2B1p3/1QP5/PP3PPP/R1B1K1NR w KQkq - 0 10,Bf4,-247,-269,-22,1
r1bqkb1r/1pp1pppp/p7/4n3/2B1pB2/1QP5/PP3PPP/R3K1NR b KQkq - 1 10,Nxc4,-270,-265,5,1
r1bqkb1r/1pp1pppp/p7/8/2n1pB2/1QP5/PP3PPP/R3K1NR w KQkq - 0 11,Qxc4,-275,-283,-8,1
r1bqkb1r/1pp1pppp/p7/8/2Q1pB2/2P5/PP3PPP/R3K1NR b KQkq - 0 11,Bf5,-260,-143,117,1
r2qkb1r/1pp1pppp/p7/5b2/2Q1pB2/2P5/PP3PPP/R3K1NR w KQkq - 1 12,Bxc7,-153,-250,-97,1
r2qkb1r/1pB1pppp/p7/5b2/2Q1p3/2P5/PP3PPP/R3K1NR b KQkq - 0 12,Qd7,-284,-196,88,1
r3kb1r/1pBqpppp/p7/5b2/2Q1p3/2P5/PP3PPP/R3K1NR w KQkq - 1 13,Rd1,-182,-198,-16,1
r3kb1r/1pBqpppp/p7/5b2/2Q1p3/2P5/PP3PPP/3RK1NR b Kkq - 2 13,Qc6,-199,-136,63,1
r3kb1r/1pB1pppp/p1q5/5b2/2Q1p3/2P5/PP3PPP/3RK1NR w Kkq - 3 14,Qxc6+,-125,-138,-13,1
r3kb1r/1pB1pppp/p1Q5/5b2/4p3/2P5/PP3PPP/3RK1NR b Kkq - 0 14,bxc6,-141,-129,12,1
r3kb1r/2B1pppp/p1p5/5b2/4p3/2P5/PP3PPP/3RK1NR w Kkq - 0 15,Ne2,-159,-163,-4,1
r3kb1r/2B1pppp/p1p5/5b2/4p3/2P5/PP2NPPP/3RK2R b Kkq - 1 15,e6,-135,-91,44,1
r3kb1r/2B2ppp/p1p1p3/5b2/4p3/2P5/PP2NPPP/3RK2R w Kkq - 0 16,Be5,-100,-122,-22,1
r3kb1r/5ppp/p1p1p3/4Bb2/4p3/2P5/PP2NPPP/3RK2R b Kkq - 1 16,f6,-118,-140,-22,1
r3kb1r/6pp/p1p1pp2/4Bb2/4p3/2P5/PP2NPPP/3RK2R w Kkq - 0 17,Bd6,-129,-140,-11,1
r3kb1r/6pp/p1pBpp2/5b2/4p3/2P5/PP2NPPP/3RK2R b Kkq - 1 17,Bxd6,-139,-35,104,1
r3k2r/6pp/p1pbpp2/5b2/4p3/2P5/PP2NPPP/3RK2R w Kkq - 0 18,Rxd6,-25,-33,-8,1
r3k2r/6pp/p1pRpp2/5b2/4p3/2P5/PP2NPPP/4K2R b Kkq - 0 18,O-O,-33,-2,31,1
r4rk1/6pp/p1pRpp2/5b2/4p3/2P5/PP2NPPP/4K2R w K - 1 19,O-O,9,-67,-76,1
r4rk1/6pp/p1pRpp2/5b2/4p3/2P5/PP2NPPP/5RK1 b - - 2 19,c5,-63,-58,5,1
r4rk1/6pp/p2Rpp2/2p2b2/4p3/2P5/PP2NPPP/5RK1 w - - 0 20,Nf4,-60,-67,-7,1
r4rk1/6pp/p2Rpp2/2p2b2/4pN2/2P5/PP3PPP/5RK1 b - - 1 20,e5,-62,-36,26,1
r4rk1/6pp/p2R1p2/2p1pb2/4pN2/2P5/PP3PPP/5RK1 w - - 0 21,Nd5,-48,-56,-8,1
r4rk1/6pp/p2R1p2/2pNpb2/4p3/2P5/PP3PPP/5RK1 b - - 1 21,Rf7,-52,20,72,1
r5k1/5rpp/p2R1p2/2pNpb2/4p3/2P5/PP3PPP/5RK1 w - - 2 22,Rc6,16,0,-16,1
r5k1/5rpp/p1R2p2/2pNpb2/4p3/2P5/PP3PPP/5RK1 b - - 3 22,Rb8,-8,-9,-1,1
1r4k1/5rpp/p1R2p2/2pNpb2/4p3/2P5/PP3PPP/5RK1 w - - 4 23,Rxc5,-1,-67,-66,1
1r4k1/5rpp/p4p2/2RNpb2/4p3/2P5/PP3PPP/5RK1 b - - 0 23,Rxb2,-69,-112,-43,1
6k1/5rpp/p4p2/2RNpb2/4p3/2P5/Pr3PPP/5RK1 w - - 0 24,Rc8+,-138,-559,-421,0
2R3k1/5rpp/p4p2/3Npb2/4p3/2P5/Pr3PPP/5RK1 b - - 1 24,Rf8,-636,93,729,1
2R2rk1/6pp/p4p2/3Npb2/4p3/2P5/Pr3PPP/5RK1 w - - 2 25,Ne7+,78,69,-9,1
2R2rk1/4N1pp/p4p2/4pb2/4p3/2P5/Pr3PPP/5RK1 b - - 3 25,Kf7,62,80,18,1
2R2r2/4Nkpp/p4p2/4pb2/4p3/2P5/Pr3PPP/5RK1 w - - 4 26,Rxf8+,105,31,-74,1
5R2/4Nkpp/p4p2/4pb2/4p3/2P5/Pr3PPP/5RK1 b - - 0 26,Kxf8,38,232,194,1
5k2/4N1pp/p4p2/4pb2/4p3/2P5/Pr3PPP/5RK1 w - - 0 27,Nxf5,270,269,-1,1
5k2/6pp/p4p2/4pN2/4p3/2P5/Pr3PPP/5RK1 b - - 0 27,Rxa2,292,287,-5,1
5k2/6pp/p4p2/4pN2/4p3/2P5/r4PPP/5RK1 w - - 0 28,Nd6,281,186,-95,1
5k2/6pp/p2N1p2/4p3/4p3/2P5/r4PPP/5RK1 b - - 1 28,Ra3,203,308,105,1
5k2/6pp/p2N1p2/4p3/4p3/r1P5/5PPP/5RK1 w - - 2 29,c4,319,277,-42,1
5k2/6pp/p2N1p2/4p3/2P1p3/r7/5PPP/5RK1 b - - 0 29,Rd3,274,327,53,1
5k2/6pp/p2N1p2/4p3/2P1p3/3r4/5PPP/5RK1 w - - 1 30,Nxe4,291,292,1,1
5k2/6pp/p4p2/4p3/2P1N3/3r4/5PPP/5RK1 b - - 0 30,Rd4,299,272,-27,1
5k2/6pp/p4p2/4p3/2PrN3/8/5PPP/5RK1 w - - 1 31,Nc5,294,291,-3,1
5k2/6pp/p4p2/2N1p3/2Pr4/8/5PPP/5RK1 b - - 2 31,Rxc4,282,283,1,1
5k2/6pp/p4p2/2N1p3/2r5/8/5PPP/5RK1 w - - 0 32,Ne6+,292,146,-146,0
rnbqkbnr/pppppppp/8/8/8/8/PPPPPPPP/RNBQKBNR w KQkq - 0 1,e4,38,29,-9,1
rnbqkbnr/pppppppp/8/8/4P3/8/PPPP1PPP/RNBQKBNR b KQkq - 0 1,e5,35,36,1,1
rnbqkbnr/pppp1ppp/8/4p3/4P3/8/PPPP1PPP/RNBQKBNR w KQkq - 0 2,f4,41,-69,-110,0
rnbqkbnr/pppp1ppp/8/4p3/4PP2/8/PPPP2PP/RNBQKBNR b KQkq - 0 2,Nc6,-40,36,76,1
r1bqkbnr/pppp1ppp/2n5/4p3/4PP2/8/PPPP2PP/RNBQKBNR w KQkq - 1 3,Nf3,35,30,-5,1
r1bqkbnr/pppp1ppp/2n5/4p3/4PP2/5N2/PPPP2PP/RNBQKB1R b KQkq - 2 3,exf4,29,23,-6,1
r1bqkbnr/pppp1ppp/2n5/8/4Pp2/5N2/PPPP2PP/RNBQKB1R w KQkq - 0 4,Bc4,25,-92,-117,0
r1bqkbnr/pppp1ppp/2n5/8/2B1Pp2/5N2/PPPP2PP/RNBQK2R b KQkq - 1 4,h6,-104,16,120,1
r1bqkbnr/pppp1pp1/2n4p/8/2B1Pp2/5N2/PPPP2PP/RNBQK2R w KQkq - 0 5,d4,52,17,-35,1
r1bqkbnr/pppp1pp1/2n4p/8/2BPPp2/5N2/PPP3PP/RNBQK2R b KQkq - 0 5,d6,43,135,92,1
r1bqkbnr/ppp2pp1/2np3p/8/2BPPp2/5N2/PPP3PP/RNBQK2R w KQkq - 0 6,Bxf4,154,154,0,1
r1bqkbnr/ppp2pp1/2np3p/8/2BPPB2/5N2/PPP3PP/RN1QK2R b KQkq - 0 6,Bg4,151,174,23,1
r2qkbnr/ppp2pp1/2np3p/8/2BPPBb1/5N2/PPP3PP/RN1QK2R w KQkq - 1 7,O-O,177,170,-7,1
r2qkbnr/ppp2pp1/2np3p/8/2BPPBb1/5N2/PPP3PP/RN1Q1RK1 b kq - 2 7,Nge7,188,258,70,1
r2qkb1r/ppp1npp1/2np3p/8/2BPPBb1/5N2/PPP3PP/RN1Q1RK1 w kq - 3 8,c3,256,120,-136,0
r2qkb1r/ppp1npp1/2np3p/8/2BPPBb1/2P2N2/PP4PP/RN1Q1RK1 b kq - 0 8,f5,124,251,127,1
r2qkb1r/ppp1n1p1/2np3p/5p2/2BPPBb1/2P2N2/PP4PP/RN1Q1RK1 w kq - 0 9,Bd3,235,78,-157,0
r2qkb1r/ppp1n1p1/2np3p/5p2/3PPBb1/2PB1N2/PP4PP/RN1Q1RK1 b kq - 1 9,Qd7,77,140,63,1
r3kb1r/pppqn1p1/2np3p/5p2/3PPBb1/2PB1N2/PP4PP/RN1Q1RK1 w kq - 2 10,Qe1,166,48,-118,0
r3kb1r/pppqn1p1/2np3p/5p2/3PPBb1/2PB1N2/PP4PP/RN2QRK1 b kq - 3 10,O-O-O,91,62,-29,1
2kr1b1r/pppqn1p1/2np3p/5p2/3PPBb1/2PB1N2/PP4PP/RN2QRK1 w - - 4 11,Qf2,95,-33,-128,0
2kr1b1r/pppqn1p1/2np3p/5p2/3PPBb1/2PB1N2/PP3QPP/RN3RK1 b - - 5 11,Re8,-64,99,163,1
2k1rb1r/pppqn1p1/2np3p/5p2/3PPBb1/2PB1N2/PP3QPP/RN3RK1 w - - 6 12,d5,109,66,-43,1
2k1rb1r/pppqn1p1/2np3p/3P1p2/4PBb1/2PB1N2/PP3QPP/RN3RK1 b - - 0 12,Ne5,73,332,259,1
2k1rb1r/pppqn1p1/3p3p/3Pnp2/4PBb1/2PB1N2/PP3QPP/RN3RK1 w - - 1 13,Nxe5,280,169,-111,0
2k1rb1r/pppqn1p1/3p3p/3PNp2/4PBb1/2PB4/PP3QPP/RN3RK1 b - - 0 13,dxe5,193,227,34,1
2k1rb1r/pppqn1p1/7p/3Ppp2/4PBb1/2PB4/PP3QPP/RN3RK1 w - - 0 14,Bxe5,238,-83,-321,0
2k1rb1r/pppqn1p1/7p/3PBp2/4P1b1/2PB4/PP3QPP/RN3RK1 b - - 0 14,Ng6,-42,293,335,1
2k1rb1r/pppq2p1/6np/3PBp2/4P1b1/2PB4/PP3QPP/RN3RK1 w - - 1 15,Bg3,251,61,-190,0
2k1rb1r/pppq2p1/6np/3P1p2/4P1b1/2PB2B1/PP3QPP/RN3RK1 b - - 2 15,b6,53,115,62,1
2k1rb1r/p1pq2p1/1p4np/3P1p2/4P1b1/2PB2B1/PP3QPP/RN3RK1 w - - 0 16,Ba6+,121,94,-27,1
2k1rb1r/p1pq2p1/Bp4np/3P1p2/4P1b1/2P3B1/PP3QPP/RN3RK1 b - - 1 16,Kb8,76,101,25,1
1k2rb1r/p1pq2p1/Bp4np/3P1p2/4P1b1/2P3B1/PP3QPP/RN3RK1 w - - 2 17,h3,93,-269,-362,0
1k2rb1r/p1pq2p1/Bp4np/3P1p2/4P1b1/2P3BP/PP3QP1/RN3RK1 b - - 0 17,Bc5,-275,-308,-33,1
1k2r2r/p1pq2p1/Bp4np/2bP1p2/4P1b1/2P3BP/PP3QP1/RN3RK1 w - - 1 18,Qxc5,-314,-292,22,1
1k2r2r/p1pq2p1/Bp4np/2QP1p2/4P1b1/2P3BP/PP4P1/RN3RK1 b - - 0 18,bxc5,-333,-325,8,1
1k2r2r/p1pq2p1/B5np/2pP1p2/4P1b1/2P3BP/PP4P1/RN3RK1 w - - 0 19,hxg4,-314,-337,-23,1
1k2r2r/p1pq2p1/B5np/2pP1p2/4P1P1/2P3B1/PP4P1/RN3RK1 b - - 0 19,f4,-357,-356,1,1
1k2r2r/p1pq2p1/B5np/2pP4/4PpP1/2P3B1/PP4P1/RN3RK1 w - - 0 20,Bf2,-332,-367,-35,1
1k2r2r/p1pq2p1/B5np/2pP4/4PpP1/2P5/PP3BP1/RN3RK1 b - - 1 20,Qxg4,-348,-351,-3,1
1k2r2r/p1p3p1/B5np/2pP4/4Ppq1/2P5/PP3BP1/RN3RK1 w - - 0 21,Nd2,-347,-373,-26,1
1k2r2r/p1p3p1/B5np/2pP4/4Ppq1/2P5/PP1N1BP1/R4RK1 b - - 1 21,Ne5,-388,-286,102,1
1k2r2r/p1p3p1/B6p/2pPn3/4Ppq1/2P5/PP1N1BP1/R4RK1 w - - 2 22,Bxc5,-381,-390,-9,1
1k2r2r/p1p3p1/B6p/2BPn3/4Ppq1/2P5/PP1N2P1/R4RK1 b - - 0 22,f3,-380,-204,176,1
1k2r2r/p1p3p1/B6p/2BPn3/4P1q1/2P2p2/PP1N2P1/R4RK1 w - - 0 23,Rf2,-233,-234,-1,1
1k2r2r/p1p3p1/B6p/2BPn3/4P1q1/2P2p2/PP1N1RP1/R5K1 b - - 1 23,fxg2,-255,-222,33,1
1k2r2r/p1p3p1/B6p/2BPn3/4P1q1/2P5/PP1N1Rp1/R5K1 w - - 0 24,Rxg2,-227,-248,-21,1
1k2r2r/p1p3p1/B6p/2BPn3/4P1q1/2P5/PP1N2R1/R5K1 b - - 0 24,Nf3+,-198,-258,-60,1
1k2r2r/p1p3p1/B6p/2BP4/4P1q1/2P2n2/PP1N2R1/R5K1 w - - 1 25,Nxf3,-268,-276,-8,1
1k2r2r/p1p3p1/B6p/2BP4/4P1q1/2P2N2/PP4R1/R5K1 b - - 0 25,Qxf3,-259,-223,36,1
1k2r2r/p1p3p1/B6p/2BP4/4P3/2P2q2/PP4R1/R5K1 w - - 0 26,Rf1,-260,-315,-55,1
1k2r2r/p1p3p1/B6p/2BP4/4P3/2P2q2/PP4R1/5RK1 b - - 1 26,Qxe4,-308,-370,-62,1
1k2r2r/p1p3p1/B6p/2BP4/4q3/2P5/PP4R1/5RK1 w - - 0 27,c4,-327,-382,-55,1
1k2r2r/p1p3p1/B6p/2BP4/2P1q3/8/PP4R1/5RK1 b - - 0 27,h5,-424,-322,102,1
1k2r2r/p1p3p1/B7/2BP3p/2P1q3/8/PP4R1/5RK1 w - - 0 28,Rxg7,-334,-626,-292,0
1k2r2r/p1p3R1/B7/2BP3p/2P1q3/8/PP6/5RK1 b - - 0 28,h4,-587,-269,318,1
1k2r2r/p1p3R1/B7/2BP4/2P1q2p/8/PP6/5RK1 w - - 0 29,Rgf7,-277,-9997,-9720,0
1k2r2r/p1p2R2/B7/2BP4/2P1q2p/8/PP6/5RK1 b - - 1 29,Rhg8+,-9997,-9998,-1,1
1k2r1r1/p1p2R2/B7/2BP4/2P1q2p/8/PP6/5RK1 w - - 2 30,Kh2,-9998,-9999,-1,1
1k2r1r1/p1p2R2/B7/2BP4/2P1q2p/8/PP5K/5R2 b - - 3 30,Qg2#,-9999,-10000,-1,1
rnbqkbnr/pppppppp/8/8/8/8/PPPPPPPP/RNBQKBNR w KQkq - 0 1,d4,35,24,-11,1
rnbqkbnr/pppppppp/8/8/3P4/8/PPP1PPPP/RNBQKBNR b KQkq - 0 1,d5,15,24,9,1
rnbqkbnr/ppp1pppp/8/3p4/3P4/8/PPP1PPPP/RNBQKBNR w KQkq - 0 2,Nf3,24,12,-12,1
rnbqkbnr/ppp1pppp/8/3p4/3P4/5N2/PPP1PPPP/RNBQKB1R b KQkq - 1 2,Nf6,18,22,4,1
rnbqkb1r/ppp1pppp/5n2/3p4/3P4/5N2/PPP1PPPP/RNBQKB1R w KQkq - 2 3,e3,20,8,-12,1
rnbqkb1r/ppp1pppp/5n2/3p4/3P4/4PN2/PPP2PPP/RNBQKB1R b KQkq - 0 3,c6,10,30,20,1
rnbqkb1r/pp2pppp/2p2n2/3p4/3P4/4PN2/PPP2PPP/RNBQKB1R w KQkq - 0 4,Be2,27,6,-21,1
rnbqkb1r/pp2pppp/2p2n2/3p4/3P4/4PN2/PPP1BPPP/RNBQK2R b KQkq - 1 4,e6,-3,26,29,1
rnbqkb1r/pp3ppp/2p1pn2/3p4/3P4/4PN2/PPP1BPPP/RNBQK2R w KQkq - 0 5,O-O,21,21,0,1
rnbqkb1r/pp3ppp/2p1pn2/3p4/3P4/4PN2/PPP1BPPP/RNBQ1RK1 b kq - 1 5,Nbd7,26,24,-2,1
r1bqkb1r/pp1n1ppp/2p1pn2/3p4/3P4/4PN2/PPP1BPPP/RNBQ1RK1 w kq - 2 6,Nbd2,20,14,-6,1
r1bqkb1r/pp1n1ppp/2p1pn2/3p4/3P4/4PN2/PPPNBPPP/R1BQ1RK1 b kq - 3 6,Be7,12,27,15,1
r1bqk2r/pp1nbppp/2p1pn2/3p4/3P4/4PN2/PPPNBPPP/R1BQ1RK1 w kq - 4 7,b3,18,19,1,1
r1bqk2r/pp1nbppp/2p1pn2/3p4/3P4/1P2PN2/P1PNBPPP/R1BQ1RK1 b kq - 0 7,O-O,28,13,-15,1
r1bq1rk1/pp1nbppp/2p1pn2/3p4/3P4/1P2PN2/P1PNBPPP/R1BQ1RK1 w - - 1 8,Bb2,14,11,-3,1
r1bq1rk1/pp1nbppp/2p1pn2/3p4/3P4/1P2PN2/PBPNBPPP/R2Q1RK1 b - - 2 8,Ne4,8,89,81,1
r1bq1rk1/pp1nbppp/2p1p3/3p4/3Pn3/1P2PN2/PBPNBPPP/R2Q1RK1 w - - 3 9,Ne5,39,-33,-72,1
r1bq1rk1/pp1nbppp/2p1p3/3pN3/3Pn3/1P2P3/PBPNBPPP/R2Q1RK1 b - - 4 9,Nxe5,-8,12,20,1
r1bq1rk1/pp2bppp/2p1p3/3pn3/3Pn3/1P2P3/PBPNBPPP/R2Q1RK1 w - - 0 10,dxe5,13,-31,-44,1
r1bq1rk1/pp2bppp/2p1p3/3pP3/4n3/1P2P3/PBPNBPPP/R2Q1RK1 b - - 0 10,f5,-30,7,37,1
r1bq1rk1/pp2b1pp/2p1p3/3pPp2/4n3/1P2P3/PBPNBPPP/R2Q1RK1 w - f6 0 11,exf6,18,13,-5,1
r1bq1rk1/pp2b1pp/2p1pP2/3p4/4n3/1P2P3/PBPNBPPP/R2Q1RK1 b - - 0 11,Bxf6,11,19,8,1
r1bq1rk1/pp4pp/2p1pb2/3p4/4n3/1P2P3/PBPNBPPP/R2Q1RK1 w - - 0 12,Bxf6,26,20,-6,1
r1bq1rk1/pp4pp/2p1pB2/3p4/4n3/1P2P3/P1PNBPPP/R2Q1RK1 b - - 0 12,Nxf6,11,24,13,1
r1bq1rk1/pp4pp/2p1pn2/3p4/8/1P2P3/P1PNBPPP/R2Q1RK1 w - - 0 13,c4,16,14,-2,1
r1bq1rk1/pp4pp/2p1pn2/3p4/2P5/1P2P3/P2NBPPP/R2Q1RK1 b - - 0 13,Qc7,23,22,-1,1
r1b2rk1/ppq3pp/2p1pn2/3p4/2P5/1P2P3/P2NBPPP/R2Q1RK1 w - - 1 14,cxd5,33,-32,-65,1
r1b2rk1/ppq3pp/2p1pn2/3P4/8/1P2P3/P2NBPPP/R2Q1RK1 b - - 0 14,exd5,-26,-24,2,1
r1b2rk1/ppq3pp/2p2n2/3p4/8/1P2P3/P2NBPPP/R2Q1RK1 w - - 0 15,Rc1,-24,-35,-11,1
r1b2rk1/ppq3pp/2p2n2/3p4/8/1P2P3/P2NBPPP/2RQ1RK1 b - - 1 15,Bf5,-30,-23,7,1
r4rk1/ppq3pp/2p2n2/3p1b2/8/1P2P3/P2NBPPP/2RQ1RK1 w - - 2 16,Nf3,-26,-36,-10,1
r4rk1/ppq3pp/2p2n2/3p1b2/8/1P2PN2/P3BPPP/2RQ1RK1 b - - 3 16,Rae8,-32,-22,10,1
4rrk1/ppq3pp/2p2n2/3p1b2/8/1P2PN2/P3BPPP/2RQ1RK1 w - - 4 17,Nd4,-29,-26,3,1
4rrk1/ppq3pp/2p2n2/3p1b2/3N4/1P2P3/P3BPPP/2RQ1RK1 b - - 5 17,Bg6,-29,-32,-3,1
4rrk1/ppq3pp/2p2nb1/3p4/3N4/1P2P3/P3BPPP/2RQ1RK1 w - - 6 18,Bd3,-32,-93,-61,1
4rrk1/ppq3pp/2p2nb1/3p4/3N4/1P1BP3/P4PPP/2RQ1RK1 b - - 7 18,Qe7,-66,-35,31,1
4rrk1/pp2q1pp/2p2nb1/3p4/3N4/1P1BP3/P4PPP/2RQ1RK1 w - - 8 19,Bxg6,-34,-34,0,1
4rrk1/pp2q1pp/2p2nB1/3p4/3N4/1P2P3/P4PPP/2RQ1RK1 b - - 0 19,hxg6,-38,-33,5,1
4rrk1/pp2q1p1/2p2np1/3p4/3N4/1P2P3/P4PPP/2RQ1RK1 w - - 0 20,Nf3,-33,-24,9,1
4rrk1/pp2q1p1/2p2np1/3p4/8/1P2PN2/P4PPP/2RQ1RK1 b - - 1 20,Ne4,-19,-14,5,1
4rrk1/pp2q1p1/2p3p1/3p4/4n3/1P2PN2/P4PPP/2RQ1RK1 w - - 2 21,Qc2,-15,-60,-45,1
4rrk1/pp2q1p1/2p3p1/3p4/4n3/1P2PN2/P1Q2PPP/2R2RK1 b - - 3 21,Kh7,-44,-28,16,1
4rr2/pp2q1pk/2p3p1/3p4/4n3/1P2PN2/P1Q2PPP/2R2RK1 w - - 4 22,Nd2,-11,-17,-6,1
4rr2/pp2q1pk/2p3p1/3p4/4n3/1P2P3/P1QN1PPP/2R2RK1 b - - 5 22,Rf5,-38,-2,36,1
4r3/pp2q1pk/2p3p1/3p1r2/4n3/1P2P3/P1QN1PPP/2R2RK1 w - - 6 23,Nxe4,-5,-7,-2,1
4r3/pp2q1pk/2p3p1/3p1r2/4N3/1P2P3/P1Q2PPP/2R2RK1 b - - 0 23,dxe4,-5,25,30,1
4r3/pp2q1pk/2p3p1/5r2/4p3/1P2P3/P1Q2PPP/2R2RK1 w - - 0 24,Rcd1,51,33,-18,1
4r3/pp2q1pk/2p3p1/5r2/4p3/1P2P3/P1Q2PPP/3R1RK1 b - - 1 24,Rh5,25,38,13,1
4r3/pp2q1pk/2p3p1/7r/4p3/1P2P3/P1Q2PPP/3R1RK1 w - - 2 25,Rd4,45,30,-15,1
4r3/pp2q1pk/2p3p1/7r/3Rp3/1P2P3/P1Q2PPP/5RK1 b - - 3 25,Qe5,34,34,0,1
4r3/pp4pk/2p3p1/4q2r/3Rp3/1P2P3/P1Q2PPP/5RK1 w - - 4 26,g3,36,-66,-102,0
4r3/pp4pk/2p3p1/4q2r/3Rp3/1P2P1P1/P1Q2P1P/5RK1 b - - 0 26,Qf5,-70,-13,57,1
4r3/pp4pk/2p3p1/5q1r/3Rp3/1P2P1P1/P1Q2P1P/5RK1 w - - 1 27,b4,-36,-36,0,1
4r3/pp4pk/2p3p1/5q1r/1P1Rp3/4P1P1/P1Q2P1P/5RK1 b - - 0 27,Qh3,-34,-3,31,1
4r3/pp4pk/2p3p1/7r/1P1Rp3/4P1Pq/P1Q2P1P/5RK1 w - - 1 28,Rfd1,-12,-490,-478,0
4r3/pp4pk/2p3p1/7r/1P1Rp3/4P1Pq/P1Q2P1P/3R2K1 b - - 2 28,Qxh2+,-615,-606,9,1
4r3/pp4pk/2p3p1/7r/1P1Rp3/4P1P1/P1Q2P1q/3R2K1 w - - 0 29,Kf1,-592,-624,-32,1
4r3/pp4pk/2p3p1/7r/1P1Rp3/4P1P1/P1Q2P1q/3R1K2 b - - 1 29,Qh1+,-615,-441,174,1
4r3/pp4pk/2p3p1/7r/1P1Rp3/4P1P1/P1Q2P2/3R1K1q w - - 2 30,Ke2,-443,-449,-6,1
4r3/pp4pk/2p3p1/7r/1P1Rp3/4P1P1/P1Q1KP2/3R3q b - - 3 30,Qf3+,-473,-466,7,1
4r3/pp4pk/2p3p1/7r/1P1Rp3/4PqP1/P1Q1KP2/3R4 w - - 4 31,Kd2,-473,-477,-4,1
4r3/pp4pk/2p3p1/7r/1P1Rp3/4PqP1/P1QK1P2/3R4 b - - 5 31,Rd5,-462,-131,331,1
4r3/pp4pk/2p3p1/3r4/1P1Rp3/4PqP1/P1QK1P2/3R4 w - - 6 32,Kc1,-132,-123,9,1
4r3/pp4pk/2p3p1/3r4/1P1Rp3/4PqP1/P1Q2P2/2KR4 b - - 7 32,Red8,-129,-95,34,1
3r4/pp4pk/2p3p1/3r4/1P1Rp3/4PqP1/P1Q2P2/2KR4 w - - 8 33,Rxd5,-124,-91,33,1
3r4/pp4pk/2p3p1/3R4/1P2p3/4PqP1/P1Q2P2/2KR4 b - - 0 33,Rxd5,-101,-96,5,1
8/pp4pk/2p3p1/3r4/1P2p3/4PqP1/P1Q2P2/2KR4 w - - 0 34,Rxd5,-102,-96,6,1
8/pp4pk/2p3p1/3R4/1P2p3/4PqP1/P1Q2P2/2K5 b - - 0 34,cxd5,-126,-113,13,1
8/pp4pk/6p1/3p4/1P2p3/4PqP1/P1Q2P2/2K5 w - - 0 35,Qd2,-114,-147,-33,1
8/pp4pk/6p1/3p4/1P2p3/4PqP1/P2Q1P2/2K5 b - - 1 35,Qh1+,-155,-144,11,1
8/pp4pk/6p1/3p4/1P2p3/4P1P1/P2Q1P2/2K4q w - - 2 36,Kb2,-112,-114,-2,1
8/pp4pk/6p1/3p4/1P2p3/4P1P1/PK1Q1P2/7q b - - 3 36,Qh5,-151,-101,50,1
8/pp4pk/6p1/3p3q/1P2p3/4P1P1/PK1Q1P2/8 w - - 4 37,a3,-80,-85,-5,1
8/pp4pk/6p1/3p3q/1P2p3/P3P1P1/1K1Q1P2/8 b - - 0 37,Qe5+,-95,-85,10,1
8/pp4pk/6p1/3pq3/1P2p3/P3P1P1/1K1Q1P2/8 w - - 1 38,Kb3,-90,-99,-9,1
8/pp4pk/6p1/3pq3/1P2p3/PK2P1P1/3Q1P2/8 b - - 2 38,b5,-106,-82,24,1
8/p5pk/6p1/1p1pq3/1P2p3/PK2P1P1/3Q1P2/8 w - - 0 39,Qc2,-64,-98,-34,1
8/p5pk/6p1/1p1pq3/1P2p3/PK2P1P1/2Q2P2/8 b - - 1 39,d4,-117,-124,-7,1
8/p5pk/6p1/1p2q3/1P1pp3/PK2P1P1/2Q2P2/8 w - - 0 40,exd4,-128,-120,8,1
8/p5pk/6p1/1p2q3/1P1Pp3/PK4P1/2Q2P2/8 b - - 0 40,Qxd4,-127,-124,3,1
8/p5pk/6p1/1p6/1P1qp3/PK4P1/2Q2P2/8 w - - 0 41,f3,-137,-547,-410,0
8/p5pk/6p1/1p6/1P1qp3/PK3PP1/2Q5/8 b - - 0 41,exf3,-634,-638,-4,1
8/p5pk/6p1/1p6/1P1q4/PK3pP1/2Q5/8 w - - 0 42,a4,-509,-683,-174,0
8/p5pk/6p1/1p6/PP1q4/1K3pP1/2Q5/8 b - - 0 42,Qe3+,-664,-701,-37,1
8/p5pk/6p1/1p6/PP6/1K2qpP1/2Q5/8 w - - 1 43,Ka2,-702,-726,-24,1
8/p5pk/6p1/1p6/PP6/4qpP1/K1Q5/8 b - - 2 43,bxa4,-718,-596,122,1
8/p5pk/6p1/8/pP6/4qpP1/K1Q5/8 w - - 0 44,Qxa4,-573,-708,-135,0
8/p5pk/6p1/8/QP6/4qpP1/K7/8 b - - 0 44,f2,-699,-671,28,1
8/p5pk/6p1/8/QP6/4q1P1/K4p2/8 w - - 0 45,Qd1,-686,-700,-14,1
8/p5pk/6p1/8/1P6/4q1P1/K4p2/3Q4 b - - 1 45,Qe6+,-692,-684,8,1
8/p5pk/4q1p1/8/1P6/6P1/K4p2/3Q4 w - - 2 46,Ka3,-714,-722,-8,1
8/p5pk/4q1p1/8/1P6/K5P1/5p2/3Q4 b - - 3 46,Qe3+,-772,-541,231,1
8/p5pk/6p1/8/1P6/K3q1P1/5p2/3Q4 w - - 4 47,Ka4,-658,-690,-32,1
8/p5pk/6p1/8/KP6/4q1P1/5p2/3Q4 b - - 5 47,Qe8+,-656,-587,69,1
4q3/p5pk/6p1/8/KP6/6P1/5p2/3Q4 w - - 6 48,Ka3,-585,-710,-125,0
4q3/p5pk/6p1/8/1P6/K5P1/5p2/3Q4 b - - 7 48,Qe3+,-726,-630,96,1
8/p5pk/6p1/8/1P6/K3q1P1/5p2/3Q4 w - - 8 49,Ka4,-639,-697,-58,1
8/p5pk/6p1/8/KP6/4q1P1/5p2/3Q4 b - - 9 49,Qxg3,-696,-445,251,1
8/p5pk/6p1/8/KP6/6q1/5p2/3Q4 w - - 0 50,Qh1+,-446,-453,-7,1
8/p5pk/6p1/8/KP6/6q1/5p2/7Q b - - 1 50,Kg8,-497,-461,36,1
6k1/p5p1/6p1/8/KP6/6q1/5p2/7Q w - - 2 51,Qd5+,-507,-460,47,1
6k1/p5p1/6p1/3Q4/KP6/6q1/5p2/8 b - - 3 51,Kh7,-431,-455,-24,1
8/p5pk/6p1/3Q4/KP6/6q1/5p2/8 w - - 4 52,Qh1+,-453,-473,-20,1
8/p5pk/6p1/8/KP6/6q1/5p2/7Q b - - 5 52,Kg8,-466,-465,1,1
6k1/p5p1/6p1/8/KP6/6q1/5p2/7Q w - - 6 53,Qa8+,-497,-536,-39,1
Q5k1/p5p1/6p1/8/KP6/6q1/5p2/8 b - - 7 53,Kh7,-474,-508,-34,1
Q7/p5pk/6p1/8/KP6/6q1/5p2/8 w - - 8 54,Qh1+,-517,-490,27,1
rnbqkbnr/pppppppp/8/8/8/8/PPPPPPPP/RNBQKBNR w KQkq - 0 1,d4,27,23,-4,1
rnbqkbnr/pppppppp/8/8/3P4/8/PPP1PPPP/RNBQKBNR b KQkq - 0 1,e6,26,80,54,1
rnbqkbnr/pppp1ppp/4p3/8/3P4/8/PPP1PPPP/RNBQKBNR w KQkq - 0 2,Nf3,36,25,-11,1
rnbqkbnr/pppp1ppp/4p3/8/3P4/5N2/PPP1PPPP/RNBQKB1R b KQkq - 1 2,Nf6,24,23,-1,1
rnbqkb1r/pppp1ppp/4pn2/8/3P4/5N2/PPP1PPPP/RNBQKB1R w KQkq - 2 3,Bf4,25,15,-10,1
rnbqkb1r/pppp1ppp/4pn2/8/3P1B2/5N2/PPP1PPPP/RN1QKB1R b KQkq - 3 3,Nc6,6,46,40,1
r1bqkb1r/pppp1ppp/2n1pn2/8/3P1B2/5N2/PPP1PPPP/RN1QKB1R w KQkq - 4 4,h3,45,5,-40,1
r1bqkb1r/pppp1ppp/2n1pn2/8/3P1B2/5N1P/PPP1PPP1/RN1QKB1R b KQkq - 0 4,d6,17,44,27,1
r1bqkb1r/ppp2ppp/2nppn2/8/3P1B2/5N1P/PPP1PPP1/RN1QKB1R w KQkq - 0 5,e3,44,37,-7,1
r1bqkb1r/ppp2ppp/2nppn2/8/3P1B2/4PN1P/PPP2PP1/RN1QKB1R b KQkq - 0 5,e5,34,190,156,1
r1bqkb1r/ppp2ppp/2np1n2/4p3/3P1B2/4PN1P/PPP2PP1/RN1QKB1R w KQkq - 0 6,dxe5,176,188,12,1
r1bqkb1r/ppp2ppp/2np1n2/4P3/5B2/4PN1P/PPP2PP1/RN1QKB1R b KQkq - 0 6,dxe5,192,230,38,1
r1bqkb1r/ppp2ppp/2n2n2/4p3/5B2/4PN1P/PPP2PP1/RN1QKB1R w KQkq - 0 7,Qxd8+,223,199,-24,1
r1bQkb1r/ppp2ppp/2n2n2/4p3/5B2/4PN1P/PPP2PP1/RN2KB1R b KQkq - 0 7,Kxd8,212,221,9,1
r1bk1b1r/ppp2ppp/2n2n2/4p3/5B2/4PN1P/PPP2PP1/RN2KB1R w KQ - 0 8,Nxe5,224,218,-6,1
r1bk1b1r/ppp2ppp/2n2n2/4N3/5B2/4P2P/PPP2PP1/RN2KB1R b KQ - 0 8,Nxe5,203,223,20,1
r1bk1b1r/ppp2ppp/5n2/4n3/5B2/4P2P/PPP2PP1/RN2KB1R w KQ - 0 9,Bxe5,221,214,-7,1
r1bk1b1r/ppp2ppp/5n2/4B3/8/4P2P/PPP2PP1/RN2KB1R b KQ - 0 9,Bd6,231,267,36,1
r1bk3r/ppp2ppp/3b1n2/4B3/8/4P2P/PPP2PP1/RN2KB1R w KQ - 1 10,Bxf6+,263,158,-105,0
r1bk3r/ppp2ppp/3b1B2/8/8/4P2P/PPP2PP1/RN2KB1R b KQ - 0 10,gxf6,167,179,12,1
r1bk3r/ppp2p1p/3b1p2/8/8/4P2P/PPP2PP1/RN2KB1R w KQ - 0 11,Nc3,178,160,-18,1
r1bk3r/ppp2p1p/3b1p2/8/8/2N1P2P/PPP2PP1/R3KB1R b KQ - 1 11,Bf5,180,296,116,1
r2k3r/ppp2p1p/3b1p2/5b2/8/2N1P2P/PPP2PP1/R3KB1R w KQ - 2 12,O-O-O,278,274,-4,1
r2k3r/ppp2p1p/3b1p2/5b2/8/2N1P2P/PPP2PP1/2KR1B1R b - - 3 12,Bg6,284,299,15,1
r2k3r/ppp2p1p/3b1pb1/8/8/2N1P2P/PPP2PP1/2KR1B1R w - - 4 13,Bd3,322,270,-52,1
r2k3r/ppp2p1p/3b1pb1/8/8/2NBP2P/PPP2PP1/2KR3R b - - 5 13,Re8,291,347,56,1
r2kr3/ppp2p1p/3b1pb1/8/8/2NBP2P/PPP2PP1/2KR3R w - - 6 14,Nd5,325,300,-25,1
r2kr3/ppp2p1p/3b1pb1/3N4/8/3BP2P/PPP2PP1/2KR3R b - - 7 14,c6,314,379,65,1
r2kr3/pp3p1p/2pb1pb1/3N4/8/3BP2P/PPP2PP1/2KR3R w - - 0 15,Nxf6,464,434,-30,1
r2kr3/pp3p1p/2pb1Nb1/8/8/3BP2P/PPP2PP1/2KR3R b - - 0 15,Re6,451,475,24,1
r2k4/pp3p1p/2pbrNb1/8/8/3BP2P/PPP2PP1/2KR3R w - - 1 16,Bxg6,445,383,-62,1
r2k4/pp3p1p/2pbrNB1/8/8/4P2P/PPP2PP1/2KR3R b - - 0 16,Rxf6,392,443,51,1
r2k4/pp3p1p/2pb1rB1/8/8/4P2P/PPP2PP1/2KR3R w - - 0 17,Bxh7,454,402,-52,1
r2k4/pp3p1B/2pb1r2/8/8/4P2P/PPP2PP1/2KR3R b - - 0 17,Rxf2,416,519,103,1
r2k4/pp3p1B/2pb4/8/8/4P2P/PPP2rP1/2KR3R w - - 0 18,g4,540,220,-320,0
r2k4/pp3p1B/2pb4/8/6P1/4P2P/PPP2r2/2KR3R b - - 0 18,Kc7,247,262,15,1
r7/ppk2p1B/2pb4/8/6P1/4P2P/PPP2r2/2KR3R w - - 1 19,e4,244,174,-70,1
r7/ppk2p1B/2pb4/8/4P1P1/7P/PPP2r2/2KR3R b - - 0 19,Rh8,196,255,59,1
7r/ppk2p1B/2pb4/8/4P1P1/7P/PPP2r2/2KR3R w - - 1 20,Bf5,227,116,-111,0
7r/ppk2p2/2pb4/5B2/4P1P1/7P/PPP2r2/2KR3R b - - 2 20,Bf4+,186,283,97,1
7r/ppk2p2/2p5/5B2/4PbP1/7P/PPP2r2/2KR3R w - - 3 21,Kb1,246,258,12,1
7r/ppk2p2/2p5/5B2/4PbP1/7P/PPP2r2/1K1R3R b - - 4 21,Rd8,244,255,11,1
3r4/ppk2p2/2p5/5B2/4PbP1/7P/PPP2r2/1K1R3R w - - 5 22,Rxd8,264,273,9,1
3R4/ppk2p2/2p5/5B2/4PbP1/7P/PPP2r2/1K5R b - - 0 22,Kxd8,269,276,7,1
3k4/pp3p2/2p5/5B2/4PbP1/7P/PPP2r2/1K5R w - - 0 23,h4,237,258,21,1
3k4/pp3p2/2p5/5B2/4PbPP/8/PPP2r2/1K5R b - - 0 23,b5,244,276,32,1
3k4/p4p2/2p5/1p3B2/4PbPP/8/PPP2r2/1K5R w - - 0 24,h5,278,251,-27,1
3k4/p4p2/2p5/1p3B1P/4PbP1/8/PPP2r2/1K5R b - - 0 24,c5,279,273,-6,1
3k4/p4p2/8/1pp2B1P/4PbP1/8/PPP2r2/1K5R w - - 0 25,a3,281,267,-14,1
3k4/p4p2/8/1pp2B1P/4PbP1/P7/1PP2r2/1K5R b - - 0 25,c4,275,363,88,1
3k4/p4p2/8/1p3B1P/2p1PbP1/P7/1PP2r2/1K5R w - - 0 26,h6,361,373,12,1
3k4/p4p2/7P/1p3B2/2p1PbP1/P7/1PP2r2/1K5R b - - 0 26,Rh2,408,359,-49,1
3k4/p4p2/7P/1p3B2/2p1PbP1/P7/1PP4r/1K5R w - - 1 27,Rxh2,331,303,-28,1
3k4/p4p2/7P/1p3B2/2p1PbP1/P7/1PP4R/1K6 b - - 0 27,Bxh2,319,254,-65,1
3k4/p4p2/7P/1p3B2/2p1P1P1/P7/1PP4b/1K6 w - - 0 28,h7,283,253,-30,1
3k4/p4p1P/8/1p3B2/2p1P1P1/P7/1PP4b/1K6 b - - 0 28,Be5,244,208,-36,1
3k4/p4p1P/8/1p2bB2/2p1P1P1/P7/1PP5/1K6 w - - 1 29,b3,237,157,-80,1
3k4/p4p1P/8/1p2bB2/2p1P1P1/PP6/2P5/1K6 b - - 0 29,Ke7,162,280,118,1
8/p3kp1P/8/1p2bB2/2p1P1P1/PP6/2P5/1K6 w - - 1 30,bxc4,261,112,-149,0
8/p3kp1P/8/1p2bB2/2P1P1P1/P7/2P5/1K6 b - - 0 30,bxc4,179,187,8,1
8/p3kp1P/8/4bB2/2p1P1P1/P7/2P5/1K6 w - - 0 31,a4,209,143,-66,1
8/p3kp1P/8/4bB2/P1p1P1P1/8/2P5/1K6 b - - 0 31,Kf8,131,160,29,1
5k2/p4p1P/8/4bB2/P1p1P1P1/8/2P5/1K6 w - - 1 32,Ka2,217,158,-59,1
5k2/p4p1P/8/4bB2/P1p1P1P1/8/K1P5/8 b - - 2 32,Kg7,137,240,103,1
8/p4pkP/8/4bB2/P1p1P1P1/8/K1P5/8 w - - 3 33,Ka3,283,101,-182,0
8/p4pkP/8/4bB2/P1p1P1P1/K7/2P5/8 b - - 4 33,a5,134,80,-54,1
8/5pkP/8/p3bB2/P1p1P1P1/K7/2P5/8 w - - 0 34,Ka2,84,84,0,1
8/5pkP/8/p3bB2/P1p1P1P1/8/K1P5/8 b - - 1 34,f6,87,155,68,1
8/6kP/5p2/p3bB2/P1p1P1P1/8/K1P5/8 w - - 0 35,Kb1,179,118,-61,1
8/6kP/5p2/p3bB2/P1p1P1P1/8/2P5/1K6 b - - 1 35,Kh8,204,257,53,1
7k/7P/5p2/p3bB2/P1p1P1P1/8/2P5/1K6 w - - 2 36,Kc1,237,246,9,1
7k/7P/5p2/p3bB2/P1p1P1P1/8/2P5/2K5 b - - 3 36,Kg7,267,236,-31,1
8/6kP/5p2/p3bB2/P1p1P1P1/8/2P5/2K5 w - - 4 37,Kd2,278,253,-25,1
8/6kP/5p2/p3bB2/P1p1P1P1/8/2PK4/8 b - - 5 37,Kh8,247,157,-90,1
7k/7P/5p2/p3bB2/P1p1P1P1/8/2PK4/8 w - - 6 38,Ke2,206,203,-3,1
7k/7P/5p2/p3bB2/P1p1P1P1/8/2P1K3/8 b - - 7 38,Kg7,208,317,109,1
8/6kP/5p2/p3bB2/P1p1P1P1/8/2P1K3/8 w - - 8 39,Kf3,301,216,-85,1
8/6kP/5p2/p3bB2/P1p1P1P1/5K2/2P5/8 b - - 9 39,Kh8,216,223,7,1
7k/7P/5p2/p3bB2/P1p1P1P1/5K2/2P5/8 w - - 10 40,Kg2,215,248,33,1
rnbqkbnr/pppppppp/8/8/8/8/PPPPPPPP/RNBQKBNR w KQkq - 0 1,e4,36,36,0,1
rnbqkbnr/pppppppp/8/8/4P3/8/PPPP1PPP/RNBQKBNR b KQkq - 0 1,e5,27,37,10,1
rnbqkbnr/pppp1ppp/8/4p3/4P3/8/PPPP1PPP/RNBQKBNR w KQkq - 0 2,Nf3,34,29,-5,1
rnbqkbnr/pppp1ppp/8/4p3/4P3/5N2/PPPP1PPP/RNBQKB1R b KQkq - 1 2,d6,39,43,4,1
rnbqkbnr/ppp2ppp/3p4/4p3/4P3/5N2/PPPP1PPP/RNBQKB1R w KQkq - 0 3,d4,42,52,10,1
rnbqkbnr/ppp2ppp/3p4/4p3/3PP3/5N2/PPP2PPP/RNBQKB1R b KQkq - 0 3,Qe7,54,117,63,1
rnb1kbnr/ppp1qppp/3p4/4p3/3PP3/5N2/PPP2PPP/RNBQKB1R w KQkq - 1 4,Nc3,114,120,6,1
rnb1kbnr/ppp1qppp/3p4/4p3/3PP3/2N2N2/PPP2PPP/R1BQKB1R b KQkq - 2 4,c6,94,117,23,1
rnb1kbnr/pp2qppp/2pp4/4p3/3PP3/2N2N2/PPP2PPP/R1BQKB1R w KQkq - 0 5,d5,117,89,-28,1
rnb1kbnr/pp2qppp/2pp4/3Pp3/4P3/2N2N2/PPP2PPP/R1BQKB1R b KQkq - 0 5,h6,82,97,15,1
rnb1kbnr/pp2qpp1/2pp3p/3Pp3/4P3/2N2N2/PPP2PPP/R1BQKB1R w KQkq - 0 6,Bc4,99,77,-22,1
rnb1kbnr/pp2qpp1/2pp3p/3Pp3/2B1P3/2N2N2/PPP2PPP/R1BQK2R b KQkq - 1 6,g5,67,180,113,1
rnb1kbnr/pp2qp2/2pp3p/3Pp1p1/2B1P3/2N2N2/PPP2PPP/R1BQK2R w KQkq - 0 7,h3,188,145,-43,1
rnb1kbnr/pp2qp2/2pp3p/3Pp1p1/2B1P3/2N2N1P/PPP2PP1/R1BQK2R b KQkq - 0 7,Bg7,141,148,7,1
rnb1k1nr/pp2qpb1/2pp3p/3Pp1p1/2B1P3/2N2N1P/PPP2PP1/R1BQK2R w KQkq - 1 8,a4,168,158,-10,1
rnb1k1nr/pp2qpb1/2pp3p/3Pp1p1/P1B1P3/2N2N1P/1PP2PP1/R1BQK2R b KQkq - 0 8,Bd7,155,198,43,1
rn2k1nr/pp1bqpb1/2pp3p/3Pp1p1/P1B1P3/2N2N1P/1PP2PP1/R1BQK2R w KQkq - 1 9,Be3,202,180,-22,1
rn2k1nr/pp1bqpb1/2pp3p/3Pp1p1/P1B1P3/2N1BN1P/1PP2PP1/R2QK2R b KQkq - 2 9,Nf6,171,186,15,1
rn2k2r/pp1bqpb1/2pp1n1p/3Pp1p1/P1B1P3/2N1BN1P/1PP2PP1/R2QK2R w KQkq - 3 10,b4,184,171,-13,1
rn2k2r/pp1bqpb1/2pp1n1p/3Pp1p1/PPB1P3/2N1BN1P/2P2PP1/R2QK2R b KQkq - 0 10,O-O,161,131,-30,1
rn3rk1/pp1bqpb1/2pp1n1p/3Pp1p1/PPB1P3/2N1BN1P/2P2PP1/R2QK2R w KQ - 1 11,dxc6,137,16,-121,0
rn3rk1/pp1bqpb1/2Pp1n1p/4p1p1/PPB1P3/2N1BN1P/2P2PP1/R2QK2R b KQ - 0 11,bxc6,19,38,19,1
rn3rk1/p2bqpb1/2pp1n1p/4p1p1/PPB1P3/2N1BN1P/2P2PP1/R2QK2R w KQ - 0 12,O-O,31,22,-9,1
rn3rk1/p2bqpb1/2pp1n1p/4p1p1/PPB1P3/2N1BN1P/2P2PP1/R2Q1RK1 b - - 1 12,Be6,19,27,8,1
rn3rk1/p3qpb1/2ppbn1p/4p1p1/PPB1P3/2N1BN1P/2P2PP1/R2Q1RK1 w - - 2 13,Bd3,19,-28,-47,1
rn3rk1/p3qpb1/2ppbn1p/4p1p1/PP2P3/2NBBN1P/2P2PP1/R2Q1RK1 b - - 3 13,Rd8,-43,-36,7,1
rn1r2k1/p3qpb1/2ppbn1p/4p1p1/PP2P3/2NBBN1P/2P2PP1/R2Q1RK1 w - - 4 14,Qc1,-24,-54,-30,1
rn1r2k1/p3qpb1/2ppbn1p/4p1p1/PP2P3/2NBBN1P/2P2PP1/R1Q2RK1 b - - 5 14,Nh7,-60,68,128,1
rn1r2k1/p3qpbn/2ppb2p/4p1p1/PP2P3/2NBBN1P/2P2PP1/R1Q2RK1 w - - 6 15,b5,67,-51,-118,0
rn1r2k1/p3qpbn/2ppb2p/1P2p1p1/P3P3/2NBBN1P/2P2PP1/R1Q2RK1 b - - 0 15,d5,-57,-57,0,1
rn1r2k1/p3qpbn/2p1b2p/1P1pp1p1/P3P3/2NBBN1P/2P2PP1/R1Q2RK1 w - - 0 16,Ne2,-47,-202,-155,0
rn1r2k1/p3qpbn/2p1b2p/1P1pp1p1/P3P3/3BBN1P/2P1NPP1/R1Q2RK1 b - - 1 16,d4,-201,51,252,1
rn1r2k1/p3qpbn/2p1b2p/1P2p1p1/P2pP3/3BBN1P/2P1NPP1/R1Q2RK1 w - - 0 17,Bd2,38,39,1,1
rn1r2k1/p3qpbn/2p1b2p/1P2p1p1/P2pP3/3B1N1P/2PBNPP1/R1Q2RK1 b - - 1 17,c5,42,91,49,1
rn1r2k1/p3qpbn/4b2p/1Pp1p1p1/P2pP3/3B1N1P/2PBNPP1/R1Q2RK1 w - - 0 18,Qa3,98,3,-95,1
rn1r2k1/p3qpbn/4b2p/1Pp1p1p1/P2pP3/Q2B1N1P/2PBNPP1/R4RK1 b - - 1 18,Qc7,-23,56,79,1
rn1r2k1/p1q2pbn/4b2p/1Pp1p1p1/P2pP3/Q2B1N1P/2PBNPP1/R4RK1 w - - 2 19,c4,78,59,-19,1
rn1r2k1/p1q2pbn/4b2p/1Pp1p1p1/P1PpP3/Q2B1N1P/3BNPP1/R4RK1 b - c3 0 19,Nd7,43,55,12,1
r2r2k1/p1qn1pbn/4b2p/1Pp1p1p1/P1PpP3/Q2B1N1P/3BNPP1/R4RK1 w - - 1 20,a5,61,47,-14,1
r2r2k1/p1qn1pbn/4b2p/PPp1p1p1/2PpP3/Q2B1N1P/3BNPP1/R4RK1 b - - 0 20,Qd6,58,109,51,1
r2r2k1/p2n1pbn/3qb2p/PPp1p1p1/2PpP3/Q2B1N1P/3BNPP1/R4RK1 w - - 1 21,Nc1,92,31,-61,1
r2r2k1/p2n1pbn/3qb2p/PPp1p1p1/2PpP3/Q2B1N1P/3B1PP1/R1N2RK1 b - - 2 21,Qe7,41,61,20,1
r2r2k1/p2nqpbn/4b2p/PPp1p1p1/2PpP3/Q2B1N1P/3B1PP1/R1N2RK1 w - - 3 22,Nb3,64,-56,-120,0
r2r2k1/p2nqpbn/4b2p/PPp1p1p1/2PpP3/QN1B1N1P/3B1PP1/R4RK1 b - - 4 22,g4,-60,82,142,1
r2r2k1/p2nqpbn/4b2p/PPp1p3/2PpP1p1/QN1B1N1P/3B1PP1/R4RK1 w - - 0 23,hxg4,89,67,-22,1
r2r2k1/p2nqpbn/4b2p/PPp1p3/2PpP1P1/QN1B1N2/3B1PP1/R4RK1 b - - 0 23,Bxg4,25,62,37,1
r2r2k1/p2nqpbn/7p/PPp1p3/2PpP1b1/QN1B1N2/3B1PP1/R4RK1 w - - 0 24,Nh2,65,58,-7,1
r2r2k1/p2nqpbn/7p/PPp1p3/2PpP1b1/QN1B4/3B1PPN/R4RK1 b - - 1 24,Be6,56,189,133,1
r2r2k1/p2nqpbn/4b2p/PPp1p3/2PpP3/QN1B4/3B1PPN/R4RK1 w - - 2 25,f3,123,-80,-203,0
r2r2k1/p2nqpbn/4b2p/PPp1p3/2PpP3/QN1B1P2/3B2PN/R4RK1 b - - 0 25,Rdc8,-94,78,172,1
r1r3k1/p2nqpbn/4b2p/PPp1p3/2PpP3/QN1B1P2/3B2PN/R4RK1 w - - 1 26,Ng4,39,-122,-161,0
r1r3k1/p2nqpbn/4b2p/PPp1p3/2PpP1N1/QN1B1P2/3B2P1/R4RK1 b - - 2 26,h5,-115,-70,45,1
r1r3k1/p2nqpbn/4b3/PPp1p2p/2PpP1N1/QN1B1P2/3B2P1/R4RK1 w - - 0 27,Nh6+,-42,-180,-138,0
r1r3k1/p2nqpbn/4b2N/PPp1p2p/2PpP3/QN1B1P2/3B2P1/R4RK1 b - - 1 27,Bxh6,-161,-137,24,1
r1r3k1/p2nqp1n/4b2b/PPp1p2p/2PpP3/QN1B1P2/3B2P1/R4RK1 w - - 0 28,Bxh6,-138,-163,-25,1
r1r3k1/p2nqp1n/4b2B/PPp1p2p/2PpP3/QN1B1P2/6P1/R4RK1 b - - 0 28,Qh4,-142,-57,85,1
r1r3k1/p2n1p1n/4b2B/PPp1p2p/2PpP2q/QN1B1P2/6P1/R4RK1 w - - 1 29,Be3,-37,-432,-395,0
r1r3k1/p2n1p1n/4b3/PPp1p2p/2PpP2q/QN1BBP2/6P1/R4RK1 b - - 2 29,dxe3,-374,-412,-38,1
r1r3k1/p2n1p1n/4b3/PPp1p2p/2P1P2q/QN1BpP2/6P1/R4RK1 w - - 0 30,Rae1,-430,-461,-31,1
r1r3k1/p2n1p1n/4b3/PPp1p2p/2P1P2q/QN1BpP2/6P1/4RRK1 b - - 1 30,Qf4,-477,-358,119,1
r1r3k1/p2n1p1n/4b3/PPp1p2p/2P1Pq2/QN1BpP2/6P1/4RRK1 w - - 2 31,Re2,-424,-466,-42,1
r1r3k1/p2n1p1n/4b3/PPp1p2p/2P1Pq2/QN1BpP2/4R1P1/5RK1 b - - 3 31,Ng5,-421,-392,29,1
r1r3k1/p2n1p2/4b3/PPp1p1np/2P1Pq2/QN1BpP2/4R1P1/5RK1 w - - 4 32,Rfe1,-395,-433,-38,1
r1r3k1/p2n1p2/4b3/PPp1p1np/2P1Pq2/QN1BpP2/4R1P1/4R1K1 b - - 5 32,Qg3,-487,-545,-58,1
r1r3k1/p2n1p2/4b3/PPp1p1np/2P1P3/QN1BpPq1/4R1P1/4R1K1 w - - 6 33,Kh1,-510,-522,-12,1
r1r3k1/p2n1p2/4b3/PPp1p1np/2P1P3/QN1BpPq1/4R1P1/4R2K b - - 7 33,h4,-566,-408,158,1
r1r3k1/p2n1p2/4b3/PPp1p1n1/2P1P2p/QN1BpPq1/4R1P1/4R2K w - - 0 34,Rxe3,-397,-423,-26,1
r1r3k1/p2n1p2/4b3/PPp1p1n1/2P1P2p/QN1BRPq1/6P1/4R2K b - - 0 34,h3,-443,-445,-2,1
r1r3k1/p2n1p2/4b3/PPp1p1n1/2P1P3/QN1BRPqp/6P1/4R2K w - - 0 35,R1e2,-449,-493,-44,1
r1r3k1/p2n1p2/4b3/PPp1p1n1/2P1P3/QN1BRPqp/4R1P1/7K b - - 1 35,Kg7,-480,-504,-24,1
r1r5/p2n1pk1/4b3/PPp1p1n1/2P1P3/QN1BRPqp/4R1P1/7K w - - 2 36,Nd2,-501,-529,-28,1
r1r5/p2n1pk1/4b3/PPp1p1n1/2P1P3/Q2BRPqp/3NR1P1/7K b - - 3 36,Rh8,-469,-494,-25,1
r6r/p2n1pk1/4b3/PPp1p1n1/2P1P3/Q2BRPqp/3NR1P1/7K w - - 4 37,f4,-522,-9998,-9476,0
r6r/p2n1pk1/4b3/PPp1p1n1/2P1PP2/Q2BR1qp/3NR1P1/7K b - - 0 37,hxg2+,-9998,-9999,-1,1
rnbqkbnr/pppppppp/8/8/8/8/PPPPPPPP/RNBQKBNR w KQkq - 0 1,d4,36,21,-15,1
rnbqkbnr/pppppppp/8/8/3P4/8/PPP1PPPP/RNBQKBNR b KQkq - 0 1,c6,22,69,47,1
rnbqkbnr/pp1ppppp/2p5/8/3P4/8/PPP1PPPP/RNBQKBNR w KQkq - 0 2,Nf3,63,37,-26,1
rnbqkbnr/pp1ppppp/2p5/8/3P4/5N2/PPP1PPPP/RNBQKB1R b KQkq - 1 2,d5,16,29,13,1
rnbqkbnr/pp2pppp/2p5/3p4/3P4/5N2/PPP1PPPP/RNBQKB1R w KQkq - 0 3,Bf4,24,25,1,1
rnbqkbnr/pp2pppp/2p5/3p4/3P1B2/5N2/PPP1PPPP/RN1QKB1R b KQkq - 1 3,Nd7,32,67,35,1
r1bqkbnr/pp1npppp/2p5/3p4/3P1B2/5N2/PPP1PPPP/RN1QKB1R w KQkq - 2 4,e3,69,43,-26,1
r1bqkbnr/pp1npppp/2p5/3p4/3P1B2/4PN2/PPP2PPP/RN1QKB1R b KQkq - 0 4,g6,37,68,31,1
r1bqkbnr/pp1npp1p/2p3p1/3p4/3P1B2/4PN2/PPP2PPP/RN1QKB1R w KQkq - 0 5,Bd3,66,44,-22,1
r1bqkbnr/pp1npp1p/2p3p1/3p4/3P1B2/3BPN2/PPP2PPP/RN1QK2R b KQkq - 1 5,Bg7,40,38,-2,1
r1bqk1nr/pp1nppbp/2p3p1/3p4/3P1B2/3BPN2/PPP2PPP/RN1QK2R w KQkq - 2 6,c3,41,43,2,1
r1bqk1nr/pp1nppbp/2p3p1/3p4/3P1B2/2PBPN2/PP3PPP/RN1QK2R b KQkq - 0 6,e6,35,75,40,1
r1bqk1nr/pp1n1pbp/2p1p1p1/3p4/3P1B2/2PBPN2/PP3PPP/RN1QK2R w KQkq - 0 7,Nbd2,72,85,13,1
r1bqk1nr/pp1n1pbp/2p1p1p1/3p4/3P1B2/2PBPN2/PP1N1PPP/R2QK2R b KQkq - 1 7,Ngf6,84,83,-1,1
r1bqk2r/pp1n1pbp/2p1pnp1/3p4/3P1B2/2PBPN2/PP1N1PPP/R2QK2R w KQkq - 2 8,Qc2,73,59,-14,1
r1bqk2r/pp1n1pbp/2p1pnp1/3p4/3P1B2/2PBPN2/PPQN1PPP/R3K2R b KQkq - 3 8,O-O,53,45,-8,1
r1bq1rk1/pp1n1pbp/2p1pnp1/3p4/3P1B2/2PBPN2/PPQN1PPP/R3K2R w KQ - 4 9,h4,44,21,-23,1
r1bq1rk1/pp1n1pbp/2p1pnp1/3p4/3P1B1P/2PBPN2/PPQN1PP1/R3K2R b KQ - 0 9,a5,-2,167,169,1
r1bq1rk1/1p1n1pbp/2p1pnp1/p2p4/3P1B1P/2PBPN2/PPQN1PP1/R3K2R w KQ - 0 10,h5,163,146,-17,1
r1bq1rk1/1p1n1pbp/2p1pnp1/p2p3P/3P1B2/2PBPN2/PPQN1PP1/R3K2R b KQ - 0 10,a4,144,217,73,1
r1bq1rk1/1p1n1pbp/2p1pnp1/3p3P/p2P1B2/2PBPN2/PPQN1PP1/R3K2R w KQ - 0 11,hxg6,210,194,-16,1
r1bq1rk1/1p1n1pbp/2p1pnP1/3p4/p2P1B2/2PBPN2/PPQN1PP1/R3K2R b KQ - 0 11,fxg6,190,204,14,1
r1bq1rk1/1p1n2bp/2p1pnp1/3p4/p2P1B2/2PBPN2/PPQN1PP1/R3K2R w KQ - 0 12,Bxg6,196,94,-102,0
r1bq1rk1/1p1n2bp/2p1pnB1/3p4/p2P1B2/2P1PN2/PPQN1PP1/R3K2R b KQ - 0 12,hxg6,62,70,8,1
r1bq1rk1/1p1n2b1/2p1pnp1/3p4/p2P1B2/2P1PN2/PPQN1PP1/R3K2R w KQ - 0 13,Qxg6,75,74,-1,1
r1bq1rk1/1p1n2b1/2p1pnQ1/3p4/p2P1B2/2P1PN2/PP1N1PP1/R3K2R b KQ - 0 13,Rf7,71,203,132,1
r1bq2k1/1p1n1rb1/2p1pnQ1/3p4/p2P1B2/2P1PN2/PP1N1PP1/R3K2R w KQ - 1 14,Ng5,207,-31,-238,0
r1bq2k1/1p1n1rb1/2p1pnQ1/3p2N1/p2P1B2/2P1P3/PP1N1PP1/R3K2R b KQ - 2 14,Re7,-71,-81,-10,1
r1bq2k1/1p1nr1b1/2p1pnQ1/3p2N1/p2P1B2/2P1P3/PP1N1PP1/R3K2R w KQ - 3 15,Nh7,-66,-102,-36,1
r1bq2k1/1p1nr1bN/2p1pnQ1/3p4/p2P1B2/2P1P3/PP1N1PP1/R3K2R b KQ - 4 15,Qe8,-105,-86,19,1
r1b1q1k1/1p1nr1bN/2p1pnQ1/3p4/p2P1B2/2P1P3/PP1N1PP1/R3K2R w KQ - 5 16,Nxf6+,-84,-93,-9,1
r1b1q1k1/1p1nr1b1/2p1pNQ1/3p4/p2P1B2/2P1P3/PP1N1PP1/R3K2R b KQ - 0 16,Nxf6,-90,-95,-5,1
r1b1q1k1/1p2r1b1/2p1pnQ1/3p4/p2P1B2/2P1P3/PP1N1PP1/R3K2R w KQ - 0 17,Qg5,-102,-84,18,1
r1b1q1k1/1p2r1b1/2p1pn2/3p2Q1/p2P1B2/2P1P3/PP1N1PP1/R3K2R b KQ - 1 17,Nh7,-85,-79,6,1
r1b1q1k1/1p2r1bn/2p1p3/3p2Q1/p2P1B2/2P1P3/PP1N1PP1/R3K2R w KQ - 2 18,Qh4,-88,-114,-26,1
r1b1q1k1/1p2r1bn/2p1p3/3p4/p2P1B1Q/2P1P3/PP1N1PP1/R3K2R b KQ - 3 18,Qg6,-118,366,484,1
r1b3k1/1p2r1bn/2p1p1q1/3p4/p2P1B1Q/2P1P3/PP1N1PP1/R3K2R w KQ - 4 19,Ke2,363,-177,-540,0
r1b3k1/1p2r1bn/2p1p1q1/3p4/p2P1B1Q/2P1P3/PP1NKPP1/R6R b - - 5 19,Bf6,-190,-183,7,1
r1b3k1/1p2r2n/2p1pbq1/3p4/p2P1B1Q/2P1P3/PP1NKPP1/R6R w - - 6 20,Qh3,-181,-447,-266,0
r1b3k1/1p2r2n/2p1pbq1/3p4/p2P1B2/2P1P2Q/PP1NKPP1/R6R b - - 7 20,e5,-451,-397,54,1
r1b3k1/1p2r2n/2p2bq1/3pp3/p2P1B2/2P1P2Q/PP1NKPP1/R6R w - - 0 21,Qh2,-391,-475,-84,1
r1b3k1/1p2r2n/2p2bq1/3pp3/p2P1B2/2P1P3/PP1NKPPQ/R6R b - - 1 21,exf4,-492,-460,32,1
r1b3k1/1p2r2n/2p2bq1/3p4/p2P1p2/2P1P3/PP1NKPPQ/R6R w - - 0 22,Qxf4,-464,-447,17,1
r1b3k1/1p2r2n/2p2bq1/3p4/p2P1Q2/2P1P3/PP1NKPP1/R6R b - - 0 22,Qg4+,-452,-468,-16,1
r1b3k1/1p2r2n/2p2b2/3p4/p2P1Qq1/2P1P3/PP1NKPP1/R6R w - - 1 23,Qxg4+,-475,-484,-9,1
r1b3k1/1p2r2n/2p2b2/3p4/p2P2Q1/2P1P3/PP1NKPP1/R6R b - - 0 23,Bxg4+,-492,-500,-8,1
r5k1/1p2r2n/2p2b2/3p4/p2P2b1/2P1P3/PP1NKPP1/R6R w - - 0 24,f3,-482,-496,-14,1
r5k1/1p2r2n/2p2b2/3p4/p2P2b1/2P1PP2/PP1NK1P1/R6R b - - 0 24,Bf5,-491,-434,57,1
r5k1/1p2r2n/2p2b2/3p1b2/p2P4/2P1PP2/PP1NK1P1/R6R w - - 1 25,g4,-471,-456,15,1
r5k1/1p2r2n/2p2b2/3p1b2/p2P2P1/2P1PP2/PP1NK3/R6R b - - 0 25,Bg6,-455,-451,4,1
r5k1/1p2r2n/2p2bb1/3p4/p2P2P1/2P1PP2/PP1NK3/R6R w - - 1 26,f4,-437,-485,-48,1
r5k1/1p2r2n/2p2bb1/3p4/p2P1PP1/2P1P3/PP1NK3/R6R b - - 0 26,Be4,-496,-312,184,1
r5k1/1p2r2n/2p2b2/3p4/p2PbPP1/2P1P3/PP1NK3/R6R w - - 1 27,Rh2,-316,-402,-86,1
r5k1/1p2r2n/2p2b2/3p4/p2PbPP1/2P1P3/PP1NK2R/R7 b - - 2 27,Rg7,-399,-301,98,1
r5k1/1p4rn/2p2b2/3p4/p2PbPP1/2P1P3/PP1NK2R/R7 w - - 3 28,g5,-326,-360,-34,1
r5k1/1p4rn/2p2b2/3p2P1/p2PbP2/2P1P3/PP1NK2R/R7 b - - 0 28,Be7,-352,-302,50,1
r5k1/1p2b1rn/2p5/3p2P1/p2PbP2/2P1P3/PP1NK2R/R7 w - - 1 29,Rg1,-288,-329,-41,1
r5k1/1p2b1rn/2p5/3p2P1/p2PbP2/2P1P3/PP1NK2R/6R1 b - - 2 29,Bd6,-334,-281,53,1
r5k1/1p4rn/2pb4/3p2P1/p2PbP2/2P1P3/PP1NK2R/6R1 w - - 3 30,Rh6,-280,-307,-27,1
r5k1/1p4rn/2pb3R/3p2P1/p2PbP2/2P1P3/PP1NK3/6R1 b - - 4 30,Rd8,-349,-268,81,1
3r2k1/1p4rn/2pb3R/3p2P1/p2PbP2/2P1P3/PP1NK3/6R1 w - - 5 31,b3,-286,-310,-24,1
3r2k1/1p4rn/2pb3R/3p2P1/p2PbP2/1PP1P3/P2NK3/6R1 b - - 0 31,axb3,-328,-293,35,1
3r2k1/1p4rn/2pb3R/3p2P1/3PbP2/1pP1P3/P2NK3/6R1 w - - 0 32,axb3,-341,-359,-18,1
3r2k1/1p4rn/2pb3R/3p2P1/3PbP2/1PP1P3/3NK3/6R1 b - - 0 32,Rg6,-332,16,348,1
3r2k1/1p5n/2pb2rR/3p2P1/3PbP2/1PP1P3/3NK3/6R1 w - - 1 33,Rh4,-3,-376,-373,0
3r2k1/1p5n/2pb2r1/3p2P1/3PbP1R/1PP1P3/3NK3/6R1 b - - 2 33,Re8,-365,-303,62,1
4r1k1/1p5n/2pb2r1/3p2P1/3PbP1R/1PP1P3/3NK3/6R1 w - - 3 34,c4,-315,-341,-26,1
4r1k1/1p5n/2pb2r1/3p2P1/2PPbP1R/1P2P3/3NK3/6R1 b - - 0 34,dxc4,-344,-264,80,1
4r1k1/1p5n/2pb2r1/6P1/2pPbP1R/1P2P3/3NK3/6R1 w - - 0 35,bxc4,-260,-324,-64,1
4r1k1/1p5n/2pb2r1/6P1/2PPbP1R/4P3/3NK3/6R1 b - - 0 35,Bf5,-313,-355,-42,1
4r1k1/1p5n/2pb2r1/5bP1/2PP1P1R/4P3/3NK3/6R1 w - - 1 36,Nf3,-313,-385,-72,1
4r1k1/1p5n/2pb2r1/5bP1/2PP1P1R/4PN2/4K3/6R1 b - - 2 36,c5,-341,-343,-2,1
4r1k1/1p5n/3b2r1/2p2bP1/2PP1P1R/4PN2/4K3/6R1 w - - 0 37,Ne5,-329,-397,-68,1
4r1k1/1p5n/3b2r1/2p1NbP1/2PP1P1R/4P3/4K3/6R1 b - - 1 37,Bxe5,-388,-347,41,1
4r1k1/1p5n/6r1/2p1bbP1/2PP1P1R/4P3/4K3/6R1 w - - 0 38,dxe5,-377,-388,-11,1
4r1k1/1p5n/6r1/2p1PbP1/2P2P1R/4P3/4K3/6R1 b - - 0 38,Rd8,-387,-277,110,1
3r2k1/1p5n/6r1/2p1PbP1/2P2P1R/4P3/4K3/6R1 w - - 1 39,Kf3,-287,-264,23,1
3r2k1/1p5n/6r1/2p1PbP1/2P2P1R/4PK2/8/6R1 b - - 2 39,Rd3,-254,-237,17,1
6k1/1p5n/6r1/2p1PbP1/2P2P1R/3rPK2/8/6R1 w - - 3 40,Ra1,-279,-310,-31,1
6k1/1p5n/6r1/2p1PbP1/2P2P1R/3rPK2/8/R7 b - - 4 40,Nf8,-298,-257,41,1
5nk1/1p6/6r1/2p1PbP1/2P2P1R/3rPK2/8/R7 w - - 5 41,Ra8,-250,-209,41,1
R4nk1/1p6/6r1/2p1PbP1/2P2P1R/3rPK2/8/8 b - - 6 41,Kf7,-237,-192,45,1
R4n2/1p3k2/6r1/2p1PbP1/2P2P1R/3rPK2/8/8 w - - 7 42,Ke2,-230,-273,-43,1
R4n2/1p3k2/6r1/2p1PbP1/2P2P1R/3rP3/4K3/8 b - - 8 42,Ne6,-303,-301,2,1
R7/1p3k2/4n1r1/2p1PbP1/2P2P1R/3rP3/4K3/8 w - - 9 43,Rh7+,-297,-316,-19,1
R7/1p3k1R/4n1r1/2p1PbP1/2P2P2/3rP3/4K3/8 b - - 10 43,Rg7,-326,-343,-17,1
R7/1p3krR/4n3/2p1PbP1/2P2P2/3rP3/4K3/8 w - - 11 44,Rhh8,-342,-382,-40,1
R6R/1p3kr1/4n3/2p1PbP1/2P2P2/3rP3/4K3/8 b - - 12 44,Nc7,-356,250,606,1
R6R/1pn2kr1/8/2p1PbP1/2P2P2/3rP3/4K3/8 w - - 13 45,Raf8+,268,284,16,1
5R1R/1pn2kr1/8/2p1PbP1/2P2P2/3rP3/4K3/8 b - - 14 45,Kg6,244,9999,9755,1
5R1R/1pn3r1/6k1/2p1PbP1/2P2P2/3rP3/4K3/8 w - - 15 46,Rh6#,9999,10000,1,1
rnbqkbnr/pppppppp/8/8/8/8/PPPPPPPP/RNBQKBNR w KQkq - 0 1,e4,32,22,-10,1
rnbqkbnr/pppppppp/8/8/4P3/8/PPPP1PPP/RNBQKBNR b KQkq - 0 1,c5,22,29,7,1
rnbqkbnr/pp1ppppp/8/2p5/4P3/8/PPPP1PPP/RNBQKBNR w KQkq - 0 2,Nc3,26,11,-15,1
rnbqkbnr/pp1ppppp/8/2p5/4P3/2N5/PPPP1PPP/R1BQKBNR b KQkq - 1 2,Nc6,14,19,5,1
r1bqkbnr/pp1ppppp/2n5/2p5/4P3/2N5/PPPP1PPP/R1BQKBNR w KQkq - 2 3,a3,20,-26,-46,1
r1bqkbnr/pp1ppppp/2n5/2p5/4P3/P1N5/1PPP1PPP/R1BQKBNR b KQkq - 0 3,e6,-19,10,29,1
r1bqkbnr/pp1p1ppp/2n1p3/2p5/4P3/P1N5/1PPP1PPP/R1BQKBNR w KQkq - 0 4,Bc4,9,-54,-63,1
r1bqkbnr/pp1p1ppp/2n1p3/2p5/2B1P3/P1N5/1PPP1PPP/R1BQK1NR b KQkq - 1 4,Nf6,-53,-46,7,1
r1bqkb1r/pp1p1ppp/2n1pn2/2p5/2B1P3/P1N5/1PPP1PPP/R1BQK1NR w KQkq - 2 5,f4,-43,-154,-111,0
r1bqkb1r/pp1p1ppp/2n1pn2/2p5/2B1PP2/P1N5/1PPP2PP/R1BQK1NR b KQkq - 0 5,d5,-160,-118,42,1
r1bqkb1r/pp3ppp/2n1pn2/2pp4/2B1PP2/P1N5/1PPP2PP/R1BQK1NR w KQkq - 0 6,exd5,-134,-166,-32,1
r1bqkb1r/pp3ppp/2n1pn2/2pP4/2B2P2/P1N5/1PPP2PP/R1BQK1NR b KQkq - 0 6,exd5,-162,-181,-19,1
r1bqkb1r/pp3ppp/2n2n2/2pp4/2B2P2/P1N5/1PPP2PP/R1BQK1NR w KQkq - 0 7,Bb5,-184,-146,38,1
r1bqkb1r/pp3ppp/2n2n2/1Bpp4/5P2/P1N5/1PPP2PP/R1BQK1NR b KQkq - 1 7,a6,-154,-87,67,1
r1bqkb1r/1p3ppp/p1n2n2/1Bpp4/5P2/P1N5/1PPP2PP/R1BQK1NR w KQkq - 0 8,Bxc6+,-65,-62,3,1
r1bqkb1r/1p3ppp/p1B2n2/2pp4/5P2/P1N5/1PPP2PP/R1BQK1NR b KQkq - 0 8,bxc6,-82,-76,6,1
r1bqkb1r/5ppp/p1p2n2/2pp4/5P2/P1N5/1PPP2PP/R1BQK1NR w KQkq - 0 9,Nf3,-74,-76,-2,1
r1bqkb1r/5ppp/p1p2n2/2pp4/5P2/P1N2N2/1PPP2PP/R1BQK2R b KQkq - 1 9,Be7,-67,-62,5,1
r1bqk2r/4bppp/p1p2n2/2pp4/5P2/P1N2N2/1PPP2PP/R1BQK2R w KQkq - 2 10,O-O,-63,-60,3,1
r1bqk2r/4bppp/p1p2n2/2pp4/5P2/P1N2N2/1PPP2PP/R1BQ1RK1 b kq - 3 10,O-O,-70,-76,-6,1
r1bq1rk1/4bppp/p1p2n2/2pp4/5P2/P1N2N2/1PPP2PP/R1BQ1RK1 w - - 4 11,Ne5,-56,-79,-23,1
r1bq1rk1/4bppp/p1p2n2/2ppN3/5P2/P1N5/1PPP2PP/R1BQ1RK1 b - - 5 11,Qc7,-83,-62,21,1
r1b2rk1/2q1bppp/p1p2n2/2ppN3/5P2/P1N5/1PPP2PP/R1BQ1RK1 w - - 6 12,a4,-54,-145,-91,1
r1b2rk1/2q1bppp/p1p2n2/2ppN3/P4P2/2N5/1PPP2PP/R1BQ1RK1 b - - 0 12,d4,-147,-52,95,1
r1b2rk1/2q1bppp/p1p2n2/2p1N3/P2p1P2/2N5/1PPP2PP/R1BQ1RK1 w - - 0 13,Ne2,-33,-41,-8,1
r1b2rk1/2q1bppp/p1p2n2/2p1N3/P2p1P2/8/1PPPN1PP/R1BQ1RK1 b - - 1 13,Nd5,-52,-36,16,1
r1b2rk1/2q1bppp/p1p5/2pnN3/P2p1P2/8/1PPPN1PP/R1BQ1RK1 w - - 2 14,Ng3,-42,-84,-42,1
r1b2rk1/2q1bppp/p1p5/2pnN3/P2p1P2/6N1/1PPP2PP/R1BQ1RK1 b - - 3 14,f6,-97,-61,36,1
r1b2rk1/2q1b1pp/p1p2p2/2pnN3/P2p1P2/6N1/1PPP2PP/R1BQ1RK1 w - - 0 15,c4,-65,-347,-282,0
r1b2rk1/2q1b1pp/p1p2p2/2pnN3/P1Pp1P2/6N1/1P1P2PP/R1BQ1RK1 b - c3 0 15,fxe5,-313,-317,-4,1
r1b2rk1/2q1b1pp/p1p5/2pnp3/P1Pp1P2/6N1/1P1P2PP/R1BQ1RK1 w - - 0 16,cxd5,-310,-299,11,1
r1b2rk1/2q1b1pp/p1p5/2pPp3/P2p1P2/6N1/1P1P2PP/R1BQ1RK1 b - - 0 16,exf4,-353,-340,13,1
r1b2rk1/2q1b1pp/p1p5/2pP4/P2p1p2/6N1/1P1P2PP/R1BQ1RK1 w - - 0 17,Ne4,-333,-424,-91,1
r1b2rk1/2q1b1pp/p1p5/2pP4/P2pNp2/8/1P1P2PP/R1BQ1RK1 b - - 1 17,cxd5,-428,-433,-5,1
r1b2rk1/2q1b1pp/p7/2pp4/P2pNp2/8/1P1P2PP/R1BQ1RK1 w - - 0 18,Nf2,-438,-488,-50,1
r1b2rk1/2q1b1pp/p7/2pp4/P2p1p2/8/1P1P1NPP/R1BQ1RK1 b - - 1 18,Bd6,-505,-377,128,1
r1b2rk1/2q3pp/p2b4/2pp4/P2p1p2/8/1P1P1NPP/R1BQ1RK1 w - - 2 19,Nd3,-351,-462,-111,0
r1b2rk1/2q3pp/p2b4/2pp4/P2p1p2/3N4/1P1P2PP/R1BQ1RK1 b - - 3 19,c4,-531,-452,79,1
r1b2rk1/2q3pp/p2b4/3p4/P1pp1p2/3N4/1P1P2PP/R1BQ1RK1 w - - 0 20,Nxf4,-498,-516,-18,1
r1b2rk1/2q3pp/p2b4/3p4/P1pp1N2/8/1P1P2PP/R1BQ1RK1 b - - 0 20,Bxf4,-527,-530,-3,1
r1b2rk1/2q3pp/p7/3p4/P1pp1b2/8/1P1P2PP/R1BQ1RK1 w - - 0 21,d3,-509,-610,-101,0
r1b2rk1/2q3pp/p7/3p4/P1pp1b2/3P4/1P4PP/R1BQ1RK1 b - - 0 21,Bxc1,-658,-401,257,1
r1b2rk1/2q3pp/p7/3p4/P1pp4/3P4/1P4PP/R1bQ1RK1 w - - 0 22,Rxf8+,-463,-481,-18,1
r1b2Rk1/2q3pp/p7/3p4/P1pp4/3P4/1P4PP/R1bQ2K1 b - - 0 22,Kxf8,-479,-481,-2,1
r1b2k2/2q3pp/p7/3p4/P1pp4/3P4/1P4PP/R1bQ2K1 w - - 0 23,Rxc1,-466,-441,25,1
r1b2k2/2q3pp/p7/3p4/P1pp4/3P4/1P4PP/2RQ2K1 b - - 0 23,Bb7,-457,-428,29,1
r4k2/1bq3pp/p7/3p4/P1pp4/3P4/1P4PP/2RQ2K1 w - - 1 24,Qh5,-407,-492,-85,1
r4k2/1bq3pp/p7/3p3Q/P1pp4/3P4/1P4PP/2R3K1 b - - 2 24,Kg8,-497,-491,6,1
r5k1/1bq3pp/p7/3p3Q/P1pp4/3P4/1P4PP/2R3K1 w - - 3 25,Re1,-501,-452,49,1
r5k1/1bq3pp/p7/3p3Q/P1pp4/3P4/1P4PP/4R1K1 b - - 4 25,Rf8,-482,-467,15,1
5rk1/1bq3pp/p7/3p3Q/P1pp4/3P4/1P4PP/4R1K1 w - - 5 26,Re8,-473,-490,-17,1
4Rrk1/1bq3pp/p7/3p3Q/P1pp4/3P4/1P4PP/6K1 b - - 6 26,Qf7,-485,-491,-6,1
4Rrk1/1b3qpp/p7/3p3Q/P1pp4/3P4/1P4PP/6K1 w - - 7 27,Rxf8+,-474,-472,2,1
5Rk1/1b3qpp/p7/3p3Q/P1pp4/3P4/1P4PP/6K1 b - - 0 27,Kxf8,-471,-477,-6,1
5k2/1b3qpp/p7/3p3Q/P1pp4/3P4/1P4PP/6K1 w - - 0 28,Qe2,-479,-553,-74,1
5k2/1b3qpp/p7/3p4/P1pp4/3P4/1P2Q1PP/6K1 b - - 1 28,Bc6,-563,-519,44,1
5k2/5qpp/p1b5/3p4/P1pp4/3P4/1P2Q1PP/6K1 w - - 2 29,Qg4,-487,-493,-6,1
5k2/5qpp/p1b5/3p4/P1pp2Q1/3P4/1P4PP/6K1 b - - 3 29,Bxa4,-493,-448,45,1
5k2/5qpp/p7/3p4/b1pp2Q1/3P4/1P4PP/6K1 w - - 0 30,Qc8+,-430,-501,-71,1
2Q2k2/5qpp/p7/3p4/b1pp4/3P4/1P4PP/6K1 b - - 1 30,Be8,-533,-512,21,1
2Q1bk2/5qpp/p7/3p4/2pp4/3P4/1P4PP/6K1 w - - 2 31,Qxa6,-543,-561,-18,1
4bk2/5qpp/Q7/3p4/2pp4/3P4/1P4PP/6K1 b - - 0 31,Kg8,-561,-487,74,1
4b1k1/5qpp/Q7/3p4/2pp4/3P4/1P4PP/6K1 w - - 1 32,Qd6,-536,-554,-18,1
4b1k1/5qpp/3Q4/3p4/2pp4/3P4/1P4PP/6K1 b - - 2 32,h6,-622,-546,76,1
4b1k1/5qp1/3Q3p/3p4/2pp4/3P4/1P4PP/6K1 w - - 0 33,Qc5,-554,-552,2,1
4b1k1/5qp1/7p/2Qp4/2pp4/3P4/1P4PP/6K1 b - - 1 33,Qe6,-558,-596,-38,1
4b1k1/6p1/4q2p/2Qp4/2pp4/3P4/1P4PP/6K1 w - - 2 34,Kf2,-614,-597,17,1
4b1k1/6p1/4q2p/2Qp4/2pp4/3P4/1P3KPP/8 b - - 3 34,Qe3+,-670,-677,-7,1
4b1k1/6p1/7p/2Qp4/2pp4/3Pq3/1P3KPP/8 w - - 4 35,Kf1,-668,-686,-18,1
4b1k1/6p1/7p/2Qp4/2pp4/3Pq3/1P4PP/5K2 b - - 5 35,Qxd3+,-666,-729,-63,1
4b1k1/6p1/7p/2Qp4/2pp4/3q4/1P4PP/5K2 w - - 0 36,Ke1,-703,-752,-49,1
4b1k1/6p1/7p/2Qp4/2pp4/3q4/1P4PP/4K3 b - - 1 36,Qe3+,-770,-808,-38,1
4b1k1/6p1/7p/2Qp4/2pp4/4q3/1P4PP/4K3 w - - 2 37,Kd1,-763,-9998,-9235,0
4b1k1/6p1/7p/2Qp4/2pp4/4q3/1P4PP/3K4 b - - 3 37,Bf7,-9998,-678,9320,1
6k1/5bp1/7p/2Qp4/2pp4/4q3/1P4PP/3K4 w - - 4 38,Qc8+,-675,-708,-33,1
2Q3k1/5bp1/7p/3p4/2pp4/4q3/1P4PP/3K4 b - - 5 38,Kh7,-694,-686,8,1
2Q5/5bpk/7p/3p4/2pp4/4q3/1P4PP/3K4 w - - 6 39,h4,-709,-742,-33,1
2Q5/5bpk/7p/3p4/2pp3P/4q3/1P4P1/3K4 b - - 0 39,Qd3+,-770,-735,35,1
2Q5/5bpk/7p/3p4/2pp3P/3q4/1P4P1/3K4 w - - 1 40,Kc1,-820,-9997,-9177,0
2Q5/5bpk/7p/3p4/2pp3P/3q4/1P4P1/2K5 b - - 2 40,c3,-9997,-849,9148,1
2Q5/5bpk/7p/3p4/3p3P/2pq4/1P4P1/2K5 w - - 0 41,g4,-865,-9998,-9133,0
2Q5/5bpk/7p/3p4/3p2PP/2pq4/1P6/2K5 b - - 0 41,Qd2+,-9998,-9999,-1,1
2Q5/5bpk/7p/3p4/3p2PP/2p5/1P1q4/2K5 w - - 1 42,Kb1,-9999,-9999,0,1
2Q5/5bpk/7p/3p4/3p2PP/2p5/1P1q4/1K6 b - - 2 42,Qxb2#,-9999,-10000,-1,1
rnbqkbnr/pppppppp/8/8/8/8/PPPPPPPP/RNBQKBNR w KQkq - 0 1,e4,23,22,-1,1
rnbqkbnr/pppppppp/8/8/4P3/8/PPPP1PPP/RNBQKBNR b KQkq - 0 1,d5,26,77,51,1
rnbqkbnr/ppp1pppp/8/3p4/4P3/8/PPPP1PPP/RNBQKBNR w KQkq - 0 2,Nf3,69,-113,-182,0
rnbqkbnr/ppp1pppp/8/3p4/4P3/5N2/PPPP1PPP/RNBQKB1R b KQkq - 1 2,dxe4,-111,-110,1,1
rnbqkbnr/ppp1pppp/8/8/4p3/5N2/PPPP1PPP/RNBQKB1R w KQkq - 0 3,Ne5,-84,-135,-51,1
rnbqkbnr/ppp1pppp/8/4N3/4p3/8/PPPP1PPP/RNBQKB1R b KQkq - 1 3,Nf6,-132,-86,46,1
rnbqkb1r/ppp1pppp/5n2/4N3/4p3/8/PPPP1PPP/RNBQKB1R w KQkq - 2 4,Qe2,-101,-189,-88,1
rnbqkb1r/ppp1pppp/5n2/4N3/4p3/8/PPPPQPPP/RNB1KB1R b KQkq - 3 4,Bf5,-179,36,215,1
rn1qkb1r/ppp1pppp/5n2/4Nb2/4p3/8/PPPPQPPP/RNB1KB1R w KQkq - 4 5,Qb5+,69,11,-58,1
rn1qkb1r/ppp1pppp/5n2/1Q2Nb2/4p3/8/PPPP1PPP/RNB1KB1R b KQkq - 5 5,Bd7,35,291,256,1
rn1qkb1r/pppbpppp/5n2/1Q2N3/4p3/8/PPPP1PPP/RNB1KB1R w KQkq - 6 6,Qb3,299,13,-286,0
rn1qkb1r/pppbpppp/5n2/4N3/4p3/1Q6/PPPP1PPP/RNB1KB1R b KQkq - 7 6,b6,-6,9999,10005,1
rn1qkb1r/p1pbpppp/1p3n2/4N3/4p3/1Q6/PPPP1PPP/RNB1KB1R w KQkq - 0 7,Qxf7#,9999,10000,1,1
rnbqkbnr/pppppppp/8/8/8/8/PPPPPPPP/RNBQKBNR w KQkq - 0 1,e3,31,13,-18,1
rnbqkbnr/pppppppp/8/8/8/4P3/PPPP1PPP/RNBQKBNR b KQkq - 0 1,d5,2,7,5,1
rnbqkbnr/ppp1pppp/8/3p4/8/4P3/PPPP1PPP/RNBQKBNR w KQkq - 0 2,g4,11,-142,-153,0
rnbqkbnr/ppp1pppp/8/3p4/6P1/4P3/PPPP1P1P/RNBQKBNR b KQkq - 0 2,Nf6,-145,-44,101,1
rnbqkb1r/ppp1pppp/5n2/3p4/6P1/4P3/PPPP1P1P/RNBQKBNR w KQkq - 1 3,h3,-36,-90,-54,1
rnbqkb1r/ppp1pppp/5n2/3p4/6P1/4P2P/PPPP1P2/RNBQKBNR b KQkq - 0 3,h5,-96,-70,26,1
rnbqkb1r/ppp1ppp1/5n2/3p3p/6P1/4P2P/PPPP1P2/RNBQKBNR w KQkq - 0 4,Nc3,-71,-254,-183,0
rnbqkb1r/ppp1ppp1/5n2/3p3p/6P1/2N1P2P/PPPP1P2/R1BQKBNR b KQkq - 1 4,hxg4,-235,-244,-9,1
rnbqkb1r/ppp1ppp1/5n2/3p4/6p1/2N1P2P/PPPP1P2/R1BQKBNR w KQkq - 0 5,f3,-251,-307,-56,1
rnbqkb1r/ppp1ppp1/5n2/3p4/6p1/2N1PP1P/PPPP4/R1BQKBNR b KQkq - 0 5,gxh3,-302,-276,26,1
rnbqkb1r/ppp1ppp1/5n2/3p4/8/2N1PP1p/PPPP4/R1BQKBNR w KQkq - 0 6,Bxh3,-265,-333,-68,1
rnbqkb1r/ppp1ppp1/5n2/3p4/8/2N1PP1B/PPPP4/R1BQK1NR b KQkq - 0 6,Bxh3,-308,-311,-3,1
rn1qkb1r/ppp1ppp1/5n2/3p4/8/2N1PP1b/PPPP4/R1BQK1NR w KQkq - 0 7,Nxh3,-287,-368,-81,1
rn1qkb1r/ppp1ppp1/5n2/3p4/8/2N1PP1N/PPPP4/R1BQK2R b KQkq - 0 7,d4,-370,-335,35,1
rn1qkb1r/ppp1ppp1/5n2/8/3p4/2N1PP1N/PPPP4/R1BQK2R w KQkq - 0 8,Nf2,-301,-584,-283,0
rn1qkb1r/ppp1ppp1/5n2/8/3p4/2N1PP2/PPPP1N2/R1BQK2R b KQkq - 1 8,dxe3,-560,4,564,1
rn1qkb1r/ppp1ppp1/5n2/8/8/2N1pP2/PPPP1N2/R1BQK2R w KQkq - 0 9,dxe3,14,-200,-214,0
rn1qkb1r/ppp1ppp1/5n2/8/8/2N1PP2/PPP2N2/R1BQK2R b KQkq - 0 9,Qxd1+,-190,-162,28,1
rn2kb1r/ppp1ppp1/5n2/8/8/2N1PP2/PPP2N2/R1BqK2R w KQkq - 0 10,Kxd1,-184,-176,8,1
rn2kb1r/ppp1ppp1/5n2/8/8/2N1PP2/PPP2N2/R1BK3R b kq - 0 10,Nc6,-175,403,578,1
r3kb1r/ppp1ppp1/2n2n2/8/8/2N1PP2/PPP2N2/R1BK3R w kq - 1 11,Rxh8,424,407,-17,1
r3kb1R/ppp1ppp1/2n2n2/8/8/2N1PP2/PPP2N2/R1BK4 b q - 0 11,O-O-O+,438,432,-6,1
2kr1b1R/ppp1ppp1/2n2n2/8/8/2N1PP2/PPP2N2/R1BK4 w - - 1 12,Bd2,436,400,-36,1
2kr1b1R/ppp1ppp1/2n2n2/8/8/2N1PP2/PPPB1N2/R2K4 b - - 2 12,Nd5,412,534,122,1
2kr1b1R/ppp1ppp1/2n5/3n4/8/2N1PP2/PPPB1N2/R2K4 w - - 3 13,e4,532,310,-222,0
2kr1b1R/ppp1ppp1/2n5/3n4/4P3/2N2P2/PPPB1N2/R2K4 b - - 0 13,Nxc3+,286,416,130,1
2kr1b1R/ppp1ppp1/2n5/8/4P3/2n2P2/PPPB1N2/R2K4 w - - 0 14,bxc3,440,424,-16,1
2kr1b1R/ppp1ppp1/2n5/8/4P3/2P2P2/P1PB1N2/R2K4 b - - 0 14,e6,393,428,35,1
2kr1b1R/ppp2pp1/2n1p3/8/4P3/2P2P2/P1PB1N2/R2K4 w - - 0 15,f4,440,433,-7,1
2kr1b1R/ppp2pp1/2n1p3/8/4PP2/2P5/P1PB1N2/R2K4 b - - 0 15,Be7,458,474,16,1
2kr3R/ppp1bpp1/2n1p3/8/4PP2/2P5/P1PB1N2/R2K4 w - - 1 16,e5,483,-246,-729,0
2kr3R/ppp1bpp1/2n1p3/4P3/5P2/2P5/P1PB1N2/R2K4 b - - 0 16,Rxh8,-269,-273,-4,1
2k4r/ppp1bpp1/2n1p3/4P3/5P2/2P5/P1PB1N2/R2K4 w - - 0 17,Ke2,-279,-256,23,1
2k4r/ppp1bpp1/2n1p3/4P3/5P2/2P5/P1PBKN2/R7 b - - 1 17,Bc5,-254,-250,4,1
2k4r/ppp2pp1/2n1p3/2b1P3/5P2/2P5/P1PBKN2/R7 w - - 2 18,Ne4,-238,-217,21,1
2k4r/ppp2pp1/2n1p3/2b1P3/4NP2/2P5/P1PBK3/R7 b - - 3 18,Rh2+,-238,-243,-5,1
2k5/ppp2pp1/2n1p3/2b1P3/4NP2/2P5/P1PBK2r/R7 w - - 4 19,Kd3,-248,-254,-6,1
2k5/ppp2pp1/2n1p3/2b1P3/4NP2/2PK4/P1PB3r/R7 b - - 5 19,Be7,-252,-254,-2,1
2k5/ppp1bpp1/2n1p3/4P3/4NP2/2PK4/P1PB3r/R7 w - - 6 20,Rb1,-242,-289,-47,1
2k5/ppp1bpp1/2n1p3/4P3/4NP2/2PK4/P1PB3r/1R6 b - - 7 20,b6,-275,-241,34,1
2k5/p1p1bpp1/1pn1p3/4P3/4NP2/2PK4/P1PB3r/1R6 w - - 0 21,c4,-269,-334,-65,1
2k5/p1p1bpp1/1pn1p3/4P3/2P1NP2/3K4/P1PB3r/1R6 b - - 0 21,Rh3+,-327,-294,33,1
2k5/p1p1bpp1/1pn1p3/4P3/2P1NP2/3K3r/P1PB4/1R6 w - - 1 22,Be3,-316,-351,-35,1
2k5/p1p1bpp1/1pn1p3/4P3/2P1NP2/3KB2r/P1P5/1R6 b - - 2 22,Bc5,-345,-182,163,1
2k5/p1p2pp1/1pn1p3/2b1P3/2P1NP2/3KB2r/P1P5/1R6 w - - 3 23,Nxc5,-170,-193,-23,1
2k5/p1p2pp1/1pn1p3/2N1P3/2P2P2/3KB2r/P1P5/1R6 b - - 0 23,bxc5,-204,-176,28,1
2k5/p1p2pp1/2n1p3/2p1P3/2P2P2/3KB2r/P1P5/1R6 w - - 0 24,Rg1,-179,-286,-107,0
2k5/p1p2pp1/2n1p3/2p1P3/2P2P2/3KB2r/P1P5/6R1 b - - 1 24,Nb4+,-262,-172,90,1
2k5/p1p2pp1/4p3/2p1P3/1nP2P2/3KB2r/P1P5/6R1 w - - 2 25,Ke4,-148,-215,-67,1
2k5/p1p2pp1/4p3/2p1P3/1nP1KP2/4B2r/P1P5/6R1 b - - 3 25,Nxc2,-270,-130,140,1
2k5/p1p2pp1/4p3/2p1P3/2P1KP2/4B2r/P1n5/6R1 w - - 0 26,Bxc5,-112,-111,1,1
2k5/p1p2pp1/4p3/2B1P3/2P1KP2/7r/P1n5/6R1 b - - 0 26,Kd7,-118,-1,117,1
8/p1pk1pp1/4p3/2B1P3/2P1KP2/7r/P1n5/6R1 w - - 1 27,Rxg7,0,3,3,1
8/p1pk1pR1/4p3/2B1P3/2P1KP2/7r/P1n5/8 b - - 0 27,Kd8,5,9,4,1
3k4/p1p2pR1/4p3/2B1P3/2P1KP2/7r/P1n5/8 w - - 1 28,Rxf7,9,0,-9,1
3k4/p1p2R2/4p3/2B1P3/2P1KP2/7r/P1n5/8 b - - 0 28,Ke8,6,388,382,1
4k3/p1p2R2/4p3/2B1P3/2P1KP2/7r/P1n5/8 w - - 1 29,Rf6,428,225,-203,0
4k3/p1p5/4pR2/2B1P3/2P1KP2/7r/P1n5/8 b - - 2 29,a6,287,474,187,1
4k3/2p5/p3pR2/2B1P3/2P1KP2/7r/P1n5/8 w - - 0 30,Rf8+,489,80,-409,0
4kR2/2p5/p3p3/2B1P3/2P1KP2/7r/P1n5/8 b - - 1 30,Kd7,36,131,95,1
5R2/2pk4/p3p3/2B1P3/2P1KP2/7r/P1n5/8 w - - 2 31,Rf7+,143,128,-15,1
8/2pk1R2/p3p3/2B1P3/2P1KP2/7r/P1n5/8 b - - 3 31,Kc6,133,141,8,1
8/2p2R2/p1k1p3/2B1P3/2P1KP2/7r/P1n5/8 w - - 4 32,Bg1,148,37,-111,0
8/2p2R2/p1k1p3/4P3/2P1KP2/7r/P1n5/6B1 b - - 5 32,a5,33,147,114,1
8/2p2R2/2k1p3/p3P3/2P1KP2/7r/P1n5/6B1 w - - 0 33,c5,144,1,-143,0
8/2p2R2/2k1p3/p1P1P3/4KP2/7r/P1n5/6B1 b - - 0 33,Nb4,0,17,17,1
8/2p2R2/2k1p3/p1P1P3/1n2KP2/7r/P7/6B1 w - - 1 34,Bd4,22,-21,-43,1
8/2p2R2/2k1p3/p1P1P3/1n1BKP2/7r/P7/8 b - - 2 34,Nxa2,-24,161,185,1
8/2p2R2/2k1p3/p1P1P3/3BKP2/7r/n7/8 w - - 0 35,f5,147,-83,-230,0
8/2p2R2/2k1p3/p1P1PP2/3BK3/7r/n7/8 b - - 0 35,exf5+,-92,0,92,1
8/2p2R2/2k5/p1P1Pp2/3BK3/7r/n7/8 w - - 0 36,Kxf5,0,0,0,1
8/2p2R2/2k5/p1P1PK2/3B4/7r/n7/8 b - - 0 36,Rh5+,0,8,8,1
8/2p2R2/2k5/p1P1PK1r/3B4/8/n7/8 w - - 1 37,Kf6,5,-9,-14,1
8/2p2R2/2k2K2/p1P1P2r/3B4/8/n7/8 b - - 2 37,Rh6+,-16,10,26,1
rnbqkbnr/pppppppp/8/8/8/8/PPPPPPPP/RNBQKBNR w KQkq - 0 1,d4,34,20,-14,1
rnbqkbnr/pppppppp/8/8/3P4/8/PPP1PPPP/RNBQKBNR b KQkq - 0 1,e6,22,45,23,1
rnbqkbnr/pppp1ppp/4p3/8/3P4/8/PPP1PPPP/RNBQKBNR w KQkq - 0 2,c4,64,23,-41,1
rnbqkbnr/pppp1ppp/4p3/8/2PP4/8/PP2PPPP/RNBQKBNR b KQkq - 0 2,c6,16,59,43,1
rnbqkbnr/pp1p1ppp/2p1p3/8/2PP4/8/PP2PPPP/RNBQKBNR w KQkq - 0 3,Nc3,53,30,-23,1
rnbqkbnr/pp1p1ppp/2p1p3/8/2PP4/2N5/PP2PPPP/R1BQKBNR b KQkq - 1 3,a6,16,144,128,1
rnbqkbnr/1p1p1ppp/p1p1p3/8/2PP4/2N5/PP2PPPP/R1BQKBNR w KQkq - 0 4,e4,120,129,9,1
rnbqkbnr/1p1p1ppp/p1p1p3/8/2PPP3/2N5/PP3PPP/R1BQKBNR b KQkq - 0 4,h6,93,157,64,1
rnbqkbnr/1p1p1pp1/p1p1p2p/8/2PPP3/2N5/PP3PPP/R1BQKBNR w KQkq - 0 5,e5,141,126,-15,1
rnbqkbnr/1p1p1pp1/p1p1p2p/4P3/2PP4/2N5/PP3PPP/R1BQKBNR b KQkq - 0 5,d6,119,127,8,1
rnbqkbnr/1p3pp1/p1ppp2p/4P3/2PP4/2N5/PP3PPP/R1BQKBNR w KQkq - 0 6,f4,117,126,9,1
rnbqkbnr/1p3pp1/p1ppp2p/4P3/2PP1P2/2N5/PP4PP/R1BQKBNR b KQkq - 0 6,dxe5,129,165,36,1
rnbqkbnr/1p3pp1/p1p1p2p/4p3/2PP1P2/2N5/PP4PP/R1BQKBNR w KQkq - 0 7,dxe5,177,42,-135,0
rnbqkbnr/1p3pp1/p1p1p2p/4P3/2P2P2/2N5/PP4PP/R1BQKBNR b KQkq - 0 7,Qxd1+,61,57,-4,1
rnb1kbnr/1p3pp1/p1p1p2p/4P3/2P2P2/2N5/PP4PP/R1BqKBNR w KQkq - 0 8,Nxd1,68,14,-54,1
rnb1kbnr/1p3pp1/p1p1p2p/4P3/2P2P2/8/PP4PP/R1BNKBNR b KQkq - 0 8,Bb4+,12,48,36,1
rnb1k1nr/1p3pp1/p1p1p2p/4P3/1bP2P2/8/PP4PP/R1BNKBNR w KQkq - 1 9,Bd2,50,44,-6,1
rnb1k1nr/1p3pp1/p1p1p2p/4P3/1bP2P2/8/PP1B2PP/R2NKBNR b KQkq - 2 9,Bxd2+,46,7,-39,1
rnb1k1nr/1p3pp1/p1p1p2p/4P3/2P2P2/8/PP1b2PP/R2NKBNR w KQkq - 0 10,Kxd2,15,18,3,1
rnb1k1nr/1p3pp1/p1p1p2p/4P3/2P2P2/8/PP1K2PP/R2N1BNR b kq - 0 10,Ne7,18,24,6,1
rnb1k2r/1p2npp1/p1p1p2p/4P3/2P2P2/8/PP1K2PP/R2N1BNR w kq - 1 11,Ne3,25,-32,-57,1
rnb1k2r/1p2npp1/p1p1p2p/4P3/2P2P2/4N3/PP1K2PP/R4BNR b kq - 2 11,O-O,-24,35,59,1
rnb2rk1/1p2npp1/p1p1p2p/4P3/2P2P2/4N3/PP1K2PP/R4BNR w - - 3 12,Bd3,37,22,-15,1
rnb2rk1/1p2npp1/p1p1p2p/4P3/2P2P2/3BN3/PP1K2PP/R5NR b - - 4 12,Rd8,27,44,17,1
rnbr2k1/1p2npp1/p1p1p2p/4P3/2P2P2/3BN3/PP1K2PP/R5NR w - - 5 13,Kc2,48,-13,-61,1
rnbr2k1/1p2npp1/p1p1p2p/4P3/2P2P2/3BN3/PPK3PP/R5NR b - - 6 13,b5,-11,10,21,1
rnbr2k1/4npp1/p1p1p2p/1p2P3/2P2P2/3BN3/PPK3PP/R5NR w - - 0 14,cxb5,3,-41,-44,1
rnbr2k1/4npp1/p1p1p2p/1P2P3/5P2/3BN3/PPK3PP/R5NR b - - 0 14,cxb5,-29,-49,-20,1
rnbr2k1/4npp1/p3p2p/1p2P3/5P2/3BN3/PPK3PP/R5NR w - - 0 15,Ne2,-23,-116,-93,1
rnbr2k1/4npp1/p3p2p/1p2P3/5P2/3BN3/PPK1N1PP/R6R b - - 1 15,Ra7,-106,16,122,1
1nbr2k1/r3npp1/p3p2p/1p2P3/5P2/3BN3/PPK1N1PP/R6R w - - 2 16,Rhd1,17,-36,-53,1
1nbr2k1/r3npp1/p3p2p/1p2P3/5P2/3BN3/PPK1N1PP/R2R4 b - - 3 16,Rc7+,-18,-19,-1,1
1nbr2k1/2r1npp1/p3p2p/1p2P3/5P2/3BN3/PPK1N1PP/R2R4 w - - 4 17,Kb3,-16,-23,-7,1
1nbr2k1/2r1npp1/p3p2p/1p2P3/5P2/1K1BN3/PP2N1PP/R2R4 b - - 5 17,Nd5,-19,46,65,1
1nbr2k1/2r2pp1/p3p2p/1p1nP3/5P2/1K1BN3/PP2N1PP/R2R4 w - - 6 18,Nxd5,55,20,-35,1
1nbr2k1/2r2pp1/p3p2p/1p1NP3/5P2/1K1B4/PP2N1PP/R2R4 b - - 0 18,Rxd5,28,23,-5,1
1nb3k1/2r2pp1/p3p2p/1p1rP3/5P2/1K1B4/PP2N1PP/R2R4 w - - 0 19,Be4,22,0,-22,1
1nb3k1/2r2pp1/p3p2p/1p1rP3/4BP2/1K6/PP2N1PP/R2R4 b - - 1 19,Rdd7,0,168,168,1
1nb3k1/2rr1pp1/p3p2p/1p2P3/4BP2/1K6/PP2N1PP/R2R4 w - - 2 20,g4,117,0,-117,0
1nb3k1/2rr1pp1/p3p2p/1p2P3/4BPP1/1K6/PP2N2P/R2R4 b - - 0 20,Nc6,0,82,82,1
2b3k1/2rr1pp1/p1n1p2p/1p2P3/4BPP1/1K6/PP2N2P/R2R4 w - - 1 21,Bxc6,90,48,-42,1
2b3k1/2rr1pp1/p1B1p2p/1p2P3/5PP1/1K6/PP2N2P/R2R4 b - - 0 21,Rxc6,30,51,21,1
2b3k1/3r1pp1/p1r1p2p/1p2P3/5PP1/1K6/PP2N2P/R2R4 w - - 0 22,Rxd7,41,41,0,1
2b3k1/3R1pp1/p1r1p2p/1p2P3/5PP1/1K6/PP2N2P/R7 b - - 0 22,Bxd7,41,81,40,1
6k1/3b1pp1/p1r1p2p/1p2P3/5PP1/1K6/PP2N2P/R7 w - - 0 23,Rd1,34,14,-20,1
6k1/3b1pp1/p1r1p2p/1p2P3/5PP1/1K6/PP2N2P/3R4 b - - 1 23,Rc7,36,31,-5,1
6k1/2rb1pp1/p3p2p/1p2P3/5PP1/1K6/PP2N2P/3R4 w - - 2 24,Nc3,33,-29,-62,1
6k1/2rb1pp1/p3p2p/1p2P3/5PP1/1KN5/PP5P/3R4 b - - 3 24,Bc6,-38,-16,22,1
6k1/2r2pp1/p1b1p2p/1p2P3/5PP1/1KN5/PP5P/3R4 w - - 4 25,Kb4,-8,-109,-101,0
6k1/2r2pp1/p1b1p2p/1p2P3/1K3PP1/2N5/PP5P/3R4 b - - 5 25,a5+,-72,258,330,1
6k1/2r2pp1/2b1p2p/pp2P3/1K3PP1/2N5/PP5P/3R4 w - - 0 26,Kxa5,244,239,-5,1
6k1/2r2pp1/2b1p2p/Kp2P3/5PP1/2N5/PP5P/3R4 b - - 0 26,Be8,242,362,120,1
4b1k1/2r2pp1/4p2p/Kp2P3/5PP1/2N5/PP5P/3R4 w - - 1 27,Rd8,392,360,-32,1
3Rb1k1/2r2pp1/4p2p/Kp2P3/5PP1/2N5/PP5P/8 b - - 2 27,Kf8,352,349,-3,1
3Rbk2/2r2pp1/4p2p/Kp2P3/5PP1/2N5/PP5P/8 w - - 3 28,Kb4,336,85,-251,0
3Rbk2/2r2pp1/4p2p/1p2P3/1K3PP1/2N5/PP5P/8 b - - 4 28,Ke7,102,247,145,1
3Rb3/2r1kpp1/4p2p/1p2P3/1K3PP1/2N5/PP5P/8 w - - 5 29,Rd4,229,256,27,1
4b3/2r1kpp1/4p2p/1p2P3/1K1R1PP1/2N5/PP5P/8 b - - 6 29,f6,266,281,15,1
4b3/2r1k1p1/4pp1p/1p2P3/1K1R1PP1/2N5/PP5P/8 w - - 0 30,exf6+,284,245,-39,1
4b3/2r1k1p1/4pP1p/1p6/1K1R1PP1/2N5/PP5P/8 b - - 0 30,Kxf6,235,271,36,1
4b3/2r3p1/4pk1p/1p6/1K1R1PP1/2N5/PP5P/8 w - - 0 31,b3,255,243,-12,1
4b3/2r3p1/4pk1p/1p6/1K1R1PP1/1PN5/P6P/8 b - - 0 31,Rc6,252,294,42,1
4b3/6p1/2r1pk1p/1p6/1K1R1PP1/1PN5/P6P/8 w - - 1 32,h4,306,271,-35,1
4b3/6p1/2r1pk1p/1p6/1K1R1PPP/1PN5/P7/8 b - - 0 32,Rc8,279,300,21,1
2r1b3/6p1/4pk1p/1p6/1K1R1PPP/1PN5/P7/8 w - - 1 33,Ne4+,333,235,-98,1
2r1b3/6p1/4pk1p/1p6/1K1RNPPP/1P6/P7/8 b - - 2 33,Kg6,312,351,39,1
2r1b3/6p1/4p1kp/1p6/1K1RNPPP/1P6/P7/8 w - - 3 34,Nd6,379,367,-12,1
2r1b3/6p1/3Np1kp/1p6/1K1R1PPP/1P6/P7/8 b - - 4 34,Ra8,369,387,18,1
r3b3/6p1/3Np1kp/1p6/1K1R1PPP/1P6/P7/8 w - - 5 35,h5+,406,458,52,1
r3b3/6p1/3Np1kp/1p5P/1K1R1PP1/1P6/P7/8 b - - 0 35,Kh7,464,484,20,1
r3b3/6pk/3Np2p/1p5P/1K1R1PP1/1P6/P7/8 w - - 1 36,Nxe8,499,506,7,1
r3N3/6pk/4p2p/1p5P/1K1R1PP1/1P6/P7/8 b - - 0 36,Rxe8,506,504,-2,1
4r3/6pk/4p2p/1p5P/1K1R1PP1/1P6/P7/8 w - - 0 37,Kxb5,490,481,-9,1
4r3/6pk/4p2p/1K5P/3R1PP1/1P6/P7/8 b - - 0 37,e5,489,509,20,1
4r3/6pk/7p/1K2p2P/3R1PP1/1P6/P7/8 w - - 0 38,Re4,520,480,-40,1
4r3/6pk/7p/1K2p2P/4RPP1/1P6/P7/8 b - - 1 38,g5,464,582,118,1
4r3/7k/7p/1K2p1pP/4RPP1/1P6/P7/8 w - g6 0 39,f5,557,490,-67,1
4r3/7k/7p/1K2pPpP/4R1P1/1P6/P7/8 b - - 0 39,Kg7,501,499,-2,1
4r3/6k1/7p/1K2pPpP/4R1P1/1P6/P7/8 w - - 1 40,a4,530,542,12,1
4r3/6k1/7p/1K2pPpP/P3R1P1/1P6/8/8 b - - 0 40,Kf7,562,558,-4,1
4r3/5k2/7p/1K2pPpP/P3R1P1/1P6/8/8 w - - 1 41,b4,558,566,8,1
4r3/5k2/7p/1K2pPpP/PP2R1P1/8/8/8 b - - 0 41,Kf6,552,609,57,1
4r3/8/5k1p/1K2pPpP/PP2R1P1/8/8/8 w - - 1 42,a5,554,591,37,1
4r3/8/5k1p/PK2pPpP/1P2R1P1/8/8/8 b - - 0 42,Rd8,640,643,3,1
3r4/8/5k1p/PK2pPpP/1P2R1P1/8/8/8 w - - 1 43,a6,665,649,-16,1
3r4/8/P4k1p/1K2pPpP/1P2R1P1/8/8/8 b - - 0 43,Rd5+,667,649,-18,1
8/8/P4k1p/1K1rpPpP/1P2R1P1/8/8/8 w - - 1 44,Kc4,623,583,-40,1
8/8/P4k1p/3rpPpP/1PK1R1P1/8/8/8 b - - 2 44,Ke7,613,924,311,1
8/4k3/P6p/3rpPpP/1PK1R1P1/8/8/8 w - - 3 45,b5,962,568,-394,0
8/4k3/P6p/1P1rpPpP/2K1R1P1/8/8/8 b - - 0 45,Kd6,590,591,1,1
8/8/P2k3p/1P1rpPpP/2K1R1P1/8/8/8 w - - 1 46,f6,581,616,35,1
8/8/P2k1P1p/1P1rp1pP/2K1R1P1/8/8/8 b - - 0 46,Rc5+,614,639,25,1
8/8/P2k1P1p/1Pr1p1pP/2K1R1P1/8/8/8 w - - 1 47,Kb4,652,645,-7,1
8/8/P2k1P1p/1Pr1p1pP/1K2R1P1/8/8/8 b - - 2 47,Kd5,667,815,148,1
8/8/P4P1p/1Prkp1pP/1K2R1P1/8/8/8 w - - 3 48,Rxe5+,848,868,20,1
8/8/P4P1p/1PrkR1pP/1K4P1/8/8/8 b - - 0 48,Kxe5,901,908,7,1
8/8/P4P1p/1Pr1k1pP/1K4P1/8/8/8 w - - 0 49,Kxc5,910,937,27,1
8/8/P4P1p/1PK1k1pP/6P1/8/8/8 b - - 0 49,Kf4,989,1112,123,1
8/8/P4P1p/1PK3pP/5kP1/8/8/8 w - - 1 50,f7,1162,1248,86,1
8/5P2/P6p/1PK3pP/5kP1/8/8/8 b - - 0 50,Kxg4,1304,1439,135,1
8/5P2/P6p/1PK3pP/6k1/8/8/8 w - - 0 51,f8=Q,1386,9989,8603,1
5Q2/8/P6p/1PK3pP/6k1/8/8/8 b - - 0 51,Kxh5,9990,9994,4,1
5Q2/8/P6p/1PK3pk/8/8/8/8 w - - 0 52,b6,9994,1303,-8691,0
5Q2/8/PP5p/2K3pk/8/8/8/8 b - - 0 52,g4,9991,9991,0,1
5Q2/8/PP5p/2K4k/6p1/8/8/8 w - - 0 53,b7,9992,9995,3,1
5Q2/1P6/P6p/2K4k/6p1/8/8/8 b - - 0 53,g3,9995,9997,2,1
5Q2/1P6/P6p/2K4k/8/6p1/8/8 w - - 0 54,b8=Q,9996,9997,1,1
rnbqkbnr/pppppppp/8/8/8/8/PPPPPPPP/RNBQKBNR w KQkq - 0 1,e4,26,30,4,1
rnbqkbnr/pppppppp/8/8/4P3/8/PPPP1PPP/RNBQKBNR b KQkq - 0 1,b6,29,96,67,1
rnbqkbnr/p1pppppp/1p6/8/4P3/8/PPPP1PPP/RNBQKBNR w KQkq - 0 2,d4,107,88,-19,1
rnbqkbnr/p1pppppp/1p6/8/3PP3/8/PPP2PPP/RNBQKBNR b KQkq - 0 2,Bb7,85,96,11,1
rn1qkbnr/pbpppppp/1p6/8/3PP3/8/PPP2PPP/RNBQKBNR w KQkq - 1 3,Nc3,86,72,-14,1
rn1qkbnr/pbpppppp/1p6/8/3PP3/2N5/PPP2PPP/R1BQKBNR b KQkq - 2 3,g6,69,132,63,1
rn1qkbnr/pbpppp1p/1p4p1/8/3PP3/2N5/PPP2PPP/R1BQKBNR w KQkq - 0 4,Qf3,163,102,-61,1
rn1qkbnr/pbpppp1p/1p4p1/8/3PP3/2N2Q2/PPP2PPP/R1B1KBNR b KQkq - 1 4,Bg7,83,81,-2,1
rn1qk1nr/pbppppbp/1p4p1/8/3PP3/2N2Q2/PPP2PPP/R1B1KBNR w KQkq - 2 5,Be2,69,-132,-201,0
rn1qk1nr/pbppppbp/1p4p1/8/3PP3/2N2Q2/PPP1BPPP/R1B1K1NR b KQkq - 3 5,Nf6,-58,52,110,1
rn1qk2r/pbppppbp/1p3np1/8/3PP3/2N2Q2/PPP1BPPP/R1B1K1NR w KQkq - 4 6,Be3,50,55,5,1
rn1qk2r/pbppppbp/1p3np1/8/3PP3/2N1BQ2/PPP1BPPP/R3K1NR b KQkq - 5 6,O-O,46,71,25,1
rn1q1rk1/pbppppbp/1p3np1/8/3PP3/2N1BQ2/PPP1BPPP/R3K1NR w KQ - 6 7,O-O-O,41,21,-20,1
rn1q1rk1/pbppppbp/1p3np1/8/3PP3/2N1BQ2/PPP1BPPP/2KR2NR b - - 7 7,a5,38,154,116,1
rn1q1rk1/1bppppbp/1p3np1/p7/3PP3/2N1BQ2/PPP1BPPP/2KR2NR w - - 0 8,h4,175,170,-5,1
rn1q1rk1/1bppppbp/1p3np1/p7/3PP2P/2N1BQ2/PPP1BPP1/2KR2NR b - - 0 8,c5,179,230,51,1
rn1q1rk1/1b1pppbp/1p3np1/p1p5/3PP2P/2N1BQ2/PPP1BPP1/2KR2NR w - - 0 9,d5,221,198,-23,1
rn1q1rk1/1b1pppbp/1p3np1/p1pP4/4P2P/2N1BQ2/PPP1BPP1/2KR2NR b - - 0 9,d6,195,198,3,1
rn1q1rk1/1b2ppbp/1p1p1np1/p1pP4/4P2P/2N1BQ2/PPP1BPP1/2KR2NR w - - 0 10,h5,207,221,14,1
rn1q1rk1/1b2ppbp/1p1p1np1/p1pP3P/4P3/2N1BQ2/PPP1BPP1/2KR2NR b - - 0 10,Bc8,200,237,37,1
rnbq1rk1/4ppbp/1p1p1np1/p1pP3P/4P3/2N1BQ2/PPP1BPP1/2KR2NR w - - 1 11,hxg6,259,280,21,1
rnbq1rk1/4ppbp/1p1p1nP1/p1pP4/4P3/2N1BQ2/PPP1BPP1/2KR2NR b - - 0 11,fxg6,257,242,-15,1
rnbq1rk1/4p1bp/1p1p1np1/p1pP4/4P3/2N1BQ2/PPP1BPP1/2KR2NR w - - 0 12,Qg3,234,244,10,1
rnbq1rk1/4p1bp/1p1p1np1/p1pP4/4P3/2N1B1Q1/PPP1BPP1/2KR2NR b - - 1 12,e5,248,426,178,1
rnbq1rk1/6bp/1p1p1np1/p1pPp3/4P3/2N1B1Q1/PPP1BPP1/2KR2NR w - e6 0 13,dxe6,398,416,18,1
rnbq1rk1/6bp/1p1pPnp1/p1p5/4P3/2N1B1Q1/PPP1BPP1/2KR2NR b - - 0 13,Bxe6,388,428,40,1
rn1q1rk1/6bp/1p1pbnp1/p1p5/4P3/2N1B1Q1/PPP1BPP1/2KR2NR w - - 0 14,Qh2,458,354,-104,0
rn1q1rk1/6bp/1p1pbnp1/p1p5/4P3/2N1B3/PPP1BPPQ/2KR2NR b - - 1 14,h5,335,397,62,1
rn1q1rk1/6b1/1p1pbnp1/p1p4p/4P3/2N1B3/PPP1BPPQ/2KR2NR w - - 0 15,Bg5,387,212,-175,0
rn1q1rk1/6b1/1p1pbnp1/p1p3Bp/4P3/2N5/PPP1BPPQ/2KR2NR b - - 1 15,Qe8,273,285,12,1
rn2qrk1/6b1/1p1pbnp1/p1p3Bp/4P3/2N5/PPP1BPPQ/2KR2NR w - - 2 16,Qxd6,295,291,-4,1
rn2qrk1/6b1/1p1Qbnp1/p1p3Bp/4P3/2N5/PPP1BPP1/2KR2NR b - - 0 16,Nc6,291,287,-4,1
r3qrk1/6b1/1pnQbnp1/p1p3Bp/4P3/2N5/PPP1BPP1/2KR2NR w - - 1 17,Bb5,259,297,38,1
r3qrk1/6b1/1pnQbnp1/pBp3Bp/4P3/2N5/PPP2PP1/2KR2NR b - - 2 17,Rc8,292,317,25,1
2r1qrk1/6b1/1pnQbnp1/pBp3Bp/4P3/2N5/PPP2PP1/2KR2NR w - - 3 18,Nf3,322,303,-19,1
2r1qrk1/6b1/1pnQbnp1/pBp3Bp/4P3/2N2N2/PPP2PP1/2KR3R b - - 4 18,Ng4,279,296,17,1
2r1qrk1/6b1/1pnQb1p1/pBp3Bp/4P1n1/2N2N2/PPP2PP1/2KR3R w - - 5 19,Rhf1,304,277,-27,1
2r1qrk1/6b1/1pnQb1p1/pBp3Bp/4P1n1/2N2N2/PPP2PP1/2KR1R2 b - - 6 19,Qf7,251,373,122,1
2r2rk1/5qb1/1pnQb1p1/pBp3Bp/4P1n1/2N2N2/PPP2PP1/2KR1R2 w - - 7 20,Bxc6,354,369,15,1
2r2rk1/5qb1/1pBQb1p1/p1p3Bp/4P1n1/2N2N2/PPP2PP1/2KR1R2 b - - 0 20,Rcd8,396,641,245,1
3r1rk1/5qb1/1pBQb1p1/p1p3Bp/4P1n1/2N2N2/PPP2PP1/2KR1R2 w - - 1 21,Qg3,617,360,-257,0
3r1rk1/5qb1/1pB1b1p1/p1p3Bp/4P1n1/2N2NQ1/PPP2PP1/2KR1R2 b - - 2 21,Rxd1+,394,426,32,1
5rk1/5qb1/1pB1b1p1/p1p3Bp/4P1n1/2N2NQ1/PPP2PP1/2Kr1R2 w - - 0 22,Rxd1,454,441,-13,1
5rk1/5qb1/1pB1b1p1/p1p3Bp/4P1n1/2N2NQ1/PPP2PP1/2KR4 b - - 0 22,b5,413,464,51,1
5rk1/5qb1/2B1b1p1/ppp3Bp/4P1n1/2N2NQ1/PPP2PP1/2KR4 w - - 0 23,Bd5,463,384,-79,1
5rk1/5qb1/4b1p1/pppB2Bp/4P1n1/2N2NQ1/PPP2PP1/2KR4 b - - 1 23,b4,394,425,31,1
5rk1/5qb1/4b1p1/p1pB2Bp/1p2P1n1/2N2NQ1/PPP2PP1/2KR4 w - - 0 24,Bxe6,385,367,-18,1
5rk1/5qb1/4B1p1/p1p3Bp/1p2P1n1/2N2NQ1/PPP2PP1/2KR4 b - - 0 24,Qxe6,363,353,-10,1
5rk1/6b1/4q1p1/p1p3Bp/1p2P1n1/2N2NQ1/PPP2PP1/2KR4 w - - 0 25,Nd5,368,347,-21,1
5rk1/6b1/4q1p1/p1pN2Bp/1p2P1n1/5NQ1/PPP2PP1/2KR4 b - - 1 25,Qxe4,323,420,97,1
5rk1/6b1/6p1/p1pN2Bp/1p2q1n1/5NQ1/PPP2PP1/2KR4 w - - 0 26,Nh4,385,44,-341,0
5rk1/6b1/6p1/p1pN2Bp/1p2q1nN/6Q1/PPP2PP1/2KR4 b - - 1 26,Nxf2,39,68,29,1
5rk1/6b1/6p1/p1pN2Bp/1p2q2N/6Q1/PPP2nP1/2KR4 w - - 0 27,Rd2,25,-9998,-10023,0
5rk1/6b1/6p1/p1pN2Bp/1p2q2N/6Q1/PPPR1nP1/2K5 b - - 1 27,Qe1+,-9998,-9999,-1,1
5rk1/6b1/6p1/p1pN2Bp/1p5N/6Q1/PPPR1nP1/2K1q3 w - - 2 28,Rd1,-9999,-9999,0,1
5rk1/6b1/6p1/p1pN2Bp/1p5N/6Q1/PPP2nP1/2KRq3 b - - 3 28,Qxd1#,-9999,-10000,-1,1
rnbqkbnr/pppppppp/8/8/8/8/PPPPPPPP/RNBQKBNR w KQkq - 0 1,e4,31,31,0,1
rnbqkbnr/pppppppp/8/8/4P3/8/PPPP1PPP/RNBQKBNR b KQkq - 0 1,c5,29,26,-3,1
rnbqkbnr/pp1ppppp/8/2p5/4P3/8/PPPP1PPP/RNBQKBNR w KQkq - 0 2,Nf3,39,30,-9,1
rnbqkbnr/pp1ppppp/8/2p5/4P3/5N2/PPPP1PPP/RNBQKB1R b KQkq - 1 2,Nc6,29,40,11,1
r1bqkbnr/pp1ppppp/2n5/2p5/4P3/5N2/PPPP1PPP/RNBQKB1R w KQkq - 2 3,d4,49,15,-34,1
r1bqkbnr/pp1ppppp/2n5/2p5/3PP3/5N2/PPP2PPP/RNBQKB1R b KQkq - 0 3,cxd4,26,34,8,1
r1bqkbnr/pp1ppppp/2n5/8/3pP3/5N2/PPP2PPP/RNBQKB1R w KQkq - 0 4,Nxd4,37,32,-5,1
r1bqkbnr/pp1ppppp/2n5/8/3NP3/8/PPP2PPP/RNBQKB1R b KQkq - 0 4,e6,32,38,6,1
r1bqkbnr/pp1p1ppp/2n1p3/8/3NP3/8/PPP2PPP/RNBQKB1R w KQkq - 0 5,Nc3,35,23,-12,1
r1bqkbnr/pp1p1ppp/2n1p3/8/3NP3/2N5/PPP2PPP/R1BQKB1R b KQkq - 1 5,a6,45,54,9,1
r1bqkbnr/1p1p1ppp/p1n1p3/8/3NP3/2N5/PPP2PPP/R1BQKB1R w KQkq - 0 6,Bc4,49,6,-43,1
r1bqkbnr/1p1p1ppp/p1n1p3/8/2BNP3/2N5/PPP2PPP/R1BQK2R b KQkq - 1 6,b5,12,50,38,1
r1bqkbnr/3p1ppp/p1n1p3/1p6/2BNP3/2N5/PPP2PPP/R1BQK2R w KQkq - 0 7,Nxc6,43,42,-1,1
r1bqkbnr/3p1ppp/p1N1p3/1p6/2B1P3/2N5/PPP2PPP/R1BQK2R b KQkq - 0 7,dxc6,36,38,2,1
r1bqkbnr/5ppp/p1p1p3/1p6/2B1P3/2N5/PPP2PPP/R1BQK2R w KQkq - 0 8,Qxd8+,42,52,10,1
r1bQkbnr/5ppp/p1p1p3/1p6/2B1P3/2N5/PPP2PPP/R1B1K2R b KQkq - 0 8,Kxd8,48,46,-2,1
r1bk1bnr/5ppp/p1p1p3/1p6/2B1P3/2N5/PPP2PPP/R1B1K2R w KQ - 0 9,Be2,45,49,4,1
r1bk1bnr/5ppp/p1p1p3/1p6/4P3/2N5/PPP1BPPP/R1B1K2R b KQ - 1 9,b4,47,177,130,1
r1bk1bnr/5ppp/p1p1p3/8/1p2P3/2N5/PPP1BPPP/R1B1K2R w KQ - 0 10,Na4,173,157,-16,1
r1bk1bnr/5ppp/p1p1p3/8/Np2P3/8/PPP1BPPP/R1B1K2R b KQ - 1 10,Rb8,149,304,155,1
1rbk1bnr/5ppp/p1p1p3/8/Np2P3/8/PPP1BPPP/R1B1K2R w KQ - 2 11,Bf4,307,333,26,1
1rbk1bnr/5ppp/p1p1p3/8/Np2PB2/8/PPP1BPPP/R3K2R b KQ - 3 11,Rb7,305,304,-1,1
2bk1bnr/1r3ppp/p1p1p3/8/Np2PB2/8/PPP1BPPP/R3K2R w KQ - 4 12,Nc5,343,-328,-671,0
2bk1bnr/1r3ppp/p1p1p3/2N5/1p2PB2/8/PPP1BPPP/R3K2R b KQ - 5 12,Rb5,-340,424,764,1
2bk1bnr/5ppp/p1p1p3/1rN5/1p2PB2/8/PPP1BPPP/R3K2R w KQ - 6 13,Bxb5,411,438,27,1
2bk1bnr/5ppp/p1p1p3/1BN5/1p2PB2/8/PPP2PPP/R3K2R b KQ - 0 13,Bxc5,444,447,3,1
2bk2nr/5ppp/p1p1p3/1Bb5/1p2PB2/8/PPP2PPP/R3K2R w KQ - 0 14,Bxc6,426,428,2,1
2bk2nr/5ppp/p1B1p3/2b5/1p2PB2/8/PPP2PPP/R3K2R b KQ - 0 14,Ne7,478,658,180,1
2bk3r/4nppp/p1B1p3/2b5/1p2PB2/8/PPP2PPP/R3K2R w KQ - 1 15,Rd1+,672,622,-50,1
rnbqkbnr/pppppppp/8/8/8/8/PPPPPPPP/RNBQKBNR w KQkq - 0 1,f4,49,-33,-82,1
rnbqkbnr/pppppppp/8/8/5P2/8/PPPPP1PP/RNBQKBNR b KQkq - 0 1,e6,-41,-13,28,1
rnbqkbnr/pppp1ppp/4p3/8/5P2/8/PPPPP1PP/RNBQKBNR w KQkq - 0 2,Nf3,-23,-21,2,1
rnbqkbnr/pppp1ppp/4p3/8/5P2/5N2/PPPPP1PP/RNBQKB1R b KQkq - 1 2,d5,-24,-26,-2,1
rnbqkbnr/ppp2ppp/4p3/3p4/5P2/5N2/PPPPP1PP/RNBQKB1R w KQkq - 0 3,e3,-20,-44,-24,1
rnbqkbnr/ppp2ppp/4p3/3p4/5P2/4PN2/PPPP2PP/RNBQKB1R b KQkq - 0 3,Nf6,-45,-11,34,1
rnbqkb1r/ppp2ppp/4pn2/3p4/5P2/4PN2/PPPP2PP/RNBQKB1R w KQkq - 1 4,d3,-24,-36,-12,1
rnbqkb1r/ppp2ppp/4pn2/3p4/5P2/3PPN2/PPP3PP/RNBQKB1R b KQkq - 0 4,c5,-43,-41,2,1
rnbqkb1r/pp3ppp/4pn2/2pp4/5P2/3PPN2/PPP3PP/RNBQKB1R w KQkq - 0 5,Be2,-32,-29,3,1
rnbqkb1r/pp3ppp/4pn2/2pp4/5P2/3PPN2/PPP1B1PP/RNBQK2R b KQkq - 1 5,Nc6,-30,-31,-1,1
r1bqkb1r/pp3ppp/2n1pn2/2pp4/5P2/3PPN2/PPP1B1PP/RNBQK2R w KQkq - 2 6,O-O,-32,-32,0,1
r1bqkb1r/pp3ppp/2n1pn2/2pp4/5P2/3PPN2/PPP1B1PP/RNBQ1RK1 b kq - 3 6,Bd6,-34,-37,-3,1
r1bqk2r/pp3ppp/2nbpn2/2pp4/5P2/3PPN2/PPP1B1PP/RNBQ1RK1 w kq - 4 7,c3,-33,-67,-34,1
r1bqk2r/pp3ppp/2nbpn2/2pp4/5P2/2PPPN2/PP2B1PP/RNBQ1RK1 b kq - 0 7,Qc7,-69,-76,-7,1
r1b1k2r/ppq2ppp/2nbpn2/2pp4/5P2/2PPPN2/PP2B1PP/RNBQ1RK1 w kq - 1 8,Qc2,-53,-146,-93,1
r1b1k2r/ppq2ppp/2nbpn2/2pp4/5P2/2PPPN2/PPQ1B1PP/RNB2RK1 b kq - 2 8,Bd7,-144,-77,67,1
r3k2r/ppqb1ppp/2nbpn2/2pp4/5P2/2PPPN2/PPQ1B1PP/RNB2RK1 w kq - 3 9,Nbd2,-75,-116,-41,1
r3k2r/ppqb1ppp/2nbpn2/2pp4/5P2/2PPPN2/PPQNB1PP/R1B2RK1 b kq - 4 9,O-O-O,-124,-48,76,1
2kr3r/ppqb1ppp/2nbpn2/2pp4/5P2/2PPPN2/PPQNB1PP/R1B2RK1 w - - 5 10,g3,-51,-190,-139,0
2kr3r/ppqb1ppp/2nbpn2/2pp4/5P2/2PPPNP1/PPQNB2P/R1B2RK1 b - - 0 10,e5,-166,-173,-7,1
2kr3r/ppqb1ppp/2nb1n2/2ppp3/5P2/2PPPNP1/PPQNB2P/R1B2RK1 w - - 0 11,e4,-164,-234,-70,1
2kr3r/ppqb1ppp/2nb1n2/2ppp3/4PP2/2PP1NP1/PPQNB2P/R1B2RK1 b - - 0 11,exf4,-254,-266,-12,1
2kr3r/ppqb1ppp/2nb1n2/2pp4/4Pp2/2PP1NP1/PPQNB2P/R1B2RK1 w - - 0 12,gxf4,-260,-339,-79,1
2kr3r/ppqb1ppp/2nb1n2/2pp4/4PP2/2PP1N2/PPQNB2P/R1B2RK1 b - - 0 12,dxe4,-354,-260,94,1
2kr3r/ppqb1ppp/2nb1n2/2p5/4pP2/2PP1N2/PPQNB2P/R1B2RK1 w - - 0 13,Nxe4,-188,-296,-108,0
2kr3r/ppqb1ppp/2nb1n2/2p5/4NP2/2PP1N2/PPQ1B2P/R1B2RK1 b - - 0 13,Nxe4,-260,-243,17,1
2kr3r/ppqb1ppp/2nb4/2p5/4nP2/2PP1N2/PPQ1B2P/R1B2RK1 w - - 0 14,dxe4,-237,-259,-22,1
2kr3r/ppqb1ppp/2nb4/2p5/4PP2/2P2N2/PPQ1B2P/R1B2RK1 b - - 0 14,Bxf4,-266,-242,24,1
2kr3r/ppqb1ppp/2n5/2p5/4Pb2/2P2N2/PPQ1B2P/R1B2RK1 w - - 0 15,Bxf4,-243,-247,-4,1
2kr3r/ppqb1ppp/2n5/2p5/4PB2/2P2N2/PPQ1B2P/R4RK1 b - - 0 15,Qxf4,-258,-266,-8,1
2kr3r/pp1b1ppp/2n5/2p5/4Pq2/2P2N2/PPQ1B2P/R4RK1 w - - 0 16,Kh1,-264,-260,4,1
2kr3r/pp1b1ppp/2n5/2p5/4Pq2/2P2N2/PPQ1B2P/R4R1K b - - 1 16,Bh3,-285,-263,22,1
2kr3r/pp3ppp/2n5/2p5/4Pq2/2P2N1b/PPQ1B2P/R4R1K w - - 2 17,Rf2,-271,-220,51,1
2kr3r/pp3ppp/2n5/2p5/4Pq2/2P2N1b/PPQ1BR1P/R6K b - - 3 17,Ne5,-227,-170,57,1
2kr3r/pp3ppp/8/2p1n3/4Pq2/2P2N1b/PPQ1BR1P/R6K w - - 4 18,Re1,-121,-452,-331,0
2kr3r/pp3ppp/8/2p1n3/4Pq2/2P2N1b/PPQ1BR1P/4R2K b - - 5 18,h5,-391,-99,292,1
2kr3r/pp3pp1/8/2p1n2p/4Pq2/2P2N1b/PPQ1BR1P/4R2K w - - 0 19,Bd1,-155,-502,-347,0
2kr3r/pp3pp1/8/2p1n2p/4Pq2/2P2N1b/PPQ2R1P/3BR2K b - - 1 19,g5,-534,-183,351,1
2kr3r/pp3p2/8/2p1n1pp/4Pq2/2P2N1b/PPQ2R1P/3BR2K w - - 0 20,Nxe5,-182,-200,-18,1
2kr3r/pp3p2/8/2p1N1pp/4Pq2/2P4b/PPQ2R1P/3BR2K b - - 0 20,Qxe5,-202,-199,3,1
2kr3r/pp3p2/8/2p1q1pp/4P3/2P4b/PPQ2R1P/3BR2K w - - 0 21,Qe2,-179,-309,-130,0
2kr3r/pp3p2/8/2p1q1pp/4P3/2P4b/PP2QR1P/3BR2K b - - 1 21,Bg4,-317,-312,5,1
2kr3r/pp3p2/8/2p1q1pp/4P1b1/2P5/PP2QR1P/3BR2K w - - 2 22,Qf1,-312,-374,-62,1
2kr3r/pp3p2/8/2p1q1pp/4P1b1/2P5/PP3R1P/3BRQ1K b - - 3 22,Be6,-425,-290,135,1
2kr3r/pp3p2/4b3/2p1q1pp/4P3/2P5/PP3R1P/3BRQ1K w - - 4 23,Be2,-266,-363,-97,1
2kr3r/pp3p2/4b3/2p1q1pp/4P3/2P5/PP2BR1P/4RQ1K b - - 5 23,g4,-363,-311,52,1
2kr3r/pp3p2/4b3/2p1q2p/4P1p1/2P5/PP2BR1P/4RQ1K w - - 0 24,Bc4,-292,-292,0,1
2kr3r/pp3p2/4b3/2p1q2p/2B1P1p1/2P5/PP3R1P/4RQ1K b - - 1 24,g3,-283,-179,104,1
2kr3r/pp3p2/4b3/2p1q2p/2B1P3/2P3p1/PP3R1P/4RQ1K w - - 0 25,Rg2,-263,-358,-95,1
2kr3r/pp3p2/4b3/2p1q2p/2B1P3/2P3p1/PP4RP/4RQ1K b - - 1 25,gxh2,-414,-285,129,1
2kr3r/pp3p2/4b3/2p1q2p/2B1P3/2P5/PP4Rp/4RQ1K w - - 0 26,Bxe6+,-261,-284,-23,1
2kr3r/pp3p2/4B3/2p1q2p/4P3/2P5/PP4Rp/4RQ1K b - - 0 26,fxe6,-279,-280,-1,1
2kr3r/pp6/4p3/2p1q2p/4P3/2P5/PP4Rp/4RQ1K w - - 0 27,Qf3,-263,-317,-54,1
2kr3r/pp6/4p3/2p1q2p/4P3/2P2Q2/PP4Rp/4R2K b - - 1 27,h4,-347,-289,58,1
2kr3r/pp6/4p3/2p1q3/4P2p/2P2Q2/PP4Rp/4R2K w - - 0 28,Qe3,-290,-321,-31,1
2kr3r/pp6/4p3/2p1q3/4P2p/2P1Q3/PP4Rp/4R2K b - - 1 28,h3,-345,-60,285,1
2kr3r/pp6/4p3/2p1q3/4P3/2P1Q2p/PP4Rp/4R2K w - - 0 29,Rge2,-117,-409,-292,0
2kr3r/pp6/4p3/2p1q3/4P3/2P1Q2p/PP2R2p/4R2K b - - 1 29,Rhg8,-413,-388,25,1
2kr2r1/pp6/4p3/2p1q3/4P3/2P1Q2p/PP2R2p/4R2K w - - 2 30,Rxh2,-392,-458,-66,1
2kr2r1/pp6/4p3/2p1q3/4P3/2P1Q2p/PP5R/4R2K b - - 0 30,Rg2,-423,-415,8,1
2kr4/pp6/4p3/2p1q3/4P3/2P1Q2p/PP4rR/4R2K w - - 1 31,Rxh3,-436,-374,62,1
2kr4/pp6/4p3/2p1q3/4P3/2P1Q2R/PP4r1/4R2K b - - 0 31,Rdg8,-394,-275,119,1
2k3r1/pp6/4p3/2p1q3/4P3/2P1Q2R/PP4r1/4R2K w - - 1 32,Rh2,-304,-9999,-9695,0
2k3r1/pp6/4p3/2p1q3/4P3/2P1Q3/PP4rR/4R2K b - - 2 32,Rxh2#,-9999,-10000,-1,1
rnbqkbnr/pppppppp/8/8/8/8/PPPPPPPP/RNBQKBNR w KQkq - 0 1,e4,28,27,-1,1
rnbqkbnr/pppppppp/8/8/4P3/8/PPPP1PPP/RNBQKBNR b KQkq - 0 1,d5,19,53,34,1
rnbqkbnr/ppp1pppp/8/3p4/4P3/8/PPPP1PPP/RNBQKBNR w KQkq - 0 2,exd5,64,66,2,1
rnbqkbnr/ppp1pppp/8/3P4/8/8/PPPP1PPP/RNBQKBNR b KQkq - 0 2,Qxd5,71,72,1,1
rnb1kbnr/ppp1pppp/8/3q4/8/8/PPPP1PPP/RNBQKBNR w KQkq - 0 3,Nf3,72,40,-32,1
rnb1kbnr/ppp1pppp/8/3q4/8/5N2/PPPP1PPP/RNBQKB1R b KQkq - 1 3,Qd8,41,75,34,1
rnbqkbnr/ppp1pppp/8/8/8/5N2/PPPP1PPP/RNBQKB1R w KQkq - 2 4,Qe2,78,52,-26,1
rnbqkbnr/ppp1pppp/8/8/8/5N2/PPPPQPPP/RNB1KB1R b KQkq - 3 4,Nc6,48,94,46,1
r1bqkbnr/ppp1pppp/2n5/8/8/5N2/PPPPQPPP/RNB1KB1R w KQkq - 4 5,Nc3,77,-14,-91,1
r1bqkbnr/ppp1pppp/2n5/8/8/2N2N2/PPPPQPPP/R1B1KB1R b KQkq - 5 5,Nf6,-16,29,45,1
r1bqkb1r/ppp1pppp/2n2n2/8/8/2N2N2/PPPPQPPP/R1B1KB1R w KQkq - 6 6,d4,23,27,4,1
r1bqkb1r/ppp1pppp/2n2n2/8/3P4/2N2N2/PPP1QPPP/R1B1KB1R b KQkq - 0 6,Bg4,28,34,6,1
r2qkb1r/ppp1pppp/2n2n2/8/3P2b1/2N2N2/PPP1QPPP/R1B1KB1R w KQkq - 1 7,d5,28,-141,-169,0
r2qkb1r/ppp1pppp/2n2n2/3P4/6b1/2N2N2/PPP1QPPP/R1B1KB1R b KQkq - 0 7,Bxf3,-158,69,227,1
r2qkb1r/ppp1pppp/2n2n2/3P4/8/2N2b2/PPP1QPPP/R1B1KB1R w KQkq - 0 8,Qxf3,79,78,-1,1
r2qkb1r/ppp1pppp/2n2n2/3P4/8/2N2Q2/PPP2PPP/R1B1KB1R b KQkq - 0 8,Ne5,89,192,103,1
r2qkb1r/ppp1pppp/5n2/3Pn3/8/2N2Q2/PPP2PPP/R1B1KB1R w KQkq - 1 9,Qe2,169,171,2,1
r2qkb1r/ppp1pppp/5n2/3Pn3/8/2N5/PPP1QPPP/R1B1KB1R b KQkq - 2 9,Nxd5,164,512,348,1
r2qkb1r/ppp1pppp/8/3nn3/8/2N5/PPP1QPPP/R1B1KB1R w KQkq - 0 10,Qxe5,484,493,9,1
r2qkb1r/ppp1pppp/8/3nQ3/8/2N5/PPP2PPP/R1B1KB1R b KQkq - 0 10,Nxc3,496,546,50,1
r2qkb1r/ppp1pppp/8/4Q3/8/2n5/PPP2PPP/R1B1KB1R w KQkq - 0 11,Qxc3,530,542,12,1
r2qkb1r/ppp1pppp/8/8/8/2Q5/PPP2PPP/R1B1KB1R b KQkq - 0 11,e5,538,560,22,1
r2qkb1r/ppp2ppp/8/4p3/8/2Q5/PPP2PPP/R1B1KB1R w KQkq - 0 12,Bd2,577,546,-31,1
r2qkb1r/ppp2ppp/8/4p3/8/2Q5/PPPB1PPP/R3KB1R b KQkq - 1 12,f6,494,563,69,1
r2qkb1r/ppp3pp/5p2/4p3/8/2Q5/PPPB1PPP/R3KB1R w KQkq - 0 13,O-O-O,583,568,-15,1
r2qkb1r/ppp3pp/5p2/4p3/8/2Q5/PPPB1PPP/2KR1B1R b kq - 1 13,Bb4,572,769,197,1
r2qk2r/ppp3pp/5p2/4p3/1b6/2Q5/PPPB1PPP/2KR1B1R w kq - 2 14,Qxb4,738,717,-21,1
r2qk2r/ppp3pp/5p2/4p3/1Q6/8/PPPB1PPP/2KR1B1R b kq - 0 14,b6,754,873,119,1
r2qk2r/p1p3pp/1p3p2/4p3/1Q6/8/PPPB1PPP/2KR1B1R w kq - 0 15,Qb5+,837,756,-81,1
rnbqkbnr/pppppppp/8/8/8/8/PPPPPPPP/RNBQKBNR w KQkq - 0 1,d4,22,23,1,1
rnbqkbnr/pppppppp/8/8/3P4/8/PPP1PPPP/RNBQKBNR b KQkq - 0 1,g6,21,75,54,1
rnbqkbnr/pppppp1p/6p1/8/3P4/8/PPP1PPPP/RNBQKBNR w KQkq - 0 2,c4,70,16,-54,1
rnbqkbnr/pppppp1p/6p1/8/2PP4/8/PP2PPPP/RNBQKBNR b KQkq - 0 2,Bg7,24,47,23,1
rnbqk1nr/ppppppbp/6p1/8/2PP4/8/PP2PPPP/RNBQKBNR w KQkq - 1 3,Nc3,53,53,0,1
rnbqk1nr/ppppppbp/6p1/8/2PP4/2N5/PP2PPPP/R1BQKBNR b KQkq - 2 3,b6,50,71,21,1
rnbqk1nr/p1ppppbp/1p4p1/8/2PP4/2N5/PP2PPPP/R1BQKBNR w KQkq - 0 4,e4,76,76,0,1
rnbqk1nr/p1ppppbp/1p4p1/8/2PPP3/2N5/PP3PPP/R1BQKBNR b KQkq - 0 4,Bb7,82,105,23,1
rn1qk1nr/pbppppbp/1p4p1/8/2PPP3/2N5/PP3PPP/R1BQKBNR w KQkq - 1 5,Nf3,122,105,-17,1
rn1qk1nr/pbppppbp/1p4p1/8/2PPP3/2N2N2/PP3PPP/R1BQKB1R b KQkq - 2 5,e6,103,125,22,1
rn1qk1nr/pbpp1pbp/1p2p1p1/8/2PPP3/2N2N2/PP3PPP/R1BQKB1R w KQkq - 0 6,Bd3,122,119,-3,1
rn1qk1nr/pbpp1pbp/1p2p1p1/8/2PPP3/2NB1N2/PP3PPP/R1BQK2R b KQkq - 1 6,Nc6,117,137,20,1
r2qk1nr/pbpp1pbp/1pn1p1p1/8/2PPP3/2NB1N2/PP3PPP/R1BQK2R w KQkq - 2 7,Be3,138,132,-6,1
r2qk1nr/pbpp1pbp/1pn1p1p1/8/2PPP3/2NBBN2/PP3PPP/R2QK2R b KQkq - 3 7,Nge7,96,155,59,1
r2qk2r/pbppnpbp/1pn1p1p1/8/2PPP3/2NBBN2/PP3PPP/R2QK2R w KQkq - 4 8,O-O,165,105,-60,1
r2qk2r/pbppnpbp/1pn1p1p1/8/2PPP3/2NBBN2/PP3PPP/R2Q1RK1 b kq - 5 8,O-O,116,117,1,1
r2q1rk1/pbppnpbp/1pn1p1p1/8/2PPP3/2NBBN2/PP3PPP/R2Q1RK1 w - - 6 9,Qd2,138,67,-71,1
r2q1rk1/pbppnpbp/1pn1p1p1/8/2PPP3/2NBBN2/PP1Q1PPP/R4RK1 b - - 7 9,d5,99,111,12,1
r2q1rk1/pbp1npbp/1pn1p1p1/3p4/2PPP3/2NBBN2/PP1Q1PPP/R4RK1 w - - 0 10,cxd5,111,103,-8,1
r2q1rk1/pbp1npbp/1pn1p1p1/3P4/3PP3/2NBBN2/PP1Q1PPP/R4RK1 b - - 0 10,exd5,101,79,-22,1
r2q1rk1/pbp1npbp/1pn3p1/3p4/3PP3/2NBBN2/PP1Q1PPP/R4RK1 w - - 0 11,e5,146,103,-43,1
r2q1rk1/pbp1npbp/1pn3p1/3pP3/3P4/2NBBN2/PP1Q1PPP/R4RK1 b - - 0 11,Nb4,109,110,1,1
r2q1rk1/pbp1npbp/1p4p1/3pP3/1n1P4/2NBBN2/PP1Q1PPP/R4RK1 w - - 1 12,Bb1,119,113,-6,1
r2q1rk1/pbp1npbp/1p4p1/3pP3/1n1P4/2N1BN2/PP1Q1PPP/RB3RK1 b - - 2 12,c5,131,104,-27,1
r2q1rk1/pb2npbp/1p4p1/2ppP3/1n1P4/2N1BN2/PP1Q1PPP/RB3RK1 w - - 0 13,a3,105,15,-90,1
r2q1rk1/pb2npbp/1p4p1/2ppP3/1n1P4/P1N1BN2/1P1Q1PPP/RB3RK1 b - - 0 13,cxd4,54,106,52,1
r2q1rk1/pb2npbp/1p4p1/3pP3/1n1p4/P1N1BN2/1P1Q1PPP/RB3RK1 w - - 0 14,Nxd4,96,29,-67,1
r2q1rk1/pb2npbp/1p4p1/3pP3/1n1N4/P1N1B3/1P1Q1PPP/RB3RK1 b - - 0 14,Nbc6,95,92,-3,1
r2q1rk1/pb2npbp/1pn3p1/3pP3/3N4/P1N1B3/1P1Q1PPP/RB3RK1 w - - 1 15,f4,77,87,10,1
r2q1rk1/pb2npbp/1pn3p1/3pP3/3N1P2/P1N1B3/1P1Q2PP/RB3RK1 b - - 0 15,Nxd4,79,102,23,1
r2q1rk1/pb2npbp/1p4p1/3pP3/3n1P2/P1N1B3/1P1Q2PP/RB3RK1 w - - 0 16,Bxd4,107,86,-21,1
r2q1rk1/pb2npbp/1p4p1/3pP3/3B1P2/P1N5/1P1Q2PP/RB3RK1 b - - 0 16,Nf5,104,338,234,1
r2q1rk1/pb3pbp/1p4p1/3pPn2/3B1P2/P1N5/1P1Q2PP/RB3RK1 w - - 1 17,Bxf5,354,317,-37,1
r2q1rk1/pb3pbp/1p4p1/3pPB2/3B1P2/P1N5/1P1Q2PP/R4RK1 b - - 0 17,gxf5,310,309,-1,1
r2q1rk1/pb3pbp/1p6/3pPp2/3B1P2/P1N5/1P1Q2PP/R4RK1 w - - 0 18,Qd3,341,261,-80,1
r2q1rk1/pb3pbp/1p6/3pPp2/3B1P2/P1NQ4/1P4PP/R4RK1 b - - 1 18,Qd7,267,286,19,1
r4rk1/pb1q1pbp/1p6/3pPp2/3B1P2/P1NQ4/1P4PP/R4RK1 w - - 2 19,Rf3,304,301,-3,1
r4rk1/pb1q1pbp/1p6/3pPp2/3B1P2/P1NQ1R2/1P4PP/R5K1 b - - 3 19,Bh6,313,858,545,1
r4rk1/pb1q1p1p/1p5b/3pPp2/3B1P2/P1NQ1R2/1P4PP/R5K1 w - - 4 20,Rg3+,807,855,48,1
r4rk1/pb1q1p1p/1p5b/3pPp2/3B1P2/P1NQ2R1/1P4PP/R5K1 b - - 5 20,Kh8,844,926,82,1
r4r1k/pb1q1p1p/1p5b/3pPp2/3B1P2/P1NQ2R1/1P4PP/R5K1 w - - 6 21,e6+,944,868,-76,1
r4r1k/pb1q1p1p/1p2P2b/3p1p2/3B1P2/P1NQ2R1/1P4PP/R5K1 b - - 0 21,Bg7,920,9998,9078,1
rnbqkbnr/pppppppp/8/8/8/8/PPPPPPPP/RNBQKBNR w KQkq - 0 1,e4,22,17,-5,1
rnbqkbnr/pppppppp/8/8/4P3/8/PPPP1PPP/RNBQKBNR b KQkq - 0 1,c5,19,41,22,1
rnbqkbnr/pp1ppppp/8/2p5/4P3/8/PPPP1PPP/RNBQKBNR w KQkq - 0 2,c3,28,-4,-32,1
rnbqkbnr/pp1ppppp/8/2p5/4P3/2P5/PP1P1PPP/RNBQKBNR b KQkq - 0 2,Nc6,3,30,27,1
r1bqkbnr/pp1ppppp/2n5/2p5/4P3/2P5/PP1P1PPP/RNBQKBNR w KQkq - 1 3,d4,42,40,-2,1
r1bqkbnr/pp1ppppp/2n5/2p5/3PP3/2P5/PP3PPP/RNBQKBNR b KQkq - 0 3,cxd4,22,45,23,1
r1bqkbnr/pp1ppppp/2n5/8/3pP3/2P5/PP3PPP/RNBQKBNR w KQkq - 0 4,cxd4,45,33,-12,1
r1bqkbnr/pp1ppppp/2n5/8/3PP3/8/PP3PPP/RNBQKBNR b KQkq - 0 4,g6,35,141,106,1
r1bqkbnr/pp1ppp1p/2n3p1/8/3PP3/8/PP3PPP/RNBQKBNR w KQkq - 0 5,d5,165,160,-5,1
r1bqkbnr/pp1ppp1p/2n3p1/3P4/4P3/8/PP3PPP/RNBQKBNR b KQkq - 0 5,Nb8,163,173,10,1
rnbqkbnr/pp1ppp1p/6p1/3P4/4P3/8/PP3PPP/RNBQKBNR w KQkq - 1 6,Bc4,187,113,-74,1
rnbqkbnr/pp1ppp1p/6p1/3P4/2B1P3/8/PP3PPP/RNBQK1NR b KQkq - 2 6,Bg7,113,103,-10,1
rnbqk1nr/pp1pppbp/6p1/3P4/2B1P3/8/PP3PPP/RNBQK1NR w KQkq - 3 7,Nc3,106,81,-25,1
rnbqk1nr/pp1pppbp/6p1/3P4/2B1P3/2N5/PP3PPP/R1BQK1NR b KQkq - 4 7,d6,100,101,1,1
rnbqk1nr/pp2ppbp/3p2p1/3P4/2B1P3/2N5/PP3PPP/R1BQK1NR w KQkq - 0 8,Nf3,110,59,-51,1
rnbqk1nr/pp2ppbp/3p2p1/3P4/2B1P3/2N2N2/PP3PPP/R1BQK2R b KQkq - 1 8,Nf6,53,110,57,1
rnbqk2r/pp2ppbp/3p1np1/3P4/2B1P3/2N2N2/PP3PPP/R1BQK2R w KQkq - 2 9,O-O,119,37,-82,1
rnbqk2r/pp2ppbp/3p1np1/3P4/2B1P3/2N2N2/PP3PPP/R1BQ1RK1 b kq - 3 9,O-O,34,134,100,1
rnbq1rk1/pp2ppbp/3p1np1/3P4/2B1P3/2N2N2/PP3PPP/R1BQ1RK1 w - - 4 10,Bg5,117,19,-98,1
rnbq1rk1/pp2ppbp/3p1np1/3P2B1/2B1P3/2N2N2/PP3PPP/R2Q1RK1 b - - 5 10,Nfd7,28,138,110,1
rnbq1rk1/pp1nppbp/3p2p1/3P2B1/2B1P3/2N2N2/PP3PPP/R2Q1RK1 w - - 6 11,Bb3,139,82,-57,1
rnbq1rk1/pp1nppbp/3p2p1/3P2B1/4P3/1BN2N2/PP3PPP/R2Q1RK1 b - - 7 11,Ne5,85,86,1,1
rnbq1rk1/pp2ppbp/3p2p1/3Pn1B1/4P3/1BN2N2/PP3PPP/R2Q1RK1 w - - 8 12,Nxe5,80,81,1,1
rnbq1rk1/pp2ppbp/3p2p1/3PN1B1/4P3/1BN5/PP3PPP/R2Q1RK1 b - - 0 12,Bxe5,79,78,-1,1
rnbq1rk1/pp2pp1p/3p2p1/3Pb1B1/4P3/1BN5/PP3PPP/R2Q1RK1 w - - 0 13,f4,75,75,0,1
rnbq1rk1/pp2pp1p/3p2p1/3Pb1B1/4PP2/1BN5/PP4PP/R2Q1RK1 b - - 0 13,Bg7,71,85,14,1
rnbq1rk1/pp2ppbp/3p2p1/3P2B1/4PP2/1BN5/PP4PP/R2Q1RK1 w - - 1 14,f5,82,15,-67,1
rnbq1rk1/pp2ppbp/3p2p1/3P1PB1/4P3/1BN5/PP4PP/R2Q1RK1 b - - 0 14,Nd7,34,36,2,1
r1bq1rk1/pp1nppbp/3p2p1/3P1PB1/4P3/1BN5/PP4PP/R2Q1RK1 w - - 1 15,Qe2,17,14,-3,1
r1bq1rk1/pp1nppbp/3p2p1/3P1PB1/4P3/1BN5/PP2Q1PP/R4RK1 b - - 2 15,Ne5,24,25,1,1
r1bq1rk1/pp2ppbp/3p2p1/3PnPB1/4P3/1BN5/PP2Q1PP/R4RK1 w - - 3 16,f6,19,-136,-155,0
r1bq1rk1/pp2ppbp/3p1Pp1/3Pn1B1/4P3/1BN5/PP2Q1PP/R4RK1 b - - 0 16,exf6,-137,-142,-5,1
r1bq1rk1/pp3pbp/3p1pp1/3Pn1B1/4P3/1BN5/PP2Q1PP/R4RK1 w - - 0 17,Bxf6,-140,-467,-327,0
r1bq1rk1/pp3pbp/3p1Bp1/3Pn3/4P3/1BN5/PP2Q1PP/R4RK1 b - - 0 17,Bxf6,-464,-505,-41,1
rnbqkbnr/pppppppp/8/8/8/8/PPPPPPPP/RNBQKBNR w KQkq - 0 1,c4,53,-7,-60,1
rnbqkbnr/pppppppp/8/8/2P5/8/PP1PPPPP/RNBQKBNR b KQkq - 0 1,f5,-5,34,39,1
rnbqkbnr/ppppp1pp/8/5p2/2P5/8/PP1PPPPP/RNBQKBNR w KQkq - 0 2,f4,43,-6,-49,1
rnbqkbnr/ppppp1pp/8/5p2/2P2P2/8/PP1PP1PP/RNBQKBNR b KQkq - 0 2,Nf6,-14,-2,12,1
rnbqkb1r/ppppp1pp/5n2/5p2/2P2P2/8/PP1PP1PP/RNBQKBNR w KQkq - 1 3,d4,1,16,15,1
rnbqkb1r/ppppp1pp/5n2/5p2/2PP1P2/8/PP2P1PP/RNBQKBNR b KQkq - 0 3,e6,15,17,2,1
rnbqkb1r/pppp2pp/4pn2/5p2/2PP1P2/8/PP2P1PP/RNBQKBNR w KQkq - 0 4,Nc3,18,-11,-29,1
rnbqkb1r/pppp2pp/4pn2/5p2/2PP1P2/2N5/PP2P1PP/R1BQKBNR b KQkq - 1 4,Bb4,-19,-17,2,1
rnbqk2r/pppp2pp/4pn2/5p2/1bPP1P2/2N5/PP2P1PP/R1BQKBNR w KQkq - 2 5,a3,-2,-121,-119,0
rnbqk2r/pppp2pp/4pn2/5p2/1bPP1P2/P1N5/1P2P1PP/R1BQKBNR b KQkq - 0 5,Bxc3+,-139,-127,12,1
rnbqk2r/pppp2pp/4pn2/5p2/2PP1P2/P1b5/1P2P1PP/R1BQKBNR w KQkq - 0 6,bxc3,-128,-133,-5,1
rnbqk2r/pppp2pp/4pn2/5p2/2PP1P2/P1P5/4P1PP/R1BQKBNR b KQkq - 0 6,b6,-120,-112,8,1
rnbqk2r/p1pp2pp/1p2pn2/5p2/2PP1P2/P1P5/4P1PP/R1BQKBNR w KQkq - 0 7,Nf3,-124,-151,-27,1
rnbqk2r/p1pp2pp/1p2pn2/5p2/2PP1P2/P1P2N2/4P1PP/R1BQKB1R b KQkq - 1 7,Bb7,-119,-118,1,1
rn1qk2r/pbpp2pp/1p2pn2/5p2/2PP1P2/P1P2N2/4P1PP/R1BQKB1R w KQkq - 2 8,Ne5,-90,-176,-86,1
rn1qk2r/pbpp2pp/1p2pn2/4Np2/2PP1P2/P1P5/4P1PP/R1BQKB1R b KQkq - 3 8,d6,-188,-158,30,1
rn1qk2r/pbp3pp/1p1ppn2/4Np2/2PP1P2/P1P5/4P1PP/R1BQKB1R w KQkq - 0 9,Nf3,-170,-159,11,1
rn1qk2r/pbp3pp/1p1ppn2/5p2/2PP1P2/P1P2N2/4P1PP/R1BQKB1R b KQkq - 1 9,O-O,-173,-163,10,1
rn1q1rk1/pbp3pp/1p1ppn2/5p2/2PP1P2/P1P2N2/4P1PP/R1BQKB1R w KQ - 2 10,h4,-150,-251,-101,0
rn1q1rk1/pbp3pp/1p1ppn2/5p2/2PP1P1P/P1P2N2/4P1P1/R1BQKB1R b KQ - 0 10,Qe8,-266,-276,-10,1
rn2qrk1/pbp3pp/1p1ppn2/5p2/2PP1P1P/P1P2N2/4P1P1/R1BQKB1R w KQ - 1 11,Ng5,-248,-322,-74,1
rn2qrk1/pbp3pp/1p1ppn2/5pN1/2PP1P1P/P1P5/4P1P1/R1BQKB1R b KQ - 2 11,h6,-305,-309,-4,1
rn2qrk1/pbp3p1/1p1ppn1p/5pN1/2PP1P1P/P1P5/4P1P1/R1BQKB1R w KQ - 0 12,e3,-304,-305,-1,1
rn2qrk1/pbp3p1/1p1ppn1p/5pN1/2PP1P1P/P1P1P3/6P1/R1BQKB1R b KQ - 0 12,hxg5,-359,-385,-26,1
rn2qrk1/pbp3p1/1p1ppn2/5pp1/2PP1P1P/P1P1P3/6P1/R1BQKB1R w KQ - 0 13,hxg5,-381,-349,32,1
rn2qrk1/pbp3p1/1p1ppn2/5pP1/2PP1P2/P1P1P3/6P1/R1BQKB1R b KQ - 0 13,Ne4,-344,-338,6,1
rn2qrk1/pbp3p1/1p1pp3/5pP1/2PPnP2/P1P1P3/6P1/R1BQKB1R w KQ - 1 14,Qf3,-337,-396,-59,1
rn2qrk1/pbp3p1/1p1pp3/5pP1/2PPnP2/P1P1PQ2/6P1/R1B1KB1R b KQ - 2 14,Kf7,-358,-356,2,1
rn2qr2/pbp2kp1/1p1pp3/5pP1/2PPnP2/P1P1PQ2/6P1/R1B1KB1R w KQ - 3 15,Qh5+,-371,-492,-121,0
rn2qr2/pbp2kp1/1p1pp3/5pPQ/2PPnP2/P1P1P3/6P1/R1B1KB1R b KQ - 4 15,Ke7,-441,-432,9,1
rn2qr2/pbp1k1p1/1p1pp3/5pPQ/2PPnP2/P1P1P3/6P1/R1B1KB1R w KQ - 5 16,g6,-451,-638,-187,0
rn2qr2/pbp1k1p1/1p1pp1P1/5p1Q/2PPnP2/P1P1P3/6P1/R1B1KB1R b KQ - 0 16,Nxc3,-628,-302,326,1
rn2qr2/pbp1k1p1/1p1pp1P1/5p1Q/2PP1P2/P1n1P3/6P1/R1B1KB1R w KQ - 0 17,d5,-290,-335,-45,1
rn2qr2/pbp1k1p1/1p1pp1P1/3P1p1Q/2P2P2/P1n1P3/6P1/R1B1KB1R b KQ - 0 17,exd5,-320,-258,62,1
rn2qr2/pbp1k1p1/1p1p2P1/3p1p1Q/2P2P2/P1n1P3/6P1/R1B1KB1R w KQ - 0 18,Bb2,-260,-330,-70,1
rn2qr2/pbp1k1p1/1p1p2P1/3p1p1Q/2P2P2/P1n1P3/1B4P1/R3KB1R b KQ - 1 18,d4,-353,-335,18,1
rn2qr2/pbp1k1p1/1p1p2P1/5p1Q/2Pp1P2/P1n1P3/1B4P1/R3KB1R w KQ - 0 19,exd4,-354,-393,-39,1
rn2qr2/pbp1k1p1/1p1p2P1/5p1Q/2PP1P2/P1n5/1B4P1/R3KB1R b KQ - 0 19,Kd8+,-424,-451,-27,1
rn1kqr2/pbp3p1/1p1p2P1/5p1Q/2PP1P2/P1n5/1B4P1/R3KB1R w KQ - 1 20,Kd2,-424,-459,-35,1
rn1kqr2/pbp3p1/1p1p2P1/5p1Q/2PP1P2/P1n5/1B1K2P1/R4B1R b - - 2 20,Ne4+,-486,-465,21,1
rn1kqr2/pbp3p1/1p1p2P1/5p1Q/2PPnP2/P7/1B1K2P1/R4B1R w - - 3 21,Kc2,-456,-498,-42,1
rn1kqr2/pbp3p1/1p1p2P1/5p1Q/2PPnP2/P7/1BK3P1/R4B1R b - - 4 21,Qa4+,-488,-429,59,1
rn1k1r2/pbp3p1/1p1p2P1/5p1Q/q1PPnP2/P7/1BK3P1/R4B1R w - - 5 22,Kc1,-441,-428,13,1
rn1k1r2/pbp3p1/1p1p2P1/5p1Q/q1PPnP2/P7/1B4P1/R1K2B1R b - - 6 22,Nf2,-420,-160,260,1
rn1k1r2/pbp3p1/1p1p2P1/5p1Q/q1PP1P2/P7/1B3nP1/R1K2B1R w - - 7 23,Qh4+,-184,-169,15,1
rnbqkbnr/pppppppp/8/8/8/8/PPPPPPPP/RNBQKBNR w KQkq - 0 1,e4,36,37,1,1
rnbqkbnr/pppppppp/8/8/4P3/8/PPPP1PPP/RNBQKBNR b KQkq - 0 1,e5,38,47,9,1
rnbqkbnr/pppp1ppp/8/4p3/4P3/8/PPPP1PPP/RNBQKBNR w KQkq - 0 2,Nf3,44,41,-3,1
rnbqkbnr/pppp1ppp/8/4p3/4P3/5N2/PPPP1PPP/RNBQKB1R b KQkq - 1 2,d6,45,44,-1,1
rnbqkbnr/ppp2ppp/3p4/4p3/4P3/5N2/PPPP1PPP/RNBQKB1R w KQkq - 0 3,d4,43,42,-1,1
rnbqkbnr/ppp2ppp/3p4/4p3/3PP3/5N2/PPP2PPP/RNBQKB1R b KQkq - 0 3,Nd7,46,75,29,1
r1bqkbnr/pppn1ppp/3p4/4p3/3PP3/5N2/PPP2PPP/RNBQKB1R w KQkq - 1 4,Bc4,57,44,-13,1
r1bqkbnr/pppn1ppp/3p4/4p3/2BPP3/5N2/PPP2PPP/RNBQK2R b KQkq - 2 4,exd4,49,94,45,1
r1bqkbnr/pppn1ppp/3p4/8/2BpP3/5N2/PPP2PPP/RNBQK2R w KQkq - 0 5,Nxd4,82,40,-42,1
r1bqkbnr/pppn1ppp/3p4/8/2BNP3/8/PPP2PPP/RNBQK2R b KQkq - 0 5,Ngf6,41,63,22,1
r1bqkb1r/pppn1ppp/3p1n2/8/2BNP3/8/PPP2PPP/RNBQK2R w KQkq - 1 6,Nc3,63,73,10,1
r1bqkb1r/pppn1ppp/3p1n2/8/2BNP3/2N5/PPP2PPP/R1BQK2R b KQkq - 2 6,Be7,75,97,22,1
r1bqk2r/pppnbppp/3p1n2/8/2BNP3/2N5/PPP2PPP/R1BQK2R w KQkq - 3 7,Be3,86,22,-64,1
r1bqk2r/pppnbppp/3p1n2/8/2BNP3/2N1B3/PPP2PPP/R2QK2R b KQkq - 4 7,O-O,25,30,5,1
r1bq1rk1/pppnbppp/3p1n2/8/2BNP3/2N1B3/PPP2PPP/R2QK2R w KQ - 5 8,f3,31,-54,-85,1
r1bq1rk1/pppnbppp/3p1n2/8/2BNP3/2N1BP2/PPP3PP/R2QK2R b KQ - 0 8,c6,-53,8,61,1
r1bq1rk1/pp1nbppp/2pp1n2/8/2BNP3/2N1BP2/PPP3PP/R2QK2R w KQ - 0 9,Qd2,6,-21,-27,1
r1bq1rk1/pp1nbppp/2pp1n2/8/2BNP3/2N1BP2/PPPQ2PP/R3K2R b KQ - 1 9,b5,-28,392,420,1
r1bq1rk1/p2nbppp/2pp1n2/1p6/2BNP3/2N1BP2/PPPQ2PP/R3K2R w KQ - 0 10,Be2,396,0,-396,0
r1bq1rk1/p2nbppp/2pp1n2/1p6/3NP3/2N1BP2/PPPQB1PP/R3K2R b KQ - 1 10,Qc7,-73,134,207,1
r1b2rk1/p1qnbppp/2pp1n2/1p6/3NP3/2N1BP2/PPPQB1PP/R3K2R w KQ - 2 11,O-O-O,102,-54,-156,0
r1b2rk1/p1qnbppp/2pp1n2/1p6/3NP3/2N1BP2/PPPQB1PP/2KR3R b - - 3 11,b4,-61,60,121,1
r1b2rk1/p1qnbppp/2pp1n2/8/1p1NP3/2N1BP2/PPPQB1PP/2KR3R w - - 0 12,Na4,40,36,-4,1
r1b2rk1/p1qnbppp/2pp1n2/8/Np1NP3/4BP2/PPPQB1PP/2KR3R b - - 1 12,Nb6,17,39,22,1
r1b2rk1/p1q1bppp/1npp1n2/8/Np1NP3/4BP2/PPPQB1PP/2KR3R w - - 2 13,Nf5,43,-335,-378,0
r1b2rk1/p1q1bppp/1npp1n2/5N2/Np2P3/4BP2/PPPQB1PP/2KR3R b - - 3 13,Bxf5,-330,-314,16,1
r4rk1/p1q1bppp/1npp1n2/5b2/Np2P3/4BP2/PPPQB1PP/2KR3R w - - 0 14,Nxb6,-321,-329,-8,1
r4rk1/p1q1bppp/1Npp1n2/5b2/1p2P3/4BP2/PPPQB1PP/2KR3R b - - 0 14,axb6,-306,-306,0,1
r4rk1/2q1bppp/1ppp1n2/5b2/1p2P3/4BP2/PPPQB1PP/2KR3R w - - 0 15,exf5,-349,-311,38,1
r4rk1/2q1bppp/1ppp1n2/5P2/1p6/4BP2/PPPQB1PP/2KR3R b - - 0 15,Rxa2,-358,-374,-16,1
5rk1/2q1bppp/1ppp1n2/5P2/1p6/4BP2/rPPQB1PP/2KR3R w - - 0 16,Qxb4,-347,-396,-49,1
5rk1/2q1bppp/1ppp1n2/5P2/1Q6/4BP2/rPP1B1PP/2KR3R b - - 0 16,Nd5,-345,-355,-10,1
5rk1/2q1bppp/1ppp4/3n1P2/1Q6/4BP2/rPP1B1PP/2KR3R w - - 1 17,Qb3,-366,-375,-9,1
5rk1/2q1bppp/1ppp4/3n1P2/8/1Q2BP2/rPP1B1PP/2KR3R b - - 2 17,Rfa8,-402,-400,2,1
r5k1/2q1bppp/1ppp4/3n1P2/8/1Q2BP2/rPP1B1PP/2KR3R w - - 3 18,Kd2,-347,-445,-98,1
r5k1/2q1bppp/1ppp4/3n1P2/8/1Q2BP2/rPPKB1PP/3R3R b - - 4 18,Nxe3,-383,-326,57,1
r5k1/2q1bppp/1ppp4/5P2/8/1Q2nP2/rPPKB1PP/3R3R w - - 0 19,Kxe3,-339,-336,3,1
r5k1/2q1bppp/1ppp4/5P2/8/1Q2KP2/rPP1B1PP/3R3R b - - 0 19,Bg5+,-355,-168,187,1
r5k1/2q2ppp/1ppp4/5Pb1/8/1Q2KP2/rPP1B1PP/3R3R w - - 1 20,f4,-219,-174,45,1
r5k1/2q2ppp/1ppp4/5Pb1/5P2/1Q2K3/rPP1B1PP/3R3R b - - 0 20,Qe7+,-159,-168,-9,1
r5k1/4qppp/1ppp4/5Pb1/5P2/1Q2K3/rPP1B1PP/3R3R w - - 1 21,Kf3,-186,-184,2,1
r5k1/4qppp/1ppp4/5Pb1/5P2/1Q3K2/rPP1B1PP/3R3R b - - 2 21,Bf6,-173,-58,115,1
r5k1/4qppp/1ppp1b2/5P2/5P2/1Q3K2/rPP1B1PP/3R3R w - - 3 22,c3,-62,-459,-397,0
r5k1/4qppp/1ppp1b2/5P2/5P2/1QP2K2/rP2B1PP/3R3R b - - 0 22,d5,-520,-49,471,1
r5k1/4qppp/1pp2b2/3p1P2/5P2/1QP2K2/rP2B1PP/3R3R w - - 0 23,Rhe1,-45,-211,-166,0
r5k1/4qppp/1pp2b2/3p1P2/5P2/1QP2K2/rP2B1PP/3RR3 b - - 1 23,Qe4+,-227,-237,-10,1
r5k1/5ppp/1pp2b2/3p1P2/4qP2/1QP2K2/rP2B1PP/3RR3 w - - 2 24,Kg3,-203,-214,-11,1
r5k1/5ppp/1pp2b2/3p1P2/4qP2/1QP3K1/rP2B1PP/3RR3 b - - 3 24,R2a4,-272,-200,72,1
r5k1/5ppp/1pp2b2/3p1P2/r3qP2/1QP3K1/1P2B1PP/3RR3 w - - 4 25,Bd3,-290,-9998,-9708,0
r5k1/5ppp/1pp2b2/3p1P2/r3qP2/1QPB2K1/1P4PP/3RR3 b - - 5 25,Qxf4+,-9998,-9999,-1,1
rnbqkbnr/pppppppp/8/8/8/8/PPPPPPPP/RNBQKBNR w KQkq - 0 1,c4,32,-10,-42,1
rnbqkbnr/pppppppp/8/8/2P5/8/PP1PPPPP/RNBQKBNR b KQkq - 0 1,c6,-17,42,59,1
rnbqkbnr/pp1ppppp/2p5/8/2P5/8/PP1PPPPP/RNBQKBNR w KQkq - 0 2,e4,33,40,7,1
rnbqkbnr/pp1ppppp/2p5/8/2P1P3/8/PP1P1PPP/RNBQKBNR b KQkq - 0 2,d5,34,38,4,1
rnbqkbnr/pp2pppp/2p5/3p4/2P1P3/8/PP1P1PPP/RNBQKBNR w KQkq - 0 3,cxd5,46,47,1,1
rnbqkbnr/pp2pppp/2p5/3P4/4P3/8/PP1P1PPP/RNBQKBNR b KQkq - 0 3,cxd5,35,48,13,1
rnbqkbnr/pp2pppp/8/3p4/4P3/8/PP1P1PPP/RNBQKBNR w KQkq - 0 4,exd5,19,20,1,1
rnbqkbnr/pp2pppp/8/3P4/8/8/PP1P1PPP/RNBQKBNR b KQkq - 0 4,Nf6,11,24,13,1
rnbqkb1r/pp2pppp/5n2/3P4/8/8/PP1P1PPP/RNBQKBNR w KQkq - 1 5,Bc4,16,17,1,1
rnbqkb1r/pp2pppp/5n2/3P4/2B5/8/PP1P1PPP/RNBQK1NR b KQkq - 2 5,Nxd5,15,14,-1,1
rnbqkb1r/pp2pppp/8/3n4/2B5/8/PP1P1PPP/RNBQK1NR w KQkq - 0 6,Nf3,17,12,-5,1
rnbqkb1r/pp2pppp/8/3n4/2B5/5N2/PP1P1PPP/RNBQK2R b KQkq - 1 6,Bg4,13,146,133,1
rn1qkb1r/pp2pppp/8/3n4/2B3b1/5N2/PP1P1PPP/RNBQK2R w KQkq - 2 7,O-O,141,20,-121,0
rn1qkb1r/pp2pppp/8/3n4/2B3b1/5N2/PP1P1PPP/RNBQ1RK1 b kq - 3 7,e6,25,417,392,1
rn1qkb1r/pp3ppp/4p3/3n4/2B3b1/5N2/PP1P1PPP/RNBQ1RK1 w kq - 0 8,d4,425,0,-425,0
rn1qkb1r/pp3ppp/4p3/3n4/2BP2b1/5N2/PP3PPP/RNBQ1RK1 b kq - 0 8,Nc6,-1,-2,-1,1
r2qkb1r/pp3ppp/2n1p3/3n4/2BP2b1/5N2/PP3PPP/RNBQ1RK1 w kq - 1 9,a3,-2,-40,-38,1
r2qkb1r/pp3ppp/2n1p3/3n4/2BP2b1/P4N2/1P3PPP/RNBQ1RK1 b kq - 0 9,Bd6,-57,-17,40,1
r2qk2r/pp3ppp/2nbp3/3n4/2BP2b1/P4N2/1P3PPP/RNBQ1RK1 w kq - 1 10,Qd3,-18,-122,-104,0
r2qk2r/pp3ppp/2nbp3/3n4/2BP2b1/P2Q1N2/1P3PPP/RNB2RK1 b kq - 2 10,O-O,-111,-23,88,1
r2q1rk1/pp3ppp/2nbp3/3n4/2BP2b1/P2Q1N2/1P3PPP/RNB2RK1 w - - 3 11,Bg5,-62,-96,-34,1
r2q1rk1/pp3ppp/2nbp3/3n2B1/2BP2b1/P2Q1N2/1P3PPP/RN3RK1 b - - 4 11,Qc7,-94,-54,40,1
r4rk1/ppq2ppp/2nbp3/3n2B1/2BP2b1/P2Q1N2/1P3PPP/RN3RK1 w - - 5 12,h3,-58,-147,-89,1
r4rk1/ppq2ppp/2nbp3/3n2B1/2BP2b1/P2Q1N1P/1P3PP1/RN3RK1 b - - 0 12,Bf5,-176,-87,89,1
r4rk1/ppq2ppp/2nbp3/3n1bB1/2BP4/P2Q1N1P/1P3PP1/RN3RK1 w - - 1 13,Qd1,-76,-74,2,1
r4rk1/ppq2ppp/2nbp3/3n1bB1/2BP4/P4N1P/1P3PP1/RN1Q1RK1 b - - 2 13,h6,-106,-97,9,1
r4rk1/ppq2pp1/2nbp2p/3n1bB1/2BP4/P4N1P/1P3PP1/RN1Q1RK1 w - - 0 14,Be3,-82,-169,-87,1
r4rk1/ppq2pp1/2nbp2p/3n1b2/2BP4/P3BN1P/1P3PP1/RN1Q1RK1 b - - 1 14,Nxe3,-166,-61,105,1
r4rk1/ppq2pp1/2nbp2p/5b2/2BP4/P3nN1P/1P3PP1/RN1Q1RK1 w - - 0 15,fxe3,-67,-123,-56,1
r4rk1/ppq2pp1/2nbp2p/5b2/2BP4/P3PN1P/1P4P1/RN1Q1RK1 b - - 0 15,Be4,-88,-7,81,1
r4rk1/ppq2pp1/2nbp2p/8/2BPb3/P3PN1P/1P4P1/RN1Q1RK1 w - - 1 16,Bd3,-18,-44,-26,1
r4rk1/ppq2pp1/2nbp2p/8/3Pb3/P2BPN1P/1P4P1/RN1Q1RK1 b - - 2 16,Bxd3,-38,-32,6,1
r4rk1/ppq2pp1/2nbp2p/8/3P4/P2bPN1P/1P4P1/RN1Q1RK1 w - - 0 17,Qxd3,-33,-37,-4,1
r4rk1/ppq2pp1/2nbp2p/8/3P4/P2QPN1P/1P4P1/RN3RK1 b - - 0 17,Rac8,-33,-33,0,1
2r2rk1/ppq2pp1/2nbp2p/8/3P4/P2QPN1P/1P4P1/RN3RK1 w - - 1 18,Nc3,-35,-38,-3,1
2r2rk1/ppq2pp1/2nbp2p/8/3P4/P1NQPN1P/1P4P1/R4RK1 b - - 2 18,a6,-47,-24,23,1
2r2rk1/1pq2pp1/p1nbp2p/8/3P4/P1NQPN1P/1P4P1/R4RK1 w - - 0 19,Ne4,-25,-23,2,1
2r2rk1/1pq2pp1/p1nbp2p/8/3PN3/P2QPN1P/1P4P1/R4RK1 b - - 1 19,Be7,-22,23,45,1
2r2rk1/1pq1bpp1/p1n1p2p/8/3PN3/P2QPN1P/1P4P1/R4RK1 w - - 2 20,Rac1,21,16,-5,1
2r2rk1/1pq1bpp1/p1n1p2p/8/3PN3/P2QPN1P/1P4P1/2R2RK1 b - - 3 20,Qd7,18,13,-5,1
2r2rk1/1p1qbpp1/p1n1p2p/8/3PN3/P2QPN1P/1P4P1/2R2RK1 w - - 4 21,Nfd2,20,-25,-45,1
2r2rk1/1p1qbpp1/p1n1p2p/8/3PN3/P2QP2P/1P1N2P1/2R2RK1 b - - 5 21,Qd5,-25,0,25,1
2r2rk1/1p2bpp1/p1n1p2p/3q4/3PN3/P2QP2P/1P1N2P1/2R2RK1 w - - 6 22,Nc3,0,-16,-16,1
2r2rk1/1p2bpp1/p1n1p2p/3q4/3P4/P1NQP2P/1P1N2P1/2R2RK1 b - - 7 22,Qh5,-21,-24,-3,1
2r2rk1/1p2bpp1/p1n1p2p/7q/3P4/P1NQP2P/1P1N2P1/2R2RK1 w - - 8 23,Nde4,-16,-42,-26,1
2r2rk1/1p2bpp1/p1n1p2p/7q/3PN3/P1NQP2P/1P4P1/2R2RK1 b - - 9 23,Bh4,-38,19,57,1
2r2rk1/1p3pp1/p1n1p2p/7q/3PN2b/P1NQP2P/1P4P1/2R2RK1 w - - 10 24,Qe2,15,-18,-33,1
2r2rk1/1p3pp1/p1n1p2p/7q/3PN2b/P1N1P2P/1P2Q1P1/2R2RK1 b - - 11 24,Qg6,-18,-8,10,1
2r2rk1/1p3pp1/p1n1p1qp/8/3PN2b/P1N1P2P/1P2Q1P1/2R2RK1 w - - 12 25,Qf3,0,-9,-9,1
2r2rk1/1p3pp1/p1n1p1qp/8/3PN2b/P1N1PQ1P/1P4P1/2R2RK1 b - - 13 25,Be7,-9,39,48,1
2r2rk1/1p2bpp1/p1n1p1qp/8/3PN3/P1N1PQ1P/1P4P1/2R2RK1 w - - 14 26,Qg3,30,-131,-161,0
2r2rk1/1p2bpp1/p1n1p1qp/8/3PN3/P1N1P1QP/1P4P1/2R2RK1 b - - 15 26,Qxg3,-99,-101,-2,1
2r2rk1/1p2bpp1/p1n1p2p/8/3PN3/P1N1P1qP/1P4P1/2R2RK1 w - - 0 27,Nxg3,-117,-67,50,1
2r2rk1/1p2bpp1/p1n1p2p/8/3P4/P1N1P1NP/1P4P1/2R2RK1 b - - 0 27,Bf6,-75,28,103,1
2r2rk1/1p3pp1/p1n1pb1p/8/3P4/P1N1P1NP/1P4P1/2R2RK1 w - - 1 28,Nge4,33,24,-9,1
2r2rk1/1p3pp1/p1n1pb1p/8/3PN3/P1N1P2P/1P4P1/2R2RK1 b - - 2 28,Bg5,29,120,91,1
2r2rk1/1p3pp1/p1n1p2p/6b1/3PN3/P1N1P2P/1P4P1/2R2RK1 w - - 3 29,Rc2,70,-528,-598,0
2r2rk1/1p3pp1/p1n1p2p/6b1/3PN3/P1N1P2P/1PR3P1/5RK1 b - - 4 29,Ne7,-541,18,559,1
2r2rk1/1p2npp1/p3p2p/6b1/3PN3/P1N1P2P/1PR3P1/5RK1 w - - 5 30,Nxg5,34,21,-13,1
2r2rk1/1p2npp1/p3p2p/6N1/3P4/P1N1P2P/1PR3P1/5RK1 b - - 0 30,hxg5,11,8,-3,1
2r2rk1/1p2npp1/p3p3/6p1/3P4/P1N1P2P/1PR3P1/5RK1 w - - 0 31,Rf3,25,-28,-53,1
2r2rk1/1p2npp1/p3p3/6p1/3P4/P1N1PR1P/1PR3P1/6K1 b - - 1 31,Nd5,-30,-31,-1,1
2r2rk1/1p3pp1/p3p3/3n2p1/3P4/P1N1PR1P/1PR3P1/6K1 w - - 2 32,Rg3,-24,-55,-31,1
2r2rk1/1p3pp1/p3p3/3n2p1/3P4/P1N1P1RP/1PR3P1/6K1 b - - 3 32,Nxc3,-37,-15,22,1
2r2rk1/1p3pp1/p3p3/6p1/3P4/P1n1P1RP/1PR3P1/6K1 w - - 0 33,bxc3,-60,-24,36,1
2r2rk1/1p3pp1/p3p3/6p1/3P4/P1P1P1RP/2R3P1/6K1 b - - 0 33,f6,-20,-11,9,1
2r2rk1/1p4p1/p3pp2/6p1/3P4/P1P1P1RP/2R3P1/6K1 w - - 0 34,e4,-20,-49,-29,1
2r2rk1/1p4p1/p3pp2/6p1/3PP3/P1P3RP/2R3P1/6K1 b - - 0 34,Kf7,-61,7,68,1
2r2r2/1p3kp1/p3pp2/6p1/3PP3/P1P3RP/2R3P1/6K1 w - - 1 35,c4,4,-32,-36,1
2r2r2/1p3kp1/p3pp2/6p1/2PPP3/P5RP/2R3P1/6K1 b - - 0 35,Rc7,-20,-12,8,1
5r2/1pr2kp1/p3pp2/6p1/2PPP3/P5RP/2R3P1/6K1 w - - 1 36,c5,-5,-9,-4,1
5r2/1pr2kp1/p3pp2/2P3p1/3PP3/P5RP/2R3P1/6K1 b - - 0 36,Rfc8,-3,0,3,1
2r5/1pr2kp1/p3pp2/2P3p1/3PP3/P5RP/2R3P1/6K1 w - - 1 37,Rgc3,0,0,0,1
2r5/1pr2kp1/p3pp2/2P3p1/3PP3/P1R4P/2R3P1/6K1 b - - 2 37,Ke7,0,1,1,1
2r5/1pr1k1p1/p3pp2/2P3p1/3PP3/P1R4P/2R3P1/6K1 w - - 3 38,Kf2,3,-8,-11,1
2r5/1pr1k1p1/p3pp2/2P3p1/3PP3/P1R4P/2R2KP1/8 b - - 4 38,Kd7,0,34,34,1
2r5/1prk2p1/p3pp2/2P3p1/3PP3/P1R4P/2R2KP1/8 w - - 5 39,Ke3,27,-8,-35,1
2r5/1prk2p1/p3pp2/2P3p1/3PP3/P1R1K2P/2R3P1/8 b - - 6 39,f5,0,109,109,1
2r5/1prk2p1/p3p3/2P2pp1/3PP3/P1R1K2P/2R3P1/8 w - - 0 40,exf5,155,103,-52,1
2r5/1prk2p1/p3p3/2P2Pp1/3P4/P1R1K2P/2R3P1/8 b - - 0 40,exf5,66,77,11,1
2r5/1prk2p1/p7/2P2pp1/3P4/P1R1K2P/2R3P1/8 w - - 0 41,Kf3,70,-5,-75,1
2r5/1prk2p1/p7/2P2pp1/3P4/P1R2K1P/2R3P1/8 b - - 1 41,Ke6,0,45,45,1
2r5/1pr3p1/p3k3/2P2pp1/3P4/P1R2K1P/2R3P1/8 w - - 2 42,g4,53,-6,-59,1
2r5/1pr3p1/p3k3/2P2pp1/3P2P1/P1R2K1P/2R5/8 b - - 0 42,f4,-12,50,62,1
2r5/1pr3p1/p3k3/2P3p1/3P1pP1/P1R2K1P/2R5/8 w - - 0 43,Re2+,71,-34,-105,0
2r5/1pr3p1/p3k3/2P3p1/3P1pP1/P1R2K1P/4R3/8 b - - 1 43,Kd5,-41,-50,-9,1
2r5/1pr3p1/p7/2Pk2p1/3P1pP1/P1R2K1P/4R3/8 w - - 2 44,Re5+,-27,-514,-487,0
2r5/1pr3p1/p7/2PkR1p1/3P1pP1/P1R2K1P/8/8 b - - 3 44,Kxd4,-531,-520,11,1
2r5/1pr3p1/p7/2P1R1p1/3k1pP1/P1R2K1P/8/8 w - - 0 45,Rxg5,-516,-522,-6,1
2r5/1pr3p1/p7/2P3R1/3k1pP1/P1R2K1P/8/8 b - - 0 45,Kxc3,-489,-529,-40,1
2r5/1pr3p1/p7/2P3R1/5pP1/P1k2K1P/8/8 w - - 0 46,Kxf4,-523,-530,-7,1
2r5/1pr3p1/p7/2P3R1/5KP1/P1k4P/8/8 b - - 0 46,Rxc5,-526,-444,82,1
2r5/1p4p1/p7/2r3R1/5KP1/P1k4P/8/8 w - - 0 47,Rg6,-438,-549,-111,0
2r5/1p4p1/p5R1/2r5/5KP1/P1k4P/8/8 b - - 1 47,Rc4+,-589,-520,69,1
2r5/1p4p1/p5R1/8/2r2KP1/P1k4P/8/8 w - - 2 48,Kg3,-536,-541,-5,1
2r5/1p4p1/p5R1/8/2r3P1/P1k3KP/8/8 b - - 3 48,R8c5,-557,-406,151,1
8/1p4p1/p5R1/2r5/2r3P1/P1k3KP/8/8 w - - 4 49,Rxg7,-440,-419,21,1
8/1p4R1/p7/2r5/2r3P1/P1k3KP/8/8 b - - 0 49,Kd2,-423,-397,26,1
8/1p4R1/p7/2r5/2r3P1/P5KP/3k4/8 w - - 1 50,Rxb7,-411,-480,-69,1
8/1R6/p7/2r5/2r3P1/P5KP/3k4/8 b - - 0 50,Ke3,-455,-390,65,1
8/1R6/p7/2r5/2r3P1/P3k1KP/8/8 w - - 1 51,Re7+,-341,-424,-83,1
8/4R3/p7/2r5/2r3P1/P3k1KP/8/8 b - - 2 51,Kd2,-407,-345,62,1
8/4R3/p7/2r5/2r3P1/P5KP/3k4/8 w - - 3 52,Re6,-322,-414,-92,1
8/8/p3R3/2r5/2r3P1/P5KP/3k4/8 b - - 4 52,a5,-389,-368,21,1
8/8/4R3/p1r5/2r3P1/P5KP/3k4/8 w - - 0 53,Rd6+,-423,-461,-38,1
8/8/3R4/p1r5/2r3P1/P5KP/3k4/8 b - - 1 53,Kc3,-443,-372,71,1
8/8/3R4/p1r5/2r3P1/P1k3KP/8/8 w - - 2 54,Rf6,-379,-415,-36,1
8/8/5R2/p1r5/2r3P1/P1k3KP/8/8 b - - 3 54,Ra4,-457,-374,83,1
8/8/5R2/p1r5/r5P1/P1k3KP/8/8 w - - 4 55,Rf3+,-353,-398,-45,1
8/8/8/p1r5/r5P1/P1k2RKP/8/8 b - - 5 55,Kb2,-406,-390,16,1
8/8/8/p1r5/r5P1/P4RKP/1k6/8 w - - 6 56,h4,-417,-466,-49,1
8/8/8/p1r5/r5PP/P4RK1/1k6/8 b - - 0 56,Rc2,-412,-323,89,1
8/8/8/p7/r5PP/P4RK1/1kr5/8 w - - 1 57,h5,-308,-378,-70,1
8/8/8/p6P/r5P1/P4RK1/1kr5/8 b - - 0 57,Rxa3,-429,0,429,1
8/8/8/p6P/6P1/r4RK1/1kr5/8 w - - 0 58,Rxa3,-1,0,1,1
8/8/8/p6P/6P1/R5K1/1kr5/8 b - - 0 58,Kxa3,0,0,0,1
8/8/8/p6P/6P1/k5K1/2r5/8 w - - 0 59,h6,0,-170,-170,0
8/8/7P/p7/6P1/k5K1/2r5/8 b - - 0 59,Kb4,-334,4,338,1
rnbqkbnr/pppppppp/8/8/8/8/PPPPPPPP/RNBQKBNR w KQkq - 0 1,e3,35,6,-29,1
rnbqkbnr/pppppppp/8/8/8/4P3/PPPP1PPP/RNBQKBNR b KQkq - 0 1,e5,6,25,19,1
rnbqkbnr/pppp1ppp/8/4p3/8/4P3/PPPP1PPP/RNBQKBNR w KQkq - 0 2,Qf3,12,-115,-127,0
rnbqkbnr/pppp1ppp/8/4p3/8/4PQ2/PPPP1PPP/RNB1KBNR b KQkq - 1 2,Bc5,-117,-12,105,1
rnbqk1nr/pppp1ppp/8/2b1p3/8/4PQ2/PPPP1PPP/RNB1KBNR w KQkq - 2 3,a3,-18,-81,-63,1
rnbqk1nr/pppp1ppp/8/2b1p3/8/P3PQ2/1PPP1PPP/RNB1KBNR b KQkq - 0 3,d6,-54,-44,10,1
rnbqk1nr/ppp2ppp/3p4/2b1p3/8/P3PQ2/1PPP1PPP/RNB1KBNR w KQkq - 0 4,Bc4,-44,-57,-13,1
rnbqk1nr/ppp2ppp/3p4/2b1p3/2B5/P3PQ2/1PPP1PPP/RNB1K1NR b KQkq - 1 4,Nf6,-43,-38,5,1
rnbqk2r/ppp2ppp/3p1n2/2b1p3/2B5/P3PQ2/1PPP1PPP/RNB1K1NR w KQkq - 2 5,h3,-46,-85,-39,1
rnbqk2r/ppp2ppp/3p1n2/2b1p3/2B5/P3PQ1P/1PPP1PP1/RNB1K1NR b KQkq - 0 5,e4,-84,-70,14,1
rnbqk2r/ppp2ppp/3p1n2/2b5/2B1p3/P3PQ1P/1PPP1PP1/RNB1K1NR w KQkq - 0 6,Qg3,-89,-170,-81,1
rnbqk2r/ppp2ppp/3p1n2/2b5/2B1p3/P3P1QP/1PPP1PP1/RNB1K1NR b KQkq - 1 6,d5,-159,-151,8,1
rnbqk2r/ppp2ppp/5n2/2bp4/2B1p3/P3P1QP/1PPP1PP1/RNB1K1NR w KQkq - 0 7,Qxg7,-162,-505,-343,0
rnbqk2r/ppp2pQp/5n2/2bp4/2B1p3/P3P2P/1PPP1PP1/RNB1K1NR b KQkq - 0 7,Rf8,-435,-55,380,1
rnbqkr2/ppp2pQp/5n2/2bp4/2B1p3/P3P2P/1PPP1PP1/RNB1K1NR w KQq - 1 8,Be2,-45,-166,-121,0
rnbqkr2/ppp2pQp/5n2/2bp4/4p3/P3P2P/1PPPBPP1/RNB1K1NR b KQq - 2 8,Rg8,-161,-159,2,1
rnbqk1r1/ppp2pQp/5n2/2bp4/4p3/P3P2P/1PPPBPP1/RNB1K1NR w KQq - 3 9,Qh6,-141,-134,7,1
rnbqk1r1/ppp2p1p/5n1Q/2bp4/4p3/P3P2P/1PPPBPP1/RNB1K1NR b KQq - 4 9,Rxg2,-144,-142,2,1
rnbqk3/ppp2p1p/5n1Q/2bp4/4p3/P3P2P/1PPPBPr1/RNB1K1NR w KQq - 0 10,b4,-132,-190,-58,1
rnbqk3/ppp2p1p/5n1Q/2bp4/1P2p3/P3P2P/2PPBPr1/RNB1K1NR b KQq - 0 10,Bb6,-178,-94,84,1
rnbqk3/ppp2p1p/1b3n1Q/3p4/1P2p3/P3P2P/2PPBPr1/RNB1K1NR w KQq - 1 11,Bb2,-83,-81,2,1
rnbqk3/ppp2p1p/1b3n1Q/3p4/1P2p3/P3P2P/1BPPBPr1/RN2K1NR b KQq - 2 11,Rg6,-75,-76,-1,1
rnbqk3/ppp2p1p/1b3nrQ/3p4/1P2p3/P3P2P/1BPPBP2/RN2K1NR w KQq - 3 12,Qf4,-67,-112,-45,1
rnbqk3/ppp2p1p/1b3nr1/3p4/1P2pQ2/P3P2P/1BPPBP2/RN2K1NR b KQq - 4 12,c5,-109,-52,57,1
rnbqk3/pp3p1p/1b3nr1/2pp4/1P2pQ2/P3P2P/1BPPBP2/RN2K1NR w KQq - 0 13,Bb5+,-55,-54,1,1
rnbqk3/pp3p1p/1b3nr1/1Bpp4/1P2pQ2/P3P2P/1BPP1P2/RN2K1NR b KQq - 1 13,Nbd7,-36,27,63,1
r1bqk3/pp1n1p1p/1b3nr1/1Bpp4/1P2pQ2/P3P2P/1BPP1P2/RN2K1NR w KQq - 2 14,Bxf6,54,-31,-85,1
r1bqk3/pp1n1p1p/1b3Br1/1Bpp4/1P2pQ2/P3P2P/2PP1P2/RN2K1NR b KQq - 0 14,Qxf6,-34,24,58,1
r1b1k3/pp1n1p1p/1b3qr1/1Bpp4/1P2pQ2/P3P2P/2PP1P2/RN2K1NR w KQq - 0 15,Nc3,43,-119,-162,0
r1b1k3/pp1n1p1p/1b3qr1/1Bpp4/1P2pQ2/P1N1P2P/2PP1P2/R3K1NR b KQq - 1 15,d4,-120,191,311,1
r1b1k3/pp1n1p1p/1b3qr1/1Bp5/1P1ppQ2/P1N1P2P/2PP1P2/R3K1NR w KQq - 0 16,Nd5,202,-38,-240,0
r1b1k3/pp1n1p1p/1b3qr1/1BpN4/1P1ppQ2/P3P2P/2PP1P2/R3K1NR b KQq - 1 16,Qg7,-35,132,167,1
r1b1k3/pp1n1pqp/1b4r1/1BpN4/1P1ppQ2/P3P2P/2PP1P2/R3K1NR w KQq - 2 17,Qxe4+,98,0,-98,1
r1b1k3/pp1n1pqp/1b4r1/1BpN4/1P1pQ3/P3P2P/2PP1P2/R3K1NR b KQq - 0 17,Re6,0,0,0,1
r1b1k3/pp1n1pqp/1b2r3/1BpN4/1P1pQ3/P3P2P/2PP1P2/R3K1NR w KQq - 1 18,Qf4,0,-116,-116,0
r1b1k3/pp1n1pqp/1b2r3/1BpN4/1P1p1Q2/P3P2P/2PP1P2/R3K1NR b KQq - 2 18,dxe3,-112,-105,7,1
r1b1k3/pp1n1pqp/1b2r3/1BpN4/1P3Q2/P3p2P/2PP1P2/R3K1NR w KQq - 0 19,fxe3,-91,-347,-256,0
r1b1k3/pp1n1pqp/1b2r3/1BpN4/1P3Q2/P3P2P/2PP4/R3K1NR b KQq - 0 19,Qxa1+,-342,-350,-8,1
r1b1k3/pp1n1p1p/1b2r3/1BpN4/1P3Q2/P3P2P/2PP4/q3K1NR w Kq - 0 20,Ke2,-347,-339,8,1
r1b1k3/pp1n1p1p/1b2r3/1BpN4/1P3Q2/P3P2P/2PPK3/q5NR b q - 1 20,a6,-334,-118,216,1
r1b1k3/1p1n1p1p/pb2r3/1BpN4/1P3Q2/P3P2P/2PPK3/q5NR w q - 0 21,Bxd7+,-161,-348,-187,0
r1b1k3/1p1B1p1p/pb2r3/2pN4/1P3Q2/P3P2P/2PPK3/q5NR b q - 0 21,Bxd7,-345,-332,13,1
r3k3/1p1b1p1p/pb2r3/2pN4/1P3Q2/P3P2P/2PPK3/q5NR w q - 0 22,Nxb6,-381,-532,-151,0
r3k3/1p1b1p1p/pN2r3/2p5/1P3Q2/P3P2P/2PPK3/q5NR b q - 0 22,Rf6,-500,0,500,1
r3k3/1p1b1p1p/pN3r2/2p5/1P3Q2/P3P2P/2PPK3/q5NR w q - 1 23,Qe4+,0,-310,-310,0
r3k3/1p1b1p1p/pN3r2/2p5/1P2Q3/P3P2P/2PPK3/q5NR b q - 2 23,Be6,-329,-368,-39,1
r3k3/1p3p1p/pN2br2/2p5/1P2Q3/P3P2P/2PPK3/q5NR w q - 3 24,Nf3,-362,-516,-154,0
r3k3/1p3p1p/pN2br2/2p5/1P2Q3/P3PN1P/2PPK3/q6R b q - 4 24,Qxh1,-507,-551,-44,1
r3k3/1p3p1p/pN2br2/2p5/1P2Q3/P3PN1P/2PPK3/7q w q - 0 25,Nd5,-535,-590,-55,1
r3k3/1p3p1p/p3br2/2pN4/1P2Q3/P3PN1P/2PPK3/7q b q - 1 25,Rg6,-592,-513,79,1
r3k3/1p3p1p/p3b1r1/2pN4/1P2Q3/P3PN1P/2PPK3/7q w q - 2 26,Nc7+,-492,-535,-43,1
r3k3/1pN2p1p/p3b1r1/2p5/1P2Q3/P3PN1P/2PPK3/7q b q - 3 26,Kf8,-522,-519,3,1
r4k2/1pN2p1p/p3b1r1/2p5/1P2Q3/P3PN1P/2PPK3/7q w - - 4 27,Nxe6+,-549,-573,-24,1
r4k2/1p3p1p/p3N1r1/2p5/1P2Q3/P3PN1P/2PPK3/7q b - - 0 27,fxe6,-562,-510,52,1
r4k2/1p5p/p3p1r1/2p5/1P2Q3/P3PN1P/2PPK3/7q w - - 0 28,Qf4+,-531,-667,-136,0
r4k2/1p5p/p3p1r1/2p5/1P3Q2/P3PN1P/2PPK3/7q b - - 1 28,Kg8,-684,-687,-3,1
r5k1/1p5p/p3p1r1/2p5/1P3Q2/P3PN1P/2PPK3/7q w - - 2 29,Ne5,-683,-719,-36,1
r5k1/1p5p/p3p1r1/2p1N3/1P3Q2/P3P2P/2PPK3/7q b - - 3 29,Rg2+,-715,-759,-44,1
r5k1/1p5p/p3p3/2p1N3/1P3Q2/P3P2P/2PPK1r1/7q w - - 4 30,Kd3,-744,-735,9,1
r5k1/1p5p/p3p3/2p1N3/1P3Q2/P2KP2P/2PP2r1/7q b - - 5 30,Rd8+,-739,-547,192,1
3r2k1/1p5p/p3p3/2p1N3/1P3Q2/P2KP2P/2PP2r1/7q w - - 6 31,Kc4,-506,-561,-55,1
3r2k1/1p5p/p3p3/2p1N3/1PK2Q2/P3P2P/2PP2r1/7q b - - 7 31,Rgxd2,-615,0,615,1
3r2k1/1p5p/p3p3/2p1N3/1PK2Q2/P3P2P/2Pr4/7q w - - 0 32,Qg5+,0,0,0,1
3r2k1/1p5p/p3p3/2p1N1Q1/1PK5/P3P2P/2Pr4/7q b - - 1 32,Kf8,0,0,0,1
3r1k2/1p5p/p3p3/2p1N1Q1/1PK5/P3P2P/2Pr4/7q w - - 2 33,Qh6+,0,0,0,1
3r1k2/1p5p/p3p2Q/2p1N3/1PK5/P3P2P/2Pr4/7q b - - 3 33,Ke7,0,9998,9998,1
3r4/1p2k2p/p3p2Q/2p1N3/1PK5/P3P2P/2Pr4/7q w - - 4 34,Qxh7+,9998,-340,-10338,0
3r4/1p2k2Q/p3p3/2p1N3/1PK5/P3P2P/2Pr4/7q b - - 0 34,Kd6,-472,-481,-9,1
3r4/1p5Q/p2kp3/2p1N3/1PK5/P3P2P/2Pr4/7q w - - 1 35,Nf7+,-534,-546,-12,1
3r4/1p3N1Q/p2kp3/2p5/1PK5/P3P2P/2Pr4/7q b - - 2 35,Ke7,-530,-365,165,1
3r4/1p2kN1Q/p3p3/2p5/1PK5/P3P2P/2Pr4/7q w - - 3 36,Nxd8+,-404,-459,-55,1
3N4/1p2k2Q/p3p3/2p5/1PK5/P3P2P/2Pr4/7q b - - 0 36,Kxd8,-467,-438,29,1
3k4/1p5Q/p3p3/2p5/1PK5/P3P2P/2Pr4/7q w - - 0 37,Qg8+,-468,-546,-78,1
3k2Q1/1p6/p3p3/2p5/1PK5/P3P2P/2Pr4/7q b - - 1 37,Kc7,-486,-463,23,1
6Q1/1pk5/p3p3/2p5/1PK5/P3P2P/2Pr4/7q w - - 2 38,Qf7+,-512,-515,-3,1
8/1pk2Q2/p3p3/2p5/1PK5/P3P2P/2Pr4/7q b - - 3 38,Kb6,-541,-488,53,1
8/1p3Q2/pk2p3/2p5/1PK5/P3P2P/2Pr4/7q w - - 4 39,Qxe6+,-556,-599,-43,1
8/1p6/pk2Q3/2p5/1PK5/P3P2P/2Pr4/7q b - - 0 39,Ka7,-607,-568,39,1
8/kp6/p3Q3/2p5/1PK5/P3P2P/2Pr4/7q w - - 1 40,Qf5,-571,-543,28,1
8/kp6/p7/2p2Q2/1PK5/P3P2P/2Pr4/7q b - - 2 40,Qa1,-589,-395,194,1
8/kp6/p7/2p2Q2/1PK5/P3P2P/2Pr4/q7 w - - 3 41,Qxc5+,-408,-418,-10,1
8/kp6/p7/2Q5/1PK5/P3P2P/2Pr4/q7 b - - 0 41,Kb8,-438,-440,-2,1
1k6/1p6/p7/2Q5/1PK5/P3P2P/2Pr4/q7 w - - 1 42,Qf8+,-424,-441,-17,1
1k3Q2/1p6/p7/8/1PK5/P3P2P/2Pr4/q7 b - - 2 42,Kc7,-440,-451,-11,1
5Q2/1pk5/p7/8/1PK5/P3P2P/2Pr4/q7 w - - 3 43,Qf7+,-446,-584,-138,0
8/1pk2Q2/p7/8/1PK5/P3P2P/2Pr4/q7 b - - 4 43,Rd7,-624,-643,-19,1
8/1pkr1Q2/p7/8/1PK5/P3P2P/2P5/q7 w - - 5 44,Qf4+,-635,-597,38,1
8/1pkr4/p7/8/1PK2Q2/P3P2P/2P5/q7 b - - 6 44,Kc8,-636,-564,72,1
rnbqkbnr/pppppppp/8/8/8/8/PPPPPPPP/RNBQKBNR w KQkq - 0 1,d4,32,17,-15,1
rnbqkbnr/pppppppp/8/8/3P4/8/PPP1PPPP/RNBQKBNR b KQkq - 0 1,d5,22,24,2,1
rnbqkbnr/ppp1pppp/8/3p4/3P4/8/PPP1PPPP/RNBQKBNR w KQkq - 0 2,Bf4,26,13,-13,1
rnbqkbnr/ppp1pppp/8/3p4/3P1B2/8/PPP1PPPP/RN1QKBNR b KQkq - 1 2,e6,12,13,1,1
rnbqkbnr/ppp2ppp/4p3/3p4/3P1B2/8/PPP1PPPP/RN1QKBNR w KQkq - 0 3,a3,15,-12,-27,1
rnbqkbnr/ppp2ppp/4p3/3p4/3P1B2/P7/1PP1PPPP/RN1QKBNR b KQkq - 0 3,Bd6,-6,3,9,1
rnbqk1nr/ppp2ppp/3bp3/3p4/3P1B2/P7/1PP1PPPP/RN1QKBNR w KQkq - 1 4,Qd2,-2,-28,-26,1
rnbqk1nr/ppp2ppp/3bp3/3p4/3P1B2/P7/1PPQPPPP/RN2KBNR b KQkq - 2 4,Bxf4,-26,19,45,1
rnbqk1nr/ppp2ppp/4p3/3p4/3P1b2/P7/1PPQPPPP/RN2KBNR w KQkq - 0 5,Qxf4,34,25,-9,1
rnbqk1nr/ppp2ppp/4p3/3p4/3P1Q2/P7/1PP1PPPP/RN2KBNR b KQkq - 0 5,Nf6,29,35,6,1
rnbqk2r/ppp2ppp/4pn2/3p4/3P1Q2/P7/1PP1PPPP/RN2KBNR w KQkq - 1 6,Nc3,33,33,0,1
rnbqk2r/ppp2ppp/4pn2/3p4/3P1Q2/P1N5/1PP1PPPP/R3KBNR b KQkq - 2 6,O-O,18,39,21,1
rnbq1rk1/ppp2ppp/4pn2/3p4/3P1Q2/P1N5/1PP1PPPP/R3KBNR w KQ - 3 7,Nb5,39,-109,-148,0
rnbq1rk1/ppp2ppp/4pn2/1N1p4/3P1Q2/P7/1PP1PPPP/R3KBNR b KQ - 4 7,Na6,-94,-2,92,1
r1bq1rk1/ppp2ppp/n3pn2/1N1p4/3P1Q2/P7/1PP1PPPP/R3KBNR w KQ - 5 8,e3,-20,-30,-10,1
r1bq1rk1/ppp2ppp/n3pn2/1N1p4/3P1Q2/P3P3/1PP2PPP/R3KBNR b KQ - 0 8,c6,-39,7,46,1
r1bq1rk1/pp3ppp/n1p1pn2/1N1p4/3P1Q2/P3P3/1PP2PPP/R3KBNR w KQ - 0 9,Nc3,29,-19,-48,1
r1bq1rk1/pp3ppp/n1p1pn2/3p4/3P1Q2/P1N1P3/1PP2PPP/R3KBNR b KQ - 1 9,b5,24,34,10,1
r1bq1rk1/p4ppp/n1p1pn2/1p1p4/3P1Q2/P1N1P3/1PP2PPP/R3KBNR w KQ - 0 10,Be2,25,-40,-65,1
r1bq1rk1/p4ppp/n1p1pn2/1p1p4/3P1Q2/P1N1P3/1PP1BPPP/R3K1NR b KQ - 1 10,Bb7,-31,47,78,1
r2q1rk1/pb3ppp/n1p1pn2/1p1p4/3P1Q2/P1N1P3/1PP1BPPP/R3K1NR w KQ - 2 11,g4,30,-44,-74,1
r2q1rk1/pb3ppp/n1p1pn2/1p1p4/3P1QP1/P1N1P3/1PP1BP1P/R3K1NR b KQ - 0 11,Qe7,-43,36,79,1
r4rk1/pb2qppp/n1p1pn2/1p1p4/3P1QP1/P1N1P3/1PP1BP1P/R3K1NR w KQ - 1 12,h4,39,-50,-89,1
r4rk1/pb2qppp/n1p1pn2/1p1p4/3P1QPP/P1N1P3/1PP1BP2/R3K1NR b KQ - 0 12,c5,-42,117,159,1
r4rk1/pb2qppp/n3pn2/1ppp4/3P1QPP/P1N1P3/1PP1BP2/R3K1NR w KQ - 0 13,Nxb5,110,110,0,1
r4rk1/pb2qppp/n3pn2/1Npp4/3P1QPP/P3P3/1PP1BP2/R3K1NR b KQ - 0 13,cxd4,91,141,50,1
r4rk1/pb2qppp/n3pn2/1N1p4/3p1QPP/P3P3/1PP1BP2/R3K1NR w KQ - 0 14,exd4,114,114,0,1
r4rk1/pb2qppp/n3pn2/1N1p4/3P1QPP/P7/1PP1BP2/R3K1NR b KQ - 0 14,Ne4,104,223,119,1
r4rk1/pb2qppp/n3p3/1N1p4/3PnQPP/P7/1PP1BP2/R3K1NR w KQ - 1 15,f3,214,226,12,1
r4rk1/pb2qppp/n3p3/1N1p4/3PnQPP/P4P2/1PP1B3/R3K1NR b KQ - 0 15,f6,223,314,91,1
r4rk1/pb2q1pp/n3pp2/1N1p4/3PnQPP/P4P2/1PP1B3/R3K1NR w KQ - 0 16,fxe4,349,346,-3,1
r4rk1/pb2q1pp/n3pp2/1N1p4/3PPQPP/P7/1PP1B3/R3K1NR b KQ - 0 16,e5,331,356,25,1
r4rk1/pb2q1pp/n4p2/1N1pp3/3PPQPP/P7/1PP1B3/R3K1NR w KQ - 0 17,Qd2,344,371,27,1
r4rk1/pb2q1pp/n4p2/1N1pp3/3PP1PP/P7/1PPQB3/R3K1NR b KQ - 1 17,dxe4,371,384,13,1
r4rk1/pb2q1pp/n4p2/1N2p3/3Pp1PP/P7/1PPQB3/R3K1NR w KQ - 0 18,Qe3,383,353,-30,1
r4rk1/pb2q1pp/n4p2/1N2p3/3Pp1PP/P3Q3/1PP1B3/R3K1NR b KQ - 1 18,exd4,330,437,107,1
r4rk1/pb2q1pp/n4p2/1N6/3pp1PP/P3Q3/1PP1B3/R3K1NR w KQ - 0 19,Nxd4,434,384,-50,1
r4rk1/pb2q1pp/n4p2/8/3Np1PP/P3Q3/1PP1B3/R3K1NR b KQ - 0 19,Nc5,351,385,34,1
r4rk1/pb2q1pp/5p2/2n5/3Np1PP/P3Q3/1PP1B3/R3K1NR w KQ - 1 20,Nf5,393,335,-58,1
r4rk1/pb2q1pp/5p2/2n2N2/4p1PP/P3Q3/1PP1B3/R3K1NR b KQ - 2 20,Qf7,332,485,153,1
r4rk1/pb3qpp/5p2/2n2N2/4p1PP/P3Q3/1PP1B3/R3K1NR w KQ - 3 21,Qxc5,546,505,-41,1
r4rk1/pb3qpp/5p2/2Q2N2/4p1PP/P7/1PP1B3/R3K1NR b KQ - 0 21,Rac8,516,569,53,1
2r2rk1/pb3qpp/5p2/2Q2N2/4p1PP/P7/1PP1B3/R3K1NR w KQ - 1 22,Qb4,569,455,-114,0
2r2rk1/pb3qpp/5p2/5N2/1Q2p1PP/P7/1PP1B3/R3K1NR b KQ - 2 22,Rxc2,511,492,-19,1
5rk1/pb3qpp/5p2/5N2/1Q2p1PP/P7/1Pr1B3/R3K1NR w KQ - 0 23,Nd6,503,395,-108,0
5rk1/pb3qpp/3N1p2/8/1Q2p1PP/P7/1Pr1B3/R3K1NR b KQ - 1 23,Qe7,400,503,103,1
5rk1/pb2q1pp/3N1p2/8/1Q2p1PP/P7/1Pr1B3/R3K1NR w KQ - 2 24,Rh3,500,455,-45,1
5rk1/pb2q1pp/3N1p2/8/1Q2p1PP/P6R/1Pr1B3/R3K1N1 b Q - 3 24,Bd5,479,519,40,1
5rk1/p3q1pp/3N1p2/3b4/1Q2p1PP/P6R/1Pr1B3/R3K1N1 w Q - 4 25,Bc4,556,274,-282,0
5rk1/p3q1pp/3N1p2/3b4/1QB1p1PP/P6R/1Pr5/R3K1N1 b Q - 5 25,Bxc4,246,257,11,1
5rk1/p3q1pp/3N1p2/8/1Qb1p1PP/P6R/1Pr5/R3K1N1 w Q - 0 26,Nxc4,244,228,-16,1
5rk1/p3q1pp/5p2/8/1QN1p1PP/P6R/1Pr5/R3K1N1 b Q - 0 26,e3,219,739,520,1
5rk1/p3q1pp/5p2/8/1QN3PP/P3p2R/1Pr5/R3K1N1 w Q - 0 27,Qxe7,690,694,4,1
5rk1/p3Q1pp/5p2/8/2N3PP/P3p2R/1Pr5/R3K1N1 b Q - 0 27,Rxc4,728,921,193,1
5rk1/p3Q1pp/5p2/8/2r3PP/P3p2R/1P6/R3K1N1 w Q - 0 28,Rxe3,913,737,-176,0
5rk1/p3Q1pp/5p2/8/2r3PP/P3R3/1P6/R3K1N1 b Q - 0 28,Rc2,705,721,16,1
5rk1/p3Q1pp/5p2/8/6PP/P3R3/1Pr5/R3K1N1 w Q - 1 29,Qe6+,781,727,-54,1
5rk1/p5pp/4Qp2/8/6PP/P3R3/1Pr5/R3K1N1 b Q - 2 29,Kh8,747,777,30,1
5r1k/p5pp/4Qp2/8/6PP/P3R3/1Pr5/R3K1N1 w Q - 3 30,Ne2,769,748,-21,1
5r1k/p5pp/4Qp2/8/6PP/P3R3/1Pr1N3/R3K3 b Q - 4 30,Rxb2,745,733,-12,1
5r1k/p5pp/4Qp2/8/6PP/P3R3/1r2N3/R3K3 w Q - 0 31,Qe7,714,718,4,1
5r1k/p3Q1pp/5p2/8/6PP/P3R3/1r2N3/R3K3 b Q - 1 31,Rb6,704,9999,9295,1
5r1k/p3Q1pp/1r3p2/8/6PP/P3R3/4N3/R3K3 w Q - 2 32,Qxf8#,9999,10000,1,1
rnbqkbnr/pppppppp/8/8/8/8/PPPPPPPP/RNBQKBNR w KQkq - 0 1,e4,35,36,1,1
rnbqkbnr/pppppppp/8/8/4P3/8/PPPP1PPP/RNBQKBNR b KQkq - 0 1,d5,36,75,39,1
rnbqkbnr/ppp1pppp/8/3p4/4P3/8/PPPP1PPP/RNBQKBNR w KQkq - 0 2,exd5,66,65,-1,1
rnbqkbnr/ppp1pppp/8/3P4/8/8/PPPP1PPP/RNBQKBNR b KQkq - 0 2,Qxd5,73,66,-7,1
rnb1kbnr/ppp1pppp/8/3q4/8/8/PPPP1PPP/RNBQKBNR w KQkq - 0 3,Nf3,64,50,-14,1
rnb1kbnr/ppp1pppp/8/3q4/8/5N2/PPPP1PPP/RNBQKB1R b KQkq - 1 3,Bg4,48,52,4,1
rn2kbnr/ppp1pppp/8/3q4/6b1/5N2/PPPP1PPP/RNBQKB1R w KQkq - 2 4,Be2,30,27,-3,1
rn2kbnr/ppp1pppp/8/3q4/6b1/5N2/PPPPBPPP/RNBQK2R b KQkq - 3 4,Qe6,25,120,95,1
rn2kbnr/ppp1pppp/4q3/8/6b1/5N2/PPPPBPPP/RNBQK2R w KQkq - 4 5,O-O,138,135,-3,1
rn2kbnr/ppp1pppp/4q3/8/6b1/5N2/PPPPBPPP/RNBQ1RK1 b kq - 5 5,Nc6,130,132,2,1
r3kbnr/ppp1pppp/2n1q3/8/6b1/5N2/PPPPBPPP/RNBQ1RK1 w kq - 6 6,d4,137,128,-9,1
r3kbnr/ppp1pppp/2n1q3/8/3P2b1/5N2/PPP1BPPP/RNBQ1RK1 b kq - 0 6,Nf6,124,122,-2,1
r3kb1r/ppp1pppp/2n1qn2/8/3P2b1/5N2/PPP1BPPP/RNBQ1RK1 w kq - 1 7,c4,130,107,-23,1
r3kb1r/ppp1pppp/2n1qn2/8/2PP2b1/5N2/PP2BPPP/RNBQ1RK1 b kq - 0 7,Bxf3,76,96,20,1
r3kb1r/ppp1pppp/2n1qn2/8/2PP4/5b2/PP2BPPP/RNBQ1RK1 w kq - 0 8,Bxf3,144,100,-44,1
r3kb1r/ppp1pppp/2n1qn2/8/2PP4/5B2/PP3PPP/RNBQ1RK1 b kq - 0 8,Qxc4,90,112,22,1
r3kb1r/ppp1pppp/2n2n2/8/2qP4/5B2/PP3PPP/RNBQ1RK1 w kq - 0 9,Nc3,160,-74,-234,0
r3kb1r/ppp1pppp/2n2n2/8/2qP4/2N2B2/PP3PPP/R1BQ1RK1 b kq - 1 9,Qxd4,-69,712,781,1
r3kb1r/ppp1pppp/2n2n2/8/3q4/2N2B2/PP3PPP/R1BQ1RK1 w kq - 0 10,Qe2,695,42,-653,0
r3kb1r/ppp1pppp/2n2n2/8/3q4/2N2B2/PP2QPPP/R1B2RK1 b kq - 1 10,Rb8,38,336,298,1
1r2kb1r/ppp1pppp/2n2n2/8/3q4/2N2B2/PP2QPPP/R1B2RK1 w k - 2 11,Be3,310,168,-142,0
1r2kb1r/ppp1pppp/2n2n2/8/3q4/2N1BB2/PP2QPPP/R4RK1 b k - 3 11,Qb4,202,319,117,1
1r2kb1r/ppp1pppp/2n2n2/8/1q6/2N1BB2/PP2QPPP/R4RK1 w k - 4 12,a3,322,235,-87,1
1r2kb1r/ppp1pppp/2n2n2/8/1q6/P1N1BB2/1P2QPPP/R4RK1 b k - 0 12,Qb3,256,257,1,1
1r2kb1r/ppp1pppp/2n2n2/8/8/PqN1BB2/1P2QPPP/R4RK1 w k - 1 13,Rac1,297,80,-217,0
1r2kb1r/ppp1pppp/2n2n2/8/8/PqN1BB2/1P2QPPP/2R2RK1 b k - 2 13,e5,79,228,149,1
1r2kb1r/ppp2ppp/2n2n2/4p3/8/PqN1BB2/1P2QPPP/2R2RK1 w k - 0 14,Ne4,243,9,-234,0
1r2kb1r/ppp2ppp/2n2n2/4p3/4N3/Pq2BB2/1P2QPPP/2R2RK1 b k - 1 14,Nxe4,3,13,10,1
1r2kb1r/ppp2ppp/2n5/4p3/4n3/Pq2BB2/1P2QPPP/2R2RK1 w k - 0 15,Bxe4,30,25,-5,1
1r2kb1r/ppp2ppp/2n5/4p3/4B3/Pq2B3/1P2QPPP/2R2RK1 b k - 0 15,Bd6,24,38,14,1
1r2k2r/ppp2ppp/2nb4/4p3/4B3/Pq2B3/1P2QPPP/2R2RK1 w k - 1 16,Rc3,34,21,-13,1
1r2k2r/ppp2ppp/2nb4/4p3/4B3/PqR1B3/1P2QPPP/5RK1 b k - 2 16,Qa4,27,68,41,1
1r2k2r/ppp2ppp/2nb4/4p3/q3B3/P1R1B3/1P2QPPP/5RK1 w k - 3 17,Rfc1,59,-402,-461,0
1r2k2r/ppp2ppp/2nb4/4p3/q3B3/P1R1B3/1P2QPPP/2R3K1 b k - 4 17,Qxe4,-421,-448,-27,1
rnbqkbnr/pppppppp/8/8/8/8/PPPPPPPP/RNBQKBNR w KQkq - 0 1,e4,39,26,-13,1
rnbqkbnr/pppppppp/8/8/4P3/8/PPPP1PPP/RNBQKBNR b KQkq - 0 1,e6,36,42,6,1
rnbqkbnr/pppp1ppp/4p3/8/4P3/8/PPPP1PPP/RNBQKBNR w KQkq - 0 2,d4,50,53,3,1
rnbqkbnr/pppp1ppp/4p3/8/3PP3/8/PPP2PPP/RNBQKBNR b KQkq - 0 2,d5,41,49,8,1
rnbqkbnr/ppp2ppp/4p3/3p4/3PP3/8/PPP2PPP/RNBQKBNR w KQkq - 0 3,e5,43,48,5,1
rnbqkbnr/ppp2ppp/4p3/3pP3/3P4/8/PPP2PPP/RNBQKBNR b KQkq - 0 3,c5,49,52,3,1
rnbqkbnr/pp3ppp/4p3/2ppP3/3P4/8/PPP2PPP/RNBQKBNR w KQkq - 0 4,f4,44,-33,-77,1
rnbqkbnr/pp3ppp/4p3/2ppP3/3P1P2/8/PPP3PP/RNBQKBNR b KQkq - 0 4,Ne7,-37,13,50,1
rnbqkb1r/pp2nppp/4p3/2ppP3/3P1P2/8/PPP3PP/RNBQKBNR w KQkq - 1 5,Nf3,11,4,-7,1
rnbqkb1r/pp2nppp/4p3/2ppP3/3P1P2/5N2/PPP3PP/RNBQKB1R b KQkq - 2 5,Nf5,-6,17,23,1
rnbqkb1r/pp3ppp/4p3/2ppPn2/3P1P2/5N2/PPP3PP/RNBQKB1R w KQkq - 3 6,Bb5+,24,-67,-91,1
rnbqkb1r/pp3ppp/4p3/1BppPn2/3P1P2/5N2/PPP3PP/RNBQK2R b KQkq - 4 6,Nc6,-80,-68,12,1
r1bqkb1r/pp3ppp/2n1p3/1BppPn2/3P1P2/5N2/PPP3PP/RNBQK2R w KQkq - 5 7,Bxc6+,-65,-178,-113,0
r1bqkb1r/pp3ppp/2B1p3/2ppPn2/3P1P2/5N2/PPP3PP/RNBQK2R b KQkq - 0 7,bxc6,-185,-206,-21,1
r1bqkb1r/p4ppp/2p1p3/2ppPn2/3P1P2/5N2/PPP3PP/RNBQK2R w KQkq - 0 8,c3,-204,-193,11,1
r1bqkb1r/p4ppp/2p1p3/2ppPn2/3P1P2/2P2N2/PP4PP/RNBQK2R b KQkq - 0 8,cxd4,-191,-206,-15,1
r1bqkb1r/p4ppp/2p1p3/3pPn2/3p1P2/2P2N2/PP4PP/RNBQK2R w KQkq - 0 9,cxd4,-212,-201,11,1
r1bqkb1r/p4ppp/2p1p3/3pPn2/3P1P2/5N2/PP4PP/RNBQK2R b KQkq - 0 9,Bb4+,-223,-71,152,1
r1bqk2r/p4ppp/2p1p3/3pPn2/1b1P1P2/5N2/PP4PP/RNBQK2R w KQkq - 1 10,Bd2,-66,-121,-55,1
r1bqk2r/p4ppp/2p1p3/3pPn2/1b1P1P2/5N2/PP1B2PP/RN1QK2R b KQkq - 2 10,Qa5,-117,43,160,1
r1b1k2r/p4ppp/2p1p3/q2pPn2/1b1P1P2/5N2/PP1B2PP/RN1QK2R w KQkq - 3 11,Bxb4,48,-24,-72,1
r1b1k2r/p4ppp/2p1p3/q2pPn2/1B1P1P2/5N2/PP4PP/RN1QK2R b KQkq - 0 11,Qxb4+,-42,-25,17,1
r1b1k2r/p4ppp/2p1p3/3pPn2/1q1P1P2/5N2/PP4PP/RN1QK2R w KQkq - 0 12,Nc3,-38,-192,-154,0
r1b1k2r/p4ppp/2p1p3/3pPn2/1q1P1P2/2N2N2/PP4PP/R2QK2R b KQkq - 1 12,Qxb2,-214,-234,-20,1
r1b1k2r/p4ppp/2p1p3/3pPn2/3P1P2/2N2N2/Pq4PP/R2QK2R w KQkq - 0 13,O-O,-227,-400,-173,0
r1b1k2r/p4ppp/2p1p3/3pPn2/3P1P2/2N2N2/Pq4PP/R2Q1RK1 b kq - 1 13,Qxc3,-367,-363,4,1
r1b1k2r/p4ppp/2p1p3/3pPn2/3P1P2/2q2N2/P5PP/R2Q1RK1 w kq - 0 14,Rc1,-351,-362,-11,1
r1b1k2r/p4ppp/2p1p3/3pPn2/3P1P2/2q2N2/P5PP/2RQ1RK1 b kq - 1 14,Qb2,-369,-308,61,1
r1b1k2r/p4ppp/2p1p3/3pPn2/3P1P2/5N2/Pq4PP/2RQ1RK1 w kq - 2 15,Rxc6,-346,-436,-90,1
r1b1k2r/p4ppp/2R1p3/3pPn2/3P1P2/5N2/Pq4PP/3Q1RK1 b kq - 0 15,Bd7,-392,-418,-26,1
r3k2r/p2b1ppp/2R1p3/3pPn2/3P1P2/5N2/Pq4PP/3Q1RK1 w kq - 1 16,Qa4,-396,-608,-212,0
r3k2r/p2b1ppp/2R1p3/3pPn2/Q2P1P2/5N2/Pq4PP/5RK1 b kq - 2 16,O-O,-646,-546,100,1
r4rk1/p2b1ppp/2R1p3/3pPn2/Q2P1P2/5N2/Pq4PP/5RK1 w - - 3 17,Qc2,-557,-481,76,1
r4rk1/p2b1ppp/2R1p3/3pPn2/3P1P2/5N2/PqQ3PP/5RK1 b - - 4 17,Qb4,-479,-394,85,1
r4rk1/p2b1ppp/2R1p3/3pPn2/1q1P1P2/5N2/P1Q3PP/5RK1 w - - 5 18,Qc3,-423,-427,-4,1
r4rk1/p2b1ppp/2R1p3/3pPn2/1q1P1P2/2Q2N2/P5PP/5RK1 b - - 6 18,Qa4,-483,-448,35,1
r4rk1/p2b1ppp/2R1p3/3pPn2/q2P1P2/2Q2N2/P5PP/5RK1 w - - 7 19,Rc5,-465,-453,12,1
r4rk1/p2b1ppp/4p3/2RpPn2/q2P1P2/2Q2N2/P5PP/5RK1 b - - 8 19,Rfc8,-462,-470,-8,1
r1r3k1/p2b1ppp/4p3/2RpPn2/q2P1P2/2Q2N2/P5PP/5RK1 w - - 9 20,Rxc8+,-439,-570,-131,0
r1R3k1/p2b1ppp/4p3/3pPn2/q2P1P2/2Q2N2/P5PP/5RK1 b - - 0 20,Rxc8,-582,-484,98,1
2r3k1/p2b1ppp/4p3/3pPn2/q2P1P2/2Q2N2/P5PP/5RK1 w - - 0 21,Qd2,-499,-529,-30,1
2r3k1/p2b1ppp/4p3/3pPn2/q2P1P2/5N2/P2Q2PP/5RK1 b - - 1 21,Rc2,-492,-462,30,1
6k1/p2b1ppp/4p3/3pPn2/q2P1P2/5N2/P1rQ2PP/5RK1 w - - 2 22,Qd1,-475,-496,-21,1
6k1/p2b1ppp/4p3/3pPn2/q2P1P2/5N2/P1r3PP/3Q1RK1 b - - 3 22,Ne3,-549,-497,52,1
6k1/p2b1ppp/4p3/3pP3/q2P1P2/4nN2/P1r3PP/3Q1RK1 w - - 4 23,Qxc2,-456,-717,-261,0
6k1/p2b1ppp/4p3/3pP3/q2P1P2/4nN2/P1Q3PP/5RK1 b - - 0 23,Qxc2,-732,-757,-25,1
6k1/p2b1ppp/4p3/3pP3/3P1P2/4nN2/P1q3PP/5RK1 w - - 0 24,h3,-768,-9999,-9231,0
6k1/p2b1ppp/4p3/3pP3/3P1P2/4nN1P/P1q3P1/5RK1 b - - 0 24,Qxg2#,-9999,-10000,-1,1
rnbqkbnr/pppppppp/8/8/8/8/PPPPPPPP/RNBQKBNR w KQkq - 0 1,e4,29,23,-6,1
rnbqkbnr/pppppppp/8/8/4P3/8/PPPP1PPP/RNBQKBNR b KQkq - 0 1,d6,27,46,19,1
rnbqkbnr/ppp1pppp/3p4/8/4P3/8/PPPP1PPP/RNBQKBNR w KQkq - 0 2,d4,53,48,-5,1
rnbqkbnr/ppp1pppp/3p4/8/3PP3/8/PPP2PPP/RNBQKBNR b KQkq - 0 2,e5,39,47,8,1
rnbqkbnr/ppp2ppp/3p4/4p3/3PP3/8/PPP2PPP/RNBQKBNR w KQkq - 0 3,d5,54,19,-35,1
rnbqkbnr/ppp2ppp/3p4/3Pp3/4P3/8/PPP2PPP/RNBQKBNR b KQkq - 0 3,Nf6,21,21,0,1
rnbqkb1r/ppp2ppp/3p1n2/3Pp3/4P3/8/PPP2PPP/RNBQKBNR w KQkq - 1 4,f3,29,18,-11,1
rnbqkb1r/ppp2ppp/3p1n2/3Pp3/4P3/5P2/PPP3PP/RNBQKBNR b KQkq - 0 4,Be7,15,24,9,1
rnbqk2r/ppp1bppp/3p1n2/3Pp3/4P3/5P2/PPP3PP/RNBQKBNR w KQkq - 1 5,Nc3,35,-7,-42,1
rnbqk2r/ppp1bppp/3p1n2/3Pp3/4P3/2N2P2/PPP3PP/R1BQKBNR b KQkq - 2 5,O-O,-12,14,26,1
rnbq1rk1/ppp1bppp/3p1n2/3Pp3/4P3/2N2P2/PPP3PP/R1BQKBNR w KQ - 3 6,g4,29,-18,-47,1
rnbq1rk1/ppp1bppp/3p1n2/3Pp3/4P1P1/2N2P2/PPP4P/R1BQKBNR b KQ - 0 6,c6,-15,-1,14,1
rnbq1rk1/pp2bppp/2pp1n2/3Pp3/4P1P1/2N2P2/PPP4P/R1BQKBNR w KQ - 0 7,h4,-1,-74,-73,1
rnbq1rk1/pp2bppp/2pp1n2/3Pp3/4P1PP/2N2P2/PPP5/R1BQKBNR b KQ - 0 7,cxd5,-79,-57,22,1
rnbq1rk1/pp2bppp/3p1n2/3pp3/4P1PP/2N2P2/PPP5/R1BQKBNR w KQ - 0 8,Nxd5,-86,-277,-191,0
rnbq1rk1/pp2bppp/3p1n2/3Np3/4P1PP/5P2/PPP5/R1BQKBNR b KQ - 0 8,Nxd5,-249,-287,-38,1
rnbq1rk1/pp2bppp/3p4/3np3/4P1PP/5P2/PPP5/R1BQKBNR w KQ - 0 9,Qxd5,-270,-270,0,1
rnbq1rk1/pp2bppp/3p4/3Qp3/4P1PP/5P2/PPP5/R1B1KBNR b KQ - 0 9,g6,-254,-52,202,1
rnbq1rk1/pp2bp1p/3p2p1/3Qp3/4P1PP/5P2/PPP5/R1B1KBNR w KQ - 0 10,Nh3,-67,-128,-61,1
rnbq1rk1/pp2bp1p/3p2p1/3Qp3/4P1PP/5P1N/PPP5/R1B1KB1R b KQ - 1 10,Nd7,-149,12,161,1
r1bq1rk1/pp1nbp1p/3p2p1/3Qp3/4P1PP/5P1N/PPP5/R1B1KB1R w KQ - 2 11,Ng5,17,-129,-146,0
r1bq1rk1/pp1nbp1p/3p2p1/3Qp1N1/4P1PP/5P2/PPP5/R1B1KB1R b KQ - 3 11,Bxg5,-132,261,393,1
r1bq1rk1/pp1n1p1p/3p2p1/3Qp1b1/4P1PP/5P2/PPP5/R1B1KB1R w KQ - 0 12,hxg5,262,169,-93,1
r1bq1rk1/pp1n1p1p/3p2p1/3Qp1P1/4P1P1/5P2/PPP5/R1B1KB1R b KQ - 0 12,Kh8,101,338,237,1
r1bq1r1k/pp1n1p1p/3p2p1/3Qp1P1/4P1P1/5P2/PPP5/R1B1KB1R w KQ - 1 13,f4,339,136,-203,0
r1bq1r1k/pp1n1p1p/3p2p1/3Qp1P1/4PPP1/8/PPP5/R1B1KB1R b KQ - 0 13,f6,177,259,82,1
r1bq1r1k/pp1n3p/3p1pp1/3Qp1P1/4PPP1/8/PPP5/R1B1KB1R w KQ - 0 14,f5,301,274,-27,1
r1bq1r1k/pp1n3p/3p1pp1/3QpPP1/4P1P1/8/PPP5/R1B1KB1R b KQ - 0 14,fxg5,279,269,-10,1
r1bq1r1k/pp1n3p/3p2p1/3QpPp1/4P1P1/8/PPP5/R1B1KB1R w KQ - 0 15,fxg6,275,133,-142,0
r1bq1r1k/pp1n3p/3p2P1/3Qp1p1/4P1P1/8/PPP5/R1B1KB1R b KQ - 0 15,Nf6,135,185,50,1
r1bq1r1k/pp5p/3p1nP1/3Qp1p1/4P1P1/8/PPP5/R1B1KB1R w KQ - 1 16,Qb3,219,143,-76,1
r1bq1r1k/pp5p/3p1nP1/4p1p1/4P1P1/1Q6/PPP5/R1B1KB1R b KQ - 2 16,Rg8,131,170,39,1
r1bq2rk/pp5p/3p1nP1/4p1p1/4P1P1/1Q6/PPP5/R1B1KB1R w KQ - 3 17,Qf7,204,-207,-411,0
r1bq2rk/pp3Q1p/3p1nP1/4p1p1/4P1P1/8/PPP5/R1B1KB1R b KQ - 4 17,Qd7,-183,9995,10178,1
r1b3rk/pp1q1Q1p/3p1nP1/4p1p1/4P1P1/8/PPP5/R1B1KB1R w KQ - 5 18,Bc4,9995,276,-9719,0
r1b3rk/pp1q1Q1p/3p1nP1/4p1p1/2B1P1P1/8/PPP5/R1B1K2R b KQ - 6 18,Qxf7,464,454,-10,1
r1b3rk/pp3q1p/3p1nP1/4p1p1/2B1P1P1/8/PPP5/R1B1K2R w KQ - 0 19,Bxf7,469,123,-346,0
r1b3rk/pp3B1p/3p1nP1/4p1p1/4P1P1/8/PPP5/R1B1K2R b KQ - 0 19,Rf8,80,612,532,1
r1b2r1k/pp3B1p/3p1nP1/4p1p1/4P1P1/8/PPP5/R1B1K2R w KQ - 1 20,Rxh7+,622,-396,-1018,0
r1b2r1k/pp3B1R/3p1nP1/4p1p1/4P1P1/8/PPP5/R1B1K3 b Q - 0 20,Nxh7,-414,-401,13,1
r1b2r1k/pp3B1n/3p2P1/4p1p1/4P1P1/8/PPP5/R1B1K3 w Q - 0 21,Be6,-443,-559,-116,0
r1b2r1k/pp5n/3pB1P1/4p1p1/4P1P1/8/PPP5/R1B1K3 b Q - 1 21,Bxe6,-609,-522,87,1
r4r1k/pp5n/3pb1P1/4p1p1/4P1P1/8/PPP5/R1B1K3 w Q - 0 22,Bxg5,-545,-751,-206,0
r4r1k/pp5n/3pb1P1/4p1B1/4P1P1/8/PPP5/R3K3 b Q - 0 22,Bxg4,-788,-523,265,1
r4r1k/pp5n/3p2P1/4p1B1/4P1b1/8/PPP5/R3K3 w Q - 0 23,Bh6,-504,-560,-56,1
r4r1k/pp5n/3p2PB/4p3/4P1b1/8/PPP5/R3K3 b Q - 1 23,Rf3,-584,-612,-28,1
r6k/pp5n/3p2PB/4p3/4P1b1/5r2/PPP5/R3K3 w Q - 2 24,g7+,-633,-673,-40,1
r6k/pp4Pn/3p3B/4p3/4P1b1/5r2/PPP5/R3K3 b Q - 0 24,Kg8,-654,-694,-40,1
r5k1/pp4Pn/3p3B/4p3/4P1b1/5r2/PPP5/R3K3 w Q - 1 25,Ke2,-713,-816,-103,0
r5k1/pp4Pn/3p3B/4p3/4P1b1/5r2/PPP1K3/R7 b - - 2 25,Rh3+,-817,-811,6,1
r5k1/pp4Pn/3p3B/4p3/4P1b1/7r/PPP1K3/R7 w - - 3 26,Kf2,-815,-823,-8,1
r5k1/pp4Pn/3p3B/4p3/4P1b1/7r/PPP2K2/R7 b - - 4 26,Rxh6,-836,-822,14,1
rnbqkbnr/pppppppp/8/8/8/8/PPPPPPPP/RNBQKBNR w KQkq - 0 1,e3,42,13,-29,1
rnbqkbnr/pppppppp/8/8/8/4P3/PPPP1PPP/RNBQKBNR b KQkq - 0 1,c5,4,8,4,1
rnbqkbnr/pp1ppppp/8/2p5/8/4P3/PPPP1PPP/RNBQKBNR w KQkq - 0 2,d4,15,20,5,1
rnbqkbnr/pp1ppppp/8/2p5/3P4/4P3/PPP2PPP/RNBQKBNR b KQkq - 0 2,cxd4,11,39,28,1
rnbqkbnr/pp1ppppp/8/8/3p4/4P3/PPP2PPP/RNBQKBNR w KQkq - 0 3,Bd3,38,-115,-153,0
rnbqkbnr/pp1ppppp/8/8/3p4/3BP3/PPP2PPP/RNBQK1NR b KQkq - 1 3,d5,-100,32,132,1
rnbqkbnr/pp2pppp/8/3p4/3p4/3BP3/PPP2PPP/RNBQK1NR w KQkq - 0 4,exd4,25,23,-2,1
rnbqkbnr/pp2pppp/8/3p4/3P4/3B4/PPP2PPP/RNBQK1NR b KQkq - 0 4,e6,23,29,6,1
rnbqkbnr/pp3ppp/4p3/3p4/3P4/3B4/PPP2PPP/RNBQK1NR w KQkq - 0 5,Nf3,33,26,-7,1
rnbqkbnr/pp3ppp/4p3/3p4/3P4/3B1N2/PPP2PPP/RNBQK2R b KQkq - 1 5,Nc6,30,45,15,1
r1bqkbnr/pp3ppp/2n1p3/3p4/3P4/3B1N2/PPP2PPP/RNBQK2R w KQkq - 2 6,O-O,40,43,3,1
r1bqkbnr/pp3ppp/2n1p3/3p4/3P4/3B1N2/PPP2PPP/RNBQ1RK1 b kq - 3 6,Nf6,25,56,31,1
r1bqkb1r/pp3ppp/2n1pn2/3p4/3P4/3B1N2/PPP2PPP/RNBQ1RK1 w kq - 4 7,c3,69,51,-18,1
r1bqkb1r/pp3ppp/2n1pn2/3p4/3P4/2PB1N2/PP3PPP/RNBQ1RK1 b kq - 0 7,Be7,59,66,7,1
r1bqk2r/pp2bppp/2n1pn2/3p4/3P4/2PB1N2/PP3PPP/RNBQ1RK1 w kq - 1 8,Qc2,71,39,-32,1
r1bqk2r/pp2bppp/2n1pn2/3p4/3P4/2PB1N2/PPQ2PPP/RNB2RK1 b kq - 2 8,O-O,48,57,9,1
r1bq1rk1/pp2bppp/2n1pn2/3p4/3P4/2PB1N2/PPQ2PPP/RNB2RK1 w - - 3 9,Bg5,54,39,-15,1
r1bq1rk1/pp2bppp/2n1pn2/3p2B1/3P4/2PB1N2/PPQ2PPP/RN3RK1 b - - 4 9,Bd7,40,32,-8,1
r2q1rk1/pp1bbppp/2n1pn2/3p2B1/3P4/2PB1N2/PPQ2PPP/RN3RK1 w - - 5 10,Bxf6,39,-22,-61,1
r2q1rk1/pp1bbppp/2n1pB2/3p4/3P4/2PB1N2/PPQ2PPP/RN3RK1 b - - 0 10,Bxf6,-37,139,176,1
r2q1rk1/pp1b1ppp/2n1pb2/3p4/3P4/2PB1N2/PPQ2PPP/RN3RK1 w - - 0 11,Bxh7+,82,102,20,1
r2q1rk1/pp1b1ppB/2n1pb2/3p4/3P4/2P2N2/PPQ2PPP/RN3RK1 b - - 0 11,Kh8,89,84,-5,1
r2q1r1k/pp1b1ppB/2n1pb2/3p4/3P4/2P2N2/PPQ2PPP/RN3RK1 w - - 1 12,Bd3,96,80,-16,1
r2q1r1k/pp1b1pp1/2n1pb2/3p4/3P4/2PB1N2/PPQ2PPP/RN3RK1 b - - 2 12,g6,79,106,27,1
r2q1r1k/pp1b1p2/2n1pbp1/3p4/3P4/2PB1N2/PPQ2PPP/RN3RK1 w - - 0 13,Nbd2,118,63,-55,1
r2q1r1k/pp1b1p2/2n1pbp1/3p4/3P4/2PB1N2/PPQN1PPP/R4RK1 b - - 1 13,Bg7,54,156,102,1
r2q1r1k/pp1b1pb1/2n1p1p1/3p4/3P4/2PB1N2/PPQN1PPP/R4RK1 w - - 2 14,h3,144,111,-33,1
r2q1r1k/pp1b1pb1/2n1p1p1/3p4/3P4/2PB1N1P/PPQN1PP1/R4RK1 b - - 0 14,Kg8,92,133,41,1
r2q1rk1/pp1b1pb1/2n1p1p1/3p4/3P4/2PB1N1P/PPQN1PP1/R4RK1 w - - 1 15,Nh2,140,44,-96,1
r2q1rk1/pp1b1pb1/2n1p1p1/3p4/3P4/2PB3P/PPQN1PPN/R4RK1 b - - 2 15,Ne7,56,186,130,1
r2q1rk1/pp1bnpb1/4p1p1/3p4/3P4/2PB3P/PPQN1PPN/R4RK1 w - - 3 16,Ng4,173,188,15,1
r2q1rk1/pp1bnpb1/4p1p1/3p4/3P2N1/2PB3P/PPQN1PP1/R4RK1 b - - 4 16,Nf5,176,227,51,1
r2q1rk1/pp1b1pb1/4p1p1/3p1n2/3P2N1/2PB3P/PPQN1PP1/R4RK1 w - - 5 17,Bxf5,219,147,-72,1
r2q1rk1/pp1b1pb1/4p1p1/3p1B2/3P2N1/2P4P/PPQN1PP1/R4RK1 b - - 0 17,exf5,190,197,7,1
r2q1rk1/pp1b1pb1/6p1/3p1p2/3P2N1/2P4P/PPQN1PP1/R4RK1 w - - 0 18,Ne5,160,171,11,1
r2q1rk1/pp1b1pb1/6p1/3pNp2/3P4/2P4P/PPQN1PP1/R4RK1 b - - 1 18,Be6,182,208,26,1
r2q1rk1/pp3pb1/4b1p1/3pNp2/3P4/2P4P/PPQN1PP1/R4RK1 w - - 2 19,f4,219,164,-55,1
r2q1rk1/pp3pb1/4b1p1/3pNp2/3P1P2/2P4P/PPQN2P1/R4RK1 b - - 0 19,f6,164,392,228,1
r2q1rk1/pp4b1/4bpp1/3pNp2/3P1P2/2P4P/PPQN2P1/R4RK1 w - - 0 20,Nxg6,366,378,12,1
r2q1rk1/pp4b1/4bpN1/3p1p2/3P1P2/2P4P/PPQN2P1/R4RK1 b - - 0 20,Rf7,363,445,82,1
r2q2k1/pp3rb1/4bpN1/3p1p2/3P1P2/2P4P/PPQN2P1/R4RK1 w - - 1 21,Nh4,457,374,-83,1
r2q2k1/pp3rb1/4bp2/3p1p2/3P1P1N/2P4P/PPQN2P1/R4RK1 b - - 2 21,Rc8,382,459,77,1
2rq2k1/pp3rb1/4bp2/3p1p2/3P1P1N/2P4P/PPQN2P1/R4RK1 w - - 3 22,Nxf5,443,387,-56,1
2rq2k1/pp3rb1/4bp2/3p1N2/3P1P2/2P4P/PPQN2P1/R4RK1 b - - 0 22,Qd7,399,384,-15,1
2r3k1/pp1q1rb1/4bp2/3p1N2/3P1P2/2P4P/PPQN2P1/R4RK1 w - - 1 23,Nxg7,408,345,-63,1
2r3k1/pp1q1rN1/4bp2/3p4/3P1P2/2P4P/PPQN2P1/R4RK1 b - - 0 23,Rxg7,351,423,72,1
2r3k1/pp1q2r1/4bp2/3p4/3P1P2/2P4P/PPQN2P1/R4RK1 w - - 0 24,f5,409,419,10,1
2r3k1/pp1q2r1/4bp2/3p1P2/3P4/2P4P/PPQN2P1/R4RK1 b - - 0 24,Bf7,428,428,0,1
2r3k1/pp1q1br1/5p2/3p1P2/3P4/2P4P/PPQN2P1/R4RK1 w - - 1 25,Rf4,417,328,-89,1
2r3k1/pp1q1br1/5p2/3p1P2/3P1R2/2P4P/PPQN2P1/R5K1 b - - 2 25,Qd6,347,385,38,1
2r3k1/pp3br1/3q1p2/3p1P2/3P1R2/2P4P/PPQN2P1/R5K1 w - - 3 26,Raf1,371,380,9,1
2r3k1/pp3br1/3q1p2/3p1P2/3P1R2/2P4P/PPQN2P1/5RK1 b - - 4 26,Re8,376,377,1,1
4r1k1/pp3br1/3q1p2/3p1P2/3P1R2/2P4P/PPQN2P1/5RK1 w - - 5 27,Qd3,403,335,-68,1
4r1k1/pp3br1/3q1p2/3p1P2/3P1R2/2PQ3P/PP1N2P1/5RK1 b - - 6 27,Rg5,358,415,57,1
4r1k1/pp3b2/3q1p2/3p1Pr1/3P1R2/2PQ3P/PP1N2P1/5RK1 w - - 7 28,Qf3,433,384,-49,1
4r1k1/pp3b2/3q1p2/3p1Pr1/3P1R2/2P2Q1P/PP1N2P1/5RK1 b - - 8 28,Kg7,370,458,88,1
4r3/pp3bk1/3q1p2/3p1Pr1/3P1R2/2P2Q1P/PP1N2P1/5RK1 w - - 9 29,Rg4,431,407,-24,1
4r3/pp3bk1/3q1p2/3p1Pr1/3P2R1/2P2Q1P/PP1N2P1/5RK1 b - - 10 29,Rg8,425,615,190,1
6r1/pp3bk1/3q1p2/3p1Pr1/3P2R1/2P2Q1P/PP1N2P1/5RK1 w - - 11 30,h4,530,385,-145,0
6r1/pp3bk1/3q1p2/3p1Pr1/3P2RP/2P2Q2/PP1N2P1/5RK1 b - - 0 30,Rxg4,392,372,-20,1
6r1/pp3bk1/3q1p2/3p1P2/3P2rP/2P2Q2/PP1N2P1/5RK1 w - - 0 31,Qxg4+,385,404,19,1
6r1/pp3bk1/3q1p2/3p1P2/3P2QP/2P5/PP1N2P1/5RK1 b - - 0 31,Kf8,382,396,14,1
5kr1/pp3b2/3q1p2/3p1P2/3P2QP/2P5/PP1N2P1/5RK1 w - - 1 32,Qf4,406,472,66,1
5kr1/pp3b2/3q1p2/3p1P2/3P1Q1P/2P5/PP1N2P1/5RK1 b - - 2 32,Qxf4,458,516,58,1
5kr1/pp3b2/5p2/3p1P2/3P1q1P/2P5/PP1N2P1/5RK1 w - - 0 33,Rxf4,462,447,-15,1
5kr1/pp3b2/5p2/3p1P2/3P1R1P/2P5/PP1N2P1/6K1 b - - 0 33,Rg3,464,460,-4,1
5k2/pp3b2/5p2/3p1P2/3P1R1P/2P3r1/PP1N2P1/6K1 w - - 1 34,Nb3,455,420,-35,1
5k2/pp3b2/5p2/3p1P2/3P1R1P/1NP3r1/PP4P1/6K1 b - - 2 34,Rd3,384,413,29,1
5k2/pp3b2/5p2/3p1P2/3P1R1P/1NPr4/PP4P1/6K1 w - - 3 35,Nc5,452,456,4,1
5k2/pp3b2/5p2/2Np1P2/3P1R1P/2Pr4/PP4P1/6K1 b - - 4 35,Rd1+,454,472,18,1
5k2/pp3b2/5p2/2Np1P2/3P1R1P/2P5/PP4P1/3r2K1 w - - 5 36,Kh2,491,372,-119,0
5k2/pp3b2/5p2/2Np1P2/3P1R1P/2P5/PP4PK/3r4 b - - 6 36,Rd2,344,363,19,1
5k2/pp3b2/5p2/2Np1P2/3P1R1P/2P5/PP1r2PK/8 w - - 7 37,Nd7+,384,303,-81,1
5k2/pp1N1b2/5p2/3p1P2/3P1R1P/2P5/PP1r2PK/8 b - - 8 37,Ke7,317,305,-12,1
8/pp1Nkb2/5p2/3p1P2/3P1R1P/2P5/PP1r2PK/8 w - - 9 38,Nc5,301,279,-22,1
8/pp2kb2/5p2/2Np1P2/3P1R1P/2P5/PP1r2PK/8 b - - 10 38,Rxb2,296,312,16,1
8/pp2kb2/5p2/2Np1P2/3P1R1P/2P5/Pr4PK/8 w - - 0 39,a4,342,288,-54,1
8/pp2kb2/5p2/2Np1P2/P2P1R1P/2P5/1r4PK/8 b - - 0 39,Kf8,281,349,68,1
5k2/pp3b2/5p2/2Np1P2/P2P1R1P/2P5/1r4PK/8 w - - 1 40,Rf3,333,368,35,1
5k2/pp3b2/5p2/2Np1P2/P2P3P/2P2R2/1r4PK/8 b - - 2 40,Rb3,337,603,266,1
5k2/pp3b2/5p2/2Np1P2/P2P3P/1rP2R2/6PK/8 w - - 3 41,Nxb3,639,652,13,1
rnbqkbnr/pppppppp/8/8/8/8/PPPPPPPP/RNBQKBNR w KQkq - 0 1,e3,29,5,-24,1
rnbqkbnr/pppppppp/8/8/8/4P3/PPPP1PPP/RNBQKBNR b KQkq - 0 1,d5,6,2,-4,1
rnbqkbnr/ppp1pppp/8/3p4/8/4P3/PPPP1PPP/RNBQKBNR w KQkq - 0 2,d3,2,-56,-58,1
rnbqkbnr/ppp1pppp/8/3p4/8/3PP3/PPP2PPP/RNBQKBNR b KQkq - 0 2,e5,-67,-53,14,1
rnbqkbnr/ppp2ppp/8/3pp3/8/3PP3/PPP2PPP/RNBQKBNR w KQkq - 0 3,Be2,-54,-58,-4,1
rnbqkbnr/ppp2ppp/8/3pp3/8/3PP3/PPP1BPPP/RNBQK1NR b KQkq - 1 3,Nf6,-61,-67,-6,1
rnbqkb1r/ppp2ppp/5n2/3pp3/8/3PP3/PPP1BPPP/RNBQK1NR w KQkq - 2 4,Nf3,-64,-63,1,1
rnbqkb1r/ppp2ppp/5n2/3pp3/8/3PPN2/PPP1BPPP/RNBQK2R b KQkq - 3 4,e4,-68,37,105,1
rnbqkb1r/ppp2ppp/5n2/3p4/4p3/3PPN2/PPP1BPPP/RNBQK2R w KQkq - 0 5,dxe4,26,30,4,1
rnbqkb1r/ppp2ppp/5n2/3p4/4P3/4PN2/PPP1BPPP/RNBQK2R b KQkq - 0 5,dxe4,28,60,32,1
rnbqkb1r/ppp2ppp/5n2/8/4p3/4PN2/PPP1BPPP/RNBQK2R w KQkq - 0 6,Nfd2,76,-93,-169,0
rnbqkb1r/ppp2ppp/5n2/8/4p3/4P3/PPPNBPPP/RNBQK2R b KQkq - 1 6,Bf5,-58,-58,0,1
rn1qkb1r/ppp2ppp/5n2/5b2/4p3/4P3/PPPNBPPP/RNBQK2R w KQkq - 2 7,O-O,-48,-89,-41,1
rn1qkb1r/ppp2ppp/5n2/5b2/4p3/4P3/PPPNBPPP/RNBQ1RK1 b kq - 3 7,Bd6,-76,47,123,1
rn1qk2r/ppp2ppp/3b1n2/5b2/4p3/4P3/PPPNBPPP/RNBQ1RK1 w kq - 4 8,Bc4,68,-339,-407,0
rn1qk2r/ppp2ppp/3b1n2/5b2/2B1p3/4P3/PPPN1PPP/RNBQ1RK1 b kq - 5 8,O-O,-332,-100,232,1
rn1q1rk1/ppp2ppp/3b1n2/5b2/2B1p3/4P3/PPPN1PPP/RNBQ1RK1 w - - 6 9,Nc3,-95,-312,-217,0
rn1q1rk1/ppp2ppp/3b1n2/5b2/2B1p3/2N1P3/PPPN1PPP/R1BQ1RK1 b - - 7 9,Ng4,-289,-41,248,1
rn1q1rk1/ppp2ppp/3b4/5b2/2B1p1n1/2N1P3/PPPN1PPP/R1BQ1RK1 w - - 8 10,Ncxe4,-41,-190,-149,0
rn1q1rk1/ppp2ppp/3b4/5b2/2B1N1n1/4P3/PPPN1PPP/R1BQ1RK1 b - - 0 10,Qd7,-233,200,433,1
rn3rk1/pppq1ppp/3b4/5b2/2B1N1n1/4P3/PPPN1PPP/R1BQ1RK1 w - - 1 11,Nxd6,232,143,-89,1
rn3rk1/pppq1ppp/3N4/5b2/2B3n1/4P3/PPPN1PPP/R1BQ1RK1 b - - 0 11,Qxd6,82,149,67,1
rn3rk1/ppp2ppp/3q4/5b2/2B3n1/4P3/PPPN1PPP/R1BQ1RK1 w - - 0 12,Bd3,146,-9999,-10145,0
rn3rk1/ppp2ppp/3q4/5b2/6n1/3BP3/PPPN1PPP/R1BQ1RK1 b - - 1 12,Qxh2#,-9999,-10000,-1,1
rnbqkbnr/pppppppp/8/8/8/8/PPPPPPPP/RNBQKBNR w KQkq - 0 1,d4,37,24,-13,1
rnbqkbnr/pppppppp/8/8/3P4/8/PPP1PPPP/RNBQKBNR b KQkq - 0 1,d5,27,27,0,1
rnbqkbnr/ppp1pppp/8/3p4/3P4/8/PPP1PPPP/RNBQKBNR w KQkq - 0 2,Bf4,25,10,-15,1
rnbqkbnr/ppp1pppp/8/3p4/3P1B2/8/PPP1PPPP/RN1QKBNR b KQkq - 1 2,Bf5,10,20,10,1
rn1qkbnr/ppp1pppp/8/3p1b2/3P1B2/8/PPP1PPPP/RN1QKBNR w KQkq - 2 3,Nd2,21,11,-10,1
rn1qkbnr/ppp1pppp/8/3p1b2/3P1B2/8/PPPNPPPP/R2QKBNR b KQkq - 3 3,Nf6,0,19,19,1
rn1qkb1r/ppp1pppp/5n2/3p1b2/3P1B2/8/PPPNPPPP/R2QKBNR w KQkq - 4 4,c3,17,-6,-23,1
rn1qkb1r/ppp1pppp/5n2/3p1b2/3P1B2/2P5/PP1NPPPP/R2QKBNR b KQkq - 0 4,e6,-17,-12,5,1
rn1qkb1r/ppp2ppp/4pn2/3p1b2/3P1B2/2P5/PP1NPPPP/R2QKBNR w KQkq - 0 5,Ngf3,-8,-1,7,1
rn1qkb1r/ppp2ppp/4pn2/3p1b2/3P1B2/2P2N2/PP1NPPPP/R2QKB1R b KQkq - 1 5,c5,-1,11,12,1
rn1qkb1r/pp3ppp/4pn2/2pp1b2/3P1B2/2P2N2/PP1NPPPP/R2QKB1R w KQkq - 0 6,Nh4,-1,-10,-9,1
rn1qkb1r/pp3ppp/4pn2/2pp1b2/3P1B1N/2P5/PP1NPPPP/R2QKB1R b KQkq - 1 6,Bg6,-27,11,38,1
rn1qkb1r/pp3ppp/4pnb1/2pp4/3P1B1N/2P5/PP1NPPPP/R2QKB1R w KQkq - 2 7,Nxg6,21,17,-4,1
rn1qkb1r/pp3ppp/4pnN1/2pp4/3P1B2/2P5/PP1NPPPP/R2QKB1R b KQkq - 0 7,fxg6,10,77,67,1
rn1qkb1r/pp4pp/4pnp1/2pp4/3P1B2/2P5/PP1NPPPP/R2QKB1R w KQkq - 0 8,e3,73,64,-9,1
rn1qkb1r/pp4pp/4pnp1/2pp4/3P1B2/2P1P3/PP1N1PPP/R2QKB1R b KQkq - 0 8,a6,68,96,28,1
rn1qkb1r/1p4pp/p3pnp1/2pp4/3P1B2/2P1P3/PP1N1PPP/R2QKB1R w KQkq - 0 9,Bd3,99,50,-49,1
rn1qkb1r/1p4pp/p3pnp1/2pp4/3P1B2/2PBP3/PP1N1PPP/R2QK2R b KQkq - 1 9,Nc6,64,71,7,1
r2qkb1r/1p4pp/p1n1pnp1/2pp4/3P1B2/2PBP3/PP1N1PPP/R2QK2R w KQkq - 2 10,Nf3,69,60,-9,1
r2qkb1r/1p4pp/p1n1pnp1/2pp4/3P1B2/2PBPN2/PP3PPP/R2QK2R b KQkq - 3 10,Be7,61,79,18,1
r2qk2r/1p2b1pp/p1n1pnp1/2pp4/3P1B2/2PBPN2/PP3PPP/R2QK2R w KQkq - 4 11,Be5,94,48,-46,1
r2qk2r/1p2b1pp/p1n1pnp1/2ppB3/3P4/2PBPN2/PP3PPP/R2QK2R b KQkq - 5 11,O-O,51,84,33,1
r2q1rk1/1p2b1pp/p1n1pnp1/2ppB3/3P4/2PBPN2/PP3PPP/R2QK2R w KQ - 6 12,Bg3,66,63,-3,1
r2q1rk1/1p2b1pp/p1n1pnp1/2pp4/3P4/2PBPNB1/PP3PPP/R2QK2R b KQ - 7 12,c4,61,64,3,1
r2q1rk1/1p2b1pp/p1n1pnp1/3p4/2pP4/2PBPNB1/PP3PPP/R2QK2R w KQ - 0 13,Bc2,58,40,-18,1
r2q1rk1/1p2b1pp/p1n1pnp1/3p4/2pP4/2P1PNB1/PPB2PPP/R2QK2R b KQ - 1 13,b5,43,94,51,1
r2q1rk1/4b1pp/p1n1pnp1/1p1p4/2pP4/2P1PNB1/PPB2PPP/R2QK2R w KQ - 0 14,h4,119,-15,-134,0
r2q1rk1/4b1pp/p1n1pnp1/1p1p4/2pP3P/2P1PNB1/PPB2PP1/R2QK2R b KQ - 0 14,h5,-48,261,309,1
r2q1rk1/4b1p1/p1n1pnp1/1p1p3p/2pP3P/2P1PNB1/PPB2PP1/R2QK2R w KQ - 0 15,Ng5,244,218,-26,1
r2q1rk1/4b1p1/p1n1pnp1/1p1p2Np/2pP3P/2P1P1B1/PPB2PP1/R2QK2R b KQ - 1 15,Qd7,253,274,21,1
r4rk1/3qb1p1/p1n1pnp1/1p1p2Np/2pP3P/2P1P1B1/PPB2PP1/R2QK2R w KQ - 2 16,f3,274,124,-150,0
r4rk1/3qb1p1/p1n1pnp1/1p1p2Np/2pP3P/2P1PPB1/PPB3P1/R2QK2R b KQ - 0 16,e5,83,305,222,1
r4rk1/3qb1p1/p1n2np1/1p1pp1Np/2pP3P/2P1PPB1/PPB3P1/R2QK2R w KQ - 0 17,Bxg6,275,152,-123,0
r4rk1/3qb1p1/p1n2nB1/1p1pp1Np/2pP3P/2P1PPB1/PP4P1/R2QK2R b KQ - 0 17,e4,202,326,124,1
r4rk1/3qb1p1/p1n2nB1/1p1p2Np/2pPp2P/2P1PPB1/PP4P1/R2QK2R w KQ - 0 18,fxe4,349,306,-43,1
r4rk1/3qb1p1/p1n2nB1/1p1p2Np/2pPP2P/2P1P1B1/PP4P1/R2QK2R b KQ - 0 18,Qg4,312,370,58,1
r4rk1/4b1p1/p1n2nB1/1p1p2Np/2pPP1qP/2P1P1B1/PP4P1/R2QK2R w KQ - 1 19,Qxg4,404,394,-10,1
r4rk1/4b1p1/p1n2nB1/1p1p2Np/2pPP1QP/2P1P1B1/PP4P1/R3K2R b KQ - 0 19,Nxg4,428,415,-13,1
r4rk1/4b1p1/p1n3B1/1p1p2Np/2pPP1nP/2P1P1B1/PP4P1/R3K2R w KQ - 0 20,Ke2,454,397,-57,1
r4rk1/4b1p1/p1n3B1/1p1p2Np/2pPP1nP/2P1P1B1/PP2K1P1/R6R b - - 1 20,dxe4,409,519,110,1
r4rk1/4b1p1/p1n3B1/1p4Np/2pPp1nP/2P1P1B1/PP2K1P1/R6R w - - 0 21,Bxh5,513,476,-37,1
r4rk1/4b1p1/p1n5/1p4NB/2pPp1nP/2P1P1B1/PP2K1P1/R6R b - - 0 21,Nf6,479,477,-2,1
r4rk1/4b1p1/p1n2n2/1p4NB/2pPp2P/2P1P1B1/PP2K1P1/R6R w - - 1 22,Bg6,422,457,35,1
r4rk1/4b1p1/p1n2nB1/1p4N1/2pPp2P/2P1P1B1/PP2K1P1/R6R b - - 2 22,b4,471,501,30,1
r4rk1/4b1p1/p1n2nB1/6N1/1ppPp2P/2P1P1B1/PP2K1P1/R6R w - - 0 23,Nxe4,476,464,-12,1
r4rk1/4b1p1/p1n2nB1/8/1ppPN2P/2P1P1B1/PP2K1P1/R6R b - - 0 23,bxc3,446,466,20,1
r4rk1/4b1p1/p1n2nB1/8/2pPN2P/2p1P1B1/PP2K1P1/R6R w - - 0 24,Nxc3,476,382,-94,1
r4rk1/4b1p1/p1n2nB1/8/2pP3P/2N1P1B1/PP2K1P1/R6R b - - 0 24,Rae8,391,464,73,1
4rrk1/4b1p1/p1n2nB1/8/2pP3P/2N1P1B1/PP2K1P1/R6R w - - 1 25,Rhf1,445,413,-32,1
4rrk1/4b1p1/p1n2nB1/8/2pP3P/2N1P1B1/PP2K1P1/R4R2 b - - 2 25,Bb4,386,420,34,1
4rrk1/6p1/p1n2nB1/8/1bpP3P/2N1P1B1/PP2K1P1/R4R2 w - - 3 26,Bxe8,424,443,19,1
4Brk1/6p1/p1n2n2/8/1bpP3P/2N1P1B1/PP2K1P1/R4R2 b - - 0 26,Rxe8,453,423,-30,1
4r1k1/6p1/p1n2n2/8/1bpP3P/2N1P1B1/PP2K1P1/R4R2 w - - 0 27,a3,438,199,-239,0
4r1k1/6p1/p1n2n2/8/1bpP3P/P1N1P1B1/1P2K1P1/R4R2 b - - 0 27,Nxd4+,179,159,-20,1
4r1k1/6p1/p4n2/8/1bpn3P/P1N1P1B1/1P2K1P1/R4R2 w - - 0 28,Kd1,202,154,-48,1
4r1k1/6p1/p4n2/8/1bpn3P/P1N1P1B1/1P4P1/R2K1R2 b - - 1 28,Bc5,169,509,340,1
4r1k1/6p1/p4n2/2b5/2pn3P/P1N1P1B1/1P4P1/R2K1R2 w - - 2 29,exd4,494,488,-6,1
4r1k1/6p1/p4n2/2b5/2pP3P/P1N3B1/1P4P1/R2K1R2 b - - 0 29,Bxd4,520,512,-8,1
4r1k1/6p1/p4n2/8/2pb3P/P1N3B1/1P4P1/R2K1R2 w - - 0 30,Rf3,518,485,-33,1
4r1k1/6p1/p4n2/8/2pb3P/P1N2RB1/1P4P1/R2K4 b - - 1 30,Ng4,514,476,-38,1
4r1k1/6p1/p7/8/2pb2nP/P1N2RB1/1P4P1/R2K4 w - - 2 31,Kd2,504,484,-20,1
4r1k1/6p1/p7/8/2pb2nP/P1N2RB1/1P1K2P1/R7 b - - 3 31,a5,477,566,89,1
4r1k1/6p1/8/p7/2pb2nP/P1N2RB1/1P1K2P1/R7 w - - 0 32,Raf1,593,536,-57,1
4r1k1/6p1/8/p7/2pb2nP/P1N2RB1/1P1K2P1/5R2 b - - 1 32,Re6,556,573,17,1
6k1/6p1/4r3/p7/2pb2nP/P1N2RB1/1P1K2P1/5R2 w - - 2 33,Bf2,581,568,-13,1
6k1/6p1/4r3/p7/2pb2nP/P1N2R2/1P1K1BP1/5R2 b - - 3 33,Bf6,565,568,3,1
6k1/6p1/4rb2/p7/2p3nP/P1N2R2/1P1K1BP1/5R2 w - - 4 34,Bg1,576,468,-108,0
6k1/6p1/4rb2/p7/2p3nP/P1N2R2/1P1K2P1/5RB1 b - - 5 34,Ne5,505,514,9,1
6k1/6p1/4rb2/p3n3/2p4P/P1N2R2/1P1K2P1/5RB1 w - - 6 35,Re3,518,515,-3,1
6k1/6p1/4rb2/p3n3/2p4P/P1N1R3/1P1K2P1/5RB1 b - - 7 35,Bxh4,538,579,41,1
6k1/6p1/4r3/p3n3/2p4b/P1N1R3/1P1K2P1/5RB1 w - - 0 36,Bh2,616,547,-69,1
6k1/6p1/4r3/p3n3/2p4b/P1N1R3/1P1K2PB/5R2 b - - 1 36,Bg5,584,601,17,1
6k1/6p1/4r3/p3n1b1/2p5/P1N1R3/1P1K2PB/5R2 w - - 2 37,Re1,600,358,-242,0
6k1/6p1/4r3/p3n1b1/2p5/P1N1R3/1P1K2PB/4R3 b - - 3 37,Ng4,368,367,-1,1
6k1/6p1/4r3/p5b1/2p3n1/P1N1R3/1P1K2PB/4R3 w - - 4 38,Bg1,382,400,18,1
6k1/6p1/4r3/p5b1/2p3n1/P1N1R3/1P1K2P1/4R1B1 b - - 5 38,Rxe3,416,589,173,1
6k1/6p1/8/p5b1/2p3n1/P1N1r3/1P1K2P1/4R1B1 w - - 0 39,Bxe3,605,551,-54,1
6k1/6p1/8/p5b1/2p3n1/P1N1B3/1P1K2P1/4R3 b - - 0 39,Nxe3,519,570,51,1
6k1/6p1/8/p5b1/2p5/P1N1n3/1P1K2P1/4R3 w - - 0 40,Rxe3,622,608,-14,1
6k1/6p1/8/p5b1/2p5/P1N1R3/1P1K2P1/8 b - - 0 40,Kf7,620,613,-7,1
8/5kp1/8/p5b1/2p5/P1N1R3/1P1K2P1/8 w - - 1 41,Ke2,607,584,-23,1
8/5kp1/8/p5b1/2p5/P1N1R3/1P2K1P1/8 b - - 2 41,Bxe3,590,589,-1,1
8/5kp1/8/p7/2p5/P1N1b3/1P2K1P1/8 w - - 0 42,Kxe3,603,589,-14,1
8/5kp1/8/p7/2p5/P1N1K3/1P4P1/8 b - - 0 42,g5,559,571,12,1
8/5k2/8/p5p1/2p5/P1N1K3/1P4P1/8 w - - 0 43,Kd4,589,607,18,1
rnbqkbnr/pppppppp/8/8/8/8/PPPPPPPP/RNBQKBNR w KQkq - 0 1,c4,32,8,-24,1
rnbqkbnr/pppppppp/8/8/2P5/8/PP1PPPPP/RNBQKBNR b KQkq - 0 1,e5,17,15,-2,1
rnbqkbnr/pppp1ppp/8/4p3/2P5/8/PP1PPPPP/RNBQKBNR w KQkq - 0 2,e3,15,-3,-18,1
rnbqkbnr/pppp1ppp/8/4p3/2P5/4P3/PP1P1PPP/RNBQKBNR b KQkq - 0 2,d5,-9,24,33,1
rnbqkbnr/ppp2ppp/8/3pp3/2P5/4P3/PP1P1PPP/RNBQKBNR w KQkq - 0 3,cxd5,33,29,-4,1
rnbqkbnr/ppp2ppp/8/3Pp3/8/4P3/PP1P1PPP/RNBQKBNR b KQkq - 0 3,Qxd5,38,49,11,1
rnb1kbnr/ppp2ppp/8/3qp3/8/4P3/PP1P1PPP/RNBQKBNR w KQkq - 0 4,Nc3,47,41,-6,1
rnb1kbnr/ppp2ppp/8/3qp3/8/2N1P3/PP1P1PPP/R1BQKBNR b KQkq - 1 4,Qd8,31,32,1,1
rnbqkbnr/ppp2ppp/8/4p3/8/2N1P3/PP1P1PPP/R1BQKBNR w KQkq - 2 5,Nf3,27,27,0,1
rnbqkbnr/ppp2ppp/8/4p3/8/2N1PN2/PP1P1PPP/R1BQKB1R b KQkq - 3 5,Nc6,17,57,40,1
r1bqkbnr/ppp2ppp/2n5/4p3/8/2N1PN2/PP1P1PPP/R1BQKB1R w KQkq - 4 6,Bb5,67,38,-29,1
r1bqkbnr/ppp2ppp/2n5/1B2p3/8/2N1PN2/PP1P1PPP/R1BQK2R b KQkq - 5 6,Bd6,38,49,11,1
r1bqk1nr/ppp2ppp/2nb4/1B2p3/8/2N1PN2/PP1P1PPP/R1BQK2R w KQkq - 6 7,d4,66,45,-21,1
r1bqk1nr/ppp2ppp/2nb4/1B2p3/3P4/2N1PN2/PP3PPP/R1BQK2R b KQkq - 0 7,exd4,36,37,1,1
r1bqk1nr/ppp2ppp/2nb4/1B6/3p4/2N1PN2/PP3PPP/R1BQK2R w KQkq - 0 8,exd4,43,37,-6,1
r1bqk1nr/ppp2ppp/2nb4/1B6/3P4/2N2N2/PP3PPP/R1BQK2R b KQkq - 0 8,Bd7,42,115,73,1
r2qk1nr/pppb1ppp/2nb4/1B6/3P4/2N2N2/PP3PPP/R1BQK2R w KQkq - 1 9,O-O,113,87,-26,1
r2qk1nr/pppb1ppp/2nb4/1B6/3P4/2N2N2/PP3PPP/R1BQ1RK1 b kq - 2 9,Nge7,94,94,0,1
r2qk2r/pppbnppp/2nb4/1B6/3P4/2N2N2/PP3PPP/R1BQ1RK1 w kq - 3 10,Re1,100,75,-25,1
r2qk2r/pppbnppp/2nb4/1B6/3P4/2N2N2/PP3PPP/R1BQR1K1 b kq - 4 10,O-O,96,99,3,1
r2q1rk1/pppbnppp/2nb4/1B6/3P4/2N2N2/PP3PPP/R1BQR1K1 w - - 5 11,d5,52,47,-5,1
r2q1rk1/pppbnppp/2nb4/1B1P4/8/2N2N2/PP3PPP/R1BQR1K1 b - - 0 11,Nb4,41,48,7,1
r2q1rk1/pppbnppp/3b4/1B1P4/1n6/2N2N2/PP3PPP/R1BQR1K1 w - - 1 12,Bc4,76,54,-22,1
r2q1rk1/pppbnppp/3b4/3P4/1nB5/2N2N2/PP3PPP/R1BQR1K1 b - - 2 12,a6,51,435,384,1
r2q1rk1/1ppbnppp/p2b4/3P4/1nB5/2N2N2/PP3PPP/R1BQR1K1 w - - 0 13,a3,391,414,23,1
r2q1rk1/1ppbnppp/p2b4/3P4/1nB5/P1N2N2/1P3PPP/R1BQR1K1 b - - 0 13,b5,390,418,28,1
r2q1rk1/2pbnppp/p2b4/1p1P4/1nB5/P1N2N2/1P3PPP/R1BQR1K1 w - - 0 14,Bb3,437,444,7,1
r2q1rk1/2pbnppp/p2b4/1p1P4/1n6/PBN2N2/1P3PPP/R1BQR1K1 b - - 1 14,a5,446,474,28,1
r2q1rk1/2pbnppp/3b4/pp1P4/1n6/PBN2N2/1P3PPP/R1BQR1K1 w - - 0 15,axb4,491,454,-37,1
r2q1rk1/2pbnppp/3b4/pp1P4/1P6/1BN2N2/1P3PPP/R1BQR1K1 b - - 0 15,Bxb4,447,507,60,1
r2q1rk1/2pbnppp/8/pp1P4/1b6/1BN2N2/1P3PPP/R1BQR1K1 w - - 0 16,Ne5,482,421,-61,1
r2q1rk1/2pbnppp/8/pp1PN3/1b6/1BN5/1P3PPP/R1BQR1K1 b - - 1 16,a4,384,421,37,1
r2q1rk1/2pbnppp/8/1p1PN3/pb6/1BN5/1P3PPP/R1BQR1K1 w - - 0 17,Bg5,433,356,-77,1
r2q1rk1/2pbnppp/8/1p1PN1B1/pb6/1BN5/1P3PPP/R2QR1K1 b - - 1 17,f6,338,539,201,1
r2q1rk1/2pbn1pp/5p2/1p1PN1B1/pb6/1BN5/1P3PPP/R2QR1K1 w - - 0 18,d6+,532,554,22,1
r2q1rk1/2pbn1pp/3P1p2/1p2N1B1/pb6/1BN5/1P3PPP/R2QR1K1 b - - 0 18,axb3,522,535,13,1
r2q1rk1/2pbn1pp/3P1p2/1p2N1B1/1b6/1pN5/1P3PPP/R2QR1K1 w - - 0 19,dxe7,518,526,8,1
r2q1rk1/2pbP1pp/5p2/1p2N1B1/1b6/1pN5/1P3PPP/R2QR1K1 b - - 0 19,Bxe7,527,527,0,1
r2q1rk1/2pbb1pp/5p2/1p2N1B1/8/1pN5/1P3PPP/R2QR1K1 w - - 0 20,Qd5+,562,599,37,1
r2q1rk1/2pbb1pp/5p2/1p1QN1B1/8/1pN5/1P3PPP/R3R1K1 b - - 1 20,Kh8,553,573,20,1
r2q1r1k/2pbb1pp/5p2/1p1QN1B1/8/1pN5/1P3PPP/R3R1K1 w - - 2 21,Nf7+,576,587,11,1
r2q1r1k/2pbbNpp/5p2/1p1Q2B1/8/1pN5/1P3PPP/R3R1K1 b - - 3 21,Rxf7,623,593,-30,1
r2q3k/2pbbrpp/5p2/1p1Q2B1/8/1pN5/1P3PPP/R3R1K1 w - - 0 22,Rxa8,603,578,-25,1
R2q3k/2pbbrpp/5p2/1p1Q2B1/8/1pN5/1P3PPP/4R1K1 b - - 0 22,Qxa8,633,643,10,1
q6k/2pbbrpp/5p2/1p1Q2B1/8/1pN5/1P3PPP/4R1K1 w - - 0 23,Qxa8+,604,613,9,1
Q6k/2pbbrpp/5p2/1p4B1/8/1pN5/1P3PPP/4R1K1 b - - 0 23,Rf8,654,656,2,1
Q4r1k/2pbb1pp/5p2/1p4B1/8/1pN5/1P3PPP/4R1K1 w - - 1 24,Qd5,642,568,-74,1
5r1k/2pbb1pp/5p2/1p1Q2B1/8/1pN5/1P3PPP/4R1K1 b - - 2 24,fxg5,609,700,91,1
5r1k/2pbb1pp/8/1p1Q2p1/8/1pN5/1P3PPP/4R1K1 w - - 0 25,Rxe7,707,707,0,1
rnbqkbnr/pppppppp/8/8/8/8/PPPPPPPP/RNBQKBNR w KQkq - 0 1,e4,38,28,-10,1
rnbqkbnr/pppppppp/8/8/4P3/8/PPPP1PPP/RNBQKBNR b KQkq - 0 1,c6,33,40,7,1
rnbqkbnr/pp1ppppp/2p5/8/4P3/8/PPPP1PPP/RNBQKBNR w KQkq - 0 2,Bc4,45,-48,-93,1
rnbqkbnr/pp1ppppp/2p5/8/2B1P3/8/PPPP1PPP/RNBQK1NR b KQkq - 1 2,d5,-42,-40,2,1
rnbqkbnr/pp2pppp/2p5/3p4/2B1P3/8/PPPP1PPP/RNBQK1NR w KQkq - 0 3,exd5,-34,-34,0,1
rnbqkbnr/pp2pppp/2p5/3P4/2B5/8/PPPP1PPP/RNBQK1NR b KQkq - 0 3,cxd5,-37,-45,-8,1
rnbqkbnr/pp2pppp/8/3p4/2B5/8/PPPP1PPP/RNBQK1NR w KQkq - 0 4,Bb3,-44,-43,1,1
rnbqkbnr/pp2pppp/8/3p4/8/1B6/PPPP1PPP/RNBQK1NR b KQkq - 1 4,Nf6,-38,-35,3,1
rnbqkb1r/pp2pppp/5n2/3p4/8/1B6/PPPP1PPP/RNBQK1NR w KQkq - 2 5,Ne2,-28,-50,-22,1
rnbqkb1r/pp2pppp/5n2/3p4/8/1B6/PPPPNPPP/RNBQK2R b KQkq - 3 5,e5,-43,11,54,1
rnbqkb1r/pp3ppp/5n2/3pp3/8/1B6/PPPPNPPP/RNBQK2R w KQkq - 0 6,h3,29,-22,-51,1
rnbqkb1r/pp3ppp/5n2/3pp3/8/1B5P/PPPPNPP1/RNBQK2R b KQkq - 0 6,Bc5,-29,-29,0,1
rnbqk2r/pp3ppp/5n2/2bpp3/8/1B5P/PPPPNPP1/RNBQK2R w KQkq - 1 7,O-O,-21,-25,-4,1
rnbqk2r/pp3ppp/5n2/2bpp3/8/1B5P/PPPPNPP1/RNBQ1RK1 b kq - 2 7,O-O,-34,-20,14,1
rnbq1rk1/pp3ppp/5n2/2bpp3/8/1B5P/PPPPNPP1/RNBQ1RK1 w - - 3 8,d4,-28,-20,8,1
rnbq1rk1/pp3ppp/5n2/2bpp3/3P4/1B5P/PPP1NPP1/RNBQ1RK1 b - - 0 8,exd4,-21,-5,16,1
rnbq1rk1/pp3ppp/5n2/2bp4/3p4/1B5P/PPP1NPP1/RNBQ1RK1 w - - 0 9,Nxd4,-29,-33,-4,1
rnbq1rk1/pp3ppp/5n2/2bp4/3N4/1B5P/PPP2PP1/RNBQ1RK1 b - - 0 9,Nc6,-34,-23,11,1
r1bq1rk1/pp3ppp/2n2n2/2bp4/3N4/1B5P/PPP2PP1/RNBQ1RK1 w - - 1 10,Nxc6,-25,-58,-33,1
r1bq1rk1/pp3ppp/2N2n2/2bp4/8/1B5P/PPP2PP1/RNBQ1RK1 b - - 0 10,bxc6,-51,-56,-5,1
r1bq1rk1/p4ppp/2p2n2/2bp4/8/1B5P/PPP2PP1/RNBQ1RK1 w - - 0 11,Bg5,-52,-98,-46,1
r1bq1rk1/p4ppp/2p2n2/2bp2B1/8/1B5P/PPP2PP1/RN1Q1RK1 b - - 1 11,Bf5,-97,-47,50,1
r2q1rk1/p4ppp/2p2n2/2bp1bB1/8/1B5P/PPP2PP1/RN1Q1RK1 w - - 2 12,Nd2,-51,-71,-20,1
r2q1rk1/p4ppp/2p2n2/2bp1bB1/8/1B5P/PPPN1PP1/R2Q1RK1 b - - 3 12,Qb6,-78,10,88,1
r4rk1/p4ppp/1qp2n2/2bp1bB1/8/1B5P/PPPN1PP1/R2Q1RK1 w - - 4 13,Bxf6,9,10,1,1
r4rk1/p4ppp/1qp2B2/2bp1b2/8/1B5P/PPPN1PP1/R2Q1RK1 b - - 0 13,gxf6,16,22,6,1
r4rk1/p4p1p/1qp2p2/2bp1b2/8/1B5P/PPPN1PP1/R2Q1RK1 w - - 0 14,c4,25,0,-25,1
r4rk1/p4p1p/1qp2p2/2bp1b2/2P5/1B5P/PP1N1PP1/R2Q1RK1 b - - 0 14,d4,0,106,106,1
r4rk1/p4p1p/1qp2p2/2b2b2/2Pp4/1B5P/PP1N1PP1/R2Q1RK1 w - - 0 15,Nf3,86,-139,-225,0
r4rk1/p4p1p/1qp2p2/2b2b2/2Pp4/1B3N1P/PP3PP1/R2Q1RK1 b - - 1 15,Rad8,-63,-68,-5,1
3r1rk1/p4p1p/1qp2p2/2b2b2/2Pp4/1B3N1P/PP3PP1/R2Q1RK1 w - - 2 16,Nh4,-78,-107,-29,1
3r1rk1/p4p1p/1qp2p2/2b2b2/2Pp3N/1B5P/PP3PP1/R2Q1RK1 b - - 3 16,Be6,-97,119,216,1
3r1rk1/p4p1p/1qp1bp2/2b5/2Pp3N/1B5P/PP3PP1/R2Q1RK1 w - - 4 17,Kh1,133,-38,-171,0
3r1rk1/p4p1p/1qp1bp2/2b5/2Pp3N/1B5P/PP3PP1/R2Q1R1K b - - 5 17,Kh8,-60,97,157,1
3r1r1k/p4p1p/1qp1bp2/2b5/2Pp3N/1B5P/PP3PP1/R2Q1R1K w - - 6 18,f4,112,-60,-172,0
3r1r1k/p4p1p/1qp1bp2/2b5/2Pp1P1N/1B5P/PP4P1/R2Q1R1K b - - 0 18,f5,-34,86,120,1
3r1r1k/p4p1p/1qp1b3/2b2p2/2Pp1P1N/1B5P/PP4P1/R2Q1R1K w - - 0 19,Qh5,86,27,-59,1
3r1r1k/p4p1p/1qp1b3/2b2p1Q/2Pp1P1N/1B5P/PP4P1/R4R1K b - - 1 19,Qb4,44,122,78,1
3r1r1k/p4p1p/2p1b3/2b2p1Q/1qPp1P1N/1B5P/PP4P1/R4R1K w - - 2 20,Nxf5,95,132,37,1
3r1r1k/p4p1p/2p1b3/2b2N1Q/1qPp1P2/1B5P/PP4P1/R4R1K b - - 0 20,Bxc4,114,9997,9883,1
3r1r1k/p4p1p/2p5/2b2N1Q/1qbp1P2/1B5P/PP4P1/R4R1K w - - 0 21,Bxc4,9997,509,-9488,0
3r1r1k/p4p1p/2p5/2b2N1Q/1qBp1P2/7P/PP4P1/R4R1K b - - 0 21,Qxc4,478,9996,9518,1
3r1r1k/p4p1p/2p5/2b2N1Q/2qp1P2/7P/PP4P1/R4R1K w - - 0 22,b3,9996,-36,-10032,0
3r1r1k/p4p1p/2p5/2b2N1Q/2qp1P2/1P5P/P5P1/R4R1K b - - 0 22,Qd5,-40,756,796,1
3r1r1k/p4p1p/2p5/2bq1N1Q/3p1P2/1P5P/P5P1/R4R1K w - - 1 23,Rf3,710,-107,-817,0
3r1r1k/p4p1p/2p5/2bq1N1Q/3p1P2/1P3R1P/P5P1/R6K b - - 2 23,Rg8,-103,-17,86,1
3r2rk/p4p1p/2p5/2bq1N1Q/3p1P2/1P3R1P/P5P1/R6K w - - 3 24,Raf1,-15,-323,-308,0
3r2rk/p4p1p/2p5/2bq1N1Q/3p1P2/1P3R1P/P5P1/5R1K b - - 4 24,Rde8,-330,-111,219,1
4r1rk/p4p1p/2p5/2bq1N1Q/3p1P2/1P3R1P/P5P1/5R1K w - - 5 25,Kh2,-103,-395,-292,0
4r1rk/p4p1p/2p5/2bq1N1Q/3p1P2/1P3R1P/P5PK/5R2 b - - 6 25,Re2,-488,-473,15,1
6rk/p4p1p/2p5/2bq1N1Q/3p1P2/1P3R1P/P3r1PK/5R2 w - - 7 26,R1f2,-492,-540,-48,1
6rk/p4p1p/2p5/2bq1N1Q/3p1P2/1P3R1P/P3rRPK/8 b - - 8 26,Rxf2,-545,-434,111,1
6rk/p4p1p/2p5/2bq1N1Q/3p1P2/1P3R1P/P4rPK/8 w - - 0 27,Rxf2,-438,-523,-85,1
6rk/p4p1p/2p5/2bq1N1Q/3p1P2/1P5P/P4RPK/8 b - - 0 27,d3,-514,-494,20,1
6rk/p4p1p/2p5/2bq1N1Q/5P2/1P1p3P/P4RPK/8 w - - 0 28,Rd2,-526,-486,40,1
6rk/p4p1p/2p5/2bq1N1Q/5P2/1P1p3P/P2R2PK/8 b - - 1 28,Bb4,-497,-471,26,1
6rk/p4p1p/2p5/3q1N1Q/1b3P2/1P1p3P/P2R2PK/8 w - - 2 29,Rd1,-516,-9999,-9483,0
6rk/p4p1p/2p5/3q1N1Q/1b3P2/1P1p3P/P5PK/3R4 b - - 3 29,Qxg2#,-9999,-10000,-1,1
rnbqkbnr/pppppppp/8/8/8/8/PPPPPPPP/RNBQKBNR w KQkq - 0 1,e4,45,38,-7,1
rnbqkbnr/pppppppp/8/8/4P3/8/PPPP1PPP/RNBQKBNR b KQkq - 0 1,c6,37,42,5,1
rnbqkbnr/pp1ppppp/2p5/8/4P3/8/PPPP1PPP/RNBQKBNR w KQkq - 0 2,d4,74,32,-42,1
rnbqkbnr/pp1ppppp/2p5/8/3PP3/8/PPP2PPP/RNBQKBNR b KQkq - 0 2,d5,37,37,0,1
rnbqkbnr/pp2pppp/2p5/3p4/3PP3/8/PPP2PPP/RNBQKBNR w KQkq - 0 3,e5,37,40,3,1
rnbqkbnr/pp2pppp/2p5/3pP3/3P4/8/PPP2PPP/RNBQKBNR b KQkq - 0 3,Bf5,35,30,-5,1
rn1qkbnr/pp2pppp/2p5/3pPb2/3P4/8/PPP2PPP/RNBQKBNR w KQkq - 1 4,Bd3,39,6,-33,1
rn1qkbnr/pp2pppp/2p5/3pPb2/3P4/3B4/PPP2PPP/RNBQK1NR b KQkq - 2 4,Bxd3,-2,-4,-2,1
rn1qkbnr/pp2pppp/2p5/3pP3/3P4/3b4/PPP2PPP/RNBQK1NR w KQkq - 0 5,Qxd3,9,11,2,1
rn1qkbnr/pp2pppp/2p5/3pP3/3P4/3Q4/PPP2PPP/RNB1K1NR b KQkq - 0 5,Qa5+,12,20,8,1
rn2kbnr/pp2pppp/2p5/q2pP3/3P4/3Q4/PPP2PPP/RNB1K1NR w KQkq - 1 6,Bd2,35,37,2,1
rn2kbnr/pp2pppp/2p5/q2pP3/3P4/3Q4/PPPB1PPP/RN2K1NR b KQkq - 2 6,Qa6,23,30,7,1
rn2kbnr/pp2pppp/q1p5/3pP3/3P4/3Q4/PPPB1PPP/RN2K1NR w KQkq - 3 7,Qxa6,40,11,-29,1
rn2kbnr/pp2pppp/Q1p5/3pP3/3P4/8/PPPB1PPP/RN2K1NR b KQkq - 0 7,Nxa6,5,1,-4,1
r3kbnr/pp2pppp/n1p5/3pP3/3P4/8/PPPB1PPP/RN2K1NR w KQkq - 0 8,Nf3,11,-8,-19,1
r3kbnr/pp2pppp/n1p5/3pP3/3P4/5N2/PPPB1PPP/RN2K2R b KQkq - 1 8,e6,9,15,6,1
r3kbnr/pp3ppp/n1p1p3/3pP3/3P4/5N2/PPPB1PPP/RN2K2R w KQkq - 0 9,Nh4,10,-37,-47,1
r3kbnr/pp3ppp/n1p1p3/3pP3/3P3N/8/PPPB1PPP/RN2K2R b KQkq - 1 9,c5,-41,-31,10,1
r3kbnr/pp3ppp/n3p3/2ppP3/3P3N/8/PPPB1PPP/RN2K2R w KQkq - 0 10,c3,-34,-39,-5,1
r3kbnr/pp3ppp/n3p3/2ppP3/3P3N/2P5/PP1B1PPP/RN2K2R b KQkq - 0 10,cxd4,-41,-45,-4,1
r3kbnr/pp3ppp/n3p3/3pP3/3p3N/2P5/PP1B1PPP/RN2K2R w KQkq - 0 11,cxd4,-40,-44,-4,1
r3kbnr/pp3ppp/n3p3/3pP3/3P3N/8/PP1B1PPP/RN2K2R b KQkq - 0 11,Be7,-73,-38,35,1
r3k1nr/pp2bppp/n3p3/3pP3/3P3N/8/PP1B1PPP/RN2K2R w KQkq - 1 12,g3,-34,-91,-57,1
r3k1nr/pp2bppp/n3p3/3pP3/3P3N/6P1/PP1B1P1P/RN2K2R b KQkq - 0 12,Bxh4,-90,-128,-38,1
r3k1nr/pp3ppp/n3p3/3pP3/3P3b/6P1/PP1B1P1P/RN2K2R w KQkq - 0 13,gxh4,-132,-144,-12,1
r3k1nr/pp3ppp/n3p3/3pP3/3P3P/8/PP1B1P1P/RN2K2R b KQkq - 0 13,g6,-133,-65,68,1
r3k1nr/pp3p1p/n3p1p1/3pP3/3P3P/8/PP1B1P1P/RN2K2R w KQkq - 0 14,Nc3,-72,-60,12,1
r3k1nr/pp3p1p/n3p1p1/3pP3/3P3P/2N5/PP1B1P1P/R3K2R b KQkq - 1 14,h5,-35,75,110,1
r3k1nr/pp3p2/n3p1p1/3pP2p/3P3P/2N5/PP1B1P1P/R3K2R w KQkq - 0 15,Nb5,58,18,-40,1
r3k1nr/pp3p2/n3p1p1/1N1pP2p/3P3P/8/PP1B1P1P/R3K2R b KQkq - 1 15,Kd7,31,31,0,1
r5nr/pp1k1p2/n3p1p1/1N1pP2p/3P3P/8/PP1B1P1P/R3K2R w KQ - 2 16,Rc1,33,-14,-47,1
r5nr/pp1k1p2/n3p1p1/1N1pP2p/3P3P/8/PP1B1P1P/2R1K2R b K - 3 16,Ne7,-36,-29,7,1
r6r/pp1knp2/n3p1p1/1N1pP2p/3P3P/8/PP1B1P1P/2R1K2R w K - 4 17,Bb4,-38,-358,-320,0
r6r/pp1knp2/n3p1p1/1N1pP2p/1B1P3P/8/PP3P1P/2R1K2R b K - 5 17,Nf5,-304,-92,212,1
r6r/pp1k1p2/n3p1p1/1N1pPn1p/1B1P3P/8/PP3P1P/2R1K2R w K - 6 18,Ba3,-94,-99,-5,1
r6r/pp1k1p2/n3p1p1/1N1pPn1p/3P3P/B7/PP3P1P/2R1K2R b K - 7 18,Rhc8,-95,-113,-18,1
r1r5/pp1k1p2/n3p1p1/1N1pPn1p/3P3P/B7/PP3P1P/2R1K2R w K - 8 19,Rxc8,-95,-143,-48,1
r1R5/pp1k1p2/n3p1p1/1N1pPn1p/3P3P/B7/PP3P1P/4K2R b K - 0 19,Rxc8,-156,-146,10,1
2r5/pp1k1p2/n3p1p1/1N1pPn1p/3P3P/B7/PP3P1P/4K2R w K - 0 20,Kd2,-132,-130,2,1
2r5/pp1k1p2/n3p1p1/1N1pPn1p/3P3P/B7/PP1K1P1P/7R b - - 1 20,Nc7,-174,-90,84,1
2r5/ppnk1p2/4p1p1/1N1pPn1p/3P3P/B7/PP1K1P1P/7R w - - 2 21,Nxa7,-75,-65,10,1
2r5/Npnk1p2/4p1p1/3pPn1p/3P3P/B7/PP1K1P1P/7R b - - 0 21,Nxd4,-86,292,378,1
2r5/Npnk1p2/4p1p1/3pP2p/3n3P/B7/PP1K1P1P/7R w - - 0 22,Nxc8,279,268,-11,1
2N5/1pnk1p2/4p1p1/3pP2p/3n3P/B7/PP1K1P1P/7R b - - 0 22,Kxc8,262,268,6,1
2k5/1pn2p2/4p1p1/3pP2p/3n3P/B7/PP1K1P1P/7R w - - 0 23,Rc1,276,201,-75,1
2k5/1pn2p2/4p1p1/3pP2p/3n3P/B7/PP1K1P1P/2R5 b - - 1 23,Kd7,201,255,54,1
8/1pnk1p2/4p1p1/3pP2p/3n3P/B7/PP1K1P1P/2R5 w - - 2 24,Kd3,271,276,5,1
8/1pnk1p2/4p1p1/3pP2p/3n3P/B2K4/PP3P1P/2R5 b - - 3 24,Nf3,253,249,-4,1
8/1pnk1p2/4p1p1/3pP2p/7P/B2K1n2/PP3P1P/2R5 w - - 4 25,Bd6,285,243,-42,1
8/1pnk1p2/3Bp1p1/3pP2p/7P/3K1n2/PP3P1P/2R5 b - - 5 25,Ne8,285,364,79,1
4n3/1p1k1p2/3Bp1p1/3pP2p/7P/3K1n2/PP3P1P/2R5 w - - 6 26,Ke3,303,332,29,1
4n3/1p1k1p2/3Bp1p1/3pP2p/7P/4Kn2/PP3P1P/2R5 b - - 7 26,Nxh4,240,227,-13,1
4n3/1p1k1p2/3Bp1p1/3pP2p/7n/4K3/PP3P1P/2R5 w - - 0 27,Kf4,233,7,-226,0
4n3/1p1k1p2/3Bp1p1/3pP2p/5K1n/8/PP3P1P/2R5 b - - 1 27,Nxd6,4,32,28,1
8/1p1k1p2/3np1p1/3pP2p/5K1n/8/PP3P1P/2R5 w - - 0 28,exd6,43,30,-13,1
8/1p1k1p2/3Pp1p1/3p3p/5K1n/8/PP3P1P/2R5 b - - 0 28,f6,58,266,208,1
8/1p1k4/3Pppp1/3p3p/5K1n/8/PP3P1P/2R5 w - - 0 29,Rc7+,270,298,28,1
8/1pRk4/3Pppp1/3p3p/5K1n/8/PP3P1P/8 b - - 1 29,Kxd6,304,291,-13,1
8/1pR5/3kppp1/3p3p/5K1n/8/PP3P1P/8 w - - 0 30,Rxb7,307,289,-18,1
8/1R6/3kppp1/3p3p/5K1n/8/PP3P1P/8 b - - 0 30,e5+,304,319,15,1
8/1R6/3k1pp1/3pp2p/5K1n/8/PP3P1P/8 w - - 0 31,Ke3,324,309,-15,1
8/1R6/3k1pp1/3pp2p/7n/4K3/PP3P1P/8 b - - 1 31,Nf5+,263,361,98,1
8/1R6/3k1pp1/3ppn1p/8/4K3/PP3P1P/8 w - - 2 32,Kd3,359,307,-52,1
8/1R6/3k1pp1/3ppn1p/8/3K4/PP3P1P/8 b - - 3 32,e4+,287,326,39,1
8/1R6/3k1pp1/3p1n1p/4p3/3K4/PP3P1P/8 w - - 0 33,Kd2,312,318,6,1
8/1R6/3k1pp1/3p1n1p/4p3/8/PP1K1P1P/8 b - - 1 33,d4,318,331,13,1
8/1R6/3k1pp1/5n1p/3pp3/8/PP1K1P1P/8 w - - 0 34,a4,373,373,0,1
8/1R6/3k1pp1/5n1p/P2pp3/8/1P1K1P1P/8 b - - 0 34,Nh4,396,430,34,1
8/1R6/3k1pp1/7p/P2pp2n/8/1P1K1P1P/8 w - - 1 35,a5,444,424,-20,1
8/1R6/3k1pp1/P6p/3pp2n/8/1P1K1P1P/8 b - - 0 35,Nf3+,463,513,50,1
8/1R6/3k1pp1/P6p/3pp3/5n2/1P1K1P1P/8 w - - 1 36,Kd1,528,512,-16,1
8/1R6/3k1pp1/P6p/3pp3/5n2/1P3P1P/3K4 b - - 2 36,Kc6,533,579,46,1
8/1R6/2k2pp1/P6p/3pp3/5n2/1P3P1P/3K4 w - - 3 37,a6,592,519,-73,1
8/1R6/P1k2pp1/7p/3pp3/5n2/1P3P1P/3K4 b - - 0 37,f5,527,596,69,1
8/1R6/P1k3p1/5p1p/3pp3/5n2/1P3P1P/3K4 w - - 0 38,Rg7,570,583,13,1
8/6R1/P1k3p1/5p1p/3pp3/5n2/1P3P1P/3K4 b - - 1 38,f4,596,608,12,1
8/6R1/P1k3p1/7p/3ppp2/5n2/1P3P1P/3K4 w - - 0 39,a7,736,791,55,1
rnbqkbnr/pppppppp/8/8/8/8/PPPPPPPP/RNBQKBNR w KQkq - 0 1,d4,31,20,-11,1
rnbqkbnr/pppppppp/8/8/3P4/8/PPP1PPPP/RNBQKBNR b KQkq - 0 1,e5,20,98,78,1
rnbqkbnr/pppp1ppp/8/4p3/3P4/8/PPP1PPPP/RNBQKBNR w KQkq - 0 2,c4,128,-31,-159,0
rnbqkbnr/pppp1ppp/8/4p3/2PP4/8/PP2PPPP/RNBQKBNR b KQkq - 0 2,exd4,-34,-41,-7,1
rnbqkbnr/pppp1ppp/8/8/2Pp4/8/PP2PPPP/RNBQKBNR w KQkq - 0 3,Qxd4,-19,-20,-1,1
rnbqkbnr/pppp1ppp/8/8/2PQ4/8/PP2PPPP/RNB1KBNR b KQkq - 0 3,Nc6,-21,-10,11,1
r1bqkbnr/pppp1ppp/2n5/8/2PQ4/8/PP2PPPP/RNB1KBNR w KQkq - 1 4,Qg4,-11,-226,-215,0
r1bqkbnr/pppp1ppp/2n5/8/2P3Q1/8/PP2PPPP/RNB1KBNR b KQkq - 2 4,d5,-234,-237,-3,1
r1bqkbnr/ppp2ppp/2n5/3p4/2P3Q1/8/PP2PPPP/RNB1KBNR w KQkq - 0 5,Qh5,-219,-317,-98,1
r1bqkbnr/ppp2ppp/2n5/3p3Q/2P5/8/PP2PPPP/RNB1KBNR b KQkq - 1 5,Nf6,-322,-312,10,1
r1bqkb1r/ppp2ppp/2n2n2/3p3Q/2P5/8/PP2PPPP/RNB1KBNR w KQkq - 2 6,Qh4,-331,-354,-23,1
r1bqkb1r/ppp2ppp/2n2n2/3p4/2P4Q/8/PP2PPPP/RNB1KBNR b KQkq - 3 6,dxc4,-331,-265,66,1
r1bqkb1r/ppp2ppp/2n2n2/8/2p4Q/8/PP2PPPP/RNB1KBNR w KQkq - 0 7,Qxc4,-258,-364,-106,0
r1bqkb1r/ppp2ppp/2n2n2/8/2Q5/8/PP2PPPP/RNB1KBNR b KQkq - 0 7,Be6,-351,-338,13,1
r2qkb1r/ppp2ppp/2n1bn2/8/2Q5/8/PP2PPPP/RNB1KBNR w KQkq - 1 8,Qd3,-348,-406,-58,1
r2qkb1r/ppp2ppp/2n1bn2/8/8/3Q4/PP2PPPP/RNB1KBNR b KQkq - 2 8,Bd6,-426,-203,223,1
r2qk2r/ppp2ppp/2nbbn2/8/8/3Q4/PP2PPPP/RNB1KBNR w KQkq - 3 9,Bg5,-222,-374,-152,0
r2qk2r/ppp2ppp/2nbbn2/6B1/8/3Q4/PP2PPPP/RN2KBNR b KQkq - 4 9,O-O,-384,-271,113,1
r2q1rk1/ppp2ppp/2nbbn2/6B1/8/3Q4/PP2PPPP/RN2KBNR w KQ - 5 10,Nh3,-244,-385,-141,0
r2q1rk1/ppp2ppp/2nbbn2/6B1/8/3Q3N/PP2PPPP/RN2KB1R b KQ - 6 10,Bxh3,-398,-210,188,1
r2q1rk1/ppp2ppp/2nb1n2/6B1/8/3Q3b/PP2PPPP/RN2KB1R w KQ - 0 11,gxh3,-210,-231,-21,1
r2q1rk1/ppp2ppp/2nb1n2/6B1/8/3Q3P/PP2PP1P/RN2KB1R b KQ - 0 11,Re8,-234,-229,5,1
r2qr1k1/ppp2ppp/2nb1n2/6B1/8/3Q3P/PP2PP1P/RN2KB1R w KQ - 1 12,Bxf6,-242,-572,-330,0
r2qr1k1/ppp2ppp/2nb1B2/8/8/3Q3P/PP2PP1P/RN2KB1R b KQ - 0 12,Qxf6,-504,-511,-7,1
r3r1k1/ppp2ppp/2nb1q2/8/8/3Q3P/PP2PP1P/RN2KB1R w KQ - 0 13,Rg1,-479,-623,-144,0
r3r1k1/ppp2ppp/2nb1q2/8/8/3Q3P/PP2PP1P/RN2KBR1 b Q - 1 13,Qxb2,-652,-643,9,1
r3r1k1/ppp2ppp/2nb4/8/8/3Q3P/Pq2PP1P/RN2KBR1 w Q - 0 14,Qc3,-692,-849,-157,0
r3r1k1/ppp2ppp/2nb4/8/8/2Q4P/Pq2PP1P/RN2KBR1 b Q - 1 14,Bb4,-878,-802,76,1
r3r1k1/ppp2ppp/2n5/8/1b6/2Q4P/Pq2PP1P/RN2KBR1 w Q - 2 15,Qxb4,-872,-9999,-9127,0
r3r1k1/ppp2ppp/2n5/8/1Q6/7P/Pq2PP1P/RN2KBR1 b Q - 0 15,Nxb4,-9999,-987,9012,1
rnbqkbnr/pppppppp/8/8/8/8/PPPPPPPP/RNBQKBNR w KQkq - 0 1,e4,34,42,8,1
rnbqkbnr/pppppppp/8/8/4P3/8/PPPP1PPP/RNBQKBNR b KQkq - 0 1,d5,43,69,26,1
rnbqkbnr/ppp1pppp/8/3p4/4P3/8/PPPP1PPP/RNBQKBNR w KQkq - 0 2,exd5,60,63,3,1
rnbqkbnr/ppp1pppp/8/3P4/8/8/PPPP1PPP/RNBQKBNR b KQkq - 0 2,Qxd5,58,77,19,1
rnb1kbnr/ppp1pppp/8/3q4/8/8/PPPP1PPP/RNBQKBNR w KQkq - 0 3,Nc3,68,72,4,1
rnb1kbnr/ppp1pppp/8/3q4/8/2N5/PPPP1PPP/R1BQKBNR b KQkq - 1 3,Qa5,73,101,28,1
rnb1kbnr/ppp1pppp/8/q7/8/2N5/PPPP1PPP/R1BQKBNR w KQkq - 2 4,Nf3,70,72,2,1
rnb1kbnr/ppp1pppp/8/q7/8/2N2N2/PPPP1PPP/R1BQKB1R b KQkq - 3 4,Nf6,76,71,-5,1
rnb1kb1r/ppp1pppp/5n2/q7/8/2N2N2/PPPP1PPP/R1BQKB1R w KQkq - 4 5,Bb5+,69,22,-47,1
rnb1kb1r/ppp1pppp/5n2/qB6/8/2N2N2/PPPP1PPP/R1BQK2R b KQkq - 5 5,c6,24,24,0,1
rnb1kb1r/pp2pppp/2p2n2/qB6/8/2N2N2/PPPP1PPP/R1BQK2R w KQkq - 0 6,Ba4,16,9,-7,1
rnb1kb1r/pp2pppp/2p2n2/q7/B7/2N2N2/PPPP1PPP/R1BQK2R b KQkq - 1 6,Bg4,0,3,3,1
rn2kb1r/pp2pppp/2p2n2/q7/B5b1/2N2N2/PPPP1PPP/R1BQK2R w KQkq - 2 7,h3,6,-10,-16,1
rn2kb1r/pp2pppp/2p2n2/q7/B5b1/2N2N1P/PPPP1PP1/R1BQK2R b KQkq - 0 7,Bh5,-30,2,32,1
rn2kb1r/pp2pppp/2p2n2/q6b/B7/2N2N1P/PPPP1PP1/R1BQK2R w KQkq - 1 8,O-O,7,-15,-22,1
rn2kb1r/pp2pppp/2p2n2/q6b/B7/2N2N1P/PPPP1PP1/R1BQ1RK1 b kq - 2 8,e6,-13,-17,-4,1
rn2kb1r/pp3ppp/2p1pn2/q6b/B7/2N2N1P/PPPP1PP1/R1BQ1RK1 w kq - 0 9,d4,-11,-17,-6,1
rn2kb1r/pp3ppp/2p1pn2/q6b/B2P4/2N2N1P/PPP2PP1/R1BQ1RK1 b kq - 0 9,Bd6,-20,-10,10,1
rn2k2r/pp3ppp/2pbpn2/q6b/B2P4/2N2N1P/PPP2PP1/R1BQ1RK1 w kq - 1 10,Bb3,-8,-25,-17,1
rn2k2r/pp3ppp/2pbpn2/q6b/3P4/1BN2N1P/PPP2PP1/R1BQ1RK1 b kq - 2 10,Qc7,-36,23,59,1
rn2k2r/ppq2ppp/2pbpn2/7b/3P4/1BN2N1P/PPP2PP1/R1BQ1RK1 w kq - 3 11,Qe2,19,-27,-46,1
rn2k2r/ppq2ppp/2pbpn2/7b/3P4/1BN2N1P/PPP1QPP1/R1B2RK1 b kq - 4 11,Nbd7,-21,-19,2,1
r3k2r/ppqn1ppp/2pbpn2/7b/3P4/1BN2N1P/PPP1QPP1/R1B2RK1 w kq - 5 12,Ng5,-24,-575,-551,0
r3k2r/ppqn1ppp/2pbpn2/6Nb/3P4/1BN4P/PPP1QPP1/R1B2RK1 b kq - 6 12,Bxe2,-598,-591,7,1
r3k2r/ppqn1ppp/2pbpn2/6N1/3P4/1BN4P/PPP1bPP1/R1B2RK1 w kq - 0 13,Re1,-573,-662,-89,1
r3k2r/ppqn1ppp/2pbpn2/6N1/3P4/1BN4P/PPP1bPP1/R1B1R1K1 b kq - 1 13,Bh5,-621,-567,54,1
r3k2r/ppqn1ppp/2pbpn2/6Nb/3P4/1BN4P/PPP2PP1/R1B1R1K1 w kq - 2 14,Nxe6,-566,-650,-84,1
r3k2r/ppqn1ppp/2pbNn2/7b/3P4/1BN4P/PPP2PP1/R1B1R1K1 b kq - 0 14,fxe6,-608,-608,0,1
r3k2r/ppqn2pp/2pbpn2/7b/3P4/1BN4P/PPP2PP1/R1B1R1K1 w kq - 0 15,Bxe6,-613,-726,-113,0
r3k2r/ppqn2pp/2pbBn2/7b/3P4/2N4P/PPP2PP1/R1B1R1K1 b kq - 0 15,O-O-O,-653,-680,-27,1
2kr3r/ppqn2pp/2pbBn2/7b/3P4/2N4P/PPP2PP1/R1B1R1K1 w - - 1 16,Bg5,-700,-758,-58,1
2kr3r/ppqn2pp/2pbBn2/6Bb/3P4/2N4P/PPP2PP1/R3R1K1 b - - 2 16,h6,-730,-671,59,1
2kr3r/ppqn2p1/2pbBn1p/6Bb/3P4/2N4P/PPP2PP1/R3R1K1 w - - 0 17,Bh4,-639,-774,-135,0
2kr3r/ppqn2p1/2pbBn1p/7b/3P3B/2N4P/PPP2PP1/R3R1K1 b - - 1 17,Kb8,-775,-748,27,1
1k1r3r/ppqn2p1/2pbBn1p/7b/3P3B/2N4P/PPP2PP1/R3R1K1 w - - 2 18,g4,-767,-759,8,1
1k1r3r/ppqn2p1/2pbBn1p/7b/3P2PB/2N4P/PPP2P2/R3R1K1 b - - 0 18,Bg6,-867,-790,77,1
1k1r3r/ppqn2p1/2pbBnbp/8/3P2PB/2N4P/PPP2P2/R3R1K1 w - - 1 19,f3,-762,-801,-39,1
1k1r3r/ppqn2p1/2pbBnbp/8/3P2PB/2N2P1P/PPP5/R3R1K1 b - - 0 19,Nb6,-784,-770,14,1
1k1r3r/ppq3p1/1npbBnbp/8/3P2PB/2N2P1P/PPP5/R3R1K1 w - - 1 20,a4,-782,-813,-31,1
1k1r3r/ppq3p1/1npbBnbp/8/P2P2PB/2N2P1P/1PP5/R3R1K1 b - - 0 20,Rde8,-796,-732,64,1
1k2r2r/ppq3p1/1npbBnbp/8/P2P2PB/2N2P1P/1PP5/R3R1K1 w - - 1 21,a5,-682,-720,-38,1
1k2r2r/ppq3p1/1npbBnbp/P7/3P2PB/2N2P1P/1PP5/R3R1K1 b - - 0 21,Nbd5,-685,-681,4,1
1k2r2r/ppq3p1/2pbBnbp/P2n4/3P2PB/2N2P1P/1PP5/R3R1K1 w - - 1 22,Bxf6,-662,-712,-50,1
1k2r2r/ppq3p1/2pbBBbp/P2n4/3P2P1/2N2P1P/1PP5/R3R1K1 b - - 0 22,Nxf6,-727,-715,12,1
1k2r2r/ppq3p1/2pbBnbp/P7/3P2P1/2N2P1P/1PP5/R3R1K1 w - - 0 23,d5,-726,-737,-11,1
1k2r2r/ppq3p1/2pbBnbp/P2P4/6P1/2N2P1P/1PP5/R3R1K1 b - - 0 23,cxd5,-754,-751,3,1
rnbqkbnr/pppppppp/8/8/8/8/PPPPPPPP/RNBQKBNR w KQkq - 0 1,d4,39,18,-21,1
rnbqkbnr/pppppppp/8/8/3P4/8/PPP1PPPP/RNBQKBNR b KQkq - 0 1,e6,18,55,37,1
rnbqkbnr/pppp1ppp/4p3/8/3P4/8/PPP1PPPP/RNBQKBNR w KQkq - 0 2,c4,41,20,-21,1
rnbqkbnr/pppp1ppp/4p3/8/2PP4/8/PP2PPPP/RNBQKBNR b KQkq - 0 2,Nf6,21,25,4,1
rnbqkb1r/pppp1ppp/4pn2/8/2PP4/8/PP2PPPP/RNBQKBNR w KQkq - 1 3,Nf3,21,18,-3,1
rnbqkb1r/pppp1ppp/4pn2/8/2PP4/5N2/PP2PPPP/RNBQKB1R b KQkq - 2 3,Bb4+,13,33,20,1
rnbqk2r/pppp1ppp/4pn2/8/1bPP4/5N2/PP2PPPP/RNBQKB1R w KQkq - 3 4,Bd2,34,32,-2,1
rnbqk2r/pppp1ppp/4pn2/8/1bPP4/5N2/PP1BPPPP/RN1QKB1R b KQkq - 4 4,Bxd2+,28,30,2,1
rnbqk2r/pppp1ppp/4pn2/8/2PP4/5N2/PP1bPPPP/RN1QKB1R w KQkq - 0 5,Qxd2,34,29,-5,1
rnbqk2r/pppp1ppp/4pn2/8/2PP4/5N2/PP1QPPPP/RN2KB1R b KQkq - 0 5,O-O,32,34,2,1
rnbq1rk1/pppp1ppp/4pn2/8/2PP4/5N2/PP1QPPPP/RN2KB1R w KQ - 1 6,Nc3,31,32,1,1
rnbq1rk1/pppp1ppp/4pn2/8/2PP4/2N2N2/PP1QPPPP/R3KB1R b KQ - 2 6,b6,32,87,55,1
rnbq1rk1/p1pp1ppp/1p2pn2/8/2PP4/2N2N2/PP1QPPPP/R3KB1R w KQ - 0 7,g3,78,44,-34,1
rnbq1rk1/p1pp1ppp/1p2pn2/8/2PP4/2N2NP1/PP1QPP1P/R3KB1R b KQ - 0 7,Bb7,37,38,1,1
rn1q1rk1/pbpp1ppp/1p2pn2/8/2PP4/2N2NP1/PP1QPP1P/R3KB1R w KQ - 1 8,Bg2,42,39,-3,1
rn1q1rk1/pbpp1ppp/1p2pn2/8/2PP4/2N2NP1/PP1QPPBP/R3K2R b KQ - 2 8,d6,20,25,5,1
rn1q1rk1/pbp2ppp/1p1ppn2/8/2PP4/2N2NP1/PP1QPPBP/R3K2R w KQ - 0 9,O-O,28,9,-19,1
rn1q1rk1/pbp2ppp/1p1ppn2/8/2PP4/2N2NP1/PP1QPPBP/R4RK1 b - - 1 9,Nbd7,20,43,23,1
r2q1rk1/pbpn1ppp/1p1ppn2/8/2PP4/2N2NP1/PP1QPPBP/R4RK1 w - - 2 10,Rfe1,37,3,-34,1
r2q1rk1/pbpn1ppp/1p1ppn2/8/2PP4/2N2NP1/PP1QPPBP/R3R1K1 b - - 3 10,Ne4,16,29,13,1
r2q1rk1/pbpn1ppp/1p1pp3/8/2PPn3/2N2NP1/PP1QPPBP/R3R1K1 w - - 4 11,Qc2,15,19,4,1
r2q1rk1/pbpn1ppp/1p1pp3/8/2PPn3/2N2NP1/PPQ1PPBP/R3R1K1 b - - 5 11,Nxc3,24,18,-6,1
r2q1rk1/pbpn1ppp/1p1pp3/8/2PP4/2n2NP1/PPQ1PPBP/R3R1K1 w - - 0 12,Qxc3,25,21,-4,1
r2q1rk1/pbpn1ppp/1p1pp3/8/2PP4/2Q2NP1/PP2PPBP/R3R1K1 b - - 0 12,f5,17,10,-7,1
r2q1rk1/pbpn2pp/1p1pp3/5p2/2PP4/2Q2NP1/PP2PPBP/R3R1K1 w - - 0 13,Nd2,25,-24,-49,1
r2q1rk1/pbpn2pp/1p1pp3/5p2/2PP4/2Q3P1/PP1NPPBP/R3R1K1 b - - 1 13,Bxg2,-26,-20,6,1
r2q1rk1/p1pn2pp/1p1pp3/5p2/2PP4/2Q3P1/PP1NPPbP/R3R1K1 w - - 0 14,Kxg2,-17,-17,0,1
r2q1rk1/p1pn2pp/1p1pp3/5p2/2PP4/2Q3P1/PP1NPPKP/R3R3 b - - 0 14,Nf6,-26,38,64,1
r2q1rk1/p1p3pp/1p1ppn2/5p2/2PP4/2Q3P1/PP1NPPKP/R3R3 w - - 1 15,e4,30,29,-1,1
r2q1rk1/p1p3pp/1p1ppn2/5p2/2PPP3/2Q3P1/PP1N1PKP/R3R3 b - - 0 15,fxe4,29,39,10,1
r2q1rk1/p1p3pp/1p1ppn2/8/2PPp3/2Q3P1/PP1N1PKP/R3R3 w - - 0 16,Nxe4,31,25,-6,1
r2q1rk1/p1p3pp/1p1ppn2/8/2PPN3/2Q3P1/PP3PKP/R3R3 b - - 0 16,Nxe4,32,71,39,1
r2q1rk1/p1p3pp/1p1pp3/8/2PPn3/2Q3P1/PP3PKP/R3R3 w - - 0 17,Rxe4,48,38,-10,1
r2q1rk1/p1p3pp/1p1pp3/8/2PPR3/2Q3P1/PP3PKP/R7 b - - 0 17,Qf6,15,39,24,1
r4rk1/p1p3pp/1p1ppq2/8/2PPR3/2Q3P1/PP3PKP/R7 w - - 1 18,Qe3,63,58,-5,1
r4rk1/p1p3pp/1p1ppq2/8/2PPR3/4Q1P1/PP3PKP/R7 b - - 2 18,Rae8,67,73,6,1
4rrk1/p1p3pp/1p1ppq2/8/2PPR3/4Q1P1/PP3PKP/R7 w - - 3 19,Re1,66,51,-15,1
4rrk1/p1p3pp/1p1ppq2/8/2PPR3/4Q1P1/PP3PKP/4R3 b - - 4 19,e5,57,54,-3,1
4rrk1/p1p3pp/1p1p1q2/4p3/2PPR3/4Q1P1/PP3PKP/4R3 w - - 0 20,dxe5,49,46,-3,1
4rrk1/p1p3pp/1p1p1q2/4P3/2P1R3/4Q1P1/PP3PKP/4R3 b - - 0 20,Rxe5,38,52,14,1
5rk1/p1p3pp/1p1p1q2/4r3/2P1R3/4Q1P1/PP3PKP/4R3 w - - 0 21,Rxe5,16,23,7,1
5rk1/p1p3pp/1p1p1q2/4R3/2P5/4Q1P1/PP3PKP/4R3 b - - 0 21,dxe5,26,18,-8,1
5rk1/p1p3pp/1p3q2/4p3/2P5/4Q1P1/PP3PKP/4R3 w - - 0 22,b3,24,23,-1,1
5rk1/p1p3pp/1p3q2/4p3/2P5/1P2Q1P1/P4PKP/4R3 b - - 0 22,e4,15,32,17,1
5rk1/p1p3pp/1p3q2/8/2P1p3/1P2Q1P1/P4PKP/4R3 w - - 0 23,Re2,25,9,-16,1
5rk1/p1p3pp/1p3q2/8/2P1p3/1P2Q1P1/P3RPKP/8 b - - 1 23,Qf3+,10,9,-1,1
5rk1/p1p3pp/1p6/8/2P1p3/1P2QqP1/P3RPKP/8 w - - 2 24,Kg1,11,0,-11,1
5rk1/p1p3pp/1p6/8/2P1p3/1P2QqP1/P3RP1P/6K1 b - - 3 24,Qf6,0,209,209,1
5rk1/p1p3pp/1p3q2/8/2P1p3/1P2Q1P1/P3RP1P/6K1 w - - 4 25,Qxe4,207,209,2,1
5rk1/p1p3pp/1p3q2/8/2P1Q3/1P4P1/P3RP1P/6K1 b - - 0 25,Qa1+,205,199,-6,1
5rk1/p1p3pp/1p6/8/2P1Q3/1P4P1/P3RP1P/q5K1 w - - 1 26,Kg2,197,197,0,1
5rk1/p1p3pp/1p6/8/2P1Q3/1P4P1/P3RPKP/q7 b - - 2 26,h6,210,233,23,1
5rk1/p1p3p1/1p5p/8/2P1Q3/1P4P1/P3RPKP/q7 w - - 0 27,Qd5+,226,198,-28,1
5rk1/p1p3p1/1p5p/3Q4/2P5/1P4P1/P3RPKP/q7 b - - 1 27,Kh8,190,203,13,1
5r1k/p1p3p1/1p5p/3Q4/2P5/1P4P1/P3RPKP/q7 w - - 2 28,Re7,186,0,-186,0
5r1k/p1p1R1p1/1p5p/3Q4/2P5/1P4P1/P4PKP/q7 b - - 3 28,Qf6,0,157,157,1
5r1k/p1p1R1p1/1p3q1p/3Q4/2P5/1P4P1/P4PKP/8 w - - 4 29,Rxc7,163,-8,-171,0
5r1k/p1R3p1/1p3q1p/3Q4/2P5/1P4P1/P4PKP/8 b - - 0 29,Qxf2+,-8,0,8,1
5r1k/p1R3p1/1p5p/3Q4/2P5/1P4P1/P4qKP/8 w - - 0 30,Kh3,-3,-12,-9,1
5r1k/p1R3p1/1p5p/3Q4/2P5/1P4PK/P4q1P/8 b - - 1 30,Qf1+,-10,0,10,1
5r1k/p1R3p1/1p5p/3Q4/2P5/1P4PK/P6P/5q2 w - - 2 31,Kh4,-11,-14,-3,1
5r1k/p1R3p1/1p5p/3Q4/2P4K/1P4P1/P6P/5q2 b - - 3 31,Qf6+,-9,0,9,1
5r1k/p1R3p1/1p3q1p/3Q4/2P4K/1P4P1/P6P/8 w - - 4 32,Kh3,0,0,0,1
5r1k/p1R3p1/1p3q1p/3Q4/2P5/1P4PK/P6P/8 b - - 5 32,Qf1+,-12,-12,0,1
5r1k/p1R3p1/1p5p/3Q4/2P5/1P4PK/P6P/5q2 w - - 6 33,Kh4,-8,-11,-3,1
5r1k/p1R3p1/1p5p/3Q4/2P4K/1P4P1/P6P/5q2 b - - 7 33,g5+,-9,63,72,1
5r1k/p1R5/1p5p/3Q2p1/2P4K/1P4P1/P6P/5q2 w - - 0 34,Kh5,0,0,0,1
5r1k/p1R5/1p5p/3Q2pK/2P5/1P4P1/P6P/5q2 b - - 1 34,Qh3+,0,171,171,1
5r1k/p1R5/1p5p/3Q2pK/2P5/1P4Pq/P6P/8 w - - 2 35,Kg6,192,219,27,1
5r1k/p1R5/1p4Kp/3Q2p1/2P5/1P4Pq/P6P/8 b - - 3 35,Rg8+,203,230,27,1
6rk/p1R5/1p4Kp/3Q2p1/2P5/1P4Pq/P6P/8 w - - 4 36,Kf6,219,203,-16,1
6rk/p1R5/1p3K1p/3Q2p1/2P5/1P4Pq/P6P/8 b - - 5 36,Qf1+,212,234,22,1
6rk/p1R5/1p3K1p/3Q2p1/2P5/1P4P1/P6P/5q2 w - - 6 37,Ke5,211,0,-211,0
6rk/p1R5/1p5p/3QK1p1/2P5/1P4P1/P6P/5q2 b - - 7 37,Qe2+,0,207,207,1
6rk/p1R5/1p5p/3QK1p1/2P5/1P4P1/P3q2P/8 w - - 8 38,Kd6,228,162,-66,1
6rk/p1R5/1p1K3p/3Q2p1/2P5/1P4P1/P3q2P/8 b - - 9 38,Rd8+,158,126,-32,1
3r3k/p1R5/1p1K3p/3Q2p1/2P5/1P4P1/P3q2P/8 w - - 10 39,Rd7,172,237,65,1
3r3k/p2R4/1p1K3p/3Q2p1/2P5/1P4P1/P3q2P/8 b - - 11 39,Rxd7+,263,260,-3,1
7k/p2r4/1p1K3p/3Q2p1/2P5/1P4P1/P3q2P/8 w - - 0 40,Kxd7,286,271,-15,1
7k/p2K4/1p5p/3Q2p1/2P5/1P4P1/P3q2P/8 b - - 0 40,Qc2,217,315,98,1
7k/p2K4/1p5p/3Q2p1/2P5/1P4P1/P1q4P/8 w - - 1 41,Qe5+,386,310,-76,1
7k/p2K4/1p5p/4Q1p1/2P5/1P4P1/P1q4P/8 b - - 2 41,Kh7,305,330,25,1
8/p2K3k/1p5p/4Q1p1/2P5/1P4P1/P1q4P/8 w - - 3 42,Qe7+,325,286,-39,1
8/p2KQ2k/1p5p/6p1/2P5/1P4P1/P1q4P/8 b - - 4 42,Kg6,284,324,40,1
8/p2KQ3/1p4kp/6p1/2P5/1P4P1/P1q4P/8 w - - 5 43,Qe6+,327,299,-28,1
8/p2K4/1p2Q1kp/6p1/2P5/1P4P1/P1q4P/8 b - - 6 43,Kh5,278,347,69,1
8/p2K4/1p2Q2p/6pk/2P5/1P4P1/P1q4P/8 w - - 7 44,Qh3+,391,321,-70,1
8/p2K4/1p5p/6pk/2P5/1P4PQ/P1q4P/8 b - - 8 44,Kg6,305,304,-1,1
8/p2K4/1p4kp/6p1/2P5/1P4PQ/P1q4P/8 w - - 9 45,Qe6+,309,293,-16,1
8/p2K4/1p2Q1kp/6p1/2P5/1P4P1/P1q4P/8 b - - 10 45,Kh7,301,455,154,1
8/p2K3k/1p2Q2p/6p1/2P5/1P4P1/P1q4P/8 w - - 11 46,Qe7+,516,278,-238,0
8/p2KQ2k/1p5p/6p1/2P5/1P4P1/P1q4P/8 b - - 12 46,Kg6,318,320,2,1
8/p2KQ3/1p4kp/6p1/2P5/1P4P1/P1q4P/8 w - - 13 47,Qe6+,304,297,-7,1
8/p2K4/1p2Q1kp/6p1/2P5/1P4P1/P1q4P/8 b - - 14 47,Kg7,269,284,15,1
8/p2K2k1/1p2Q2p/6p1/2P5/1P4P1/P1q4P/8 w - - 15 48,Qe7+,301,285,-16,1
8/p2KQ1k1/1p5p/6p1/2P5/1P4P1/P1q4P/8 b - - 16 48,Kg6,307,316,9,1
rnbqkbnr/pppppppp/8/8/8/8/PPPPPPPP/RNBQKBNR w KQkq - 0 1,e4,27,24,-3,1
rnbqkbnr/pppppppp/8/8/4P3/8/PPPP1PPP/RNBQKBNR b KQkq - 0 1,e5,30,39,9,1
rnbqkbnr/pppp1ppp/8/4p3/4P3/8/PPPP1PPP/RNBQKBNR w KQkq - 0 2,Nf3,50,42,-8,1
rnbqkbnr/pppp1ppp/8/4p3/4P3/5N2/PPPP1PPP/RNBQKB1R b KQkq - 1 2,Nc6,36,42,6,1
r1bqkbnr/pppp1ppp/2n5/4p3/4P3/5N2/PPPP1PPP/RNBQKB1R w KQkq - 2 3,c3,36,-24,-60,1
r1bqkbnr/pppp1ppp/2n5/4p3/4P3/2P2N2/PP1P1PPP/RNBQKB1R b KQkq - 0 3,d5,-37,-20,17,1
r1bqkbnr/ppp2ppp/2n5/3pp3/4P3/2P2N2/PP1P1PPP/RNBQKB1R w KQkq - 0 4,exd5,21,-51,-72,1
r1bqkbnr/ppp2ppp/2n5/3Pp3/8/2P2N2/PP1P1PPP/RNBQKB1R b KQkq - 0 4,Qxd5,-44,-27,17,1
r1b1kbnr/ppp2ppp/2n5/3qp3/8/2P2N2/PP1P1PPP/RNBQKB1R w KQkq - 0 5,d4,-19,-29,-10,1
r1b1kbnr/ppp2ppp/2n5/3qp3/3P4/2P2N2/PP3PPP/RNBQKB1R b KQkq - 0 5,e4,-34,13,47,1
r1b1kbnr/ppp2ppp/2n5/3q4/3Pp3/2P2N2/PP3PPP/RNBQKB1R w KQkq - 0 6,Nfd2,19,10,-9,1
r1b1kbnr/ppp2ppp/2n5/3q4/3Pp3/2P5/PP1N1PPP/RNBQKB1R b KQkq - 1 6,Nf6,-1,8,9,1
r1b1kb1r/ppp2ppp/2n2n2/3q4/3Pp3/2P5/PP1N1PPP/RNBQKB1R w KQkq - 2 7,Bc4,26,-83,-109,0
r1b1kb1r/ppp2ppp/2n2n2/3q4/2BPp3/2P5/PP1N1PPP/RNBQK2R b KQkq - 3 7,Qg5,-94,-76,18,1
r1b1kb1r/ppp2ppp/2n2n2/6q1/2BPp3/2P5/PP1N1PPP/RNBQK2R w KQkq - 4 8,Nxe4,-87,-97,-10,1
r1b1kb1r/ppp2ppp/2n2n2/6q1/2BPN3/2P5/PP3PPP/RNBQK2R b KQkq - 0 8,Qxg2,-106,-80,26,1
r1b1kb1r/ppp2ppp/2n2n2/8/2BPN3/2P5/PP3PqP/RNBQK2R w KQkq - 0 9,Nxf6+,-94,-114,-20,1
r1b1kb1r/ppp2ppp/2n2N2/8/2BP4/2P5/PP3PqP/RNBQK2R b KQkq - 0 9,gxf6,-90,-82,8,1
r1b1kb1r/ppp2p1p/2n2p2/8/2BP4/2P5/PP3PqP/RNBQK2R w KQkq - 0 10,Qe2+,-83,-84,-1,1
r1b1kb1r/ppp2p1p/2n2p2/8/2BP4/2P5/PP2QPqP/RNB1K2R b KQkq - 1 10,Ne7,-86,-82,4,1
r1b1kb1r/ppp1np1p/5p2/8/2BP4/2P5/PP2QPqP/RNB1K2R w KQkq - 2 11,Qf1,-79,-81,-2,1
r1b1kb1r/ppp1np1p/5p2/8/2BP4/2P5/PP3PqP/RNB1KQ1R b KQkq - 3 11,Bh3,-109,29,138,1
r3kb1r/ppp1np1p/5p2/8/2BP4/2P4b/PP3PqP/RNB1KQ1R w KQkq - 4 12,Qxg2,39,27,-12,1
r3kb1r/ppp1np1p/5p2/8/2BP4/2P4b/PP3PQP/RNB1K2R b KQkq - 0 12,Bxg2,24,32,8,1
r3kb1r/ppp1np1p/5p2/8/2BP4/2P5/PP3PbP/RNB1K2R w KQkq - 0 13,Rg1,38,25,-13,1
r3kb1r/ppp1np1p/5p2/8/2BP4/2P5/PP3PbP/RNB1K1R1 b Qkq - 1 13,Rg8,33,69,36,1
r3kbr1/ppp1np1p/5p2/8/2BP4/2P5/PP3PbP/RNB1K1R1 w Qq - 2 14,Nd2,53,44,-9,1
r3kbr1/ppp1np1p/5p2/8/2BP4/2P5/PP1N1PbP/R1B1K1R1 b Qq - 3 14,h5,41,144,103,1
r3kbr1/ppp1np2/5p2/7p/2BP4/2P5/PP1N1PbP/R1B1K1R1 w Qq - 0 15,b3,113,75,-38,1
r3kbr1/ppp1np2/5p2/7p/2BP4/1PP5/P2N1PbP/R1B1K1R1 b Qq - 0 15,h4,59,71,12,1
r3kbr1/ppp1np2/5p2/8/2BP3p/1PP5/P2N1PbP/R1B1K1R1 w Qq - 0 16,Ba3,76,30,-46,1
r3kbr1/ppp1np2/5p2/8/2BP3p/BPP5/P2N1PbP/R3K1R1 b Qq - 1 16,c6,33,98,65,1
r3kbr1/pp2np2/2p2p2/8/2BP3p/BPP5/P2N1PbP/R3K1R1 w Qq - 0 17,O-O-O,80,27,-53,1
r3kbr1/pp2np2/2p2p2/8/2BP3p/BPP5/P2N1PbP/2KR2R1 b q - 1 17,Bh6,14,314,300,1
r3k1r1/pp2np2/2p2p1b/8/2BP3p/BPP5/P2N1PbP/2KR2R1 w q - 2 18,Rge1,374,330,-44,1
r3k1r1/pp2np2/2p2p1b/8/2BP3p/BPP5/P2N1PbP/2KRR3 b q - 3 18,Bf8,347,369,22,1
r3kbr1/pp2np2/2p2p2/8/2BP3p/BPP5/P2N1PbP/2KRR3 w q - 4 19,Bxe7,387,-34,-421,0
r3kbr1/pp2Bp2/2p2p2/8/2BP3p/1PP5/P2N1PbP/2KRR3 b q - 0 19,Bxe7,-44,-27,17,1
r3k1r1/pp2bp2/2p2p2/8/2BP3p/1PP5/P2N1PbP/2KRR3 w q - 0 20,f3,-12,-112,-100,1
r3k1r1/pp2bp2/2p2p2/8/2BP3p/1PP2P2/P2N2bP/2KRR3 b q - 0 20,h3,-115,-25,90,1
r3k1r1/pp2bp2/2p2p2/8/2BP4/1PP2P1p/P2N2bP/2KRR3 w q - 0 21,Bd3,-30,-203,-173,0
r3k1r1/pp2bp2/2p2p2/8/3P4/1PPB1P1p/P2N2bP/2KRR3 b q - 1 21,Rd8,-206,-75,131,1
3rk1r1/pp2bp2/2p2p2/8/3P4/1PPB1P1p/P2N2bP/2KRR3 w - - 2 22,Rg1,-76,-288,-212,0
3rk1r1/pp2bp2/2p2p2/8/3P4/1PPB1P1p/P2N2bP/2KR2R1 b - - 3 22,Bd6,-283,-303,-20,1
3rk1r1/pp3p2/2pb1p2/8/3P4/1PPB1P1p/P2N2bP/2KR2R1 w - - 4 23,Bh7,-327,-398,-71,1
3rk1r1/pp3p1B/2pb1p2/8/3P4/1PP2P1p/P2N2bP/2KR2R1 b - - 5 23,Rg5,-353,-362,-9,1
3rk3/pp3p1B/2pb1p2/6r1/3P4/1PP2P1p/P2N2bP/2KR2R1 w - - 6 24,Rde1+,-321,-440,-119,0
3rk3/pp3p1B/2pb1p2/6r1/3P4/1PP2P1p/P2N2bP/2K1R1R1 b - - 7 24,Kd7,-407,-333,74,1
3r4/pp1k1p1B/2pb1p2/6r1/3P4/1PP2P1p/P2N2bP/2K1R1R1 w - - 8 25,Ne4,-391,-412,-21,1
3r4/pp1k1p1B/2pb1p2/6r1/3PN3/1PP2P1p/P5bP/2K1R1R1 b - - 9 25,Rh5,-395,178,573,1
3r4/pp1k1p1B/2pb1p2/7r/3PN3/1PP2P1p/P5bP/2K1R1R1 w - - 10 26,Nxf6+,216,254,38,1
3r4/pp1k1p1B/2pb1N2/7r/3P4/1PP2P1p/P5bP/2K1R1R1 b - - 0 26,Kc7,257,263,6,1
3r4/ppk2p1B/2pb1N2/7r/3P4/1PP2P1p/P5bP/2K1R1R1 w - - 1 27,Nxh5,262,253,-9,1
3r4/ppk2p1B/2pb4/7N/3P4/1PP2P1p/P5bP/2K1R1R1 b - - 0 27,Bxh2,271,290,19,1
3r4/ppk2p1B/2p5/7N/3P4/1PP2P1p/P5bb/2K1R1R1 w - - 0 28,Re7+,260,301,41,1
3r4/ppk1Rp1B/2p5/7N/3P4/1PP2P1p/P5bb/2K3R1 b - - 1 28,Kd6,272,390,118,1
3r4/pp2Rp1B/2pk4/7N/3P4/1PP2P1p/P5bb/2K3R1 w - - 2 29,Rxf7,372,-182,-554,0
3r4/pp3R1B/2pk4/7N/3P4/1PP2P1p/P5bb/2K3R1 b - - 0 29,Bxg1,-177,-210,-33,1
3r4/pp3R1B/2pk4/7N/3P4/1PP2P1p/P5b1/2K3b1 w - - 0 30,Rf6+,-227,-385,-158,0
3r4/pp5B/2pk1R2/7N/3P4/1PP2P1p/P5b1/2K3b1 b - - 1 30,Kc7,-402,-401,1,1
3r4/ppk4B/2p2R2/7N/3P4/1PP2P1p/P5b1/2K3b1 w - - 2 31,Nf4,-433,-446,-13,1
3r4/ppk4B/2p2R2/8/3P1N2/1PP2P1p/P5b1/2K3b1 b - - 3 31,Rh8,-416,-255,161,1
7r/ppk4B/2p2R2/8/3P1N2/1PP2P1p/P5b1/2K3b1 w - - 4 32,Rf7+,-274,-261,13,1
7r/ppk2R1B/2p5/8/3P1N2/1PP2P1p/P5b1/2K3b1 b - - 5 32,Kd6,-261,-39,222,1
7r/pp3R1B/2pk4/8/3P1N2/1PP2P1p/P5b1/2K3b1 w - - 6 33,Nxg2,-20,-460,-440,0
7r/pp3R1B/2pk4/8/3P4/1PP2P1p/P5N1/2K3b1 b - - 0 33,hxg2,-547,-529,18,1
7r/pp3R1B/2pk4/8/3P4/1PP2P2/P5p1/2K3b1 w - - 0 34,Rg7,-535,-512,23,1
7r/pp4RB/2pk4/8/3P4/1PP2P2/P5p1/2K3b1 b - - 1 34,Be3+,-536,-504,32,1
7r/pp4RB/2pk4/8/3P4/1PP1bP2/P5p1/2K5 w - - 2 35,Kd1,-487,-501,-14,1
7r/pp4RB/2pk4/8/3P4/1PP1bP2/P5p1/3K4 b - - 3 35,g1=Q+,-525,-515,10,1
7r/pp4RB/2pk4/8/3P4/1PP1bP2/P7/3K2q1 w - - 0 36,Rxg1,-518,-493,25,1
7r/pp5B/2pk4/8/3P4/1PP1bP2/P7/3K2R1 b - - 0 36,Bxg1,-499,-503,-4,1
7r/pp5B/2pk4/8/3P4/1PP2P2/P7/3K2b1 w - - 0 37,Be4,-513,-509,4,1
7r/pp6/2pk4/8/3PB3/1PP2P2/P7/3K2b1 b - - 1 37,Rh2,-505,-508,-3,1
8/pp6/2pk4/8/3PB3/1PP2P2/P6r/3K2b1 w - - 2 38,Ke1,-523,-562,-39,1
8/pp6/2pk4/8/3PB3/1PP2P2/P6r/4K1b1 b - - 3 38,Rxa2,-534,-509,25,1
8/pp6/2pk4/8/3PB3/1PP2P2/r7/4K1b1 w - - 0 39,Kf1,-534,-579,-45,1
8/pp6/2pk4/8/3PB3/1PP2P2/r7/5Kb1 b - - 1 39,Bh2,-572,-548,24,1
8/pp6/2pk4/8/3PB3/1PP2P2/r6b/5K2 w - - 2 40,f4,-555,-584,-29,1
8/pp6/2pk4/8/3PBP2/1PP5/r6b/5K2 b - - 0 40,Bxf4,-574,-585,-11,1
rnbqkbnr/pppppppp/8/8/8/8/PPPPPPPP/RNBQKBNR w KQkq - 0 1,h3,31,-26,-57,1
rnbqkbnr/pppppppp/8/8/8/7P/PPPPPPP1/RNBQKBNR b KQkq - 0 1,e5,-34,-29,5,1
rnbqkbnr/pppp1ppp/8/4p3/8/7P/PPPPPPP1/RNBQKBNR w KQkq - 0 2,e3,-28,-38,-10,1
rnbqkbnr/pppp1ppp/8/4p3/8/4P2P/PPPP1PP1/RNBQKBNR b KQkq - 0 2,Qf6,-43,72,115,1
rnb1kbnr/pppp1ppp/5q2/4p3/8/4P2P/PPPP1PP1/RNBQKBNR w KQkq - 1 3,Nf3,84,2,-82,1
rnb1kbnr/pppp1ppp/5q2/4p3/8/4PN1P/PPPP1PP1/RNBQKB1R b KQkq - 2 3,b6,-23,28,51,1
rnb1kbnr/p1pp1ppp/1p3q2/4p3/8/4PN1P/PPPP1PP1/RNBQKB1R w KQkq - 0 4,b3,30,-150,-180,0
rnb1kbnr/p1pp1ppp/1p3q2/4p3/8/1P2PN1P/P1PP1PP1/RNBQKB1R b KQkq - 0 4,Bb7,-178,10,188,1
rn2kbnr/pbpp1ppp/1p3q2/4p3/8/1P2PN1P/P1PP1PP1/RNBQKB1R w KQkq - 1 5,c4,5,-146,-151,0
rn2kbnr/pbpp1ppp/1p3q2/4p3/2P5/1P2PN1P/P2P1PP1/RNBQKB1R b KQkq - 0 5,Bb4,-117,74,191,1
rn2k1nr/pbpp1ppp/1p3q2/4p3/1bP5/1P2PN1P/P2P1PP1/RNBQKB1R w KQkq - 1 6,Ba3,88,-77,-165,0
rn2k1nr/pbpp1ppp/1p3q2/4p3/1bP5/BP2PN1P/P2P1PP1/RN1QKB1R b KQkq - 2 6,Bxa3,-50,-45,5,1
rn2k1nr/pbpp1ppp/1p3q2/4p3/2P5/bP2PN1P/P2P1PP1/RN1QKB1R w KQkq - 0 7,Nxa3,-52,-52,0,1
rn2k1nr/pbpp1ppp/1p3q2/4p3/2P5/NP2PN1P/P2P1PP1/R2QKB1R b KQkq - 0 7,e4,-61,-45,16,1
rn2k1nr/pbpp1ppp/1p3q2/8/2P1p3/NP2PN1P/P2P1PP1/R2QKB1R w KQkq - 0 8,Ng1,-41,-92,-51,1
rn2k1nr/pbpp1ppp/1p3q2/8/2P1p3/NP2P2P/P2P1PP1/R2QKBNR b KQkq - 1 8,Na6,-99,-86,13,1
r3k1nr/pbpp1ppp/np3q2/8/2P1p3/NP2P2P/P2P1PP1/R2QKBNR w KQkq - 2 9,g3,-91,-243,-152,0
r3k1nr/pbpp1ppp/np3q2/8/2P1p3/NP2P1PP/P2P1P2/R2QKBNR b KQkq - 0 9,Nb4,-257,-242,15,1
r3k1nr/pbpp1ppp/1p3q2/8/1nP1p3/NP2P1PP/P2P1P2/R2QKBNR w KQkq - 1 10,h4,-225,-265,-40,1
r3k1nr/pbpp1ppp/1p3q2/8/1nP1p2P/NP2P1P1/P2P1P2/R2QKBNR b KQkq - 0 10,Nd3+,-250,-200,50,1
r3k1nr/pbpp1ppp/1p3q2/8/2P1p2P/NP1nP1P1/P2P1P2/R2QKBNR w KQkq - 1 11,Ke2,-199,-9999,-9800,0
r3k1nr/pbpp1ppp/1p3q2/8/2P1p2P/NP1nP1P1/P2PKP2/R2Q1BNR b kq - 2 11,Qf3+,-9999,496,10495,1
r3k1nr/pbpp1ppp/1p6/8/2P1p2P/NP1nPqP1/P2PKP2/R2Q1BNR w kq - 3 12,Nxf3,523,537,14,1
r3k1nr/pbpp1ppp/1p6/8/2P1p2P/NP1nPNP1/P2PKP2/R2Q1B1R b kq - 0 12,exf3+,551,633,82,1
r3k1nr/pbpp1ppp/1p6/8/2P4P/NP1nPpP1/P2PKP2/R2Q1B1R w kq - 0 13,Kxd3,676,675,-1,1
r3k1nr/pbpp1ppp/1p6/8/2P4P/NP1KPpP1/P2P1P2/R2Q1B1R b kq - 0 13,O-O-O,659,679,20,1
2kr2nr/pbpp1ppp/1p6/8/2P4P/NP1KPpP1/P2P1P2/R2Q1B1R w - - 1 14,Kc2,656,664,8,1
2kr2nr/pbpp1ppp/1p6/8/2P4P/NP2PpP1/P1KP1P2/R2Q1B1R b - - 2 14,Re8,674,697,23,1
2k1r1nr/pbpp1ppp/1p6/8/2P4P/NP2PpP1/P1KP1P2/R2Q1B1R w - - 3 15,Rc1,686,693,7,1
2k1r1nr/pbpp1ppp/1p6/8/2P4P/NP2PpP1/P1KP1P2/2RQ1B1R b - - 4 15,Be4+,673,747,74,1
2k1r1nr/p1pp1ppp/1p6/8/2P1b2P/NP2PpP1/P1KP1P2/2RQ1B1R w - - 5 16,Kb2,716,700,-16,1
2k1r1nr/p1pp1ppp/1p6/8/2P1b2P/NP2PpP1/PK1P1P2/2RQ1B1R b - - 6 16,f6,703,779,76,1
2k1r1nr/p1pp2pp/1p3p2/8/2P1b2P/NP2PpP1/PK1P1P2/2RQ1B1R w - - 0 17,Rg1,736,716,-20,1
2k1r1nr/p1pp2pp/1p3p2/8/2P1b2P/NP2PpP1/PK1P1P2/2RQ1BR1 b - - 1 17,Ne7,735,747,12,1
2k1r2r/p1ppn1pp/1p3p2/8/2P1b2P/NP2PpP1/PK1P1P2/2RQ1BR1 w - - 2 18,g4,752,682,-70,1
2k1r2r/p1ppn1pp/1p3p2/8/2P1b1PP/NP2Pp2/PK1P1P2/2RQ1BR1 b - - 0 18,Rhf8,637,738,101,1
2k1rr2/p1ppn1pp/1p3p2/8/2P1b1PP/NP2Pp2/PK1P1P2/2RQ1BR1 w - - 1 19,Rc3,709,685,-24,1
2k1rr2/p1ppn1pp/1p3p2/8/2P1b1PP/NPR1Pp2/PK1P1P2/3Q1BR1 b - - 2 19,d5,715,736,21,1
2k1rr2/p1p1n1pp/1p3p2/3p4/2P1b1PP/NPR1Pp2/PK1P1P2/3Q1BR1 w - - 0 20,cxd5,719,699,-20,1
2k1rr2/p1p1n1pp/1p3p2/3P4/4b1PP/NPR1Pp2/PK1P1P2/3Q1BR1 b - - 0 20,Nxd5,675,648,-27,1
2k1rr2/p1p3pp/1p3p2/3n4/4b1PP/NPR1Pp2/PK1P1P2/3Q1BR1 w - - 0 21,Rc1,677,619,-58,1
2k1rr2/p1p3pp/1p3p2/3n4/4b1PP/NP2Pp2/PK1P1P2/2RQ1BR1 b - - 1 21,c5,641,713,72,1
2k1rr2/p5pp/1p3p2/2pn4/4b1PP/NP2Pp2/PK1P1P2/2RQ1BR1 w - - 0 22,Bc4,725,671,-54,1
2k1rr2/p5pp/1p3p2/2pn4/2B1b1PP/NP2Pp2/PK1P1P2/2RQ2R1 b - - 1 22,Nb4,645,655,10,1
2k1rr2/p5pp/1p3p2/2p5/1nB1b1PP/NP2Pp2/PK1P1P2/2RQ2R1 w - - 2 23,Rc3,642,606,-36,1
2k1rr2/p5pp/1p3p2/2p5/1nB1b1PP/NPR1Pp2/PK1P1P2/3Q2R1 b - - 3 23,b5,563,608,45,1
2k1rr2/p5pp/5p2/1pp5/1nB1b1PP/NPR1Pp2/PK1P1P2/3Q2R1 w - - 0 24,Nxb5,637,625,-12,1
2k1rr2/p5pp/5p2/1Np5/1nB1b1PP/1PR1Pp2/PK1P1P2/3Q2R1 b - - 0 24,a6,640,723,83,1
2k1rr2/6pp/p4p2/1Np5/1nB1b1PP/1PR1Pp2/PK1P1P2/3Q2R1 w - - 0 25,Na7+,692,569,-123,0
2k1rr2/N5pp/p4p2/2p5/1nB1b1PP/1PR1Pp2/PK1P1P2/3Q2R1 b - - 1 25,Kb7,617,587,-30,1
4rr2/Nk4pp/p4p2/2p5/1nB1b1PP/1PR1Pp2/PK1P1P2/3Q2R1 w - - 2 26,Nc6,585,582,-3,1
4rr2/1k4pp/p1N2p2/2p5/1nB1b1PP/1PR1Pp2/PK1P1P2/3Q2R1 b - - 3 26,Kxc6,587,618,31,1
4rr2/6pp/p1k2p2/2p5/1nB1b1PP/1PR1Pp2/PK1P1P2/3Q2R1 w - - 0 27,a3,620,585,-35,1
4rr2/6pp/p1k2p2/2p5/1nB1b1PP/PPR1Pp2/1K1P1P2/3Q2R1 b - - 0 27,Nd5,600,660,60,1
4rr2/6pp/p1k2p2/2pn4/2B1b1PP/PPR1Pp2/1K1P1P2/3Q2R1 w - - 1 28,d3,648,575,-73,1
4rr2/6pp/p1k2p2/2pn4/2B1b1PP/PPRPPp2/1K3P2/3Q2R1 b - - 0 28,Nxc3,534,608,74,1
4rr2/6pp/p1k2p2/2p5/2B1b1PP/PPnPPp2/1K3P2/3Q2R1 w - - 0 29,dxe4,625,-34,-659,0
4rr2/6pp/p1k2p2/2p5/2B1P1PP/PPn1Pp2/1K3P2/3Q2R1 b - - 0 29,Ne2,-60,753,813,1
4rr2/6pp/p1k2p2/2p5/2B1P1PP/PP2Pp2/1K2nP2/3Q2R1 w - - 1 30,Qe1,855,529,-326,0
4rr2/6pp/p1k2p2/2p5/2B1P1PP/PP2Pp2/1K2nP2/4Q1R1 b - - 2 30,Nxg1,518,533,15,1
4rr2/6pp/p1k2p2/2p5/2B1P1PP/PP2Pp2/1K3P2/4Q1n1 w - - 0 31,Qxg1,503,441,-62,1
4rr2/6pp/p1k2p2/2p5/2B1P1PP/PP2Pp2/1K3P2/6Q1 b - - 0 31,Rd8,469,461,-8,1
3r1r2/6pp/p1k2p2/2p5/2B1P1PP/PP2Pp2/1K3P2/6Q1 w - - 1 32,a4,499,467,-32,1
3r1r2/6pp/p1k2p2/2p5/P1B1P1PP/1P2Pp2/1K3P2/6Q1 b - - 0 32,Rd2+,434,439,5,1
5r2/6pp/p1k2p2/2p5/P1B1P1PP/1P2Pp2/1K1r1P2/6Q1 w - - 1 33,Ka3,491,401,-90,1
5r2/6pp/p1k2p2/2p5/P1B1P1PP/KP2Pp2/3r1P2/6Q1 b - - 2 33,Rb8,446,498,52,1
1r6/6pp/p1k2p2/2p5/P1B1P1PP/KP2Pp2/3r1P2/6Q1 w - - 3 34,b4,472,362,-110,0
1r6/6pp/p1k2p2/2p5/PPB1P1PP/K3Pp2/3r1P2/6Q1 b - - 0 34,a5,399,457,58,1
1r6/6pp/2k2p2/p1p5/PPB1P1PP/K3Pp2/3r1P2/6Q1 w - - 0 35,bxa5,431,354,-77,1
1r6/6pp/2k2p2/P1p5/P1B1P1PP/K3Pp2/3r1P2/6Q1 b - - 0 35,Rbb2,406,380,-26,1
rnbqkbnr/pppppppp/8/8/8/8/PPPPPPPP/RNBQKBNR w KQkq - 0 1,e4,27,24,-3,1
rnbqkbnr/pppppppp/8/8/4P3/8/PPPP1PPP/RNBQKBNR b KQkq - 0 1,e5,38,38,0,1
rnbqkbnr/pppp1ppp/8/4p3/4P3/8/PPPP1PPP/RNBQKBNR w KQkq - 0 2,Nf3,48,36,-12,1
rnbqkbnr/pppp1ppp/8/4p3/4P3/5N2/PPPP1PPP/RNBQKB1R b KQkq - 1 2,Nc6,37,42,5,1
r1bqkbnr/pppp1ppp/2n5/4p3/4P3/5N2/PPPP1PPP/RNBQKB1R w KQkq - 2 3,d4,32,25,-7,1
r1bqkbnr/pppp1ppp/2n5/4p3/3PP3/5N2/PPP2PPP/RNBQKB1R b KQkq - 0 3,exd4,23,35,12,1
r1bqkbnr/pppp1ppp/2n5/8/3pP3/5N2/PPP2PPP/RNBQKB1R w KQkq - 0 4,Nxd4,41,21,-20,1
r1bqkbnr/pppp1ppp/2n5/8/3NP3/8/PPP2PPP/RNBQKB1R b KQkq - 0 4,Nf6,24,33,9,1
r1bqkb1r/pppp1ppp/2n2n2/8/3NP3/8/PPP2PPP/RNBQKB1R w KQkq - 1 5,Nxc6,28,18,-10,1
r1bqkb1r/pppp1ppp/2N2n2/8/4P3/8/PPP2PPP/RNBQKB1R b KQkq - 0 5,bxc6,12,16,4,1
r1bqkb1r/p1pp1ppp/2p2n2/8/4P3/8/PPP2PPP/RNBQKB1R w KQkq - 0 6,Bd3,16,8,-8,1
r1bqkb1r/p1pp1ppp/2p2n2/8/4P3/3B4/PPP2PPP/RNBQK2R b KQkq - 1 6,Bc5,8,74,66,1
r1bqk2r/p1pp1ppp/2p2n2/2b5/4P3/3B4/PPP2PPP/RNBQK2R w KQkq - 2 7,O-O,88,22,-66,1
r1bqk2r/p1pp1ppp/2p2n2/2b5/4P3/3B4/PPP2PPP/RNBQ1RK1 b kq - 3 7,O-O,30,103,73,1
r1bq1rk1/p1pp1ppp/2p2n2/2b5/4P3/3B4/PPP2PPP/RNBQ1RK1 w - - 4 8,h3,89,20,-69,1
r1bq1rk1/p1pp1ppp/2p2n2/2b5/4P3/3B3P/PPP2PP1/RNBQ1RK1 b - - 0 8,d5,19,31,12,1
r1bq1rk1/p1p2ppp/2p2n2/2bp4/4P3/3B3P/PPP2PP1/RNBQ1RK1 w - - 0 9,e5,27,-31,-58,1
r1bq1rk1/p1p2ppp/2p2n2/2bpP3/8/3B3P/PPP2PP1/RNBQ1RK1 b - - 0 9,Nd7,-35,-13,22,1
r1bq1rk1/p1pn1ppp/2p5/2bpP3/8/3B3P/PPP2PP1/RNBQ1RK1 w - - 1 10,c3,-15,-232,-217,0
r1bq1rk1/p1pn1ppp/2p5/2bpP3/8/2PB3P/PP3PP1/RNBQ1RK1 b - - 0 10,Nxe5,-173,-163,10,1
r1bq1rk1/p1p2ppp/2p5/2bpn3/8/2PB3P/PP3PP1/RNBQ1RK1 w - - 0 11,Bc2,-158,-270,-112,0
r1bq1rk1/p1p2ppp/2p5/2bpn3/8/2P4P/PPB2PP1/RNBQ1RK1 b - - 1 11,Bxh3,-294,209,503,1
r2q1rk1/p1p2ppp/2p5/2bpn3/8/2P4b/PPB2PP1/RNBQ1RK1 w - - 0 12,Qh5,259,228,-31,1
r2q1rk1/p1p2ppp/2p5/2bpn2Q/8/2P4b/PPB2PP1/RNB2RK1 b - - 1 12,g6,238,265,27,1
r2q1rk1/p1p2p1p/2p3p1/2bpn2Q/8/2P4b/PPB2PP1/RNB2RK1 w - - 0 13,Qxh3,291,264,-27,1
r2q1rk1/p1p2p1p/2p3p1/2bpn3/8/2P4Q/PPB2PP1/RNB2RK1 b - - 0 13,Qd6,246,339,93,1
r4rk1/p1p2p1p/2pq2p1/2bpn3/8/2P4Q/PPB2PP1/RNB2RK1 w - - 1 14,Bh6,363,325,-38,1
r4rk1/p1p2p1p/2pq2pB/2bpn3/8/2P4Q/PPB2PP1/RN3RK1 b - - 2 14,Rfe8,381,369,-12,1
r3r1k1/p1p2p1p/2pq2pB/2bpn3/8/2P4Q/PPB2PP1/RN3RK1 w - - 3 15,b4,346,304,-42,1
r3r1k1/p1p2p1p/2pq2pB/2bpn3/1P6/2P4Q/P1B2PP1/RN3RK1 b - - 0 15,Bb6,311,308,-3,1
r3r1k1/p1p2p1p/1bpq2pB/3pn3/1P6/2P4Q/P1B2PP1/RN3RK1 w - - 1 16,a4,330,310,-20,1
r3r1k1/p1p2p1p/1bpq2pB/3pn3/PP6/2P4Q/2B2PP1/RN3RK1 b - - 0 16,f5,298,317,19,1
r3r1k1/p1p4p/1bpq2pB/3pnp2/PP6/2P4Q/2B2PP1/RN3RK1 w - - 0 17,a5,375,358,-17,1
r3r1k1/p1p4p/1bpq2pB/P2pnp2/1P6/2P4Q/2B2PP1/RN3RK1 b - - 0 17,Bxf2+,323,352,29,1
r3r1k1/p1p4p/2pq2pB/P2pnp2/1P6/2P4Q/2B2bP1/RN3RK1 w - - 0 18,Rxf2,391,344,-47,1
r3r1k1/p1p4p/2pq2pB/P2pnp2/1P6/2P4Q/2B2RP1/RN4K1 b - - 0 18,Ng4,353,336,-17,1
r3r1k1/p1p4p/2pq2pB/P2p1p2/1P4n1/2P4Q/2B2RP1/RN4K1 w - - 1 19,Rf1,336,346,10,1
r3r1k1/p1p4p/2pq2pB/P2p1p2/1P4n1/2P4Q/2B3P1/RN3RK1 b - - 2 19,Re2,372,396,24,1
r5k1/p1p4p/2pq2pB/P2p1p2/1P4n1/2P4Q/2B1r1P1/RN3RK1 w - - 3 20,Bd1,417,462,45,1
r5k1/p1p4p/2pq2pB/P2p1p2/1P4n1/2P4Q/4r1P1/RN1B1RK1 b - - 4 20,Rxg2+,431,500,69,1
r5k1/p1p4p/2pq2pB/P2p1p2/1P4n1/2P4Q/6r1/RN1B1RK1 w - - 0 21,Qxg2,471,411,-60,1
r5k1/p1p4p/2pq2pB/P2p1p2/1P4n1/2P5/6Q1/RN1B1RK1 b - - 0 21,Nxh6,426,440,14,1
r5k1/p1p4p/2pq2pn/P2p1p2/1P6/2P5/6Q1/RN1B1RK1 w - - 0 22,Nd2,419,418,-1,1
r5k1/p1p4p/2pq2pn/P2p1p2/1P6/2P5/3N2Q1/R2B1RK1 b - - 1 22,Re8,394,434,40,1
4r1k1/p1p4p/2pq2pn/P2p1p2/1P6/2P5/3N2Q1/R2B1RK1 w - - 2 23,Nf3,383,341,-42,1
4r1k1/p1p4p/2pq2pn/P2p1p2/1P6/2P2N2/6Q1/R2B1RK1 b - - 3 23,Re3,387,469,82,1
6k1/p1p4p/2pq2pn/P2p1p2/1P6/2P1rN2/6Q1/R2B1RK1 w - - 4 24,Ng5,454,-41,-495,0
6k1/p1p4p/2pq2pn/P2p1pN1/1P6/2P1r3/6Q1/R2B1RK1 b - - 5 24,Rg3,-64,-63,1,1
6k1/p1p4p/2pq2pn/P2p1pN1/1P6/2P3r1/6Q1/R2B1RK1 w - - 6 25,Ra2,-44,-116,-72,1
6k1/p1p4p/2pq2pn/P2p1pN1/1P6/2P3r1/R5Q1/3B1RK1 b - - 7 25,Qf4,-88,828,916,1
6k1/p1p4p/2p3pn/P2p1pN1/1P3q2/2P3r1/R5Q1/3B1RK1 w - - 8 26,Rxf4,805,783,-22,1
rnbqkbnr/pppppppp/8/8/8/8/PPPPPPPP/RNBQKBNR w KQkq - 0 1,e4,24,26,2,1
rnbqkbnr/pppppppp/8/8/4P3/8/PPPP1PPP/RNBQKBNR b KQkq - 0 1,c5,30,29,-1,1
rnbqkbnr/pp1ppppp/8/2p5/4P3/8/PPPP1PPP/RNBQKBNR w KQkq - 0 2,Nf3,31,16,-15,1
rnbqkbnr/pp1ppppp/8/2p5/4P3/5N2/PPPP1PPP/RNBQKB1R b KQkq - 1 2,e6,25,44,19,1
rnbqkbnr/pp1p1ppp/4p3/2p5/4P3/5N2/PPPP1PPP/RNBQKB1R w KQkq - 0 3,d4,45,44,-1,1
rnbqkbnr/pp1p1ppp/4p3/2p5/3PP3/5N2/PPP2PPP/RNBQKB1R b KQkq - 0 3,cxd4,29,37,8,1
rnbqkbnr/pp1p1ppp/4p3/8/3pP3/5N2/PPP2PPP/RNBQKB1R w KQkq - 0 4,Nxd4,47,46,-1,1
rnbqkbnr/pp1p1ppp/4p3/8/3NP3/8/PPP2PPP/RNBQKB1R b KQkq - 0 4,a6,53,70,17,1
rnbqkbnr/1p1p1ppp/p3p3/8/3NP3/8/PPP2PPP/RNBQKB1R w KQkq - 0 5,c3,61,30,-31,1
rnbqkbnr/1p1p1ppp/p3p3/8/3NP3/2P5/PP3PPP/RNBQKB1R b KQkq - 0 5,Qc7,34,25,-9,1
rnb1kbnr/1pqp1ppp/p3p3/8/3NP3/2P5/PP3PPP/RNBQKB1R w KQkq - 1 6,Be3,29,-22,-51,1
rnb1kbnr/1pqp1ppp/p3p3/8/3NP3/2P1B3/PP3PPP/RN1QKB1R b KQkq - 2 6,Nc6,-24,27,51,1
r1b1kbnr/1pqp1ppp/p1n1p3/8/3NP3/2P1B3/PP3PPP/RN1QKB1R w KQkq - 3 7,Bd3,24,15,-9,1
r1b1kbnr/1pqp1ppp/p1n1p3/8/3NP3/2PBB3/PP3PPP/RN1QK2R b KQkq - 4 7,Bd6,-10,98,108,1
r1b1k1nr/1pqp1ppp/p1nbp3/8/3NP3/2PBB3/PP3PPP/RN1QK2R w KQkq - 5 8,Nd2,100,76,-24,1
r1b1k1nr/1pqp1ppp/p1nbp3/8/3NP3/2PBB3/PP1N1PPP/R2QK2R b KQkq - 6 8,Nge7,75,106,31,1
r1b1k2r/1pqpnppp/p1nbp3/8/3NP3/2PBB3/PP1N1PPP/R2QK2R w KQkq - 7 9,N2f3,118,36,-82,1
r1b1k2r/1pqpnppp/p1nbp3/8/3NP3/2PBBN2/PP3PPP/R2QK2R b KQkq - 8 9,e5,33,93,60,1
r1b1k2r/1pqpnppp/p1nb4/4p3/3NP3/2PBBN2/PP3PPP/R2QK2R w KQkq - 0 10,Nf5,115,89,-26,1
r1b1k2r/1pqpnppp/p1nb4/4pN2/4P3/2PBBN2/PP3PPP/R2QK2R b KQkq - 1 10,Nxf5,104,111,7,1
r1b1k2r/1pqp1ppp/p1nb4/4pn2/4P3/2PBBN2/PP3PPP/R2QK2R w KQkq - 0 11,exf5,110,110,0,1
r1b1k2r/1pqp1ppp/p1nb4/4pP2/8/2PBBN2/PP3PPP/R2QK2R b KQkq - 0 11,O-O,101,338,237,1
r1b2rk1/1pqp1ppp/p1nb4/4pP2/8/2PBBN2/PP3PPP/R2QK2R w KQ - 1 12,f6,344,242,-102,0
r1b2rk1/1pqp1ppp/p1nb1P2/4p3/8/2PBBN2/PP3PPP/R2QK2R b KQ - 0 12,g6,256,296,40,1
r1b2rk1/1pqp1p1p/p1nb1Pp1/4p3/8/2PBBN2/PP3PPP/R2QK2R w KQ - 0 13,Qd2,283,196,-87,1
r1b2rk1/1pqp1p1p/p1nb1Pp1/4p3/8/2PBBN2/PP1Q1PPP/R3K2R b KQ - 1 13,Re8,211,228,17,1
r1b1r1k1/1pqp1p1p/p1nb1Pp1/4p3/8/2PBBN2/PP1Q1PPP/R3K2R w KQ - 2 14,Bh6,257,-224,-481,0
r1b1r1k1/1pqp1p1p/p1nb1PpB/4p3/8/2PB1N2/PP1Q1PPP/R3K2R b KQ - 3 14,e4,-218,-215,3,1
r1b1r1k1/1pqp1p1p/p1nb1PpB/8/4p3/2PB1N2/PP1Q1PPP/R3K2R w KQ - 0 15,O-O-O,-205,-189,16,1
r1b1r1k1/1pqp1p1p/p1nb1PpB/8/4p3/2PB1N2/PP1Q1PPP/2KR3R b - - 1 15,exd3,-192,-224,-32,1
r1b1r1k1/1pqp1p1p/p1nb1PpB/8/8/2Pp1N2/PP1Q1PPP/2KR3R w - - 0 16,Qxd3,-207,-447,-240,0
r1b1r1k1/1pqp1p1p/p1nb1PpB/8/8/2PQ1N2/PP3PPP/2KR3R b - - 0 16,Bf4+,-421,-403,18,1
r1b1r1k1/1pqp1p1p/p1n2PpB/8/5b2/2PQ1N2/PP3PPP/2KR3R w - - 1 17,Bxf4,-399,-402,-3,1
r1b1r1k1/1pqp1p1p/p1n2Pp1/8/5B2/2PQ1N2/PP3PPP/2KR3R b - - 0 17,Qxf4+,-411,-423,-12,1
r1b1r1k1/1p1p1p1p/p1n2Pp1/8/5q2/2PQ1N2/PP3PPP/2KR3R w - - 0 18,Kb1,-415,-521,-106,0
r1b1r1k1/1p1p1p1p/p1n2Pp1/8/5q2/2PQ1N2/PP3PPP/1K1R3R b - - 1 18,Qxf6,-527,-506,21,1
r1b1r1k1/1p1p1p1p/p1n2qp1/8/8/2PQ1N2/PP3PPP/1K1R3R w - - 0 19,Rde1,-505,-536,-31,1
r1b1r1k1/1p1p1p1p/p1n2qp1/8/8/2PQ1N2/PP3PPP/1K2R2R b - - 1 19,Rf8,-517,-501,16,1
r1b2rk1/1p1p1p1p/p1n2qp1/8/8/2PQ1N2/PP3PPP/1K2R2R w - - 2 20,h4,-466,-508,-42,1
r1b2rk1/1p1p1p1p/p1n2qp1/8/7P/2PQ1N2/PP3PP1/1K2R2R b - - 0 20,d6,-480,-466,14,1
r1b2rk1/1p3p1p/p1np1qp1/8/7P/2PQ1N2/PP3PP1/1K2R2R w - - 0 21,h5,-464,-630,-166,0
r1b2rk1/1p3p1p/p1np1qp1/7P/8/2PQ1N2/PP3PP1/1K2R2R b - - 0 21,Bf5,-660,-523,137,1
rnbqkbnr/pppppppp/8/8/8/8/PPPPPPPP/RNBQKBNR w KQkq - 0 1,e4,36,30,-6,1
rnbqkbnr/pppppppp/8/8/4P3/8/PPPP1PPP/RNBQKBNR b KQkq - 0 1,d5,33,74,41,1
rnbqkbnr/ppp1pppp/8/3p4/4P3/8/PPPP1PPP/RNBQKBNR w KQkq - 0 2,d4,63,-58,-121,0
rnbqkbnr/ppp1pppp/8/3p4/3PP3/8/PPP2PPP/RNBQKBNR b KQkq - 0 2,Nf6,-67,61,128,1
rnbqkb1r/ppp1pppp/5n2/3p4/3PP3/8/PPP2PPP/RNBQKBNR w KQkq - 1 3,e5,80,63,-17,1
rnbqkb1r/ppp1pppp/5n2/3pP3/3P4/8/PPP2PPP/RNBQKBNR b KQkq - 0 3,Ne4,87,312,225,1
rnbqkb1r/ppp1pppp/8/3pP3/3Pn3/8/PPP2PPP/RNBQKBNR w KQkq - 1 4,Nf3,312,17,-295,0
rnbqkb1r/ppp1pppp/8/3pP3/3Pn3/5N2/PPP2PPP/RNBQKB1R b KQkq - 2 4,Bg4,12,90,78,1
rn1qkb1r/ppp1pppp/8/3pP3/3Pn1b1/5N2/PPP2PPP/RNBQKB1R w KQkq - 3 5,Be2,97,40,-57,1
rn1qkb1r/ppp1pppp/8/3pP3/3Pn1b1/5N2/PPP1BPPP/RNBQK2R b KQkq - 4 5,e6,16,42,26,1
rn1qkb1r/ppp2ppp/4p3/3pP3/3Pn1b1/5N2/PPP1BPPP/RNBQK2R w KQkq - 0 6,h3,20,15,-5,1
rn1qkb1r/ppp2ppp/4p3/3pP3/3Pn1b1/5N1P/PPP1BPP1/RNBQK2R b KQkq - 0 6,Bf5,9,39,30,1
rn1qkb1r/ppp2ppp/4p3/3pPb2/3Pn3/5N1P/PPP1BPP1/RNBQK2R w KQkq - 1 7,O-O,37,30,-7,1
rn1qkb1r/ppp2ppp/4p3/3pPb2/3Pn3/5N1P/PPP1BPP1/RNBQ1RK1 b kq - 2 7,Bxh3,29,382,353,1
rn1qkb1r/ppp2ppp/4p3/3pP3/3Pn3/5N1b/PPP1BPP1/RNBQ1RK1 w kq - 0 8,gxh3,376,350,-26,1
rn1qkb1r/ppp2ppp/4p3/3pP3/3Pn3/5N1P/PPP1BP2/RNBQ1RK1 b kq - 0 8,Be7,383,394,11,1
rn1qk2r/ppp1bppp/4p3/3pP3/3Pn3/5N1P/PPP1BP2/RNBQ1RK1 w kq - 1 9,Kh2,394,347,-47,1
rn1qk2r/ppp1bppp/4p3/3pP3/3Pn3/5N1P/PPP1BP1K/RNBQ1R2 b kq - 2 9,Bh4,356,429,73,1
rn1qk2r/ppp2ppp/4p3/3pP3/3Pn2b/5N1P/PPP1BP1K/RNBQ1R2 w kq - 3 10,Be3,449,433,-16,1
rn1qk2r/ppp2ppp/4p3/3pP3/3Pn2b/4BN1P/PPP1BP1K/RN1Q1R2 b kq - 4 10,Nc6,437,429,-8,1
r2qk2r/ppp2ppp/2n1p3/3pP3/3Pn2b/4BN1P/PPP1BP1K/RN1Q1R2 w kq - 5 11,c3,428,361,-67,1
r2qk2r/ppp2ppp/2n1p3/3pP3/3Pn2b/2P1BN1P/PP2BP1K/RN1Q1R2 b kq - 0 11,g5,421,419,-2,1
r2qk2r/ppp2p1p/2n1p3/3pP1p1/3Pn2b/2P1BN1P/PP2BP1K/RN1Q1R2 w kq - 0 12,Nxh4,436,421,-15,1
r2qk2r/ppp2p1p/2n1p3/3pP1p1/3Pn2N/2P1B2P/PP2BP1K/RN1Q1R2 b kq - 0 12,gxh4,445,601,156,1
r2qk2r/ppp2p1p/2n1p3/3pP3/3Pn2p/2P1B2P/PP2BP1K/RN1Q1R2 w kq - 0 13,Rg1,581,585,4,1
r2qk2r/ppp2p1p/2n1p3/3pP3/3Pn2p/2P1B2P/PP2BP1K/RN1Q2R1 b kq - 1 13,Qe7,547,540,-7,1
r3k2r/ppp1qp1p/2n1p3/3pP3/3Pn2p/2P1B2P/PP2BP1K/RN1Q2R1 w kq - 2 14,Nd2,560,533,-27,1
r3k2r/ppp1qp1p/2n1p3/3pP3/3Pn2p/2P1B2P/PP1NBP1K/R2Q2R1 b kq - 3 14,O-O-O,550,594,44,1
2kr3r/ppp1qp1p/2n1p3/3pP3/3Pn2p/2P1B2P/PP1NBP1K/R2Q2R1 w - - 4 15,Nxe4,531,533,2,1
2kr3r/ppp1qp1p/2n1p3/3pP3/3PN2p/2P1B2P/PP2BP1K/R2Q2R1 b - - 0 15,dxe4,561,580,19,1
2kr3r/ppp1qp1p/2n1p3/4P3/3Pp2p/2P1B2P/PP2BP1K/R2Q2R1 w - - 0 16,Bg5,589,569,-20,1
2kr3r/ppp1qp1p/2n1p3/4P1B1/3Pp2p/2P4P/PP2BP1K/R2Q2R1 b - - 1 16,f6,555,536,-19,1
2kr3r/ppp1q2p/2n1pp2/4P1B1/3Pp2p/2P4P/PP2BP1K/R2Q2R1 w - - 0 17,Bxf6,575,481,-94,1
2kr3r/ppp1q2p/2n1pB2/4P3/3Pp2p/2P4P/PP2BP1K/R2Q2R1 b - - 0 17,Qf7,508,565,57,1
2kr3r/ppp2q1p/2n1pB2/4P3/3Pp2p/2P4P/PP2BP1K/R2Q2R1 w - - 1 18,Rg7,571,529,-42,1
2kr3r/ppp2qRp/2n1pB2/4P3/3Pp2p/2P4P/PP2BP1K/R2Q4 b - - 2 18,Qf8,491,469,-22,1
2kr1q1r/ppp3Rp/2n1pB2/4P3/3Pp2p/2P4P/PP2BP1K/R2Q4 w - - 3 19,Bg4,479,447,-32,1
2kr1q1r/ppp3Rp/2n1pB2/4P3/3Pp1Bp/2P4P/PP3P1K/R2Q4 b - - 4 19,Rg8,495,668,173,1
2kr1qr1/ppp3Rp/2n1pB2/4P3/3Pp1Bp/2P4P/PP3P1K/R2Q4 w - - 5 20,Bxe6+,686,656,-30,1
2kr1qr1/ppp3Rp/2n1BB2/4P3/3Pp2p/2P4P/PP3P1K/R2Q4 b - - 0 20,Kb8,697,711,14,1
1k1r1qr1/ppp3Rp/2n1BB2/4P3/3Pp2p/2P4P/PP3P1K/R2Q4 w - - 1 21,Bxg8,670,571,-99,1
1k1r1qB1/ppp3Rp/2n2B2/4P3/3Pp2p/2P4P/PP3P1K/R2Q4 b - - 0 21,Nxe5,587,824,237,1
1k1r1qB1/ppp3Rp/5B2/4n3/3Pp2p/2P4P/PP3P1K/R2Q4 w - - 0 22,Bxe5,805,665,-140,0
1k1r1qB1/ppp3Rp/8/4B3/3Pp2p/2P4P/PP3P1K/R2Q4 b - - 0 22,Qxf2+,681,724,43,1
1k1r2B1/ppp3Rp/8/4B3/3Pp2p/2P4P/PP3q1K/R2Q4 w - - 0 23,Rg2,702,733,31,1
1k1r2B1/ppp4p/8/4B3/3Pp2p/2P4P/PP3qRK/R2Q4 b - - 1 23,Qxb2,721,858,137,1
1k1r2B1/ppp4p/8/4B3/3Pp2p/2P4P/Pq4RK/R2Q4 w - - 0 24,Bxc7+,927,846,-81,1
rnbqkbnr/pppppppp/8/8/8/8/PPPPPPPP/RNBQKBNR w KQkq - 0 1,e4,29,32,3,1
rnbqkbnr/pppppppp/8/8/4P3/8/PPPP1PPP/RNBQKBNR b KQkq - 0 1,e5,28,22,-6,1
rnbqkbnr/pppp1ppp/8/4p3/4P3/8/PPPP1PPP/RNBQKBNR w KQkq - 0 2,c4,43,-27,-70,1
rnbqkbnr/pppp1ppp/8/4p3/2P1P3/8/PP1P1PPP/RNBQKBNR b KQkq - 0 2,g6,-37,25,62,1
rnbqkbnr/pppp1p1p/6p1/4p3/2P1P3/8/PP1P1PPP/RNBQKBNR w KQkq - 0 3,g4,20,-99,-119,0
rnbqkbnr/pppp1p1p/6p1/4p3/2P1P1P1/8/PP1P1P1P/RNBQKBNR b KQkq - 0 3,Bg7,-105,-49,56,1
rnbqk1nr/pppp1pbp/6p1/4p3/2P1P1P1/8/PP1P1P1P/RNBQKBNR w KQkq - 1 4,f3,-58,-255,-197,0
rnbqk1nr/pppp1pbp/6p1/4p3/2P1P1P1/5P2/PP1P3P/RNBQKBNR b KQkq - 0 4,Nc6,-247,-124,123,1
r1bqk1nr/pppp1pbp/2n3p1/4p3/2P1P1P1/5P2/PP1P3P/RNBQKBNR w KQkq - 1 5,Ne2,-139,-287,-148,0
r1bqk1nr/pppp1pbp/2n3p1/4p3/2P1P1P1/5P2/PP1PN2P/RNBQKB1R b KQkq - 2 5,a6,-270,-75,195,1
r1bqk1nr/1ppp1pbp/p1n3p1/4p3/2P1P1P1/5P2/PP1PN2P/RNBQKB1R w KQkq - 0 6,a3,-64,-291,-227,0
r1bqk1nr/1ppp1pbp/p1n3p1/4p3/2P1P1P1/P4P2/1P1PN2P/RNBQKB1R b KQkq - 0 6,b5,-291,-175,116,1
r1bqk1nr/2pp1pbp/p1n3p1/1p2p3/2P1P1P1/P4P2/1P1PN2P/RNBQKB1R w KQkq - 0 7,c5,-165,-270,-105,0
r1bqk1nr/2pp1pbp/p1n3p1/1pP1p3/4P1P1/P4P2/1P1PN2P/RNBQKB1R b KQkq - 0 7,Nce7,-248,-93,155,1
r1bqk1nr/2ppnpbp/p5p1/1pP1p3/4P1P1/P4P2/1P1PN2P/RNBQKB1R w KQkq - 1 8,b4,-89,-151,-62,1
r1bqk1nr/2ppnpbp/p5p1/1pP1p3/1P2P1P1/P4P2/3PN2P/RNBQKB1R b KQkq - 0 8,d6,-158,-140,18,1
r1bqk1nr/2p1npbp/p2p2p1/1pP1p3/1P2P1P1/P4P2/3PN2P/RNBQKB1R w KQkq - 0 9,d4,-144,-201,-57,1
r1bqk1nr/2p1npbp/p2p2p1/1pP1p3/1P1PP1P1/P4P2/4N2P/RNBQKB1R b KQkq - 0 9,d5,-235,-47,188,1
r1bqk1nr/2p1npbp/p5p1/1pPpp3/1P1PP1P1/P4P2/4N2P/RNBQKB1R w KQkq - 0 10,Bg5,-86,-285,-199,0
r1bqk1nr/2p1npbp/p5p1/1pPpp1B1/1P1PP1P1/P4P2/4N2P/RN1QKB1R b KQkq - 1 10,dxe4,-271,-279,-8,1
r1bqk1nr/2p1npbp/p5p1/1pP1p1B1/1P1Pp1P1/P4P2/4N2P/RN1QKB1R w KQkq - 0 11,d5,-275,-373,-98,1
r1bqk1nr/2p1npbp/p5p1/1pPPp1B1/1P2p1P1/P4P2/4N2P/RN1QKB1R b KQkq - 0 11,Nf6,-374,-174,200,1
r1bqk2r/2p1npbp/p4np1/1pPPp1B1/1P2p1P1/P4P2/4N2P/RN1QKB1R w KQkq - 1 12,d6,-175,-302,-127,0
r1bqk2r/2p1npbp/p2P1np1/1pP1p1B1/1P2p1P1/P4P2/4N2P/RN1QKB1R b KQkq - 0 12,cxd6,-320,-274,46,1
r1bqk2r/4npbp/p2p1np1/1pP1p1B1/1P2p1P1/P4P2/4N2P/RN1QKB1R w KQkq - 0 13,Qxd6,-266,-338,-72,1
r1bqk2r/4npbp/p2Q1np1/1pP1p1B1/1P2p1P1/P4P2/4N2P/RN2KB1R b KQkq - 0 13,Qxd6,-316,-289,27,1
r1b1k2r/4npbp/p2q1np1/1pP1p1B1/1P2p1P1/P4P2/4N2P/RN2KB1R w KQkq - 0 14,cxd6,-261,-267,-6,1
r1b1k2r/4npbp/p2P1np1/1p2p1B1/1P2p1P1/P4P2/4N2P/RN2KB1R b KQkq - 0 14,exf3,-285,-278,7,1
r1b1k2r/4npbp/p2P1np1/1p2p1B1/1P4P1/P4p2/4N2P/RN2KB1R w KQkq - 0 15,Ng3,-296,-438,-142,0
r1b1k2r/4npbp/p2P1np1/1p2p1B1/1P4P1/P4pN1/7P/RN2KB1R b KQkq - 1 15,Ned5,-397,-404,-7,1
r1b1k2r/5pbp/p2P1np1/1p1np1B1/1P4P1/P4pN1/7P/RN2KB1R w KQkq - 2 16,Nd2,-446,-397,49,1
r1b1k2r/5pbp/p2P1np1/1p1np1B1/1P4P1/P4pN1/3N3P/R3KB1R b KQkq - 3 16,Bxg4,-402,-410,-8,1
r3k2r/5pbp/p2P1np1/1p1np1B1/1P4b1/P4pN1/3N3P/R3KB1R w KQkq - 0 17,Bxf6,-434,-447,-13,1
r3k2r/5pbp/p2P1Bp1/1p1np3/1P4b1/P4pN1/3N3P/R3KB1R b KQkq - 0 17,Nxf6,-432,-444,-12,1
r3k2r/5pbp/p2P1np1/1p2p3/1P4b1/P4pN1/3N3P/R3KB1R w KQkq - 0 18,Nde4,-428,-472,-44,1
r3k2r/5pbp/p2P1np1/1p2p3/1P2N1b1/P4pN1/7P/R3KB1R b KQkq - 1 18,Nxe4,-434,-427,7,1
r3k2r/5pbp/p2P2p1/1p2p3/1P2n1b1/P4pN1/7P/R3KB1R w KQkq - 0 19,Nxe4,-454,-431,23,1
r3k2r/5pbp/p2P2p1/1p2p3/1P2N1b1/P4p2/7P/R3KB1R b KQkq - 0 19,O-O,-405,-434,-29,1
r4rk1/5pbp/p2P2p1/1p2p3/1P2N1b1/P4p2/7P/R3KB1R w KQ - 1 20,O-O-O,-433,-510,-77,1
r4rk1/5pbp/p2P2p1/1p2p3/1P2N1b1/P4p2/7P/2KR1B1R b - - 2 20,Rac8+,-517,-488,29,1
2r2rk1/5pbp/p2P2p1/1p2p3/1P2N1b1/P4p2/7P/2KR1B1R w - - 3 21,Kb2,-489,-527,-38,1
2r2rk1/5pbp/p2P2p1/1p2p3/1P2N1b1/P4p2/1K5P/3R1B1R b - - 4 21,Bf5,-512,-458,54,1
2r2rk1/5pbp/p2P2p1/1p2pb2/1P2N3/P4p2/1K5P/3R1B1R w - - 5 22,Bd3,-484,-452,32,1
2r2rk1/5pbp/p2P2p1/1p2pb2/1P2N3/P2B1p2/1K5P/3R3R b - - 6 22,Bxe4,-502,-427,75,1
2r2rk1/5pbp/p2P2p1/1p2p3/1P2b3/P2B1p2/1K5P/3R3R w - - 0 23,Bxe4,-471,-453,18,1
2r2rk1/5pbp/p2P2p1/1p2p3/1P2B3/P4p2/1K5P/3R3R b - - 0 23,f5,-480,-470,10,1
2r2rk1/6bp/p2P2p1/1p2pp2/1P2B3/P4p2/1K5P/3R3R w - - 0 24,Bxf3,-471,-551,-80,1
2r2rk1/6bp/p2P2p1/1p2pp2/1P6/P4B2/1K5P/3R3R b - - 0 24,e4+,-546,-517,29,1
2r2rk1/6bp/p2P2p1/1p3p2/1P2p3/P4B2/1K5P/3R3R w - - 0 25,Kb3,-529,-553,-24,1
2r2rk1/6bp/p2P2p1/1p3p2/1P2p3/PK3B2/7P/3R3R b - - 1 25,exf3,-521,-551,-30,1
2r2rk1/6bp/p2P2p1/1p3p2/1P6/PK3p2/7P/3R3R w - - 0 26,Rhf1,-519,-573,-54,1
2r2rk1/6bp/p2P2p1/1p3p2/1P6/PK3p2/7P/3R1R2 b - - 1 26,Rc3+,-610,-628,-18,1
5rk1/6bp/p2P2p1/1p3p2/1P6/PKr2p2/7P/3R1R2 w - - 2 27,Kb2,-620,-653,-33,1
5rk1/6bp/p2P2p1/1p3p2/1P6/P1r2p2/1K5P/3R1R2 b - - 3 27,Rd3+,-667,-611,56,1
5rk1/6bp/p2P2p1/1p3p2/1P6/P2r1p2/1K5P/3R1R2 w - - 4 28,Kc2,-635,-642,-7,1
5rk1/6bp/p2P2p1/1p3p2/1P6/P2r1p2/2K4P/3R1R2 b - - 5 28,Rxd1,-642,-656,-14,1
5rk1/6bp/p2P2p1/1p3p2/1P6/P4p2/2K4P/3r1R2 w - - 0 29,Rxd1,-659,-651,8,1
5rk1/6bp/p2P2p1/1p3p2/1P6/P4p2/2K4P/3R4 b - - 0 29,Rd8,-673,-663,10,1
3r2k1/6bp/p2P2p1/1p3p2/1P6/P4p2/2K4P/3R4 w - - 1 30,Rd3,-678,-687,-9,1
3r2k1/6bp/p2P2p1/1p3p2/1P6/P2R1p2/2K4P/8 b - - 2 30,Kf7,-674,-656,18,1
3r4/5kbp/p2P2p1/1p3p2/1P6/P2R1p2/2K4P/8 w - - 3 31,Kd2,-611,-704,-93,1
3r4/5kbp/p2P2p1/1p3p2/1P6/P2R1p2/3K3P/8 b - - 4 31,Bh6+,-701,-608,93,1
3r4/5k1p/p2P2pb/1p3p2/1P6/P2R1p2/3K3P/8 w - - 5 32,Ke1,-635,-652,-17,1
3r4/5k1p/p2P2pb/1p3p2/1P6/P2R1p2/7P/4K3 b - - 6 32,Ke6,-649,-641,8,1
3r4/7p/p2Pk1pb/1p3p2/1P6/P2R1p2/7P/4K3 w - - 7 33,Kf2,-666,-673,-7,1
3r4/7p/p2Pk1pb/1p3p2/1P6/P2R1p2/5K1P/8 b - - 8 33,Rxd6,-666,-673,-7,1
8/7p/p2rk1pb/1p3p2/1P6/P2R1p2/5K1P/8 w - - 0 34,Rxd6+,-676,-769,-93,1
8/7p/p2Rk1pb/1p3p2/1P6/P4p2/5K1P/8 b - - 0 34,Kxd6,-789,-777,12,1
8/7p/p2k2pb/1p3p2/1P6/P4p2/5K1P/8 w - - 0 35,Kxf3,-792,-779,13,1
8/7p/p2k2pb/1p3p2/1P6/P4K2/7P/8 b - - 0 35,Bc1,-803,-801,2,1
8/7p/p2k2p1/1p3p2/1P6/P4K2/7P/2b5 w - - 1 36,a4,-803,-842,-39,1
8/7p/p2k2p1/1p3p2/PP6/5K2/7P/2b5 b - - 0 36,bxa4,-848,-826,22,1
8/7p/p2k2p1/5p2/pP6/5K2/7P/2b5 w - - 0 37,h4,-845,-840,5,1
8/7p/p2k2p1/5p2/pP5P/5K2/8/2b5 b - - 0 37,Ba3,-870,-849,21,1
8/7p/p2k2p1/5p2/pP5P/b4K2/8/8 w - - 1 38,Kf4,-821,-872,-51,1
8/7p/p2k2p1/5p2/pP3K1P/b7/8/8 b - - 2 38,Bxb4,-871,-740,131,1
8/7p/p2k2p1/5p2/pb3K1P/8/8/8 w - - 0 39,Kg5,-705,-758,-53,1
8/7p/p2k2p1/5pK1/pb5P/8/8/8 b - - 1 39,Bd2+,-778,-827,-49,1
8/7p/p2k2p1/5pK1/p6P/8/3b4/8 w - - 2 40,Kf6,-875,-883,-8,1
8/7p/p2k1Kp1/5p2/p6P/8/3b4/8 b - - 3 40,a3,-883,-941,-58,1
8/7p/p2k1Kp1/5p2/7P/p7/3b4/8 w - - 0 41,Kg7,-9987,-9987,0,1
8/6Kp/p2k2p1/5p2/7P/p7/3b4/8 b - - 1 41,a2,-9987,-9988,-1,1
8/6Kp/p2k2p1/5p2/7P/8/p2b4/8 w - - 0 42,Kxh7,-9988,-9989,-1,1
8/7K/p2k2p1/5p2/7P/8/p2b4/8 b - - 0 42,a1=Q,-9989,-9990,-1,1
8/7K/p2k2p1/5p2/7P/8/3b4/q7 w - - 0 43,Kxg6,-9990,-9992,-2,1
8/8/p2k2K1/5p2/7P/8/3b4/q7 b - - 0 43,Be1,-9992,-762,9230,1
8/8/p2k2K1/5p2/7P/8/8/q3b3 w - - 1 44,h5,-844,-9990,-9146,0
8/8/p2k2K1/5p1P/8/8/8/q3b3 b - - 0 44,Bd2,-9990,-812,9178,1
8/8/p2k2K1/5p1P/8/8/3b4/q7 w - - 1 45,Kxf5,-9992,-9993,-1,1
8/8/p2k4/5K1P/8/8/3b4/q7 b - - 0 45,Qe1,-9993,-797,9196,1
8/8/p2k4/5K1P/8/8/3b4/4q3 w - - 1 46,Kg6,-872,-9992,-9120,0
8/8/p2k2K1/7P/8/8/3b4/4q3 b - - 2 46,Qf1,-9992,-9992,0,1
8/8/p2k2K1/7P/8/8/3b4/5q2 w - - 3 47,h6,-9992,-9992,0,1
8/8/p2k2KP/8/8/8/3b4/5q2 b - - 0 47,Bxh6,-9992,-1231,8761,1
8/8/p2k2Kb/8/8/8/8/5q2 w - - 0 48,Kxh6,-9990,-9990,0,1
8/8/p2k3K/8/8/8/8/5q2 b - - 0 48,Qg1,-9990,-9994,-4,1
8/8/p2k3K/8/8/8/8/6q1 w - - 1 49,Kh5,-9994,-1249,8745,1
8/8/p2k4/7K/8/8/8/6q1 b - - 2 49,Ke6,-9994,-9991,3,1
8/8/p3k3/7K/8/8/8/6q1 w - - 3 50,Kh4,-9991,-9994,-3,1
8/8/p3k3/8/7K/8/8/6q1 b - - 4 50,Kf5,-9994,-9998,-4,1
8/8/p7/5k2/7K/8/8/6q1 w - - 5 51,Kh3,-9998,-9998,0,1
8/8/p7/5k2/8/7K/8/6q1 b - - 6 51,Kf4,-9998,-9999,-1,1
8/8/p7/8/5k2/7K/8/6q1 w - - 7 52,Kh4,-9999,-9999,0,1
8/8/p7/8/5k1K/8/8/6q1 b - - 8 52,Qh1#,-9999,-10000,-1,1
rnbqkbnr/pppppppp/8/8/8/8/PPPPPPPP/RNBQKBNR w KQkq - 0 1,g3,34,18,-16,1
rnbqkbnr/pppppppp/8/8/8/6P1/PPPPPP1P/RNBQKBNR b KQkq - 0 1,d5,20,17,-3,1
rnbqkbnr/ppp1pppp/8/3p4/8/6P1/PPPPPP1P/RNBQKBNR w KQkq - 0 2,Bg2,17,-28,-45,1
rnbqkbnr/ppp1pppp/8/3p4/8/6P1/PPPPPPBP/RNBQK1NR b KQkq - 1 2,Nc6,-28,43,71,1
r1bqkbnr/ppp1pppp/2n5/3p4/8/6P1/PPPPPPBP/RNBQK1NR w KQkq - 2 3,a3,33,-41,-74,1
r1bqkbnr/ppp1pppp/2n5/3p4/8/P5P1/1PPPPPBP/RNBQK1NR b KQkq - 0 3,Bf5,-48,4,52,1
r2qkbnr/ppp1pppp/2n5/3p1b2/8/P5P1/1PPPPPBP/RNBQK1NR w KQkq - 1 4,d3,17,-21,-38,1
r2qkbnr/ppp1pppp/2n5/3p1b2/8/P2P2P1/1PP1PPBP/RNBQK1NR b KQkq - 0 4,e6,-2,52,54,1
r2qkbnr/ppp2ppp/2n1p3/3p1b2/8/P2P2P1/1PP1PPBP/RNBQK1NR w KQkq - 0 5,Bf4,43,-63,-106,0
r2qkbnr/ppp2ppp/2n1p3/3p1b2/5B2/P2P2P1/1PP1PPBP/RN1QK1NR b KQkq - 1 5,Nf6,-82,-4,78,1
r2qkb1r/ppp2ppp/2n1pn2/3p1b2/5B2/P2P2P1/1PP1PPBP/RN1QK1NR w KQkq - 2 6,Nc3,-19,-38,-19,1
r2qkb1r/ppp2ppp/2n1pn2/3p1b2/5B2/P1NP2P1/1PP1PPBP/R2QK1NR b KQkq - 3 6,a6,-39,8,47,1
r2qkb1r/1pp2ppp/p1n1pn2/3p1b2/5B2/P1NP2P1/1PP1PPBP/R2QK1NR w KQkq - 0 7,Nf3,3,-36,-39,1
r2qkb1r/1pp2ppp/p1n1pn2/3p1b2/5B2/P1NP1NP1/1PP1PPBP/R2QK2R b KQkq - 1 7,Bd6,-31,-24,7,1
r2qk2r/1pp2ppp/p1nbpn2/3p1b2/5B2/P1NP1NP1/1PP1PPBP/R2QK2R w KQkq - 2 8,O-O,-21,-56,-35,1
r2qk2r/1pp2ppp/p1nbpn2/3p1b2/5B2/P1NP1NP1/1PP1PPBP/R2Q1RK1 b kq - 3 8,Bxf4,-67,-82,-15,1
r2qk2r/1pp2ppp/p1n1pn2/3p1b2/5b2/P1NP1NP1/1PP1PPBP/R2Q1RK1 w kq - 0 9,gxf4,-88,-80,8,1
r2qk2r/1pp2ppp/p1n1pn2/3p1b2/5P2/P1NP1N2/1PP1PPBP/R2Q1RK1 b kq - 0 9,Qd6,-78,-99,-21,1
r3k2r/1pp2ppp/p1nqpn2/3p1b2/5P2/P1NP1N2/1PP1PPBP/R2Q1RK1 w kq - 1 10,e3,-70,-92,-22,1
r3k2r/1pp2ppp/p1nqpn2/3p1b2/5P2/P1NPPN2/1PP2PBP/R2Q1RK1 b kq - 0 10,h6,-93,-89,4,1
r3k2r/1pp2pp1/p1nqpn1p/3p1b2/5P2/P1NPPN2/1PP2PBP/R2Q1RK1 w kq - 0 11,Nh4,-77,-206,-129,0
r3k2r/1pp2pp1/p1nqpn1p/3p1b2/5P1N/P1NPP3/1PP2PBP/R2Q1RK1 b kq - 1 11,Bg4,-181,-188,-7,1
r3k2r/1pp2pp1/p1nqpn1p/3p4/5PbN/P1NPP3/1PP2PBP/R2Q1RK1 w kq - 2 12,f3,-169,-222,-53,1
r3k2r/1pp2pp1/p1nqpn1p/3p4/5PbN/P1NPPP2/1PP3BP/R2Q1RK1 b kq - 0 12,Bh5,-244,-259,-15,1
r3k2r/1pp2pp1/p1nqpn1p/3p3b/5P1N/P1NPPP2/1PP3BP/R2Q1RK1 w kq - 1 13,Qe1,-237,-371,-134,0
r3k2r/1pp2pp1/p1nqpn1p/3p3b/5P1N/P1NPPP2/1PP3BP/R3QRK1 b kq - 2 13,Qc5,-357,-128,229,1
r3k2r/1pp2pp1/p1n1pn1p/2qp3b/5P1N/P1NPPP2/1PP3BP/R3QRK1 w kq - 3 14,d4,-135,-161,-26,1
r3k2r/1pp2pp1/p1n1pn1p/2qp3b/3P1P1N/P1N1PP2/1PP3BP/R3QRK1 b kq - 0 14,Qe7,-168,-136,32,1
r3k2r/1pp1qpp1/p1n1pn1p/3p3b/3P1P1N/P1N1PP2/1PP3BP/R3QRK1 w kq - 1 15,Ne2,-126,-398,-272,0
r3k2r/1pp1qpp1/p1n1pn1p/3p3b/3P1P1N/P3PP2/1PP1N1BP/R3QRK1 b kq - 2 15,g5,-384,-398,-14,1
r3k2r/1pp1qp2/p1n1pn1p/3p2pb/3P1P1N/P3PP2/1PP1N1BP/R3QRK1 w kq - 0 16,fxg5,-393,-464,-71,1
r3k2r/1pp1qp2/p1n1pn1p/3p2Pb/3P3N/P3PP2/1PP1N1BP/R3QRK1 b kq - 0 16,hxg5,-476,-451,25,1
r3k2r/1pp1qp2/p1n1pn2/3p2pb/3P3N/P3PP2/1PP1N1BP/R3QRK1 w kq - 0 17,f4,-426,-607,-181,0
r3k2r/1pp1qp2/p1n1pn2/3p2pb/3P1P1N/P3P3/1PP1N1BP/R3QRK1 b kq - 0 17,gxh4,-576,-529,47,1
r3k2r/1pp1qp2/p1n1pn2/3p3b/3P1P1p/P3P3/1PP1N1BP/R3QRK1 w kq - 0 18,Qxh4,-575,-594,-19,1
r3k2r/1pp1qp2/p1n1pn2/3p3b/3P1P1Q/P3P3/1PP1N1BP/R4RK1 b kq - 0 18,O-O-O,-617,-620,-3,1
2kr3r/1pp1qp2/p1n1pn2/3p3b/3P1P1Q/P3P3/1PP1N1BP/R4RK1 w - - 1 19,Bf3,-623,-744,-121,0
2kr3r/1pp1qp2/p1n1pn2/3p3b/3P1P1Q/P3PB2/1PP1N2P/R4RK1 b - - 2 19,Rdg8+,-763,-711,52,1
2k3rr/1pp1qp2/p1n1pn2/3p3b/3P1P1Q/P3PB2/1PP1N2P/R4RK1 w - - 3 20,Kh1,-734,-842,-108,0
2k3rr/1pp1qp2/p1n1pn2/3p3b/3P1P1Q/P3PB2/1PP1N2P/R4R1K b - - 4 20,Bxf3+,-862,-855,7,1
2k3rr/1pp1qp2/p1n1pn2/3p4/3P1P1Q/P3Pb2/1PP1N2P/R4R1K w - - 0 21,Rxf3,-859,-849,10,1
2k3rr/1pp1qp2/p1n1pn2/3p4/3P1P1Q/P3PR2/1PP1N2P/R6K b - - 0 21,Rxh4,-875,-865,10,1
2k3r1/1pp1qp2/p1n1pn2/3p4/3P1P1r/P3PR2/1PP1N2P/R6K w - - 0 22,Ng3,-844,-956,-112,0
rnbqkbnr/pppppppp/8/8/8/8/PPPPPPPP/RNBQKBNR w KQkq - 0 1,f3,31,-57,-88,1
rnbqkbnr/pppppppp/8/8/8/5P2/PPPPP1PP/RNBQKBNR b KQkq - 0 1,e6,-82,-57,25,1
rnbqkbnr/pppp1ppp/4p3/8/8/5P2/PPPPP1PP/RNBQKBNR w KQkq - 0 2,Kf2,-61,-131,-70,1
rnbqkbnr/pppp1ppp/4p3/8/8/5P2/PPPPPKPP/RNBQ1BNR b kq - 1 2,d5,-156,-162,-6,1
rnbqkbnr/ppp2ppp/4p3/3p4/8/5P2/PPPPPKPP/RNBQ1BNR w kq - 0 3,e3,-152,-152,0,1
rnbqkbnr/ppp2ppp/4p3/3p4/8/4PP2/PPPP1KPP/RNBQ1BNR b kq - 0 3,Nf6,-134,-141,-7,1
rnbqkb1r/ppp2ppp/4pn2/3p4/8/4PP2/PPPP1KPP/RNBQ1BNR w kq - 1 4,d4,-116,-110,6,1
rnbqkb1r/ppp2ppp/4pn2/3p4/3P4/4PP2/PPP2KPP/RNBQ1BNR b kq - 0 4,Bd6,-125,-114,11,1
rnbqk2r/ppp2ppp/3bpn2/3p4/3P4/4PP2/PPP2KPP/RNBQ1BNR w kq - 1 5,Bd3,-119,-147,-28,1
rnbqk2r/ppp2ppp/3bpn2/3p4/3P4/3BPP2/PPP2KPP/RNBQ2NR b kq - 2 5,c5,-131,-164,-33,1
rnbqk2r/pp3ppp/3bpn2/2pp4/3P4/3BPP2/PPP2KPP/RNBQ2NR w kq - 0 6,c3,-171,-166,5,1
rnbqk2r/pp3ppp/3bpn2/2pp4/3P4/2PBPP2/PP3KPP/RNBQ2NR b kq - 0 6,c4,-163,-117,46,1
rnbqk2r/pp3ppp/3bpn2/3p4/2pP4/2PBPP2/PP3KPP/RNBQ2NR w kq - 0 7,Bc2,-118,-114,4,1
rnbqk2r/pp3ppp/3bpn2/3p4/2pP4/2P1PP2/PPB2KPP/RNBQ2NR b kq - 1 7,Nc6,-120,-114,6,1
r1bqk2r/pp3ppp/2nbpn2/3p4/2pP4/2P1PP2/PPB2KPP/RNBQ2NR w kq - 2 8,g3,-103,-166,-63,1
r1bqk2r/pp3ppp/2nbpn2/3p4/2pP4/2P1PPP1/PPB2K1P/RNBQ2NR b kq - 0 8,e5,-172,-163,9,1
r1bqk2r/pp3ppp/2nb1n2/3pp3/2pP4/2P1PPP1/PPB2K1P/RNBQ2NR w kq - 0 9,Ne2,-179,-189,-10,1
r1bqk2r/pp3ppp/2nb1n2/3pp3/2pP4/2P1PPP1/PPB1NK1P/RNBQ3R b kq - 1 9,e4,-191,-130,61,1
r1bqk2r/pp3ppp/2nb1n2/3p4/2pPp3/2P1PPP1/PPB1NK1P/RNBQ3R w kq - 0 10,Nd2,-128,-211,-83,1
r1bqk2r/pp3ppp/2nb1n2/3p4/2pPp3/2P1PPP1/PPBNNK1P/R1BQ3R b kq - 1 10,exf3,-205,-217,-12,1
r1bqk2r/pp3ppp/2nb1n2/3p4/2pP4/2P1PpP1/PPBNNK1P/R1BQ3R w kq - 0 11,Nxf3,-237,-215,22,1
r1bqk2r/pp3ppp/2nb1n2/3p4/2pP4/2P1PNP1/PPB1NK1P/R1BQ3R b kq - 0 11,Bg4,-229,-164,65,1
r2qk2r/pp3ppp/2nb1n2/3p4/2pP2b1/2P1PNP1/PPB1NK1P/R1BQ3R w kq - 1 12,Kg2,-128,-193,-65,1
r2qk2r/pp3ppp/2nb1n2/3p4/2pP2b1/2P1PNP1/PPB1N1KP/R1BQ3R b kq - 2 12,Qd7,-188,-217,-29,1
r3k2r/pp1q1ppp/2nb1n2/3p4/2pP2b1/2P1PNP1/PPB1N1KP/R1BQ3R w kq - 3 13,Nf4,-213,-245,-32,1
r3k2r/pp1q1ppp/2nb1n2/3p4/2pP1Nb1/2P1PNP1/PPB3KP/R1BQ3R b kq - 4 13,Bxf4,-231,-203,28,1
r3k2r/pp1q1ppp/2n2n2/3p4/2pP1bb1/2P1PNP1/PPB3KP/R1BQ3R w kq - 0 14,exf4,-225,-247,-22,1
r3k2r/pp1q1ppp/2n2n2/3p4/2pP1Pb1/2P2NP1/PPB3KP/R1BQ3R b kq - 0 14,Bh3+,-244,-261,-17,1
r3k2r/pp1q1ppp/2n2n2/3p4/2pP1P2/2P2NPb/PPB3KP/R1BQ3R w kq - 1 15,Kf2,-198,-257,-59,1
r3k2r/pp1q1ppp/2n2n2/3p4/2pP1P2/2P2NPb/PPB2K1P/R1BQ3R b kq - 2 15,Bg4,-255,-17,238,1
r3k2r/pp1q1ppp/2n2n2/3p4/2pP1Pb1/2P2NP1/PPB2K1P/R1BQ3R w kq - 3 16,Re1+,-11,-51,-40,1
r3k2r/pp1q1ppp/2n2n2/3p4/2pP1Pb1/2P2NP1/PPB2K1P/R1BQR3 b kq - 4 16,Kd8,-26,-21,5,1
r2k3r/pp1q1ppp/2n2n2/3p4/2pP1Pb1/2P2NP1/PPB2K1P/R1BQR3 w - - 5 17,Be3,-11,-80,-69,1
r2k3r/pp1q1ppp/2n2n2/3p4/2pP1Pb1/2P1BNP1/PPB2K1P/R2QR3 b - - 6 17,Ne4+,-77,-56,21,1
r2k3r/pp1q1ppp/2n5/3p4/2pPnPb1/2P1BNP1/PPB2K1P/R2QR3 w - - 7 18,Bxe4,-56,-61,-5,1
r2k3r/pp1q1ppp/2n5/3p4/2pPBPb1/2P1BNP1/PP3K1P/R2QR3 b - - 0 18,dxe4,-47,-62,-15,1
r2k3r/pp1q1ppp/2n5/8/2pPpPb1/2P1BNP1/PP3K1P/R2QR3 w - - 0 19,Ne5,-88,-71,17,1
r2k3r/pp1q1ppp/2n5/4N3/2pPpPb1/2P1B1P1/PP3K1P/R2QR3 b - - 1 19,Bf3,-71,291,362,1
r2k3r/pp1q1ppp/2n5/4N3/2pPpP2/2P1BbP1/PP3K1P/R2QR3 w - - 2 20,Nxf3,290,280,-10,1
r2k3r/pp1q1ppp/2n5/8/2pPpP2/2P1BNP1/PP3K1P/R2QR3 b - - 0 20,exf3,274,328,54,1
r2k3r/pp1q1ppp/2n5/8/2pP1P2/2P1BpP1/PP3K1P/R2QR3 w - - 0 21,Qxf3,331,276,-55,1
r2k3r/pp1q1ppp/2n5/8/2pP1P2/2P1BQP1/PP3K1P/R3R3 b - - 0 21,Re8,293,340,47,1
r2kr3/pp1q1ppp/2n5/8/2pP1P2/2P1BQP1/PP3K1P/R3R3 w - - 1 22,h3,326,205,-121,0
r2kr3/pp1q1ppp/2n5/8/2pP1P2/2P1BQPP/PP3K2/R3R3 b - - 0 22,Kc7,189,319,130,1
r3r3/ppkq1ppp/2n5/8/2pP1P2/2P1BQPP/PP3K2/R3R3 w - - 1 23,Qg4,351,152,-199,0
r3r3/ppkq1ppp/2n5/8/2pP1PQ1/2P1B1PP/PP3K2/R3R3 b - - 2 23,Qd6,156,364,208,1
r3r3/ppk2ppp/2nq4/8/2pP1PQ1/2P1B1PP/PP3K2/R3R3 w - - 3 24,Qxg7,333,298,-35,1
r3r3/ppk2pQp/2nq4/8/2pP1P2/2P1B1PP/PP3K2/R3R3 b - - 0 24,Re7,294,388,94,1
r7/ppk1rpQp/2nq4/8/2pP1P2/2P1B1PP/PP3K2/R3R3 w - - 1 25,f5,397,430,33,1
r7/ppk1rpQp/2nq4/5P2/2pP4/2P1B1PP/PP3K2/R3R3 b - - 0 25,Rae8,438,698,260,1
4r3/ppk1rpQp/2nq4/5P2/2pP4/2P1B1PP/PP3K2/R3R3 w - - 1 26,Bf4,732,548,-184,0
4r3/ppk1rpQp/2nq4/5P2/2pP1B2/2P3PP/PP3K2/R3R3 b - - 2 26,Ne5,585,608,23,1
4r3/ppk1rpQp/3q4/4nP2/2pP1B2/2P3PP/PP3K2/R3R3 w - - 3 27,g4,666,-521,-1187,0
4r3/ppk1rpQp/3q4/4nP2/2pP1BP1/2P4P/PP3K2/R3R3 b - - 0 27,Qd5,-586,609,1195,1
4r3/ppk1rpQp/8/3qnP2/2pP1BP1/2P4P/PP3K2/R3R3 w - - 1 28,Bxe5+,558,415,-143,0
4r3/ppk1rpQp/8/3qBP2/2pP2P1/2P4P/PP3K2/R3R3 b - - 0 28,Rxe5,442,712,270,1
4r3/ppk2pQp/8/3qrP2/2pP2P1/2P4P/PP3K2/R3R3 w - - 0 29,dxe5,733,478,-255,0
4r3/ppk2pQp/8/3qPP2/2p3P1/2P4P/PP3K2/R3R3 b - - 0 29,Qd2+,407,488,81,1
4r3/ppk2pQp/8/4PP2/2p3P1/2P4P/PP1q1K2/R3R3 w - - 1 30,Re2,451,561,110,1
4r3/ppk2pQp/8/4PP2/2p3P1/2P4P/PP1qRK2/R7 b - - 2 30,Qf4+,581,678,97,1
4r3/ppk2pQp/8/4PP2/2p2qP1/2P4P/PP2RK2/R7 w - - 3 31,Kg2,687,678,-9,1
4r3/ppk2pQp/8/4PP2/2p2qP1/2P4P/PP2R1K1/R7 b - - 4 31,Rd8,669,719,50,1
3r4/ppk2pQp/8/4PP2/2p2qP1/2P4P/PP2R1K1/R7 w - - 5 32,Rae1,788,481,-307,0
3r4/ppk2pQp/8/4PP2/2p2qP1/2P4P/PP2R1K1/4R3 b - - 6 32,Rd2,537,589,52,1
8/ppk2pQp/8/4PP2/2p2qP1/2P4P/PP1rR1K1/4R3 w - - 7 33,Qxf7+,574,612,38,1
8/ppk2Q1p/8/4PP2/2p2qP1/2P4P/PP1rR1K1/4R3 b - - 0 33,Kb6,604,621,17,1
8/pp3Q1p/1k6/4PP2/2p2qP1/2P4P/PP1rR1K1/4R3 w - - 1 34,Qf6+,670,649,-21,1
8/pp5p/1k3Q2/4PP2/2p2qP1/2P4P/PP1rR1K1/4R3 b - - 2 34,Kc7,629,711,82,1
8/ppk4p/5Q2/4PP2/2p2qP1/2P4P/PP1rR1K1/4R3 w - - 3 35,Qe7+,685,635,-50,1
8/ppk1Q2p/8/4PP2/2p2qP1/2P4P/PP1rR1K1/4R3 b - - 4 35,Kb6,624,718,94,1
8/pp2Q2p/1k6/4PP2/2p2qP1/2P4P/PP1rR1K1/4R3 w - - 5 36,Qb4+,720,626,-94,1
8/pp5p/1k6/4PP2/1Qp2qP1/2P4P/PP1rR1K1/4R3 b - - 6 36,Kc7,621,813,192,1
8/ppk4p/8/4PP2/1Qp2qP1/2P4P/PP1rR1K1/4R3 w - - 7 37,Rxd2,817,607,-210,0
8/ppk4p/8/4PP2/1Qp2qP1/2P4P/PP1R2K1/4R3 b - - 0 37,Qxd2+,600,596,-4,1
8/ppk4p/8/4PP2/1Qp3P1/2P4P/PP1q2K1/4R3 w - - 0 38,Kf1,587,526,-61,1
8/ppk4p/8/4PP2/1Qp3P1/2P4P/PP1q4/4RK2 b - - 1 38,Qf4+,588,599,11,1
8/ppk4p/8/4PP2/1Qp2qP1/2P4P/PP6/4RK2 w - - 2 39,Ke2,595,595,0,1
8/ppk4p/8/4PP2/1Qp2qP1/2P4P/PP2K3/4R3 b - - 3 39,Qe4+,596,702,106,1
8/ppk4p/8/4PP2/1Qp1q1P1/2P4P/PP2K3/4R3 w - - 4 40,Kd1,662,769,107,1
8/ppk4p/8/4PP2/1Qp1q1P1/2P4P/PP6/3KR3 b - - 5 40,Qd3+,762,831,69,1
8/ppk4p/8/4PP2/1Qp3P1/2Pq3P/PP6/3KR3 w - - 6 41,Kc1,814,854,40,1
8/ppk4p/8/4PP2/1Qp3P1/2Pq3P/PP6/2K1R3 b - - 7 41,a5,834,836,2,1
8/1pk4p/8/p3PP2/1Qp3P1/2Pq3P/PP6/2K1R3 w - - 0 42,Qc5+,892,857,-35,1
8/1pk4p/8/p1Q1PP2/2p3P1/2Pq3P/PP6/2K1R3 b - - 1 42,Kb8,876,892,16,1
1k6/1p5p/8/p1Q1PP2/2p3P1/2Pq3P/PP6/2K1R3 w - - 2 43,Qd6+,920,933,13,1
1k6/1p5p/3Q4/p3PP2/2p3P1/2Pq3P/PP6/2K1R3 b - - 3 43,Qxd6,874,924,50,1
1k6/1p5p/3q4/p3PP2/2p3P1/2P4P/PP6/2K1R3 w - - 0 44,exd6,927,907,-20,1
1k6/1p5p/3P4/p4P2/2p3P1/2P4P/PP6/2K1R3 b - - 0 44,Kc8,923,966,43,1
2k5/1p5p/3P4/p4P2/2p3P1/2P4P/PP6/2K1R3 w - - 1 45,Re6,984,863,-121,0
2k5/1p5p/3PR3/p4P2/2p3P1/2P4P/PP6/2K5 b - - 2 45,Kd7,863,884,21,1
8/1p1k3p/3PR3/p4P2/2p3P1/2P4P/PP6/2K5 w - - 3 46,Re7+,889,868,-21,1
8/1p1kR2p/3P4/p4P2/2p3P1/2P4P/PP6/2K5 b - - 4 46,Kxd6,882,893,11,1
8/1p2R2p/3k4/p4P2/2p3P1/2P4P/PP6/2K5 w - - 0 47,Rxh7,894,860,-34,1
8/1p5R/3k4/p4P2/2p3P1/2P4P/PP6/2K5 b - - 0 47,b5,816,795,-21,1
8/7R/3k4/pp3P2/2p3P1/2P4P/PP6/2K5 w - - 0 48,Rh6+,838,790,-48,1
8/8/3k3R/pp3P2/2p3P1/2P4P/PP6/2K5 b - - 1 48,Ke5,812,847,35,1
8/8/7R/pp2kP2/2p3P1/2P4P/PP6/2K5 w - - 2 49,f6,846,741,-105,0
8/8/5P1R/pp2k3/2p3P1/2P4P/PP6/2K5 b - - 0 49,Ke6,841,829,-12,1
8/8/4kP1R/pp6/2p3P1/2P4P/PP6/2K5 w - - 1 50,g5,822,764,-58,1
8/8/4kP1R/pp4P1/2p5/2P4P/PP6/2K5 b - - 0 50,Kf7,810,839,29,1
8/5k2/5P1R/pp4P1/2p5/2P4P/PP6/2K5 w - - 1 51,g6+,850,704,-146,0
8/5k2/5PPR/pp6/2p5/2P4P/PP6/2K5 b - - 0 51,Kxf6,737,697,-40,1
8/8/5kPR/pp6/2p5/2P4P/PP6/2K5 w - - 0 52,Rh5,693,697,4,1
8/8/5kP1/pp5R/2p5/2P4P/PP6/2K5 b - - 1 52,Kxg6,681,708,27,1
8/8/6k1/pp5R/2p5/2P4P/PP6/2K5 w - - 0 53,Rh8,749,667,-82,1
7R/8/6k1/pp6/2p5/2P4P/PP6/2K5 b - - 1 53,Kg7,679,709,30,1
7R/6k1/8/pp6/2p5/2P4P/PP6/2K5 w - - 2 54,Rc8,685,688,3,1
2R5/6k1/8/pp6/2p5/2P4P/PP6/2K5 b - - 3 54,a4,671,726,55,1
2R5/6k1/8/1p6/p1p5/2P4P/PP6/2K5 w - - 0 55,Rc6,730,700,-30,1
8/6k1/2R5/1p6/p1p5/2P4P/PP6/2K5 b - - 1 55,Kf7,729,758,29,1
8/5k2/2R5/1p6/p1p5/2P4P/PP6/2K5 w - - 2 56,Rb6,749,658,-91,1
8/5k2/1R6/1p6/p1p5/2P4P/PP6/2K5 b - - 3 56,Ke7,709,760,51,1
8/4k3/1R6/1p6/p1p5/2P4P/PP6/2K5 w - - 4 57,Rxb5,790,689,-101,0
8/4k3/8/1R6/p1p5/2P4P/PP6/2K5 b - - 0 57,Kd6,735,793,58,1
8/8/3k4/1R6/p1p5/2P4P/PP6/2K5 w - - 1 58,Rh5,800,757,-43,1
8/8/3k4/7R/p1p5/2P4P/PP6/2K5 b - - 2 58,Kc6,772,785,13,1
8/8/2k5/7R/p1p5/2P4P/PP6/2K5 w - - 3 59,Rh6+,812,783,-29,1
8/8/2k4R/8/p1p5/2P4P/PP6/2K5 b - - 4 59,Kc5,800,815,15,1
8/8/7R/2k5/p1p5/2P4P/PP6/2K5 w - - 5 60,Rh5+,836,813,-23,1
8/8/8/2k4R/p1p5/2P4P/PP6/2K5 b - - 6 60,Kc6,805,800,-5,1
8/8/2k5/7R/p1p5/2P4P/PP6/2K5 w - - 7 61,Rh6+,817,827,10,1
8/8/2k4R/8/p1p5/2P4P/PP6/2K5 b - - 8 61,Kc5,807,817,10,1
8/8/7R/2k5/p1p5/2P4P/PP6/2K5 w - - 9 62,Rh5+,816,841,25,1
8/8/8/2k4R/p1p5/2P4P/PP6/2K5 b - - 10 62,Kd6,827,822,-5,1
8/8/3k4/7R/p1p5/2P4P/PP6/2K5 w - - 11 63,Rh6+,845,745,-100,1
8/8/3k3R/8/p1p5/2P4P/PP6/2K5 b - - 12 63,Kc7,827,833,6,1
8/2k5/7R/8/p1p5/2P4P/PP6/2K5 w - - 13 64,Rh5,841,764,-77,1
8/2k5/8/7R/p1p5/2P4P/PP6/2K5 b - - 14 64,Kd7,768,830,62,1
8/3k4/8/7R/p1p5/2P4P/PP6/2K5 w - - 15 65,Rh6,833,760,-73,1
8/3k4/7R/8/p1p5/2P4P/PP6/2K5 b - - 16 65,Ke8,787,842,55,1
4k3/8/7R/8/p1p5/2P4P/PP6/2K5 w - - 17 66,Rh7,850,801,-49,1
4k3/7R/8/8/p1p5/2P4P/PP6/2K5 b - - 18 66,Kf8,805,860,55,1
5k2/7R/8/8/p1p5/2P4P/PP6/2K5 w - - 19 67,Rh6,837,777,-60,1
5k2/8/7R/8/p1p5/2P4P/PP6/2K5 b - - 20 67,Kg7,793,811,18,1
8/6k1/7R/8/p1p5/2P4P/PP6/2K5 w - - 21 68,Rh7+,816,530,-286,0
8/6kR/8/8/p1p5/2P4P/PP6/2K5 b - - 22 68,Kxh7,541,570,29,1
rnbqkbnr/pppppppp/8/8/8/8/PPPPPPPP/RNBQKBNR w KQkq - 0 1,e4,31,41,10,1
rnbqkbnr/pppppppp/8/8/4P3/8/PPPP1PPP/RNBQKBNR b KQkq - 0 1,d5,27,65,38,1
rnbqkbnr/ppp1pppp/8/3p4/4P3/8/PPPP1PPP/RNBQKBNR w KQkq - 0 2,exd5,69,76,7,1
rnbqkbnr/ppp1pppp/8/3P4/8/8/PPPP1PPP/RNBQKBNR b KQkq - 0 2,Qxd5,65,75,10,1
rnb1kbnr/ppp1pppp/8/3q4/8/8/PPPP1PPP/RNBQKBNR w KQkq - 0 3,Nc3,82,73,-9,1
rnb1kbnr/ppp1pppp/8/3q4/8/2N5/PPPP1PPP/R1BQKBNR b KQkq - 1 3,Qe5+,75,97,22,1
rnb1kbnr/ppp1pppp/8/4q3/8/2N5/PPPP1PPP/R1BQKBNR w KQkq - 2 4,Qe2,127,31,-96,1
rnb1kbnr/ppp1pppp/8/4q3/8/2N5/PPPPQPPP/R1B1KBNR b KQkq - 3 4,Qxe2+,26,39,13,1
rnb1kbnr/ppp1pppp/8/8/8/2N5/PPPPqPPP/R1B1KBNR w KQkq - 0 5,Bxe2,31,34,3,1
rnb1kbnr/ppp1pppp/8/8/8/2N5/PPPPBPPP/R1B1K1NR b KQkq - 0 5,Nc6,34,19,-15,1
r1b1kbnr/ppp1pppp/2n5/8/8/2N5/PPPPBPPP/R1B1K1NR w KQkq - 1 6,Nf3,23,26,3,1
r1b1kbnr/ppp1pppp/2n5/8/8/2N2N2/PPPPBPPP/R1B1K2R b KQkq - 2 6,a6,26,51,25,1
r1b1kbnr/1pp1pppp/p1n5/8/8/2N2N2/PPPPBPPP/R1B1K2R w KQkq - 0 7,h3,71,-14,-85,1
r1b1kbnr/1pp1pppp/p1n5/8/8/2N2N1P/PPPPBPP1/R1B1K2R b KQkq - 0 7,Nb4,-19,6,25,1
r1b1kbnr/1pp1pppp/p7/8/1n6/2N2N1P/PPPPBPP1/R1B1K2R w KQkq - 1 8,Nd4,7,-298,-305,0
r1b1kbnr/1pp1pppp/p7/8/1n1N4/2N4P/PPPPBPP1/R1B1K2R b KQkq - 2 8,c5,-334,-297,37,1
r1b1kbnr/1p2pppp/p7/2p5/1n1N4/2N4P/PPPPBPP1/R1B1K2R w KQkq - 0 9,a3,-282,-301,-19,1
r1b1kbnr/1p2pppp/p7/2p5/1n1N4/P1N4P/1PPPBPP1/R1B1K2R b KQkq - 0 9,cxd4,-322,-323,-1,1
r1b1kbnr/1p2pppp/p7/8/1n1p4/P1N4P/1PPPBPP1/R1B1K2R w KQkq - 0 10,axb4,-304,-302,2,1
r1b1kbnr/1p2pppp/p7/8/1P1p4/2N4P/1PPPBPP1/R1B1K2R b KQkq - 0 10,dxc3,-291,-329,-38,1
r1b1kbnr/1p2pppp/p7/8/1P6/2p4P/1PPPBPP1/R1B1K2R w KQkq - 0 11,bxc3,-295,-326,-31,1
r1b1kbnr/1p2pppp/p7/8/1P6/2P4P/2PPBPP1/R1B1K2R b KQkq - 0 11,Bf5,-300,-227,73,1
r3kbnr/1p2pppp/p7/5b2/1P6/2P4P/2PPBPP1/R1B1K2R w KQkq - 1 12,d3,-234,-272,-38,1
r3kbnr/1p2pppp/p7/5b2/1P6/2PP3P/2P1BPP1/R1B1K2R b KQkq - 0 12,Nf6,-253,-213,40,1
r3kb1r/1p2pppp/p4n2/5b2/1P6/2PP3P/2P1BPP1/R1B1K2R w KQkq - 1 13,O-O,-228,-268,-40,1
r3kb1r/1p2pppp/p4n2/5b2/1P6/2PP3P/2P1BPP1/R1B2RK1 b kq - 2 13,Rc8,-242,-114,128,1
2r1kb1r/1p2pppp/p4n2/5b2/1P6/2PP3P/2P1BPP1/R1B2RK1 w k - 3 14,Bb2,-127,-227,-100,1
2r1kb1r/1p2pppp/p4n2/5b2/1P6/2PP3P/1BP1BPP1/R4RK1 b k - 4 14,Nd5,-234,-180,54,1
2r1kb1r/1p2pppp/p7/3n1b2/1P6/2PP3P/1BP1BPP1/R4RK1 w k - 5 15,c4,-177,-249,-72,1
2r1kb1r/1p2pppp/p7/3n1b2/1PP5/3P3P/1BP1BPP1/R4RK1 b k - 0 15,Nf4,-306,-43,263,1
2r1kb1r/1p2pppp/p7/5b2/1PP2n2/3P3P/1BP1BPP1/R4RK1 w k - 1 16,Bf3,-42,-73,-31,1
2r1kb1r/1p2pppp/p7/5b2/1PP2n2/3P1B1P/1BP2PP1/R4RK1 b k - 2 16,e6,-110,126,236,1
2r1kb1r/1p3ppp/p3p3/5b2/1PP2n2/3P1B1P/1BP2PP1/R4RK1 w k - 0 17,Rfe1,134,-185,-319,0
2r1kb1r/1p3ppp/p3p3/5b2/1PP2n2/3P1B1P/1BP2PP1/R3R1K1 b k - 1 17,Bxb4,-155,-177,-22,1
2r1k2r/1p3ppp/p3p3/5b2/1bP2n2/3P1B1P/1BP2PP1/R3R1K1 w k - 0 18,Rf1,-166,-272,-106,0
2r1k2r/1p3ppp/p3p3/5b2/1bP2n2/3P1B1P/1BP2PP1/R4RK1 b k - 1 18,Rb8,-261,79,340,1
1r2k2r/1p3ppp/p3p3/5b2/1bP2n2/3P1B1P/1BP2PP1/R4RK1 w k - 2 19,Bxg7,99,-92,-191,0
1r2k2r/1p3pBp/p3p3/5b2/1bP2n2/3P1B1P/2P2PP1/R4RK1 b k - 0 19,Rg8,-99,-8,91,1
1r2k1r1/1p3pBp/p3p3/5b2/1bP2n2/3P1B1P/2P2PP1/R4RK1 w - - 1 20,Be5,0,4,4,1
1r2k1r1/1p3p1p/p3p3/4Bb2/1bP2n2/3P1B1P/2P2PP1/R4RK1 b - - 2 20,Nxh3+,1,105,104,1
1r2k1r1/1p3p1p/p3p3/4Bb2/1bP5/3P1B1n/2P2PP1/R4RK1 w - - 0 21,Kh2,112,121,9,1
1r2k1r1/1p3p1p/p3p3/4Bb2/1bP5/3P1B1n/2P2PPK/R4R2 b - - 1 21,Rd8,107,157,50,1
3rk1r1/1p3p1p/p3p3/4Bb2/1bP5/3P1B1n/2P2PPK/R4R2 w - - 2 22,Bxb7,143,65,-78,1
3rk1r1/1B3p1p/p3p3/4Bb2/1bP5/3P3n/2P2PPK/R4R2 b - - 0 22,Ng5,66,77,11,1
3rk1r1/1B3p1p/p3p3/4Bbn1/1bP5/3P4/2P2PPK/R4R2 w - - 1 23,Rxa6,99,-70,-169,0
3rk1r1/1B3p1p/R3p3/4Bbn1/1bP5/3P4/2P2PPK/5R2 b - - 0 23,Rg6,-64,46,110,1
3rk3/1B3p1p/R3p1r1/4Bbn1/1bP5/3P4/2P2PPK/5R2 w - - 1 24,Bc6+,54,0,-54,1
3rk3/5p1p/R1B1p1r1/4Bbn1/1bP5/3P4/2P2PPK/5R2 b - - 2 24,Kf8,0,0,0,1
3r1k2/5p1p/R1B1p1r1/4Bbn1/1bP5/3P4/2P2PPK/5R2 w - - 3 25,Ra4,0,-170,-170,0
3r1k2/5p1p/2B1p1r1/4Bbn1/RbP5/3P4/2P2PPK/5R2 b - - 4 25,Rh6+,-142,-93,49,1
3r1k2/5p1p/2B1p2r/4Bbn1/RbP5/3P4/2P2PPK/5R2 w - - 5 26,Kg1,-34,-80,-46,1
3r1k2/5p1p/2B1p2r/4Bbn1/RbP5/3P4/2P2PP1/5RK1 b - - 6 26,Bc5,-37,-63,-26,1
3r1k2/5p1p/2B1p2r/2b1Bbn1/R1P5/3P4/2P2PP1/5RK1 w - - 7 27,Bf4,-30,-231,-201,0
3r1k2/5p1p/2B1p2r/2b2bn1/R1P2B2/3P4/2P2PP1/5RK1 b - - 8 27,Rg6,-216,-208,8,1
3r1k2/5p1p/2B1p1r1/2b2bn1/R1P2B2/3P4/2P2PP1/5RK1 w - - 9 28,Be4,-186,-537,-351,0
3r1k2/5p1p/4p1r1/2b2bn1/R1P1BB2/3P4/2P2PP1/5RK1 b - - 10 28,Nxe4,-525,-390,135,1
3r1k2/5p1p/4p1r1/2b2b2/R1P1nB2/3P4/2P2PP1/5RK1 w - - 0 29,dxe4,-446,-427,19,1
3r1k2/5p1p/4p1r1/2b2b2/R1P1PB2/8/2P2PP1/5RK1 b - - 0 29,Bh3,-453,-443,10,1
3r1k2/5p1p/4p1r1/2b5/R1P1PB2/7b/2P2PP1/5RK1 w - - 1 30,Bg3,-421,-508,-87,1
3r1k2/5p1p/4p1r1/2b5/R1P1P3/6Bb/2P2PP1/5RK1 b - - 2 30,Bg4,-513,-284,229,1
3r1k2/5p1p/4p1r1/2b5/R1P1P1b1/6B1/2P2PP1/5RK1 w - - 3 31,Ra5,-284,-333,-49,1
3r1k2/5p1p/4p1r1/R1b5/2P1P1b1/6B1/2P2PP1/5RK1 b - - 4 31,Bb6,-331,-245,86,1
3r1k2/5p1p/1b2p1r1/R7/2P1P1b1/6B1/2P2PP1/5RK1 w - - 5 32,Ra6,-245,-351,-106,0
3r1k2/5p1p/Rb2p1r1/8/2P1P1b1/6B1/2P2PP1/5RK1 b - - 6 32,Bc5,-360,-284,76,1
3r1k2/5p1p/R3p1r1/2b5/2P1P1b1/6B1/2P2PP1/5RK1 w - - 7 33,Ra5,-303,-311,-8,1
3r1k2/5p1p/4p1r1/R1b5/2P1P1b1/6B1/2P2PP1/5RK1 b - - 8 33,Bd4,-318,-324,-6,1
3r1k2/5p1p/4p1r1/R7/2PbP1b1/6B1/2P2PP1/5RK1 w - - 9 34,c5,-340,-389,-49,1
3r1k2/5p1p/4p1r1/R1P5/3bP1b1/6B1/2P2PP1/5RK1 b - - 0 34,Be2,-406,-316,90,1
3r1k2/5p1p/4p1r1/R1P5/3bP3/6B1/2P1bPP1/5RK1 w - - 1 35,Re1,-332,-452,-120,0
3r1k2/5p1p/4p1r1/R1P5/3bP3/6B1/2P1bPP1/4R1K1 b - - 2 35,Bc4,-405,-101,304,1
3r1k2/5p1p/4p1r1/R1P5/2bbP3/6B1/2P2PP1/4R1K1 w - - 3 36,c6,-95,-355,-260,0
3r1k2/5p1p/2P1p1r1/R7/2bbP3/6B1/2P2PP1/4R1K1 b - - 0 36,Bc3,-354,-376,-22,1
3r1k2/5p1p/2P1p1r1/R7/2b1P3/2b3B1/2P2PP1/4R1K1 w - - 1 37,Rb1,-390,-489,-99,1
3r1k2/5p1p/2P1p1r1/R7/2b1P3/2b3B1/2P2PP1/1R4K1 b - - 2 37,Bxa5,-460,-484,-24,1
3r1k2/5p1p/2P1p1r1/b7/2b1P3/6B1/2P2PP1/1R4K1 w - - 0 38,c7,-509,-540,-31,1
3r1k2/2P2p1p/4p1r1/b7/2b1P3/6B1/2P2PP1/1R4K1 b - - 0 38,Bxc7,-548,-419,129,1
3r1k2/2b2p1p/4p1r1/8/2b1P3/6B1/2P2PP1/1R4K1 w - - 0 39,Bxc7,-438,-443,-5,1
3r1k2/2B2p1p/4p1r1/8/2b1P3/8/2P2PP1/1R4K1 b - - 0 39,Rd7,-435,-290,145,1
5k2/2Br1p1p/4p1r1/8/2b1P3/8/2P2PP1/1R4K1 w - - 1 40,Rb8+,-381,-412,-31,1
1R3k2/2Br1p1p/4p1r1/8/2b1P3/8/2P2PP1/6K1 b - - 2 40,Kg7,-416,-363,53,1
1R6/2Br1pkp/4p1r1/8/2b1P3/8/2P2PP1/6K1 w - - 3 41,Be5+,-403,-448,-45,1
1R6/3r1pkp/4p1r1/4B3/2b1P3/8/2P2PP1/6K1 b - - 4 41,f6,-448,-429,19,1
1R6/3r2kp/4ppr1/4B3/2b1P3/8/2P2PP1/6K1 w - - 0 42,Bf4,-420,-445,-25,1
1R6/3r2kp/4ppr1/8/2b1PB2/8/2P2PP1/6K1 b - - 1 42,Rd1+,-428,-384,44,1
1R6/6kp/4ppr1/8/2b1PB2/8/2P2PP1/3r2K1 w - - 2 43,Kh2,-440,-451,-11,1
1R6/6kp/4ppr1/8/2b1PB2/8/2P2PPK/3r4 b - - 3 43,e5,-429,-431,-2,1
1R6/6kp/5pr1/4p3/2b1PB2/8/2P2PPK/3r4 w - - 0 44,Rb7+,-431,-452,-21,1
8/1R4kp/5pr1/4p3/2b1PB2/8/2P2PPK/3r4 b - - 1 44,Bf7,-431,-381,50,1
8/1R3bkp/5pr1/4p3/4PB2/8/2P2PPK/3r4 w - - 2 45,g3,-410,-537,-127,0
8/1R3bkp/5pr1/4p3/4PB2/6P1/2P2P1K/3r4 b - - 0 45,Rh6+,-532,3,535,1
8/1R3bkp/5p1r/4p3/4PB2/6P1/2P2P1K/3r4 w - - 1 46,Kg2,12,-489,-501,0
8/1R3bkp/5p1r/4p3/4PB2/6P1/2P2PK1/3r4 b - - 2 46,exf4,-513,-484,29,1
rnbqkbnr/pppppppp/8/8/8/8/PPPPPPPP/RNBQKBNR w KQkq - 0 1,c4,35,-16,-51,1
rnbqkbnr/pppppppp/8/8/2P5/8/PP1PPPPP/RNBQKBNR b KQkq - 0 1,Nf6,-15,26,41,1
rnbqkb1r/pppppppp/5n2/8/2P5/8/PP1PPPPP/RNBQKBNR w KQkq - 1 2,Nc3,22,-24,-46,1
rnbqkb1r/pppppppp/5n2/8/2P5/2N5/PP1PPPPP/R1BQKBNR b KQkq - 2 2,e6,-12,45,57,1
rnbqkb1r/pppp1ppp/4pn2/8/2P5/2N5/PP1PPPPP/R1BQKBNR w KQkq - 0 3,Nf3,38,20,-18,1
rnbqkb1r/pppp1ppp/4pn2/8/2P5/2N2N2/PP1PPPPP/R1BQKB1R b KQkq - 1 3,d5,17,19,2,1
rnbqkb1r/ppp2ppp/4pn2/3p4/2P5/2N2N2/PP1PPPPP/R1BQKB1R w KQkq - 0 4,d4,22,23,1,1
rnbqkb1r/ppp2ppp/4pn2/3p4/2PP4/2N2N2/PP2PPPP/R1BQKB1R b KQkq - 0 4,Bb4,17,30,13,1
rnbqk2r/ppp2ppp/4pn2/3p4/1bPP4/2N2N2/PP2PPPP/R1BQKB1R w KQkq - 1 5,a3,30,-10,-40,1
rnbqk2r/ppp2ppp/4pn2/3p4/1bPP4/P1N2N2/1P2PPPP/R1BQKB1R b KQkq - 0 5,Bxc3+,-2,5,7,1
rnbqk2r/ppp2ppp/4pn2/3p4/2PP4/P1b2N2/1P2PPPP/R1BQKB1R w KQkq - 0 6,bxc3,2,9,7,1
rnbqk2r/ppp2ppp/4pn2/3p4/2PP4/P1P2N2/4PPPP/R1BQKB1R b KQkq - 0 6,dxc4,11,37,26,1
rnbqk2r/ppp2ppp/4pn2/8/2pP4/P1P2N2/4PPPP/R1BQKB1R w KQkq - 0 7,e3,37,36,-1,1
rnbqk2r/ppp2ppp/4pn2/8/2pP4/P1P1PN2/5PPP/R1BQKB1R b KQkq - 0 7,O-O,23,44,21,1
rnbq1rk1/ppp2ppp/4pn2/8/2pP4/P1P1PN2/5PPP/R1BQKB1R w KQ - 1 8,Bxc4,53,43,-10,1
rnbq1rk1/ppp2ppp/4pn2/8/2BP4/P1P1PN2/5PPP/R1BQK2R b KQ - 0 8,Nbd7,49,68,19,1
r1bq1rk1/pppn1ppp/4pn2/8/2BP4/P1P1PN2/5PPP/R1BQK2R w KQ - 1 9,a4,73,50,-23,1
r1bq1rk1/pppn1ppp/4pn2/8/P1BP4/2P1PN2/5PPP/R1BQK2R b KQ - 0 9,b6,43,56,13,1
r1bq1rk1/p1pn1ppp/1p2pn2/8/P1BP4/2P1PN2/5PPP/R1BQK2R w KQ - 0 10,a5,76,38,-38,1
r1bq1rk1/p1pn1ppp/1p2pn2/P7/2BP4/2P1PN2/5PPP/R1BQK2R b KQ - 0 10,Bb7,65,63,-2,1
r2q1rk1/pbpn1ppp/1p2pn2/P7/2BP4/2P1PN2/5PPP/R1BQK2R w KQ - 1 11,a6,68,40,-28,1
r2q1rk1/pbpn1ppp/Pp2pn2/8/2BP4/2P1PN2/5PPP/R1BQK2R b KQ - 0 11,Bd5,54,54,0,1
r2q1rk1/p1pn1ppp/Pp2pn2/3b4/2BP4/2P1PN2/5PPP/R1BQK2R w KQ - 1 12,Bxd5,63,-17,-80,1
r2q1rk1/p1pn1ppp/Pp2pn2/3B4/3P4/2P1PN2/5PPP/R1BQK2R b KQ - 0 12,exd5,-17,-16,1,1
r2q1rk1/p1pn1ppp/Pp3n2/3p4/3P4/2P1PN2/5PPP/R1BQK2R w KQ - 0 13,Nd2,-15,-44,-29,1
r2q1rk1/p1pn1ppp/Pp3n2/3p4/3P4/2P1P3/3N1PPP/R1BQK2R b KQ - 1 13,h6,-43,-25,18,1
r2q1rk1/p1pn1pp1/Pp3n1p/3p4/3P4/2P1P3/3N1PPP/R1BQK2R w KQ - 0 14,c4,-24,-40,-16,1
r2q1rk1/p1pn1pp1/Pp3n1p/3p4/2PP4/4P3/3N1PPP/R1BQK2R b KQ - 0 14,dxc4,-42,-20,22,1
r2q1rk1/p1pn1pp1/Pp3n1p/8/2pP4/4P3/3N1PPP/R1BQK2R w KQ - 0 15,Nxc4,-25,-29,-4,1
r2q1rk1/p1pn1pp1/Pp3n1p/8/2NP4/4P3/5PPP/R1BQK2R b KQ - 0 15,Ne4,-24,46,70,1
r2q1rk1/p1pn1pp1/Pp5p/8/2NPn3/4P3/5PPP/R1BQK2R w KQ - 1 16,Bb2,53,19,-34,1
r2q1rk1/p1pn1pp1/Pp5p/8/2NPn3/4P3/1B3PPP/R2QK2R b KQ - 2 16,Ndf6,30,66,36,1
r2q1rk1/p1p2pp1/Pp3n1p/8/2NPn3/4P3/1B3PPP/R2QK2R w KQ - 3 17,Ne5,75,53,-22,1
r2q1rk1/p1p2pp1/Pp3n1p/4N3/3Pn3/4P3/1B3PPP/R2QK2R b KQ - 4 17,Qd5,64,51,-13,1
r4rk1/p1p2pp1/Pp3n1p/3qN3/3Pn3/4P3/1B3PPP/R2QK2R w KQ - 5 18,O-O,63,40,-23,1
r4rk1/p1p2pp1/Pp3n1p/3qN3/3Pn3/4P3/1B3PPP/R2Q1RK1 b - - 6 18,Rac8,33,185,152,1
2r2rk1/p1p2pp1/Pp3n1p/3qN3/3Pn3/4P3/1B3PPP/R2Q1RK1 w - - 7 19,f3,215,245,30,1
2r2rk1/p1p2pp1/Pp3n1p/3qN3/3Pn3/4PP2/1B4PP/R2Q1RK1 b - - 0 19,Nd6,240,218,-22,1
2r2rk1/p1p2pp1/Pp1n1n1p/3qN3/3P4/4PP2/1B4PP/R2Q1RK1 w - - 1 20,Ra3,214,66,-148,0
2r2rk1/p1p2pp1/Pp1n1n1p/3qN3/3P4/R3PP2/1B4PP/3Q1RK1 b - - 2 20,Nc4,66,80,14,1
2r2rk1/p1p2pp1/Pp3n1p/3qN3/2nP4/R3PP2/1B4PP/3Q1RK1 w - - 3 21,e4,110,-161,-271,0
2r2rk1/p1p2pp1/Pp3n1p/3qN3/2nPP3/R4P2/1B4PP/3Q1RK1 b - - 0 21,Qb5,-62,113,175,1
2r2rk1/p1p2pp1/Pp3n1p/1q2N3/2nPP3/R4P2/1B4PP/3Q1RK1 w - - 1 22,Rb3,112,69,-43,1
2r2rk1/p1p2pp1/Pp3n1p/1q2N3/2nPP3/1R3P2/1B4PP/3Q1RK1 b - - 2 22,Qxa6,92,125,33,1
2r2rk1/p1p2pp1/qp3n1p/4N3/2nPP3/1R3P2/1B4PP/3Q1RK1 w - - 0 23,Nxc4,119,73,-46,1
2r2rk1/p1p2pp1/qp3n1p/8/2NPP3/1R3P2/1B4PP/3Q1RK1 b - - 0 23,Qxc4,49,55,6,1
2r2rk1/p1p2pp1/1p3n1p/8/2qPP3/1R3P2/1B4PP/3Q1RK1 w - - 0 24,Rc3,64,12,-52,1
2r2rk1/p1p2pp1/1p3n1p/8/2qPP3/2R2P2/1B4PP/3Q1RK1 b - - 1 24,Qb4,43,24,-19,1
2r2rk1/p1p2pp1/1p3n1p/8/1q1PP3/2R2P2/1B4PP/3Q1RK1 w - - 2 25,Qc2,23,-190,-213,0
2r2rk1/p1p2pp1/1p3n1p/8/1q1PP3/2R2P2/1BQ3PP/5RK1 b - - 3 25,c6,-145,101,246,1
2r2rk1/p4pp1/1pp2n1p/8/1q1PP3/2R2P2/1BQ3PP/5RK1 w - - 0 26,Rxc6,110,-453,-563,0
2r2rk1/p4pp1/1pR2n1p/8/1q1PP3/5P2/1BQ3PP/5RK1 b - - 0 26,Rxc6,-450,-458,-8,1
5rk1/p4pp1/1pr2n1p/8/1q1PP3/5P2/1BQ3PP/5RK1 w - - 0 27,Qxc6,-432,-428,4,1
5rk1/p4pp1/1pQ2n1p/8/1q1PP3/5P2/1B4PP/5RK1 b - - 0 27,Qxb2,-463,-418,45,1
5rk1/p4pp1/1pQ2n1p/8/3PP3/5P2/1q4PP/5RK1 w - - 0 28,Qb7,-455,-501,-46,1
5rk1/pQ3pp1/1p3n1p/8/3PP3/5P2/1q4PP/5RK1 b - - 1 28,a5,-525,-479,46,1
5rk1/1Q3pp1/1p3n1p/p7/3PP3/5P2/1q4PP/5RK1 w - - 0 29,d5,-539,-565,-26,1
5rk1/1Q3pp1/1p3n1p/p2P4/4P3/5P2/1q4PP/5RK1 b - - 0 29,Qd4+,-538,-488,50,1
5rk1/1Q3pp1/1p3n1p/p2P4/3qP3/5P2/6PP/5RK1 w - - 1 30,Kh1,-505,-500,5,1
5rk1/1Q3pp1/1p3n1p/p2P4/3qP3/5P2/6PP/5R1K b - - 2 30,Qd3,-485,-479,6,1
5rk1/1Q3pp1/1p3n1p/p2P4/4P3/3q1P2/6PP/5R1K w - - 3 31,Rc1,-453,-499,-46,1
5rk1/1Q3pp1/1p3n1p/p2P4/4P3/3q1P2/6PP/2R4K b - - 4 31,b5,-484,-417,67,1
5rk1/1Q3pp1/5n1p/pp1P4/4P3/3q1P2/6PP/2R4K w - - 0 32,h3,-381,-451,-70,1
5rk1/1Q3pp1/5n1p/pp1P4/4P3/3q1P1P/6P1/2R4K b - - 0 32,b4,-371,-419,-48,1
5rk1/1Q3pp1/5n1p/p2P4/1p2P3/3q1P1P/6P1/2R4K w - - 0 33,Qa7,-428,-511,-83,1
5rk1/Q4pp1/5n1p/p2P4/1p2P3/3q1P1P/6P1/2R4K b - - 1 33,b3,-522,-501,21,1
5rk1/Q4pp1/5n1p/p2P4/4P3/1p1q1P1P/6P1/2R4K w - - 0 34,Qxa5,-499,-629,-130,0
5rk1/5pp1/5n1p/Q2P4/4P3/1p1q1P1P/6P1/2R4K b - - 0 34,b2,-629,-640,-11,1
rnbqkbnr/pppppppp/8/8/8/8/PPPPPPPP/RNBQKBNR w KQkq - 0 1,e4,31,26,-5,1
rnbqkbnr/pppppppp/8/8/4P3/8/PPPP1PPP/RNBQKBNR b KQkq - 0 1,d5,33,64,31,1
rnbqkbnr/ppp1pppp/8/3p4/4P3/8/PPPP1PPP/RNBQKBNR w KQkq - 0 2,exd5,70,61,-9,1
rnbqkbnr/ppp1pppp/8/3P4/8/8/PPPP1PPP/RNBQKBNR b KQkq - 0 2,Qxd5,68,84,16,1
rnb1kbnr/ppp1pppp/8/3q4/8/8/PPPP1PPP/RNBQKBNR w KQkq - 0 3,Nc3,71,73,2,1
rnb1kbnr/ppp1pppp/8/3q4/8/2N5/PPPP1PPP/R1BQKBNR b KQkq - 1 3,Qe5+,74,104,30,1
rnb1kbnr/ppp1pppp/8/4q3/8/2N5/PPPP1PPP/R1BQKBNR w KQkq - 2 4,Be2,98,102,4,1
rnb1kbnr/ppp1pppp/8/4q3/8/2N5/PPPPBPPP/R1BQK1NR b KQkq - 3 4,Bg4,108,79,-29,1
rn2kbnr/ppp1pppp/8/4q3/6b1/2N5/PPPPBPPP/R1BQK1NR w KQkq - 4 5,f3,77,69,-8,1
rn2kbnr/ppp1pppp/8/4q3/6b1/2N2P2/PPPPB1PP/R1BQK1NR b KQkq - 0 5,Bh5,62,146,84,1
rn2kbnr/ppp1pppp/8/4q2b/8/2N2P2/PPPPB1PP/R1BQK1NR w KQkq - 1 6,d4,136,135,-1,1
rn2kbnr/ppp1pppp/8/4q2b/3P4/2N2P2/PPP1B1PP/R1BQK1NR b KQkq - 0 6,Qe6,133,212,79,1
rn2kbnr/ppp1pppp/4q3/7b/3P4/2N2P2/PPP1B1PP/R1BQK1NR w KQkq - 1 7,h4,231,171,-60,1
rn2kbnr/ppp1pppp/4q3/7b/3P3P/2N2P2/PPP1B1P1/R1BQK1NR b KQkq - 0 7,Bg6,183,426,243,1
rn2kbnr/ppp1pppp/4q1b1/8/3P3P/2N2P2/PPP1B1P1/R1BQK1NR w KQkq - 1 8,g4,430,169,-261,0
rn2kbnr/ppp1pppp/4q1b1/8/3P2PP/2N2P2/PPP1B3/R1BQK1NR b KQkq - 0 8,h5,170,175,5,1
rn2kbnr/ppp1ppp1/4q1b1/7p/3P2PP/2N2P2/PPP1B3/R1BQK1NR w KQkq - 0 9,d5,169,75,-94,1
rn2kbnr/ppp1ppp1/4q1b1/3P3p/6PP/2N2P2/PPP1B3/R1BQK1NR b KQkq - 0 9,Qe5,60,218,158,1
rn2kbnr/ppp1ppp1/6b1/3Pq2p/6PP/2N2P2/PPP1B3/R1BQK1NR w KQkq - 1 10,f4,173,194,21,1
rn2kbnr/ppp1ppp1/6b1/3Pq2p/5PPP/2N5/PPP1B3/R1BQK1NR b KQkq - 0 10,Qd6,176,186,10,1
rn2kbnr/ppp1ppp1/3q2b1/3P3p/5PPP/2N5/PPP1B3/R1BQK1NR w KQkq - 1 11,f5,165,145,-20,1
rn2kbnr/ppp1ppp1/3q2b1/3P1P1p/6PP/2N5/PPP1B3/R1BQK1NR b KQkq - 0 11,Qg3+,119,263,144,1
rn2kbnr/ppp1ppp1/6b1/3P1P1p/6PP/2N3q1/PPP1B3/R1BQK1NR w KQkq - 1 12,Kd2,270,-5,-275,0
rn2kbnr/ppp1ppp1/6b1/3P1P1p/6PP/2N3q1/PPPKB3/R1BQ2NR b kq - 2 12,Qf4+,1,276,275,1
rn2kbnr/ppp1ppp1/6b1/3P1P1p/5qPP/2N5/PPPKB3/R1BQ2NR w kq - 3 13,Ke1,293,337,44,1
rn2kbnr/ppp1ppp1/6b1/3P1P1p/5qPP/2N5/PPP1B3/R1BQK1NR b kq - 4 13,Qg3+,258,303,45,1
rn2kbnr/ppp1ppp1/6b1/3P1P1p/6PP/2N3q1/PPP1B3/R1BQK1NR w kq - 5 14,Kd2,346,-9,-355,0
rn2kbnr/ppp1ppp1/6b1/3P1P1p/6PP/2N3q1/PPPKB3/R1BQ2NR b kq - 6 14,Bh7,-22,-4,18,1
rn2kbnr/ppp1pppb/8/3P1P1p/6PP/2N3q1/PPPKB3/R1BQ2NR w kq - 7 15,Ne4,3,-233,-236,0
rn2kbnr/ppp1pppb/8/3P1P1p/4N1PP/6q1/PPPKB3/R1BQ2NR b kq - 8 15,Qf4+,-259,-178,81,1
rn2kbnr/ppp1pppb/8/3P1P1p/4NqPP/8/PPPKB3/R1BQ2NR w kq - 9 16,Kd3,-154,-169,-15,1
rn2kbnr/ppp1pppb/8/3P1P1p/4NqPP/3K4/PPP1B3/R1BQ2NR b kq - 10 16,Nd7,-166,535,701,1
r3kbnr/pppnpppb/8/3P1P1p/4NqPP/3K4/PPP1B3/R1BQ2NR w kq - 11 17,Bxf4,498,483,-15,1
rnbqkbnr/pppppppp/8/8/8/8/PPPPPPPP/RNBQKBNR w KQkq - 0 1,Nf3,29,27,-2,1
rnbqkbnr/pppppppp/8/8/8/5N2/PPPPPPPP/RNBQKB1R b KQkq - 1 1,d5,19,16,-3,1
rnbqkbnr/ppp1pppp/8/3p4/8/5N2/PPPPPPPP/RNBQKB1R w KQkq - 0 2,d4,17,12,-5,1
rnbqkbnr/ppp1pppp/8/3p4/3P4/5N2/PPP1PPPP/RNBQKB1R b KQkq - 0 2,Nc6,7,51,44,1
r1bqkbnr/ppp1pppp/2n5/3p4/3P4/5N2/PPP1PPPP/RNBQKB1R w KQkq - 1 3,c3,44,0,-44,1
r1bqkbnr/ppp1pppp/2n5/3p4/3P4/2P2N2/PP2PPPP/RNBQKB1R b KQkq - 0 3,Nf6,10,22,12,1
r1bqkb1r/ppp1pppp/2n2n2/3p4/3P4/2P2N2/PP2PPPP/RNBQKB1R w KQkq - 1 4,Bg5,23,-38,-61,1
r1bqkb1r/ppp1pppp/2n2n2/3p2B1/3P4/2P2N2/PP2PPPP/RN1QKB1R b KQkq - 2 4,e6,-11,37,48,1
r1bqkb1r/ppp2ppp/2n1pn2/3p2B1/3P4/2P2N2/PP2PPPP/RN1QKB1R w KQkq - 0 5,e3,40,22,-18,1
r1bqkb1r/ppp2ppp/2n1pn2/3p2B1/3P4/2P1PN2/PP3PPP/RN1QKB1R b KQkq - 0 5,Be7,21,38,17,1
r1bqk2r/ppp1bppp/2n1pn2/3p2B1/3P4/2P1PN2/PP3PPP/RN1QKB1R w KQkq - 1 6,Bb5,39,44,5,1
r1bqk2r/ppp1bppp/2n1pn2/1B1p2B1/3P4/2P1PN2/PP3PPP/RN1QK2R b KQkq - 2 6,Bd7,45,52,7,1
r2qk2r/pppbbppp/2n1pn2/1B1p2B1/3P4/2P1PN2/PP3PPP/RN1QK2R w KQkq - 3 7,O-O,55,42,-13,1
r2qk2r/pppbbppp/2n1pn2/1B1p2B1/3P4/2P1PN2/PP3PPP/RN1Q1RK1 b kq - 4 7,a6,45,47,2,1
r2qk2r/1ppbbppp/p1n1pn2/1B1p2B1/3P4/2P1PN2/PP3PPP/RN1Q1RK1 w kq - 0 8,Ba4,47,45,-2,1
r2qk2r/1ppbbppp/p1n1pn2/3p2B1/B2P4/2P1PN2/PP3PPP/RN1Q1RK1 b kq - 1 8,h6,46,48,2,1
r2qk2r/1ppbbpp1/p1n1pn1p/3p2B1/B2P4/2P1PN2/PP3PPP/RN1Q1RK1 w kq - 0 9,Bh4,54,-2,-56,1
r2qk2r/1ppbbpp1/p1n1pn1p/3p4/B2P3B/2P1PN2/PP3PPP/RN1Q1RK1 b kq - 1 9,g5,-14,7,21,1
r2qk2r/1ppbbp2/p1n1pn1p/3p2p1/B2P3B/2P1PN2/PP3PPP/RN1Q1RK1 w kq - 0 10,Bg3,5,-10,-15,1
r2qk2r/1ppbbp2/p1n1pn1p/3p2p1/B2P4/2P1PNB1/PP3PPP/RN1Q1RK1 b kq - 1 10,Ne4,-12,-3,9,1
r2qk2r/1ppbbp2/p1n1p2p/3p2p1/B2Pn3/2P1PNB1/PP3PPP/RN1Q1RK1 w kq - 2 11,Nbd2,8,-31,-39,1
r2qk2r/1ppbbp2/p1n1p2p/3p2p1/B2Pn3/2P1PNB1/PP1N1PPP/R2Q1RK1 b kq - 3 11,f5,-44,148,192,1
r2qk2r/1ppbb3/p1n1p2p/3p1pp1/B2Pn3/2P1PNB1/PP1N1PPP/R2Q1RK1 w kq - 0 12,h3,135,-62,-197,0
r2qk2r/1ppbb3/p1n1p2p/3p1pp1/B2Pn3/2P1PNBP/PP1N1PP1/R2Q1RK1 b kq - 0 12,h5,-68,139,207,1
r2qk2r/1ppbb3/p1n1p3/3p1ppp/B2Pn3/2P1PNBP/PP1N1PP1/R2Q1RK1 w kq - 0 13,Ne5,79,-71,-150,0
r2qk2r/1ppbb3/p1n1p3/3pNppp/B2Pn3/2P1P1BP/PP1N1PP1/R2Q1RK1 b kq - 1 13,g4,-43,159,202,1
r2qk2r/1ppbb3/p1n1p3/3pNp1p/B2Pn1p1/2P1P1BP/PP1N1PP1/R2Q1RK1 w kq - 0 14,Nxc6,162,17,-145,0
r2qk2r/1ppbb3/p1N1p3/3p1p1p/B2Pn1p1/2P1P1BP/PP1N1PP1/R2Q1RK1 b kq - 0 14,Bxc6,39,38,-1,1
r2qk2r/1pp1b3/p1b1p3/3p1p1p/B2Pn1p1/2P1P1BP/PP1N1PP1/R2Q1RK1 w kq - 0 15,Bxc6+,39,18,-21,1
r2qk2r/1pp1b3/p1B1p3/3p1p1p/3Pn1p1/2P1P1BP/PP1N1PP1/R2Q1RK1 b kq - 0 15,bxc6,27,0,-27,1
r2qk2r/2p1b3/p1p1p3/3p1p1p/3Pn1p1/2P1P1BP/PP1N1PP1/R2Q1RK1 w kq - 0 16,Nxe4,0,0,0,1
r2qk2r/2p1b3/p1p1p3/3p1p1p/3PN1p1/2P1P1BP/PP3PP1/R2Q1RK1 b kq - 0 16,dxe4,0,86,86,1
r2qk2r/2p1b3/p1p1p3/5p1p/3Pp1p1/2P1P1BP/PP3PP1/R2Q1RK1 w kq - 0 17,Be5,104,23,-81,1
r2qk2r/2p1b3/p1p1p3/4Bp1p/3Pp1p1/2P1P2P/PP3PP1/R2Q1RK1 b kq - 1 17,Bf6,21,151,130,1
r2qk2r/2p5/p1p1pb2/4Bp1p/3Pp1p1/2P1P2P/PP3PP1/R2Q1RK1 w kq - 2 18,Qa4,173,167,-6,1
r2qk2r/2p5/p1p1pb2/4Bp1p/Q2Pp1p1/2P1P2P/PP3PP1/R4RK1 b kq - 3 18,Bxe5,171,177,6,1
r2qk2r/2p5/p1p1p3/4bp1p/Q2Pp1p1/2P1P2P/PP3PP1/R4RK1 w kq - 0 19,Qxc6+,136,151,15,1
r2qk2r/2p5/p1Q1p3/4bp1p/3Pp1p1/2P1P2P/PP3PP1/R4RK1 b kq - 0 19,Ke7,147,132,-15,1
r2q3r/2p1k3/p1Q1p3/4bp1p/3Pp1p1/2P1P2P/PP3PP1/R4RK1 w - - 1 20,dxe5,143,137,-6,1
r2q3r/2p1k3/p1Q1p3/4Pp1p/4p1p1/2P1P2P/PP3PP1/R4RK1 b - - 0 20,Qd7,180,173,-7,1
r6r/2pqk3/p1Q1p3/4Pp1p/4p1p1/2P1P2P/PP3PP1/R4RK1 w - - 1 21,Qc5+,179,182,3,1
r6r/2pqk3/p3p3/2Q1Pp1p/4p1p1/2P1P2P/PP3PP1/R4RK1 b - - 2 21,Kf7,164,194,30,1
r6r/2pq1k2/p3p3/2Q1Pp1p/4p1p1/2P1P2P/PP3PP1/R4RK1 w - - 3 22,Rfd1,212,197,-15,1
r6r/2pq1k2/p3p3/2Q1Pp1p/4p1p1/2P1P2P/PP3PP1/R2R2K1 b - - 4 22,Qe7,201,176,-25,1
r6r/2p1qk2/p3p3/2Q1Pp1p/4p1p1/2P1P2P/PP3PP1/R2R2K1 w - - 5 23,Qc6,194,200,6,1
r6r/2p1qk2/p1Q1p3/4Pp1p/4p1p1/2P1P2P/PP3PP1/R2R2K1 b - - 6 23,Rad8,178,213,35,1
3r3r/2p1qk2/p1Q1p3/4Pp1p/4p1p1/2P1P2P/PP3PP1/R2R2K1 w - - 7 24,Qxa6,141,-69,-210,0
3r3r/2p1qk2/Q3p3/4Pp1p/4p1p1/2P1P2P/PP3PP1/R2R2K1 b - - 0 24,h4,-47,239,286,1
3r3r/2p1qk2/Q3p3/4Pp2/4p1pp/2P1P2P/PP3PP1/R2R2K1 w - - 0 25,hxg4,224,259,35,1
3r3r/2p1qk2/Q3p3/4Pp2/4p1Pp/2P1P3/PP3PP1/R2R2K1 b - - 0 25,fxg4,260,289,29,1
3r3r/2p1qk2/Q3p3/4P3/4p1pp/2P1P3/PP3PP1/R2R2K1 w - - 0 26,Qe2,284,184,-100,1
3r3r/2p1qk2/4p3/4P3/4p1pp/2P1P3/PP2QPP1/R2R2K1 b - - 1 26,Rhg8,183,270,87,1
3r2r1/2p1qk2/4p3/4P3/4p1pp/2P1P3/PP2QPP1/R2R2K1 w - - 2 27,Rxd8,300,280,-20,1
3R2r1/2p1qk2/4p3/4P3/4p1pp/2P1P3/PP2QPP1/R5K1 b - - 0 27,Qxd8,291,300,9,1
3q2r1/2p2k2/4p3/4P3/4p1pp/2P1P3/PP2QPP1/R5K1 w - - 0 28,Rd1,265,183,-82,1
3q2r1/2p2k2/4p3/4P3/4p1pp/2P1P3/PP2QPP1/3R2K1 b - - 1 28,Qe7,185,387,202,1
6r1/2p1qk2/4p3/4P3/4p1pp/2P1P3/PP2QPP1/3R2K1 w - - 2 29,a4,360,218,-142,0
6r1/2p1qk2/4p3/4P3/P3p1pp/2P1P3/1P2QPP1/3R2K1 b - - 0 29,h3,249,339,90,1
6r1/2p1qk2/4p3/4P3/P3p1p1/2P1P2p/1P2QPP1/3R2K1 w - - 0 30,g3,348,217,-131,0
6r1/2p1qk2/4p3/4P3/P3p1p1/2P1P1Pp/1P2QP2/3R2K1 b - - 0 30,Qg5,230,204,-26,1
6r1/2p2k2/4p3/4P1q1/P3p1p1/2P1P1Pp/1P2QP2/3R2K1 w - - 1 31,Rd7+,216,183,-33,1
6r1/2pR1k2/4p3/4P1q1/P3p1p1/2P1P1Pp/1P2QP2/6K1 b - - 2 31,Kg6,166,179,13,1
6r1/2pR4/4p1k1/4P1q1/P3p1p1/2P1P1Pp/1P2QP2/6K1 w - - 3 32,Rxc7,191,164,-27,1
6r1/2R5/4p1k1/4P1q1/P3p1p1/2P1P1Pp/1P2QP2/6K1 b - - 0 32,Qf5,219,210,-9,1
6r1/2R5/4p1k1/4Pq2/P3p1p1/2P1P1Pp/1P2QP2/6K1 w - - 1 33,f4,121,-410,-531,0
6r1/2R5/4p1k1/4Pq2/P3pPp1/2P1P1Pp/1P2Q3/6K1 b - f3 0 33,gxf3,-385,-440,-55,1
6r1/2R5/4p1k1/4Pq2/P3p3/2P1PpPp/1P2Q3/6K1 w - - 0 34,Qf2,-510,-565,-55,1
6r1/2R5/4p1k1/4Pq2/P3p3/2P1PpPp/1P3Q2/6K1 b - - 1 34,Kh5,-544,12,556,1
6r1/2R5/4p3/4Pq1k/P3p3/2P1PpPp/1P3Q2/6K1 w - - 2 35,Kh2,24,0,-24,1
6r1/2R5/4p3/4Pq1k/P3p3/2P1PpPp/1P3Q1K/8 b - - 3 35,Rg6,3,157,154,1
8/2R5/4p1r1/4Pq1k/P3p3/2P1PpPp/1P3Q1K/8 w - - 4 36,Rh7+,175,149,-26,1
8/7R/4p1r1/4Pq1k/P3p3/2P1PpPp/1P3Q1K/8 b - - 5 36,Rh6,133,168,35,1
8/7R/4p2r/4Pq1k/P3p3/2P1PpPp/1P3Q1K/8 w - - 6 37,Rxh6+,131,13,-118,0
8/8/4p2R/4Pq1k/P3p3/2P1PpPp/1P3Q1K/8 b - - 0 37,Kxh6,118,110,-8,1
8/8/4p2k/4Pq2/P3p3/2P1PpPp/1P3Q1K/8 w - - 0 38,b4,74,6,-68,1
8/8/4p2k/4Pq2/PP2p3/2P1PpPp/5Q1K/8 b - - 0 38,Qxe5,4,0,-4,1
8/8/4p2k/4q3/PP2p3/2P1PpPp/5Q1K/8 w - - 0 39,a5,0,-470,-470,0
8/8/4p2k/P3q3/1P2p3/2P1PpPp/5Q1K/8 b - - 0 39,Kg5,-540,21,561,1
8/8/4p3/P3q1k1/1P2p3/2P1PpPp/5Q1K/8 w - - 1 40,c4,0,0,0,1
8/8/4p3/P3q1k1/1PP1p3/4PpPp/5Q1K/8 b - - 0 40,Kg4,-1,183,184,1
8/8/4p3/P3q3/1PP1p1k1/4PpPp/5Q1K/8 w - - 1 41,b5,58,51,-7,1
8/8/4p3/PP2q3/2P1p1k1/4PpPp/5Q1K/8 b - - 0 41,Qc3,19,0,-19,1
8/8/4p3/PP6/2P1p1k1/2q1PpPp/5Q1K/8 w - - 1 42,b6,0,0,0,1
8/8/1P2p3/P7/2P1p1k1/2q1PpPp/5Q1K/8 b - - 0 42,Qd3,0,297,297,1
8/8/1P2p3/P7/2P1p1k1/3qPpPp/5Q1K/8 w - - 1 43,c5,398,-9995,-10393,0
8/8/1P2p3/P1P5/4p1k1/3qPpPp/5Q1K/8 b - - 0 43,Qe2,-9995,-9996,-1,1
8/8/1P2p3/P1P5/4p1k1/4PpPp/4qQ1K/8 w - - 1 44,Kg1,-9996,-9997,-1,1
8/8/1P2p3/P1P5/4p1k1/4PpPp/4qQ2/6K1 b - - 2 44,Qd1+,-9997,-9995,2,1
8/8/1P2p3/P1P5/4p1k1/4PpPp/5Q2/3q2K1 w - - 3 45,Kh2,-9995,-9995,0,1
8/8/1P2p3/P1P5/4p1k1/4PpPp/5Q1K/3q4 b - - 4 45,Qe2,-9995,-9996,-1,1
8/8/1P2p3/P1P5/4p1k1/4PpPp/4qQ1K/8 w - - 5 46,Kg1,-9996,-9997,-1,1
8/8/1P2p3/P1P5/4p1k1/4PpPp/4qQ2/6K1 b - - 6 46,Qd1+,-9997,-9995,2,1
8/8/1P2p3/P1P5/4p1k1/4PpPp/5Q2/3q2K1 w - - 7 47,Qf1,-9995,-9997,-2,1
8/8/1P2p3/P1P5/4p1k1/4PpPp/8/3q1QK1 b - - 8 47,h2+,-9997,-9998,-1,1
8/8/1P2p3/P1P5/4p1k1/4PpP1/7p/3q1QK1 w - - 0 48,Kf2,-9998,-9998,0,1
8/8/1P2p3/P1P5/4p1k1/4PpP1/5K1p/3q1Q2 b - - 1 48,Qxf1+,-9998,-9997,1,1
8/8/1P2p3/P1P5/4p1k1/4PpP1/5K1p/5q2 w - - 0 49,Kxf1,-9997,-9997,0,1
8/8/1P2p3/P1P5/4p1k1/4PpP1/7p/5K2 b - - 0 49,h1=Q+,-9997,-9998,-1,1
8/8/1P2p3/P1P5/4p1k1/4PpP1/8/5K1q w - - 0 50,Kf2,-9998,-9998,0,1
8/8/1P2p3/P1P5/4p1k1/4PpP1/5K2/7q b - - 1 50,Qg2+,-9998,-9999,-1,1
8/8/1P2p3/P1P5/4p1k1/4PpP1/5Kq1/8 w - - 2 51,Ke1,-9999,-9999,0,1
8/8/1P2p3/P1P5/4p1k1/4PpP1/6q1/4K3 b - - 3 51,f2+,-9999,-9996,3,1
8/8/1P2p3/P1P5/4p1k1/4P1P1/5pq1/4K3 w - - 0 52,Kd2,-9996,-9996,0,1
8/8/1P2p3/P1P5/4p1k1/4P1P1/3K1pq1/8 b - - 1 52,f1=Q+,-9996,-9997,-1,1
8/8/1P2p3/P1P5/4p1k1/4P1P1/3K2q1/5q2 w - - 0 53,Kc3,-9997,-9997,0,1
8/8/1P2p3/P1P5/4p1k1/2K1P1P1/6q1/5q2 b - - 1 53,Qc1+,-9997,-9998,-1,1
8/8/1P2p3/P1P5/4p1k1/2K1P1P1/6q1/2q5 w - - 2 54,Kd4,-9998,-9998,0,1
8/8/1P2p3/P1P5/3Kp1k1/4P1P1/6q1/2q5 b - - 3 54,Qgd2+,-9998,-9994,4,1
8/8/1P2p3/P1P5/3Kp1k1/4P1P1/3q4/2q5 w - - 4 55,Ke5,-9995,-9995,0,1
8/8/1P2p3/P1P1K3/4p1k1/4P1P1/3q4/2q5 b - - 5 55,Qxe3,-9995,-1054,8941,1
8/8/1P2p3/P1P1K3/4p1k1/4q1P1/8/2q5 w - - 0 56,b7,-1299,-9996,-8697,0
8/1P6/4p3/P1P1K3/4p1k1/4q1P1/8/2q5 b - - 0 56,Qcxc5+,-9996,-9997,-1,1
8/1P6/4p3/P1q1K3/4p1k1/4q1P1/8/8 w - - 0 57,Kf6,-9997,-9998,-1,1
8/1P6/4pK2/P1q5/4p1k1/4q1P1/8/8 b - - 1 57,Qb3,-9998,-9997,1,1
8/1P6/4pK2/P1q5/4p1k1/1q4P1/8/8 w - - 2 58,a6,-9997,-9997,0,1
8/1P6/P3pK2/2q5/4p1k1/1q4P1/8/8 b - - 0 58,Qa5,-9997,-9993,4,1
rnbqkbnr/pppppppp/8/8/8/8/PPPPPPPP/RNBQKBNR w KQkq - 0 1,e4,38,30,-8,1
rnbqkbnr/pppppppp/8/8/4P3/8/PPPP1PPP/RNBQKBNR b KQkq - 0 1,e5,27,31,4,1
rnbqkbnr/pppp1ppp/8/4p3/4P3/8/PPPP1PPP/RNBQKBNR w KQkq - 0 2,f4,33,-59,-92,1
rnbqkbnr/pppp1ppp/8/4p3/4PP2/8/PPPP2PP/RNBQKBNR b KQkq - 0 2,d6,-55,-1,54,1
rnbqkbnr/ppp2ppp/3p4/4p3/4PP2/8/PPPP2PP/RNBQKBNR w KQkq - 0 3,Nf3,-11,-39,-28,1
rnbqkbnr/ppp2ppp/3p4/4p3/4PP2/5N2/PPPP2PP/RNBQKB1R b KQkq - 1 3,f6,-36,147,183,1
rnbqkbnr/ppp3pp/3p1p2/4p3/4PP2/5N2/PPPP2PP/RNBQKB1R w KQkq - 0 4,d3,133,57,-76,1
rnbqkbnr/ppp3pp/3p1p2/4p3/4PP2/3P1N2/PPP3PP/RNBQKB1R b KQkq - 0 4,Nc6,55,55,0,1
r1bqkbnr/ppp3pp/2np1p2/4p3/4PP2/3P1N2/PPP3PP/RNBQKB1R w KQkq - 1 5,Nc3,61,52,-9,1
r1bqkbnr/ppp3pp/2np1p2/4p3/4PP2/2NP1N2/PPP3PP/R1BQKB1R b KQkq - 2 5,Be6,64,157,93,1
r2qkbnr/ppp3pp/2npbp2/4p3/4PP2/2NP1N2/PPP3PP/R1BQKB1R w KQkq - 3 6,f5,145,93,-52,1
r2qkbnr/ppp3pp/2npbp2/4pP2/4P3/2NP1N2/PPP3PP/R1BQKB1R b KQkq - 0 6,Bf7,105,115,10,1
r2qkbnr/ppp2bpp/2np1p2/4pP2/4P3/2NP1N2/PPP3PP/R1BQKB1R w KQkq - 1 7,g4,127,-42,-169,0
r2qkbnr/ppp2bpp/2np1p2/4pP2/4P1P1/2NP1N2/PPP4P/R1BQKB1R b KQkq - 0 7,Nge7,-24,30,54,1
r2qkb1r/ppp1nbpp/2np1p2/4pP2/4P1P1/2NP1N2/PPP4P/R1BQKB1R w KQkq - 1 8,h4,29,-53,-82,1
r2qkb1r/ppp1nbpp/2np1p2/4pP2/4P1PP/2NP1N2/PPP5/R1BQKB1R b KQkq - 0 8,d5,-59,-78,-19,1
r2qkb1r/ppp1nbpp/2n2p2/3ppP2/4P1PP/2NP1N2/PPP5/R1BQKB1R w KQkq - 0 9,Bd2,-60,-93,-33,1
r2qkb1r/ppp1nbpp/2n2p2/3ppP2/4P1PP/2NP1N2/PPPB4/R2QKB1R b KQkq - 1 9,d4,-94,19,113,1
r2qkb1r/ppp1nbpp/2n2p2/4pP2/3pP1PP/2NP1N2/PPPB4/R2QKB1R w KQkq - 0 10,Ne2,12,6,-6,1
r2qkb1r/ppp1nbpp/2n2p2/4pP2/3pP1PP/3P1N2/PPPBN3/R2QKB1R b KQkq - 1 10,Qd7,-13,46,59,1
r3kb1r/pppqnbpp/2n2p2/4pP2/3pP1PP/3P1N2/PPPBN3/R2QKB1R w KQkq - 2 11,c3,69,-92,-161,0
r3kb1r/pppqnbpp/2n2p2/4pP2/3pP1PP/2PP1N2/PP1BN3/R2QKB1R b KQkq - 0 11,dxc3,-102,-117,-15,1
r3kb1r/pppqnbpp/2n2p2/4pP2/4P1PP/2pP1N2/PP1BN3/R2QKB1R w KQkq - 0 12,Bxc3,-118,-87,31,1
r3kb1r/pppqnbpp/2n2p2/4pP2/4P1PP/2BP1N2/PP2N3/R2QKB1R b KQkq - 0 12,O-O-O,-126,-116,10,1
2kr1b1r/pppqnbpp/2n2p2/4pP2/4P1PP/2BP1N2/PP2N3/R2QKB1R w KQ - 1 13,h5,-118,-154,-36,1
2kr1b1r/pppqnbpp/2n2p2/4pP1P/4P1P1/2BP1N2/PP2N3/R2QKB1R b KQ - 0 13,Kb8,-152,-152,0,1
1k1r1b1r/pppqnbpp/2n2p2/4pP1P/4P1P1/2BP1N2/PP2N3/R2QKB1R w KQ - 1 14,Nc1,-140,-173,-33,1
1k1r1b1r/pppqnbpp/2n2p2/4pP1P/4P1P1/2BP1N2/PP6/R1NQKB1R b KQ - 2 14,Nc8,-180,-178,2,1
1knr1b1r/pppq1bpp/2n2p2/4pP1P/4P1P1/2BP1N2/PP6/R1NQKB1R w KQ - 3 15,h6,-177,-258,-81,1
1knr1b1r/pppq1bpp/2n2p1P/4pP2/4P1P1/2BP1N2/PP6/R1NQKB1R b KQ - 0 15,g6,-261,-238,23,1
1knr1b1r/pppq1b1p/2n2ppP/4pP2/4P1P1/2BP1N2/PP6/R1NQKB1R w KQ - 0 16,g5,-234,-357,-123,0
1knr1b1r/pppq1b1p/2n2ppP/4pPP1/4P3/2BP1N2/PP6/R1NQKB1R b KQ - 0 16,fxg5,-325,-229,96,1
1knr1b1r/pppq1b1p/2n3pP/4pPp1/4P3/2BP1N2/PP6/R1NQKB1R w KQ - 0 17,fxg6,-215,-272,-57,1
1knr1b1r/pppq1b1p/2n3PP/4p1p1/4P3/2BP1N2/PP6/R1NQKB1R b KQ - 0 17,Bxg6,-295,-297,-2,1
1knr1b1r/pppq3p/2n3bP/4p1p1/4P3/2BP1N2/PP6/R1NQKB1R w KQ - 0 18,Nxg5,-290,-300,-10,1
1knr1b1r/pppq3p/2n3bP/4p1N1/4P3/2BP4/PP6/R1NQKB1R b KQ - 0 18,Nb4,-288,-221,67,1
1knr1b1r/pppq3p/6bP/4p1N1/1n2P3/2BP4/PP6/R1NQKB1R w KQ - 1 19,Qf3,-204,-363,-159,0
1knr1b1r/pppq3p/6bP/4p1N1/1n2P3/2BP1Q2/PP6/R1N1KB1R b KQ - 2 19,Nc2+,-364,-359,5,1
1knr1b1r/pppq3p/6bP/4p1N1/4P3/2BP1Q2/PPn5/R1N1KB1R w KQ - 3 20,Kd2,-344,-399,-55,1
1knr1b1r/pppq3p/6bP/4p1N1/4P3/2BP1Q2/PPnK4/R1N2B1R b - - 4 20,Nxa1,-415,-375,40,1
1knr1b1r/pppq3p/6bP/4p1N1/4P3/2BP1Q2/PP1K4/n1N2B1R w - - 0 21,Bh3,-394,-426,-32,1
1knr1b1r/pppq3p/6bP/4p1N1/4P3/2BP1Q1B/PP1K4/n1N4R b - - 1 21,Qa4,-421,-465,-44,1
1knr1b1r/ppp4p/6bP/4p1N1/q3P3/2BP1Q1B/PP1K4/n1N4R w - - 2 22,Ne6,-423,-526,-103,0
1knr1b1r/ppp4p/4N1bP/4p3/q3P3/2BP1Q1B/PP1K4/n1N4R b - - 3 22,Rd6,-552,-390,162,1
1kn2b1r/ppp4p/3rN1bP/4p3/q3P3/2BP1Q1B/PP1K4/n1N4R w - - 4 23,Nc5,-427,-530,-103,0
1kn2b1r/ppp4p/3r2bP/2N1p3/q3P3/2BP1Q1B/PP1K4/n1N4R b - - 5 23,Qc2+,-603,-612,-9,1
1kn2b1r/ppp4p/3r2bP/2N1p3/4P3/2BP1Q1B/PPqK4/n1N4R w - - 6 24,Ke3,-600,-9994,-9394,0
1kn2b1r/ppp4p/3r2bP/2N1p3/4P3/2BPKQ1B/PPq5/n1N4R b - - 7 24,Bxh6+,-9994,-9995,-1,1
rnbqkbnr/pppppppp/8/8/8/8/PPPPPPPP/RNBQKBNR w KQkq - 0 1,e4,28,22,-6,1
rnbqkbnr/pppppppp/8/8/4P3/8/PPPP1PPP/RNBQKBNR b KQkq - 0 1,c5,11,12,1,1
rnbqkbnr/pp1ppppp/8/2p5/4P3/8/PPPP1PPP/RNBQKBNR w KQkq - 0 2,Nf3,27,10,-17,1
rnbqkbnr/pp1ppppp/8/2p5/4P3/5N2/PPPP1PPP/RNBQKB1R b KQkq - 1 2,Nc6,10,31,21,1
r1bqkbnr/pp1ppppp/2n5/2p5/4P3/5N2/PPPP1PPP/RNBQKB1R w KQkq - 2 3,Bc4,31,-9,-40,1
r1bqkbnr/pp1ppppp/2n5/2p5/2B1P3/5N2/PPPP1PPP/RNBQK2R b KQkq - 3 3,g6,-5,50,55,1
r1bqkbnr/pp1ppp1p/2n3p1/2p5/2B1P3/5N2/PPPP1PPP/RNBQK2R w KQkq - 0 4,O-O,44,31,-13,1
r1bqkbnr/pp1ppp1p/2n3p1/2p5/2B1P3/5N2/PPPP1PPP/RNBQ1RK1 b kq - 1 4,Bg7,24,55,31,1
r1bqk1nr/pp1pppbp/2n3p1/2p5/2B1P3/5N2/PPPP1PPP/RNBQ1RK1 w kq - 2 5,c3,30,49,19,1
r1bqk1nr/pp1pppbp/2n3p1/2p5/2B1P3/2P2N2/PP1P1PPP/RNBQ1RK1 b kq - 0 5,d6,39,48,9,1
r1bqk1nr/pp2ppbp/2np2p1/2p5/2B1P3/2P2N2/PP1P1PPP/RNBQ1RK1 w kq - 0 6,d4,58,52,-6,1
r1bqk1nr/pp2ppbp/2np2p1/2p5/2BPP3/2P2N2/PP3PPP/RNBQ1RK1 b kq - 0 6,cxd4,51,79,28,1
r1bqk1nr/pp2ppbp/2np2p1/8/2BpP3/2P2N2/PP3PPP/RNBQ1RK1 w kq - 0 7,cxd4,80,67,-13,1
r1bqk1nr/pp2ppbp/2np2p1/8/2BPP3/5N2/PP3PPP/RNBQ1RK1 b kq - 0 7,Nf6,40,69,29,1
r1bqk2r/pp2ppbp/2np1np1/8/2BPP3/5N2/PP3PPP/RNBQ1RK1 w kq - 1 8,d5,68,51,-17,1
r1bqk2r/pp2ppbp/2np1np1/3P4/2B1P3/5N2/PP3PPP/RNBQ1RK1 b kq - 0 8,Ne5,49,66,17,1
r1bqk2r/pp2ppbp/3p1np1/3Pn3/2B1P3/5N2/PP3PPP/RNBQ1RK1 w kq - 1 9,Nxe5,86,86,0,1
r1bqk2r/pp2ppbp/3p1np1/3PN3/2B1P3/8/PP3PPP/RNBQ1RK1 b kq - 0 9,dxe5,80,91,11,1
r1bqk2r/pp2ppbp/5np1/3Pp3/2B1P3/8/PP3PPP/RNBQ1RK1 w kq - 0 10,d6,76,-22,-98,1
r1bqk2r/pp2ppbp/3P1np1/4p3/2B1P3/8/PP3PPP/RNBQ1RK1 b kq - 0 10,exd6,-15,54,69,1
r1bqk2r/pp3pbp/3p1np1/4p3/2B1P3/8/PP3PPP/RNBQ1RK1 w kq - 0 11,Bb5+,22,-34,-56,1
r1bqk2r/pp3pbp/3p1np1/1B2p3/4P3/8/PP3PPP/RNBQ1RK1 b kq - 1 11,Bd7,-24,-8,16,1
r2qk2r/pp1b1pbp/3p1np1/1B2p3/4P3/8/PP3PPP/RNBQ1RK1 w kq - 2 12,Qxd6,-12,-35,-23,1
r2qk2r/pp1b1pbp/3Q1np1/1B2p3/4P3/8/PP3PPP/RNB2RK1 b kq - 0 12,Qe7,-45,44,89,1
r3k2r/pp1bqpbp/3Q1np1/1B2p3/4P3/8/PP3PPP/RNB2RK1 w kq - 1 13,Bxd7+,56,40,-16,1
r3k2r/pp1Bqpbp/3Q1np1/4p3/4P3/8/PP3PPP/RNB2RK1 b kq - 0 13,Qxd7,31,141,110,1
r3k2r/pp1q1pbp/3Q1np1/4p3/4P3/8/PP3PPP/RNB2RK1 w kq - 0 14,Qxe5+,128,116,-12,1
r3k2r/pp1q1pbp/5np1/4Q3/4P3/8/PP3PPP/RNB2RK1 b kq - 0 14,Qe7,127,151,24,1
r3k2r/pp2qpbp/5np1/4Q3/4P3/8/PP3PPP/RNB2RK1 w kq - 1 15,Qb5+,162,123,-39,1
r3k2r/pp2qpbp/5np1/1Q6/4P3/8/PP3PPP/RNB2RK1 b kq - 2 15,Qd7,124,119,-5,1
r3k2r/pp1q1pbp/5np1/1Q6/4P3/8/PP3PPP/RNB2RK1 w kq - 3 16,Qxd7+,125,86,-39,1
r3k2r/pp1Q1pbp/5np1/8/4P3/8/PP3PPP/RNB2RK1 b kq - 0 16,Kxd7,82,164,82,1
r6r/pp1k1pbp/5np1/8/4P3/8/PP3PPP/RNB2RK1 w - - 0 17,Nc3,160,159,-1,1
r6r/pp1k1pbp/5np1/8/4P3/2N5/PP3PPP/R1B2RK1 b - - 1 17,Ke7,141,250,109,1
r6r/pp2kpbp/5np1/8/4P3/2N5/PP3PPP/R1B2RK1 w - - 2 18,Bg5,254,296,42,1
r6r/pp2kpbp/5np1/6B1/4P3/2N5/PP3PPP/R4RK1 b - - 3 18,Ke6,283,268,-15,1
rnbqkbnr/pppppppp/8/8/8/8/PPPPPPPP/RNBQKBNR w KQkq - 0 1,c3,26,-14,-40,1
rnbqkbnr/pppppppp/8/8/8/2P5/PP1PPPPP/RNBQKBNR b KQkq - 0 1,Nf6,-13,8,21,1
rnbqkb1r/pppppppp/5n2/8/8/2P5/PP1PPPPP/RNBQKBNR w KQkq - 1 2,d4,14,8,-6,1
rnbqkb1r/pppppppp/5n2/8/3P4/2P5/PP2PPPP/RNBQKBNR b KQkq - 0 2,d5,10,11,1,1
rnbqkb1r/ppp1pppp/5n2/3p4/3P4/2P5/PP2PPPP/RNBQKBNR w KQkq - 0 3,Bf4,1,-7,-8,1
rnbqkb1r/ppp1pppp/5n2/3p4/3P1B2/2P5/PP2PPPP/RN1QKBNR b KQkq - 1 3,e6,-5,13,18,1
rnbqkb1r/ppp2ppp/4pn2/3p4/3P1B2/2P5/PP2PPPP/RN1QKBNR w KQkq - 0 4,e3,21,18,-3,1
rnbqkb1r/ppp2ppp/4pn2/3p4/3P1B2/2P1P3/PP3PPP/RN1QKBNR b KQkq - 0 4,c5,12,14,2,1
rnbqkb1r/pp3ppp/4pn2/2pp4/3P1B2/2P1P3/PP3PPP/RN1QKBNR w KQkq - 0 5,dxc5,15,-41,-56,1
rnbqkb1r/pp3ppp/4pn2/2Pp4/5B2/2P1P3/PP3PPP/RN1QKBNR b KQkq - 0 5,Nc6,-43,26,69,1
r1bqkb1r/pp3ppp/2n1pn2/2Pp4/5B2/2P1P3/PP3PPP/RN1QKBNR w KQkq - 1 6,Bb5,24,-50,-74,1
r1bqkb1r/pp3ppp/2n1pn2/1BPp4/5B2/2P1P3/PP3PPP/RN1QK1NR b KQkq - 2 6,Bd7,-52,57,109,1
r2qkb1r/pp1b1ppp/2n1pn2/1BPp4/5B2/2P1P3/PP3PPP/RN1QK1NR w KQkq - 3 7,Nf3,43,-30,-73,1
r2qkb1r/pp1b1ppp/2n1pn2/1BPp4/5B2/2P1PN2/PP3PPP/RN1QK2R b KQkq - 4 7,Bxc5,-34,-28,6,1
r2qk2r/pp1b1ppp/2n1pn2/1Bbp4/5B2/2P1PN2/PP3PPP/RN1QK2R w KQkq - 0 8,Nd4,-34,-90,-56,1
r2qk2r/pp1b1ppp/2n1pn2/1Bbp4/3N1B2/2P1P3/PP3PPP/RN1QK2R b KQkq - 1 8,O-O,-76,-54,22,1
r2q1rk1/pp1b1ppp/2n1pn2/1Bbp4/3N1B2/2P1P3/PP3PPP/RN1QK2R w KQ - 2 9,Bxc6,-49,-90,-41,1
r2q1rk1/pp1b1ppp/2B1pn2/2bp4/3N1B2/2P1P3/PP3PPP/RN1QK2R b KQ - 0 9,bxc6,-91,-108,-17,1
r2q1rk1/p2b1ppp/2p1pn2/2bp4/3N1B2/2P1P3/PP3PPP/RN1QK2R w KQ - 0 10,Nd2,-94,-102,-8,1
r2q1rk1/p2b1ppp/2p1pn2/2bp4/3N1B2/2P1P3/PP1N1PPP/R2QK2R b KQ - 1 10,Re8,-107,-77,30,1
r2qr1k1/p2b1ppp/2p1pn2/2bp4/3N1B2/2P1P3/PP1N1PPP/R2QK2R w KQ - 2 11,N2f3,-75,-133,-58,1
r2qr1k1/p2b1ppp/2p1pn2/2bp4/3N1B2/2P1PN2/PP3PPP/R2QK2R b KQ - 3 11,Nh5,-133,-111,22,1
r2qr1k1/p2b1ppp/2p1p3/2bp3n/3N1B2/2P1PN2/PP3PPP/R2QK2R w KQ - 4 12,Ne2,-130,-168,-38,1
r2qr1k1/p2b1ppp/2p1p3/2bp3n/5B2/2P1PN2/PP2NPPP/R2QK2R b KQ - 5 12,Nxf4,-159,-181,-22,1
r2qr1k1/p2b1ppp/2p1p3/2bp4/5n2/2P1PN2/PP2NPPP/R2QK2R w KQ - 0 13,Nxf4,-183,-230,-47,1
r2qr1k1/p2b1ppp/2p1p3/2bp4/5N2/2P1PN2/PP3PPP/R2QK2R b KQ - 0 13,e5,-219,-229,-10,1
r2qr1k1/p2b1ppp/2p5/2bpp3/5N2/2P1PN2/PP3PPP/R2QK2R w KQ - 0 14,Nd3,-202,-331,-129,0
r2qr1k1/p2b1ppp/2p5/2bpp3/8/2PNPN2/PP3PPP/R2QK2R b KQ - 1 14,Bd6,-295,-296,-1,1
r2qr1k1/p2b1ppp/2pb4/3pp3/8/2PNPN2/PP3PPP/R2QK2R w KQ - 2 15,Nd2,-297,-302,-5,1
r2qr1k1/p2b1ppp/2pb4/3pp3/8/2PNP3/PP1N1PPP/R2QK2R b KQ - 3 15,e4,-318,-316,2,1
r2qr1k1/p2b1ppp/2pb4/3p4/4p3/2PNP3/PP1N1PPP/R2QK2R w KQ - 0 16,Nc1,-304,-302,2,1
r2qr1k1/p2b1ppp/2pb4/3p4/4p3/2P1P3/PP1N1PPP/R1NQK2R b KQ - 1 16,f5,-309,-191,118,1
r2qr1k1/p2b2pp/2pb4/3p1p2/4p3/2P1P3/PP1N1PPP/R1NQK2R w KQ - 0 17,Ne2,-203,-211,-8,1
r2qr1k1/p2b2pp/2pb4/3p1p2/4p3/2P1P3/PP1NNPPP/R2QK2R b KQ - 1 17,Rf8,-208,-129,79,1
r2q1rk1/p2b2pp/2pb4/3p1p2/4p3/2P1P3/PP1NNPPP/R2QK2R w KQ - 2 18,Nb3,-151,-218,-67,1
r2q1rk1/p2b2pp/2pb4/3p1p2/4p3/1NP1P3/PP2NPPP/R2QK2R b KQ - 3 18,a5,-239,-207,32,1
r2q1rk1/3b2pp/2pb4/p2p1p2/4p3/1NP1P3/PP2NPPP/R2QK2R w KQ - 0 19,Nf4,-193,-256,-63,1
r2q1rk1/3b2pp/2pb4/p2p1p2/4pN2/1NP1P3/PP3PPP/R2QK2R b KQ - 1 19,g5,-248,-319,-71,1
r2q1rk1/3b3p/2pb4/p2p1pp1/4pN2/1NP1P3/PP3PPP/R2QK2R w KQ - 0 20,Nxd5,-309,-391,-82,1
r2q1rk1/3b3p/2pb4/p2N1pp1/4p3/1NP1P3/PP3PPP/R2QK2R b KQ - 0 20,Be6,-127,-18,109,1
r2q1rk1/7p/2pbb3/p2N1pp1/4p3/1NP1P3/PP3PPP/R2QK2R w KQ - 1 21,c4,0,-432,-432,0
r2q1rk1/7p/2pbb3/p2N1pp1/2P1p3/1N2P3/PP3PPP/R2QK2R b KQ - 0 21,cxd5,-474,-446,28,1
r2q1rk1/7p/3bb3/p2p1pp1/2P1p3/1N2P3/PP3PPP/R2QK2R w KQ - 0 22,cxd5,-435,-472,-37,1
r2q1rk1/7p/3bb3/p2P1pp1/4p3/1N2P3/PP3PPP/R2QK2R b KQ - 0 22,Bd7,-546,-426,120,1
r2q1rk1/3b3p/3b4/p2P1pp1/4p3/1N2P3/PP3PPP/R2QK2R w KQ - 1 23,O-O,-435,-419,16,1
r2q1rk1/3b3p/3b4/p2P1pp1/4p3/1N2P3/PP3PPP/R2Q1RK1 b - - 2 23,f4,-414,-389,25,1
r2q1rk1/3b3p/3b4/p2P2p1/4pp2/1N2P3/PP3PPP/R2Q1RK1 w - - 0 24,Qh5,-392,-435,-43,1
r2q1rk1/3b3p/3b4/p2P2pQ/4pp2/1N2P3/PP3PPP/R4RK1 b - - 1 24,f3,-427,-406,21,1
r2q1rk1/3b3p/3b4/p2P2pQ/4p3/1N2Pp2/PP3PPP/R4RK1 w - - 0 25,gxf3,-385,-545,-160,0
r2q1rk1/3b3p/3b4/p2P2pQ/4p3/1N2PP2/PP3P1P/R4RK1 b - - 0 25,Rxf3,-473,-473,0,1
r2q2k1/3b3p/3b4/p2P2pQ/4p3/1N2Pr2/PP3P1P/R4RK1 w - - 0 26,Nd2,-474,-573,-99,1
r2q2k1/3b3p/3b4/p2P2pQ/4p3/4Pr2/PP1N1P1P/R4RK1 b - - 1 26,Rh3,-590,-553,37,1
r2q2k1/3b3p/3b4/p2P2pQ/4p3/4P2r/PP1N1P1P/R4RK1 w - - 2 27,Qe2,-582,-553,29,1
r2q2k1/3b3p/3b4/p2P2p1/4p3/4P2r/PP1NQP1P/R4RK1 b - - 3 27,Bxh2+,-565,-559,6,1
r2q2k1/3b3p/8/p2P2p1/4p3/4P2r/PP1NQP1b/R4RK1 w - - 0 28,Kg2,-535,-541,-6,1
r2q2k1/3b3p/8/p2P2p1/4p3/4P2r/PP1NQPKb/R4R2 b - - 1 28,Bd6,-553,-409,144,1
r2q2k1/3b3p/3b4/p2P2p1/4p3/4P2r/PP1NQPK1/R4R2 w - - 2 29,Nxe4,-333,-506,-173,0
r2q2k1/3b3p/3b4/p2P2p1/4N3/4P2r/PP2QPK1/R4R2 b - - 0 29,Rh2+,-521,-497,24,1
r2q2k1/3b3p/3b4/p2P2p1/4N3/4P3/PP2QPKr/R4R2 w - - 1 30,Kg1,-523,-525,-2,1
r2q2k1/3b3p/3b4/p2P2p1/4N3/4P3/PP2QP1r/R4RK1 b - - 2 30,Be5,-499,-402,97,1
r2q2k1/3b3p/8/p2Pb1p1/4N3/4P3/PP2QP1r/R4RK1 w - - 3 31,Qe1,-353,-547,-194,0
r2q2k1/3b3p/8/p2Pb1p1/4N3/4P3/PP3P1r/R3QRK1 b - - 4 31,Bh3,-560,-340,220,1
r2q2k1/7p/8/p2Pb1p1/4N3/4P2b/PP3P1r/R3QRK1 w - - 5 32,f4,-430,-462,-32,1
r2q2k1/7p/8/p2Pb1p1/4NP2/4P2b/PP5r/R3QRK1 b - - 0 32,Rg2+,-503,-521,-18,1
r2q2k1/7p/8/p2Pb1p1/4NP2/4P2b/PP4r1/R3QRK1 w - - 1 33,Kh1,-528,-547,-19,1
r2q2k1/7p/8/p2Pb1p1/4NP2/4P2b/PP4r1/R3QR1K b - - 2 33,gxf4,-538,-420,118,1
r2q2k1/7p/8/p2Pb3/4Np2/4P2b/PP4r1/R3QR1K w - - 0 34,exf4,-385,-399,-14,1
r2q2k1/7p/8/p2Pb3/4NP2/7b/PP4r1/R3QR1K b - - 0 34,Bd4,-430,-304,126,1
r2q2k1/7p/8/p2P4/3bNP2/7b/PP4r1/R3QR1K w - - 1 35,Qh4,-263,-946,-683,0
r2q2k1/7p/8/p2P4/3bNP1Q/7b/PP4r1/R4R1K b - - 2 35,Qxh4,-1052,-9993,-8941,0
r5k1/7p/8/p2P4/3bNP1q/7b/PP4r1/R4R1K w - - 0 36,Ng5,-9993,-9997,-4,1
r5k1/7p/8/p2P2N1/3b1P1q/7b/PP4r1/R4R1K b - - 1 36,Bg4+,-9997,-809,9188,1
r5k1/7p/8/p2P2N1/3b1Pbq/8/PP4r1/R4R1K w - - 2 37,Kxg2,-829,-824,5,1
r5k1/7p/8/p2P2N1/3b1Pbq/8/PP4K1/R4R2 b - - 0 37,Qh5,-924,-590,334,1
rnbqkbnr/pppppppp/8/8/8/8/PPPPPPPP/RNBQKBNR w KQkq - 0 1,e4,32,33,1,1
rnbqkbnr/pppppppp/8/8/4P3/8/PPPP1PPP/RNBQKBNR b KQkq - 0 1,e5,26,30,4,1
rnbqkbnr/pppp1ppp/8/4p3/4P3/8/PPPP1PPP/RNBQKBNR w KQkq - 0 2,Nf3,26,36,10,1
rnbqkbnr/pppp1ppp/8/4p3/4P3/5N2/PPPP1PPP/RNBQKB1R b KQkq - 1 2,Nc6,27,27,0,1
r1bqkbnr/pppp1ppp/2n5/4p3/4P3/5N2/PPPP1PPP/RNBQKB1R w KQkq - 2 3,d4,45,14,-31,1
r1bqkbnr/pppp1ppp/2n5/4p3/3PP3/5N2/PPP2PPP/RNBQKB1R b KQkq - 0 3,d6,23,91,68,1
r1bqkbnr/ppp2ppp/2np4/4p3/3PP3/5N2/PPP2PPP/RNBQKB1R w KQkq - 0 4,dxe5,85,50,-35,1
r1bqkbnr/ppp2ppp/2np4/4P3/4P3/5N2/PPP2PPP/RNBQKB1R b KQkq - 0 4,dxe5,31,37,6,1
r1bqkbnr/ppp2ppp/2n5/4p3/4P3/5N2/PPP2PPP/RNBQKB1R w KQkq - 0 5,Qxd8+,34,32,-2,1
r1bQkbnr/ppp2ppp/2n5/4p3/4P3/5N2/PPP2PPP/RNB1KB1R b KQkq - 0 5,Kxd8,40,56,16,1
r1bk1bnr/ppp2ppp/2n5/4p3/4P3/5N2/PPP2PPP/RNB1KB1R w KQ - 0 6,Bc4,57,24,-33,1
r1bk1bnr/ppp2ppp/2n5/4p3/2B1P3/5N2/PPP2PPP/RNB1K2R b KQ - 1 6,Be6,23,98,75,1
r2k1bnr/ppp2ppp/2n1b3/4p3/2B1P3/5N2/PPP2PPP/RNB1K2R w KQ - 2 7,Bxe6,120,125,5,1
r2k1bnr/ppp2ppp/2n1B3/4p3/4P3/5N2/PPP2PPP/RNB1K2R b KQ - 0 7,fxe6,114,125,11,1
r2k1bnr/ppp3pp/2n1p3/4p3/4P3/5N2/PPP2PPP/RNB1K2R w KQ - 0 8,Be3,121,98,-23,1
r2k1bnr/ppp3pp/2n1p3/4p3/4P3/4BN2/PPP2PPP/RN2K2R b KQ - 1 8,Bd6,88,96,8,1
r2k2nr/ppp3pp/2nbp3/4p3/4P3/4BN2/PPP2PPP/RN2K2R w KQ - 2 9,Nc3,101,50,-51,1
r2k2nr/ppp3pp/2nbp3/4p3/4P3/2N1BN2/PPP2PPP/R3K2R b KQ - 3 9,Nf6,34,35,1,1
r2k3r/ppp3pp/2nbpn2/4p3/4P3/2N1BN2/PPP2PPP/R3K2R w KQ - 4 10,O-O-O,28,23,-5,1
r2k3r/ppp3pp/2nbpn2/4p3/4P3/2N1BN2/PPP2PPP/2KR3R b - - 5 10,Ke7,23,28,5,1
r6r/ppp1k1pp/2nbpn2/4p3/4P3/2N1BN2/PPP2PPP/2KR3R w - - 6 11,a3,32,25,-7,1
r6r/ppp1k1pp/2nbpn2/4p3/4P3/P1N1BN2/1PP2PPP/2KR3R b - - 0 11,Rhd8,21,36,15,1
r2r4/ppp1k1pp/2nbpn2/4p3/4P3/P1N1BN2/1PP2PPP/2KR3R w - - 1 12,Bg5,35,-20,-55,1
r2r4/ppp1k1pp/2nbpn2/4p1B1/4P3/P1N2N2/1PP2PPP/2KR3R b - - 2 12,h6,-19,-21,-2,1
r2r4/ppp1k1p1/2nbpn1p/4p1B1/4P3/P1N2N2/1PP2PPP/2KR3R w - - 0 13,Bxf6+,-19,-48,-29,1
r2r4/ppp1k1p1/2nbpB1p/4p3/4P3/P1N2N2/1PP2PPP/2KR3R b - - 0 13,gxf6,-46,-54,-8,1
r2r4/ppp1k3/2nbpp1p/4p3/4P3/P1N2N2/1PP2PPP/2KR3R w - - 0 14,Rd2,-53,-52,1,1
r2r4/ppp1k3/2nbpp1p/4p3/4P3/P1N2N2/1PPR1PPP/2K4R b - - 1 14,Nd4,-54,-61,-7,1
r2r4/ppp1k3/3bpp1p/4p3/3nP3/P1N2N2/1PPR1PPP/2K4R w - - 2 15,Nxd4,-37,-36,1,1
r2r4/ppp1k3/3bpp1p/4p3/3NP3/P1N5/1PPR1PPP/2K4R b - - 0 15,exd4,-57,-60,-3,1
r2r4/ppp1k3/3bpp1p/8/3pP3/P1N5/1PPR1PPP/2K4R w - - 0 16,Rxd4,-46,-428,-382,0
r2r4/ppp1k3/3bpp1p/8/3RP3/P1N5/1PP2PPP/2K4R b - - 0 16,Bf4+,-478,-507,-29,1
r2r4/ppp1k3/4pp1p/8/3RPb2/P1N5/1PP2PPP/2K4R w - - 1 17,Kb1,-540,-517,23,1
r2r4/ppp1k3/4pp1p/8/3RPb2/P1N5/1PP2PPP/1K5R b - - 2 17,Rxd4,-507,-528,-21,1
r7/ppp1k3/4pp1p/8/3rPb2/P1N5/1PP2PPP/1K5R w - - 0 18,Rd1,-538,-602,-64,1
r7/ppp1k3/4pp1p/8/3rPb2/P1N5/1PP2PPP/1K1R4 b - - 1 18,Rxd1+,-587,-608,-21,1
rnbqkbnr/pppppppp/8/8/8/8/PPPPPPPP/RNBQKBNR w KQkq - 0 1,d4,27,13,-14,1
rnbqkbnr/pppppppp/8/8/3P4/8/PPP1PPPP/RNBQKBNR b KQkq - 0 1,Nf6,12,29,17,1
rnbqkb1r/pppppppp/5n2/8/3P4/8/PPP1PPPP/RNBQKBNR w KQkq - 1 2,c4,16,15,-1,1
rnbqkb1r/pppppppp/5n2/8/2PP4/8/PP2PPPP/RNBQKBNR b KQkq - 0 2,e6,16,16,0,1
rnbqkb1r/pppp1ppp/4pn2/8/2PP4/8/PP2PPPP/RNBQKBNR w KQkq - 0 3,Nc3,18,13,-5,1
rnbqkb1r/pppp1ppp/4pn2/8/2PP4/2N5/PP2PPPP/R1BQKBNR b KQkq - 1 3,d5,20,29,9,1
rnbqkb1r/ppp2ppp/4pn2/3p4/2PP4/2N5/PP2PPPP/R1BQKBNR w KQkq - 0 4,Bg5,25,18,-7,1
rnbqkb1r/ppp2ppp/4pn2/3p2B1/2PP4/2N5/PP2PPPP/R2QKBNR b KQkq - 1 4,Be7,18,33,15,1
rnbqk2r/ppp1bppp/4pn2/3p2B1/2PP4/2N5/PP2PPPP/R2QKBNR w KQkq - 2 5,cxd5,26,7,-19,1
rnbqk2r/ppp1bppp/4pn2/3P2B1/3P4/2N5/PP2PPPP/R2QKBNR b KQkq - 0 5,exd5,8,34,26,1
rnbqk2r/ppp1bppp/5n2/3p2B1/3P4/2N5/PP2PPPP/R2QKBNR w KQkq - 0 6,e3,24,22,-2,1
rnbqk2r/ppp1bppp/5n2/3p2B1/3P4/2N1P3/PP3PPP/R2QKBNR b KQkq - 0 6,c6,24,32,8,1
rnbqk2r/pp2bppp/2p2n2/3p2B1/3P4/2N1P3/PP3PPP/R2QKBNR w KQkq - 0 7,Bd3,34,36,2,1
rnbqk2r/pp2bppp/2p2n2/3p2B1/3P4/2NBP3/PP3PPP/R2QK1NR b KQkq - 1 7,O-O,29,34,5,1
rnbq1rk1/pp2bppp/2p2n2/3p2B1/3P4/2NBP3/PP3PPP/R2QK1NR w KQ - 2 8,Nge2,35,18,-17,1
rnbq1rk1/pp2bppp/2p2n2/3p2B1/3P4/2NBP3/PP2NPPP/R2QK2R b KQ - 3 8,Re8,18,24,6,1
rnbqr1k1/pp2bppp/2p2n2/3p2B1/3P4/2NBP3/PP2NPPP/R2QK2R w KQ - 4 9,O-O,22,13,-9,1
rnbqr1k1/pp2bppp/2p2n2/3p2B1/3P4/2NBP3/PP2NPPP/R2Q1RK1 b - - 5 9,Ne4,28,60,32,1
rnbqr1k1/pp2bppp/2p5/3p2B1/3Pn3/2NBP3/PP2NPPP/R2Q1RK1 w - - 6 10,Bxe7,56,56,0,1
rnbqr1k1/pp2Bppp/2p5/3p4/3Pn3/2NBP3/PP2NPPP/R2Q1RK1 b - - 0 10,Qxe7,44,65,21,1
rnb1r1k1/pp2qppp/2p5/3p4/3Pn3/2NBP3/PP2NPPP/R2Q1RK1 w - - 0 11,Qc2,55,19,-36,1
rnb1r1k1/pp2qppp/2p5/3p4/3Pn3/2NBP3/PPQ1NPPP/R4RK1 b - - 1 11,f5,40,68,28,1
rnb1r1k1/pp2q1pp/2p5/3p1p2/3Pn3/2NBP3/PPQ1NPPP/R4RK1 w - - 0 12,Ng3,79,20,-59,1
rnb1r1k1/pp2q1pp/2p5/3p1p2/3Pn3/2NBP1N1/PPQ2PPP/R4RK1 b - - 1 12,g6,19,36,17,1
rnb1r1k1/pp2q2p/2p3p1/3p1p2/3Pn3/2NBP1N1/PPQ2PPP/R4RK1 w - - 0 13,Rfe1,35,3,-32,1
rnb1r1k1/pp2q2p/2p3p1/3p1p2/3Pn3/2NBP1N1/PPQ2PPP/R3R1K1 b - - 1 13,Nd7,-7,0,7,1
r1b1r1k1/pp1nq2p/2p3p1/3p1p2/3Pn3/2NBP1N1/PPQ2PPP/R3R1K1 w - - 2 14,f3,6,-42,-48,1
r1b1r1k1/pp1nq2p/2p3p1/3p1p2/3Pn3/2NBPPN1/PPQ3PP/R3R1K1 b - - 0 14,Nxg3,-59,-71,-12,1
r1b1r1k1/pp1nq2p/2p3p1/3p1p2/3P4/2NBPPn1/PPQ3PP/R3R1K1 w - - 0 15,hxg3,-77,-72,5,1
r1b1r1k1/pp1nq2p/2p3p1/3p1p2/3P4/2NBPPP1/PPQ3P1/R3R1K1 b - - 0 15,Qd6,-79,-8,71,1
r1b1r1k1/pp1n3p/2pq2p1/3p1p2/3P4/2NBPPP1/PPQ3P1/R3R1K1 w - - 1 16,Kf2,-5,7,12,1
r1b1r1k1/pp1n3p/2pq2p1/3p1p2/3P4/2NBPPP1/PPQ2KP1/R3R3 b - - 2 16,Nf6,2,-17,-19,1
r1b1r1k1/pp5p/2pq1np1/3p1p2/3P4/2NBPPP1/PPQ2KP1/R3R3 w - - 3 17,a3,-8,-49,-41,1
r1b1r1k1/pp5p/2pq1np1/3p1p2/3P4/P1NBPPP1/1PQ2KP1/R3R3 b - - 0 17,Bd7,-50,-53,-3,1
r3r1k1/pp1b3p/2pq1np1/3p1p2/3P4/P1NBPPP1/1PQ2KP1/R3R3 w - - 1 18,b4,-33,-111,-78,1
r3r1k1/pp1b3p/2pq1np1/3p1p2/1P1P4/P1NBPPP1/2Q2KP1/R3R3 b - - 0 18,a6,-116,-45,71,1
r3r1k1/1p1b3p/p1pq1np1/3p1p2/1P1P4/P1NBPPP1/2Q2KP1/R3R3 w - - 0 19,Rab1,-32,-93,-61,1
r3r1k1/1p1b3p/p1pq1np1/3p1p2/1P1P4/P1NBPPP1/2Q2KP1/1R2R3 b - - 1 19,Re7,-96,-97,-1,1
r5k1/1p1br2p/p1pq1np1/3p1p2/1P1P4/P1NBPPP1/2Q2KP1/1R2R3 w - - 2 20,a4,-46,-121,-75,1
r5k1/1p1br2p/p1pq1np1/3p1p2/PP1P4/2NBPPP1/2Q2KP1/1R2R3 b - - 0 20,Rae8,-125,-112,13,1
4r1k1/1p1br2p/p1pq1np1/3p1p2/PP1P4/2NBPPP1/2Q2KP1/1R2R3 w - - 1 21,b5,-107,-153,-46,1
4r1k1/1p1br2p/p1pq1np1/1P1p1p2/P2P4/2NBPPP1/2Q2KP1/1R2R3 b - - 0 21,axb5,-147,-135,12,1
4r1k1/1p1br2p/2pq1np1/1p1p1p2/P2P4/2NBPPP1/2Q2KP1/1R2R3 w - - 0 22,axb5,-147,-170,-23,1
4r1k1/1p1br2p/2pq1np1/1P1p1p2/3P4/2NBPPP1/2Q2KP1/1R2R3 b - - 0 22,Nh5,-156,-163,-7,1
4r1k1/1p1br2p/2pq2p1/1P1p1p1n/3P4/2NBPPP1/2Q2KP1/1R2R3 w - - 1 23,f4,-182,-205,-23,1
4r1k1/1p1br2p/2pq2p1/1P1p1p1n/3P1P2/2NBP1P1/2Q2KP1/1R2R3 b - - 0 23,Nf6,-186,-113,73,1
4r1k1/1p1br2p/2pq1np1/1P1p1p2/3P1P2/2NBP1P1/2Q2KP1/1R2R3 w - - 1 24,Nd1,-126,-125,1,1
4r1k1/1p1br2p/2pq1np1/1P1p1p2/3P1P2/3BP1P1/2Q2KP1/1R1NR3 b - - 2 24,Ng4+,-133,-158,-25,1
4r1k1/1p1br2p/2pq2p1/1P1p1p2/3P1Pn1/3BP1P1/2Q2KP1/1R1NR3 w - - 3 25,Kf3,-125,-255,-130,0
4r1k1/1p1br2p/2pq2p1/1P1p1p2/3P1Pn1/3BPKP1/2Q3P1/1R1NR3 b - - 4 25,Nh2+,-242,-134,108,1
4r1k1/1p1br2p/2pq2p1/1P1p1p2/3P1P2/3BPKP1/2Q3Pn/1R1NR3 w - - 5 26,Kf2,-122,-147,-25,1
4r1k1/1p1br2p/2pq2p1/1P1p1p2/3P1P2/3BP1P1/2Q2KPn/1R1NR3 b - - 6 26,Ng4+,-142,-132,10,1
4r1k1/1p1br2p/2pq2p1/1P1p1p2/3P1Pn1/3BP1P1/2Q2KP1/1R1NR3 w - - 7 27,Kf3,-119,-233,-114,0
4r1k1/1p1br2p/2pq2p1/1P1p1p2/3P1Pn1/3BPKP1/2Q3P1/1R1NR3 b - - 8 27,Nh2+,-233,-146,87,1
4r1k1/1p1br2p/2pq2p1/1P1p1p2/3P1P2/3BPKP1/2Q3Pn/1R1NR3 w - - 9 28,Kf2,-123,-135,-12,1
4r1k1/1p1br2p/2pq2p1/1P1p1p2/3P1P2/3BP1P1/2Q2KPn/1R1NR3 b - - 10 28,Ng4+,-139,-141,-2,1
4r1k1/1p1br2p/2pq2p1/1P1p1p2/3P1Pn1/3BP1P1/2Q2KP1/1R1NR3 w - - 11 29,Kf3,-149,-228,-79,1
rnbqkbnr/pppppppp/8/8/8/8/PPPPPPPP/RNBQKBNR w KQkq - 0 1,e4,32,30,-2,1
rnbqkbnr/pppppppp/8/8/4P3/8/PPPP1PPP/RNBQKBNR b KQkq - 0 1,d5,25,63,38,1
rnbqkbnr/ppp1pppp/8/3p4/4P3/8/PPPP1PPP/RNBQKBNR w KQkq - 0 2,exd5,72,59,-13,1
rnbqkbnr/ppp1pppp/8/3P4/8/8/PPPP1PPP/RNBQKBNR b KQkq - 0 2,Nf6,59,69,10,1
rnbqkb1r/ppp1pppp/5n2/3P4/8/8/PPPP1PPP/RNBQKBNR w KQkq - 1 3,Nc3,58,29,-29,1
rnbqkb1r/ppp1pppp/5n2/3P4/8/2N5/PPPP1PPP/R1BQKBNR b KQkq - 2 3,Nxd5,26,27,1,1
rnbqkb1r/ppp1pppp/8/3n4/8/2N5/PPPP1PPP/R1BQKBNR w KQkq - 0 4,Nxd5,25,-24,-49,1
rnbqkb1r/ppp1pppp/8/3N4/8/8/PPPP1PPP/R1BQKBNR b KQkq - 0 4,Qxd5,-32,-22,10,1
rnb1kb1r/ppp1pppp/8/3q4/8/8/PPPP1PPP/R1BQKBNR w KQkq - 0 5,Nf3,-15,-22,-7,1
rnb1kb1r/ppp1pppp/8/3q4/8/5N2/PPPP1PPP/R1BQKB1R b KQkq - 1 5,Bf5,-23,18,41,1
rn2kb1r/ppp1pppp/8/3q1b2/8/5N2/PPPP1PPP/R1BQKB1R w KQkq - 2 6,a3,18,-99,-117,0
rn2kb1r/ppp1pppp/8/3q1b2/8/P4N2/1PPP1PPP/R1BQKB1R b KQkq - 0 6,Nc6,-114,-31,83,1
r3kb1r/ppp1pppp/2n5/3q1b2/8/P4N2/1PPP1PPP/R1BQKB1R w KQkq - 1 7,d3,-47,-85,-38,1
r3kb1r/ppp1pppp/2n5/3q1b2/8/P2P1N2/1PP2PPP/R1BQKB1R b KQkq - 0 7,e5,-79,-100,-21,1
r3kb1r/ppp2ppp/2n5/3qpb2/8/P2P1N2/1PP2PPP/R1BQKB1R w KQkq - 0 8,Qe2,-90,-186,-96,1
r3kb1r/ppp2ppp/2n5/3qpb2/8/P2P1N2/1PP1QPPP/R1B1KB1R b KQkq - 1 8,e4,-200,-35,165,1
r3kb1r/ppp2ppp/2n5/3q1b2/4p3/P2P1N2/1PP1QPPP/R1B1KB1R w KQkq - 0 9,dxe4,-33,-30,3,1
r3kb1r/ppp2ppp/2n5/3q1b2/4P3/P4N2/1PP1QPPP/R1B1KB1R b KQkq - 0 9,Bxe4,-35,-41,-6,1
r3kb1r/ppp2ppp/2n5/3q4/4b3/P4N2/1PP1QPPP/R1B1KB1R w KQkq - 0 10,Qc4,-32,-82,-50,1
r3kb1r/ppp2ppp/2n5/3q4/2Q1b3/P4N2/1PP2PPP/R1B1KB1R b KQkq - 1 10,Qxc4,-93,-73,20,1
r3kb1r/ppp2ppp/2n5/8/2q1b3/P4N2/1PP2PPP/R1B1KB1R w KQkq - 0 11,Bxc4,-61,-54,7,1
r3kb1r/ppp2ppp/2n5/8/2B1b3/P4N2/1PP2PPP/R1B1K2R b KQkq - 0 11,Bxc2,-88,-24,64,1
r3kb1r/ppp2ppp/2n5/8/2B5/P4N2/1Pb2PPP/R1B1K2R w KQkq - 0 12,Bg5,-25,-171,-146,0
r3kb1r/ppp2ppp/2n5/6B1/2B5/P4N2/1Pb2PPP/R3K2R b KQkq - 1 12,Be7,-169,-38,131,1
r3k2r/ppp1bppp/2n5/6B1/2B5/P4N2/1Pb2PPP/R3K2R w KQkq - 2 13,O-O,-53,-144,-91,1
r3k2r/ppp1bppp/2n5/6B1/2B5/P4N2/1Pb2PPP/R4RK1 b kq - 3 13,Bxg5,-143,-20,123,1
r3k2r/ppp2ppp/2n5/6b1/2B5/P4N2/1Pb2PPP/R4RK1 w kq - 0 14,Rfe1+,-21,-318,-297,0
r3k2r/ppp2ppp/2n5/6b1/2B5/P4N2/1Pb2PPP/R3R1K1 b kq - 1 14,Be7,-324,-360,-36,1
r3k2r/ppp1bppp/2n5/8/2B5/P4N2/1Pb2PPP/R3R1K1 w kq - 2 15,Ng5,-367,-528,-161,0
r3k2r/ppp1bppp/2n5/6N1/2B5/P7/1Pb2PPP/R3R1K1 b kq - 3 15,O-O,-479,-492,-13,1
r4rk1/ppp1bppp/2n5/6N1/2B5/P7/1Pb2PPP/R3R1K1 w - - 4 16,Rac1,-500,-538,-38,1
r4rk1/ppp1bppp/2n5/6N1/2B5/P7/1Pb2PPP/2R1R1K1 b - - 5 16,Bxg5,-540,-474,66,1
r4rk1/ppp2ppp/2n5/6b1/2B5/P7/1Pb2PPP/2R1R1K1 w - - 0 17,Rxc2,-495,-522,-27,1
r4rk1/ppp2ppp/2n5/6b1/2B5/P7/1PR2PPP/4R1K1 b - - 0 17,Rae8,-509,-498,11,1
4rrk1/ppp2ppp/2n5/6b1/2B5/P7/1PR2PPP/4R1K1 w - - 1 18,Rxe8,-498,-500,-2,1
4Rrk1/ppp2ppp/2n5/6b1/2B5/P7/1PR2PPP/6K1 b - - 0 18,Rxe8,-526,-522,4,1
4r1k1/ppp2ppp/2n5/6b1/2B5/P7/1PR2PPP/6K1 w - - 0 19,Rc3,-509,-534,-25,1
4r1k1/ppp2ppp/2n5/6b1/2B5/P1R5/1P3PPP/6K1 b - - 1 19,Re1+,-533,-516,17,1
6k1/ppp2ppp/2n5/6b1/2B5/P1R5/1P3PPP/4r1K1 w - - 2 20,Bf1,-523,-559,-36,1
6k1/ppp2ppp/2n5/6b1/8/P1R5/1P3PPP/4rBK1 b - - 3 20,Nd4,-564,-523,41,1
6k1/ppp2ppp/8/6b1/3n4/P1R5/1P3PPP/4rBK1 w - - 4 21,Rd3,-526,-9998,-9472,0
6k1/ppp2ppp/8/6b1/3n4/P2R4/1P3PPP/4rBK1 b - - 5 21,Ne2+,-9998,-9999,-1,1
6k1/ppp2ppp/8/6b1/8/P2R4/1P2nPPP/4rBK1 w - - 6 22,Kh1,-9999,-9999,0,1
6k1/ppp2ppp/8/6b1/8/P2R4/1P2nPPP/4rB1K b - - 7 22,h6,-9999,-622,9377,1
6k1/ppp2pp1/7p/6b1/8/P2R4/1P2nPPP/4rB1K w - - 0 23,h3,-645,-813,-168,0
6k1/ppp2pp1/7p/6b1/8/P2R3P/1P2nPP1/4rB1K b - - 0 23,Rxf1+,-822,-884,-62,1
6k1/ppp2pp1/7p/6b1/8/P2R3P/1P2nPP1/5r1K w - - 0 24,Kh2,-870,-887,-17,1
6k1/ppp2pp1/7p/6b1/8/P2R3P/1P2nPPK/5r2 b - - 1 24,Bf4+,-878,-905,-27,1
6k1/ppp2pp1/7p/8/5b2/P2R3P/1P2nPPK/5r2 w - - 2 25,g3,-956,-958,-2,1
6k1/ppp2pp1/7p/8/5b2/P2R2PP/1P2nP1K/5r2 b - - 0 25,Bd6,-974,-660,314,1
6k1/ppp2pp1/3b3p/8/8/P2R2PP/1P2nP1K/5r2 w - - 1 26,Re3,-682,-882,-200,0
6k1/ppp2pp1/3b3p/8/8/P3R1PP/1P2nP1K/5r2 b - - 2 26,Rxf2+,-861,-880,-19,1
6k1/ppp2pp1/3b3p/8/8/P3R1PP/1P2nr1K/8 w - - 0 27,Kh1,-875,-914,-39,1
6k1/ppp2pp1/3b3p/8/8/P3R1PP/1P2nr2/7K b - - 1 27,Nxg3+,-920,-933,-13,1
6k1/ppp2pp1/3b3p/8/8/P3R1nP/1P3r2/7K w - - 0 28,Kg1,-918,-931,-13,1
6k1/ppp2pp1/3b3p/8/8/P3R1nP/1P3r2/6K1 b - - 1 28,Rf1+,-939,-786,153,1
6k1/ppp2pp1/3b3p/8/8/P3R1nP/1P6/5rK1 w - - 2 29,Kg2,-805,-821,-16,1
6k1/ppp2pp1/3b3p/8/8/P3R1nP/1P4K1/5r2 b - - 3 29,Rb1,-818,-790,28,1
6k1/ppp2pp1/3b3p/8/8/P3R1nP/1P4K1/1r6 w - - 4 30,Rxg3,-809,-852,-43,1
6k1/ppp2pp1/3b3p/8/8/P5RP/1P4K1/1r6 b - - 0 30,Bxg3,-871,-864,7,1
6k1/ppp2pp1/7p/8/8/P5bP/1P4K1/1r6 w - - 0 31,Kxg3,-874,-873,1,1
6k1/ppp2pp1/7p/8/8/P5KP/1P6/1r6 b - - 0 31,Rxb2,-867,-884,-17,1
6k1/ppp2pp1/7p/8/8/P5KP/1r6/8 w - - 0 32,Kf3,-878,-925,-47,1
6k1/ppp2pp1/7p/8/8/P4K1P/1r6/8 b - - 1 32,Ra2,-913,-873,40,1
6k1/ppp2pp1/7p/8/8/P4K1P/r7/8 w - - 2 33,Ke3,-861,-899,-38,1
6k1/ppp2pp1/7p/8/8/P3K2P/r7/8 b - - 3 33,Rxa3+,-931,-877,54,1
6k1/ppp2pp1/7p/8/8/r3K2P/8/8 w - - 0 34,Kf2,-902,-917,-15,1
6k1/ppp2pp1/7p/8/8/r6P/5K2/8 b - - 1 34,Rxh3,-916,-950,-34,1
6k1/ppp2pp1/7p/8/8/7r/5K2/8 w - - 0 35,Kg2,-956,-965,-9,1
6k1/ppp2pp1/7p/8/8/7r/6K1/8 b - - 1 35,Rh5,-973,-959,14,1
6k1/ppp2pp1/7p/7r/8/8/6K1/8 w - - 2 36,Kf2,-944,-963,-19,1
6k1/ppp2pp1/7p/7r/8/8/5K2/8 b - - 3 36,c5,-999,-979,20,1
6k1/pp3pp1/7p/2p4r/8/8/5K2/8 w - - 0 37,Kg2,-959,-996,-37,1
6k1/pp3pp1/7p/2p4r/8/8/6K1/8 b - - 1 37,c4,-1059,-931,128,1
6k1/pp3pp1/7p/7r/2p5/8/6K1/8 w - - 0 38,Kf2,-955,-948,7,1
6k1/pp3pp1/7p/7r/2p5/8/5K2/8 b - - 1 38,c3,-926,-857,69,1
6k1/pp3pp1/7p/7r/8/2p5/5K2/8 w - - 0 39,Kg2,-917,-1053,-136,0
6k1/pp3pp1/7p/7r/8/2p5/6K1/8 b - - 1 39,c2,-1055,-1009,46,1
6k1/pp3pp1/7p/7r/8/8/2p3K1/8 w - - 0 40,Kf2,-1017,-1007,10,1
6k1/pp3pp1/7p/7r/8/8/2p2K2/8 b - - 1 40,c1=R,-1219,-888,331,1
6k1/pp3pp1/7p/7r/8/8/5K2/2r5 w - - 0 41,Kf3,-934,-930,4,1
6k1/pp3pp1/7p/7r/8/5K2/8/2r5 b - - 1 41,Rc4,-925,-988,-63,1
6k1/pp3pp1/7p/7r/2r5/5K2/8/8 w - - 2 42,Ke3,-1071,-1060,11,1
6k1/pp3pp1/7p/7r/2r5/4K3/8/8 b - - 3 42,Rhc5,-1088,-1100,-12,1
6k1/pp3pp1/7p/2r5/2r5/4K3/8/8 w - - 4 43,Kd2,-1109,-1125,-16,1
6k1/pp3pp1/7p/2r5/2r5/8/3K4/8 b - - 5 43,f5,-1151,-893,258,1
6k1/pp4p1/7p/2r2p2/2r5/8/3K4/8 w - - 0 44,Ke3,-934,-940,-6,1
6k1/pp4p1/7p/2r2p2/2r5/4K3/8/8 b - - 1 44,f4+,-931,-878,53,1
6k1/pp4p1/7p/2r5/2r2p2/4K3/8/8 w - - 0 45,Kd2,-943,-978,-35,1
6k1/pp4p1/7p/2r5/2r2p2/8/3K4/8 b - - 1 45,f3,-984,-1322,-338,0
6k1/pp4p1/7p/2r5/2r5/5p2/3K4/8 w - - 0 46,Ke3,-9990,-9991,-1,1
6k1/pp4p1/7p/2r5/2r5/4Kp2/8/8 b - - 1 46,g5,-9991,-880,9111,1
6k1/pp6/7p/2r3p1/2r5/4Kp2/8/8 w - - 0 47,Kd2,-888,-1148,-260,0
6k1/pp6/7p/2r3p1/2r5/5p2/3K4/8 b - - 1 47,h5,-9991,-1192,8799,1
6k1/pp6/8/2r3pp/2r5/5p2/3K4/8 w - - 0 48,Ke3,-9989,-9989,0,1
6k1/pp6/8/2r3pp/2r5/4Kp2/8/8 b - - 1 48,g4,-9989,-9992,-3,1
6k1/pp6/8/2r4p/2r3p1/4Kp2/8/8 w - - 0 49,Kd2,-9992,-9992,0,1
6k1/pp6/8/2r4p/2r3p1/5p2/3K4/8 b - - 1 49,g3,-9992,-9991,1,1
6k1/pp6/8/2r4p/2r5/5pp1/3K4/8 w - - 0 50,Ke3,-9991,-9991,0,1
6k1/pp6/8/2r4p/2r5/4Kpp1/8/8 b - - 1 50,f2,-9991,-9992,-1,1
6k1/pp6/8/2r4p/2r5/4K1p1/5p2/8 w - - 0 51,Kd2,-9992,-9996,-4,1
6k1/pp6/8/2r4p/2r5/6p1/3K1p2/8 b - - 1 51,f1=R,-9997,-9995,2,1
6k1/pp6/8/2r4p/2r5/6p1/3K4/5r2 w - - 0 52,Ke3,-9996,-9996,0,1
6k1/pp6/8/2r4p/2r5/4K1p1/8/5r2 b - - 1 52,g2,-9996,-9997,-1,1
6k1/pp6/8/2r4p/2r5/4K3/6p1/5r2 w - - 0 53,Ke2,-9997,-9997,0,1
6k1/pp6/8/2r4p/2r5/8/4K1p1/5r2 b - - 1 53,g1=R,-9997,-1057,8940,1
6k1/pp6/8/2r4p/2r5/8/4K3/5rr1 w - - 0 54,Ke3,-9997,-9998,-1,1
6k1/pp6/8/2r4p/2r5/4K3/8/5rr1 b - - 1 54,h4,-9998,-1110,8888,1
6k1/pp6/8/2r5/2r4p/4K3/8/5rr1 w - - 0 55,Ke2,-9996,-9998,-2,1
6k1/pp6/8/2r5/2r4p/8/4K3/5rr1 b - - 1 55,h3,-9998,-9997,1,1
6k1/pp6/8/2r5/2r5/7p/4K3/5rr1 w - - 0 56,Ke3,-9997,-9998,-1,1
6k1/pp6/8/2r5/2r5/4K2p/8/5rr1 b - - 1 56,h2,-9997,-9997,0,1
6k1/pp6/8/2r5/2r5/4K3/7p/5rr1 w - - 0 57,Ke2,-9997,-9997,0,1
6k1/pp6/8/2r5/2r5/8/4K2p/5rr1 b - - 1 57,h1=R,-9997,-9998,-1,1
6k1/pp6/8/2r5/2r5/8/4K3/5rrr w - - 0 58,Ke3,-9998,-9998,0,1
6k1/pp6/8/2r5/2r5/4K3/8/5rrr b - - 1 58,Rh3+,-9998,-9999,-1,1
6k1/pp6/8/2r5/2r5/4K2r/8/5rr1 w - - 2 59,Ke2,-9999,-9999,0,1
6k1/pp6/8/2r5/2r5/7r/4K3/5rr1 b - - 3 59,Rg2+,-9999,-9998,1,1
6k1/pp6/8/2r5/2r5/7r/4K1r1/5r2 w - - 4 60,Kxf1,-9998,-9998,0,1
6k1/pp6/8/2r5/2r5/7r/6r1/5K2 b - - 0 60,Rgh2,-9998,-9999,-1,1
rnbqkbnr/pppppppp/8/8/8/8/PPPPPPPP/RNBQKBNR w KQkq - 0 1,e4,38,27,-11,1
rnbqkbnr/pppppppp/8/8/4P3/8/PPPP1PPP/RNBQKBNR b KQkq - 0 1,e6,38,47,9,1
rnbqkbnr/pppp1ppp/4p3/8/4P3/8/PPPP1PPP/RNBQKBNR w KQkq - 0 2,Nf3,42,11,-31,1
rnbqkbnr/pppp1ppp/4p3/8/4P3/5N2/PPPP1PPP/RNBQKB1R b KQkq - 1 2,d5,12,35,23,1
rnbqkbnr/ppp2ppp/4p3/3p4/4P3/5N2/PPPP1PPP/RNBQKB1R w KQkq - 0 3,e5,22,21,-1,1
rnbqkbnr/ppp2ppp/4p3/3pP3/8/5N2/PPPP1PPP/RNBQKB1R b KQkq - 0 3,Nc6,30,127,97,1
r1bqkbnr/ppp2ppp/2n1p3/3pP3/8/5N2/PPPP1PPP/RNBQKB1R w KQkq - 1 4,d4,106,93,-13,1
r1bqkbnr/ppp2ppp/2n1p3/3pP3/3P4/5N2/PPP2PPP/RNBQKB1R b KQkq - 0 4,f6,100,96,-4,1
r1bqkbnr/ppp3pp/2n1pp2/3pP3/3P4/5N2/PPP2PPP/RNBQKB1R w KQkq - 0 5,Bb5,92,77,-15,1
r1bqkbnr/ppp3pp/2n1pp2/1B1pP3/3P4/5N2/PPP2PPP/RNBQK2R b KQkq - 1 5,Bd7,65,65,0,1
r2qkbnr/pppb2pp/2n1pp2/1B1pP3/3P4/5N2/PPP2PPP/RNBQK2R w KQkq - 2 6,Bf4,80,9,-71,1
r2qkbnr/pppb2pp/2n1pp2/1B1pP3/3P1B2/5N2/PPP2PPP/RN1QK2R b KQkq - 3 6,g5,28,68,40,1
r2qkbnr/pppb3p/2n1pp2/1B1pP1p1/3P1B2/5N2/PPP2PPP/RN1QK2R w KQkq - 0 7,Be3,73,14,-59,1
r2qkbnr/pppb3p/2n1pp2/1B1pP1p1/3P4/4BN2/PPP2PPP/RN1QK2R b KQkq - 1 7,g4,31,38,7,1
r2qkbnr/pppb3p/2n1pp2/1B1pP3/3P2p1/4BN2/PPP2PPP/RN1QK2R w KQkq - 0 8,Nfd2,16,-62,-78,1
r2qkbnr/pppb3p/2n1pp2/1B1pP3/3P2p1/4B3/PPPN1PPP/RN1QK2R b KQkq - 1 8,f5,-48,102,150,1
r2qkbnr/pppb3p/2n1p3/1B1pPp2/3P2p1/4B3/PPPN1PPP/RN1QK2R w KQkq - 0 9,f3,125,-62,-187,0
r2qkbnr/pppb3p/2n1p3/1B1pPp2/3P2p1/4BP2/PPPN2PP/RN1QK2R b KQkq - 0 9,a6,-73,75,148,1
r2qkbnr/1ppb3p/p1n1p3/1B1pPp2/3P2p1/4BP2/PPPN2PP/RN1QK2R w KQkq - 0 10,Ba4,85,-121,-206,0
r2qkbnr/1ppb3p/p1n1p3/3pPp2/B2P2p1/4BP2/PPPN2PP/RN1QK2R b KQkq - 1 10,b5,-110,-46,64,1
r2qkbnr/2pb3p/p1n1p3/1p1pPp2/B2P2p1/4BP2/PPPN2PP/RN1QK2R w KQkq - 0 11,Bb3,-28,-52,-24,1
r2qkbnr/2pb3p/p1n1p3/1p1pPp2/3P2p1/1B2BP2/PPPN2PP/RN1QK2R b KQkq - 1 11,Nb4,-64,105,169,1
r2qkbnr/2pb3p/p3p3/1p1pPp2/1n1P2p1/1B2BP2/PPPN2PP/RN1QK2R w KQkq - 2 12,fxg4,84,69,-15,1
r2qkbnr/2pb3p/p3p3/1p1pPp2/1n1P2P1/1B2B3/PPPN2PP/RN1QK2R b KQkq - 0 12,Bh6,53,240,187,1
r2qk1nr/2pb3p/p3p2b/1p1pPp2/1n1P2P1/1B2B3/PPPN2PP/RN1QK2R w KQkq - 1 13,Bxh6,261,73,-188,0
r2qk1nr/2pb3p/p3p2B/1p1pPp2/1n1P2P1/1B6/PPPN2PP/RN1QK2R b KQkq - 0 13,Nxh6,69,82,13,1
r2qk2r/2pb3p/p3p2n/1p1pPp2/1n1P2P1/1B6/PPPN2PP/RN1QK2R w KQkq - 0 14,gxf5,94,94,0,1
r2qk2r/2pb3p/p3p2n/1p1pPP2/1n1P4/1B6/PPPN2PP/RN1QK2R b KQkq - 0 14,Nxf5,77,210,133,1
r2qk2r/2pb3p/p3p3/1p1pPn2/1n1P4/1B6/PPPN2PP/RN1QK2R w KQkq - 0 15,Nf3,215,56,-159,0
r2qk2r/2pb3p/p3p3/1p1pPn2/1n1P4/1B3N2/PPP3PP/RN1QK2R b KQkq - 1 15,Rc8,35,196,161,1
2rqk2r/2pb3p/p3p3/1p1pPn2/1n1P4/1B3N2/PPP3PP/RN1QK2R w KQk - 2 16,Qd2,175,191,16,1
2rqk2r/2pb3p/p3p3/1p1pPn2/1n1P4/1B3N2/PPPQ2PP/RN2K2R b KQk - 3 16,Qe7,204,203,-1,1
2r1k2r/2pbq2p/p3p3/1p1pPn2/1n1P4/1B3N2/PPPQ2PP/RN2K2R w KQk - 4 17,a3,225,218,-7,1
2r1k2r/2pbq2p/p3p3/1p1pPn2/1n1P4/PB3N2/1PPQ2PP/RN2K2R b KQk - 0 17,Nc6,208,221,13,1
2r1k2r/2pbq2p/p1n1p3/1p1pPn2/3P4/PB3N2/1PPQ2PP/RN2K2R w KQk - 1 18,c3,204,76,-128,0
2r1k2r/2pbq2p/p1n1p3/1p1pPn2/3P4/PBP2N2/1P1Q2PP/RN2K2R b KQk - 0 18,Rg8,69,166,97,1
2r1k1r1/2pbq2p/p1n1p3/1p1pPn2/3P4/PBP2N2/1P1Q2PP/RN2K2R w KQ - 1 19,O-O,153,75,-78,1
2r1k1r1/2pbq2p/p1n1p3/1p1pPn2/3P4/PBP2N2/1P1Q2PP/RN3RK1 b - - 2 19,Na5,106,96,-10,1
2r1k1r1/2pbq2p/p3p3/np1pPn2/3P4/PBP2N2/1P1Q2PP/RN3RK1 w - - 3 20,Bc2,100,112,12,1
2r1k1r1/2pbq2p/p3p3/np1pPn2/3P4/P1P2N2/1PBQ2PP/RN3RK1 b - - 4 20,Nc4,99,90,-9,1
2r1k1r1/2pbq2p/p3p3/1p1pPn2/2nP4/P1P2N2/1PBQ2PP/RN3RK1 w - - 5 21,Qc1,100,97,-3,1
2r1k1r1/2pbq2p/p3p3/1p1pPn2/2nP4/P1P2N2/1PB3PP/RNQ2RK1 b - - 6 21,c5,79,193,114,1
2r1k1r1/3bq2p/p3p3/1pppPn2/2nP4/P1P2N2/1PB3PP/RNQ2RK1 w - - 0 22,b3,242,20,-222,0
2r1k1r1/3bq2p/p3p3/1pppPn2/2nP4/PPP2N2/2B3PP/RNQ2RK1 b - - 0 22,Nce3,-33,-15,18,1
2r1k1r1/3bq2p/p3p3/1pppPn2/3P4/PPP1nN2/2B3PP/RNQ2RK1 w - - 1 23,Bxf5,-12,-27,-15,1
2r1k1r1/3bq2p/p3p3/1pppPB2/3P4/PPP1nN2/6PP/RNQ2RK1 b - - 0 23,Rxg2+,-26,-23,3,1
2r1k3/3bq2p/p3p3/1pppPB2/3P4/PPP1nN2/6rP/RNQ2RK1 w - - 0 24,Kh1,-31,-52,-21,1
2r1k3/3bq2p/p3p3/1pppPB2/3P4/PPP1nN2/6rP/RNQ2R1K b - - 1 24,Nxf1,-48,280,328,1
2r1k3/3bq2p/p3p3/1pppPB2/3P4/PPP2N2/6rP/RNQ2n1K w - - 0 25,Kxg2,275,254,-21,1
2r1k3/3bq2p/p3p3/1pppPB2/3P4/PPP2N2/6KP/RNQ2n2 b - - 0 25,exf5,233,385,152,1
2r1k3/3bq2p/p7/1pppPp2/3P4/PPP2N2/6KP/RNQ2n2 w - - 0 26,Kxf1,358,354,-4,1
2r1k3/3bq2p/p7/1pppPp2/3P4/PPP2N2/7P/RNQ2K2 b - - 0 26,cxd4,328,422,94,1
2r1k3/3bq2p/p7/1p1pPp2/3p4/PPP2N2/7P/RNQ2K2 w - - 0 27,cxd4,413,-633,-1046,0
2r1k3/3bq2p/p7/1p1pPp2/3P4/PP3N2/7P/RNQ2K2 b - - 0 27,Rxc1+,-644,-660,-16,1
4k3/3bq2p/p7/1p1pPp2/3P4/PP3N2/7P/RNr2K2 w - - 0 28,Kf2,-652,-685,-33,1
4k3/3bq2p/p7/1p1pPp2/3P4/PP3N2/5K1P/RNr5 b - - 1 28,Qg7,-643,-590,53,1
4k3/3b2qp/p7/1p1pPp2/3P4/PP3N2/5K1P/RNr5 w - - 2 29,Nbd2,-668,-777,-109,0
4k3/3b2qp/p7/1p1pPp2/3P4/PP3N2/3N1K1P/R1r5 b - - 3 29,Rxa1,-827,-817,10,1
4k3/3b2qp/p7/1p1pPp2/3P4/PP3N2/3N1K1P/r7 w - - 0 30,Ng5,-787,-915,-128,0
4k3/3b2qp/p7/1p1pPpN1/3P4/PP6/3N1K1P/r7 b - - 1 30,Qxg5,-1024,-9992,-8968,0
4k3/3b3p/p7/1p1pPpq1/3P4/PP6/3N1K1P/r7 w - - 0 31,Nb1,-9992,-9995,-3,1
4k3/3b3p/p7/1p1pPpq1/3P4/PP6/5K1P/rN6 b - - 1 31,Qf4+,-9995,-9996,-1,1
4k3/3b3p/p7/1p1pPp2/3P1q2/PP6/5K1P/rN6 w - - 2 32,Kg1,-9996,-9998,-2,1
4k3/3b3p/p7/1p1pPp2/3P1q2/PP6/7P/rN4K1 b - - 3 32,Rxb1+,-9998,-9998,0,1
4k3/3b3p/p7/1p1pPp2/3P1q2/PP6/7P/1r4K1 w - - 0 33,Kg2,-9998,-9998,0,1
rnbqkbnr/pppppppp/8/8/8/8/PPPPPPPP/RNBQKBNR w KQkq - 0 1,e3,28,-2,-30,1
rnbqkbnr/pppppppp/8/8/8/4P3/PPPP1PPP/RNBQKBNR b KQkq - 0 1,e5,-4,1,5,1
rnbqkbnr/pppp1ppp/8/4p3/8/4P3/PPPP1PPP/RNBQKBNR w KQkq - 0 2,d3,6,-55,-61,1
rnbqkbnr/pppp1ppp/8/4p3/8/3PP3/PPP2PPP/RNBQKBNR b KQkq - 0 2,d5,-42,-41,1,1
rnbqkbnr/ppp2ppp/8/3pp3/8/3PP3/PPP2PPP/RNBQKBNR w KQkq - 0 3,c3,-40,-80,-40,1
rnbqkbnr/ppp2ppp/8/3pp3/8/2PPP3/PP3PPP/RNBQKBNR b KQkq - 0 3,Nc6,-74,-67,7,1
r1bqkbnr/ppp2ppp/2n5/3pp3/8/2PPP3/PP3PPP/RNBQKBNR w KQkq - 1 4,f3,-62,-167,-105,0
r1bqkbnr/ppp2ppp/2n5/3pp3/8/2PPPP2/PP4PP/RNBQKBNR b KQkq - 0 4,Be6,-159,-150,9,1
r2qkbnr/ppp2ppp/2n1b3/3pp3/8/2PPPP2/PP4PP/RNBQKBNR w KQkq - 1 5,b3,-147,-198,-51,1
r2qkbnr/ppp2ppp/2n1b3/3pp3/8/1PPPPP2/P5PP/RNBQKBNR b KQkq - 0 5,Bd6,-194,-196,-2,1
r2qk1nr/ppp2ppp/2nbb3/3pp3/8/1PPPPP2/P5PP/RNBQKBNR w KQkq - 1 6,a3,-189,-237,-48,1
r2qk1nr/ppp2ppp/2nbb3/3pp3/8/PPPPPP2/6PP/RNBQKBNR b KQkq - 0 6,Nge7,-236,-204,32,1
r2qk2r/ppp1nppp/2nbb3/3pp3/8/PPPPPP2/6PP/RNBQKBNR w KQkq - 1 7,b4,-219,-207,12,1
r2qk2r/ppp1nppp/2nbb3/3pp3/1P6/P1PPPP2/6PP/RNBQKBNR b KQkq - 0 7,a6,-198,-184,14,1
r2qk2r/1pp1nppp/p1nbb3/3pp3/1P6/P1PPPP2/6PP/RNBQKBNR w KQkq - 0 8,g3,-176,-196,-20,1
r2qk2r/1pp1nppp/p1nbb3/3pp3/1P6/P1PPPPP1/7P/RNBQKBNR b KQkq - 0 8,O-O,-198,-174,24,1
r2q1rk1/1pp1nppp/p1nbb3/3pp3/1P6/P1PPPPP1/7P/RNBQKBNR w KQ - 1 9,Bg2,-160,-165,-5,1
r2q1rk1/1pp1nppp/p1nbb3/3pp3/1P6/P1PPPPP1/6BP/RNBQK1NR b KQ - 2 9,f5,-176,-136,40,1
r2q1rk1/1pp1n1pp/p1nbb3/3ppp2/1P6/P1PPPPP1/6BP/RNBQK1NR w KQ - 0 10,h3,-145,-347,-202,0
r2q1rk1/1pp1n1pp/p1nbb3/3ppp2/1P6/P1PPPPPP/6B1/RNBQK1NR b KQ - 0 10,e4,-306,-126,180,1
r2q1rk1/1pp1n1pp/p1nbb3/3p1p2/1P2p3/P1PPPPPP/6B1/RNBQK1NR w KQ - 0 11,f4,-121,-110,11,1
r2q1rk1/1pp1n1pp/p1nbb3/3p1p2/1P2pP2/P1PPP1PP/6B1/RNBQK1NR b KQ - 0 11,Ng6,-121,-71,50,1
r2q1rk1/1pp3pp/p1nbb1n1/3p1p2/1P2pP2/P1PPP1PP/6B1/RNBQK1NR w KQ - 1 12,h4,-63,-222,-159,0
r2q1rk1/1pp3pp/p1nbb1n1/3p1p2/1P2pP1P/P1PPP1P1/6B1/RNBQK1NR b KQ - 0 12,Nge7,-207,-114,93,1
r2q1rk1/1pp1n1pp/p1nbb3/3p1p2/1P2pP1P/P1PPP1P1/6B1/RNBQK1NR w KQ - 1 13,h5,-115,-150,-35,1
r2q1rk1/1pp1n1pp/p1nbb3/3p1p1P/1P2pP2/P1PPP1P1/6B1/RNBQK1NR b KQ - 0 13,h6,-163,-152,11,1
r2q1rk1/1pp1n1p1/p1nbb2p/3p1p1P/1P2pP2/P1PPP1P1/6B1/RNBQK1NR w KQ - 0 14,d4,-160,-183,-23,1
r2q1rk1/1pp1n1p1/p1nbb2p/3p1p1P/1P1PpP2/P1P1P1P1/6B1/RNBQK1NR b KQ - 0 14,Kh7,-198,-226,-28,1
r2q1r2/1pp1n1pk/p1nbb2p/3p1p1P/1P1PpP2/P1P1P1P1/6B1/RNBQK1NR w KQ - 1 15,Ne2,-225,-263,-38,1
r2q1r2/1pp1n1pk/p1nbb2p/3p1p1P/1P1PpP2/P1P1P1P1/4N1B1/RNBQK2R b KQ - 2 15,Ng8,-268,-265,3,1
r2q1rn1/1pp3pk/p1nbb2p/3p1p1P/1P1PpP2/P1P1P1P1/4N1B1/RNBQK2R w KQ - 3 16,Qb3,-267,-312,-45,1
r2q1rn1/1pp3pk/p1nbb2p/3p1p1P/1P1PpP2/PQP1P1P1/4N1B1/RNB1K2R b KQ - 4 16,Nf6,-317,-304,13,1
r2q1r2/1pp3pk/p1nbbn1p/3p1p1P/1P1PpP2/PQP1P1P1/4N1B1/RNB1K2R w KQ - 5 17,Nd2,-322,-334,-12,1
r2q1r2/1pp3pk/p1nbbn1p/3p1p1P/1P1PpP2/PQP1P1P1/3NN1B1/R1B1K2R b KQ - 6 17,Ng4,-328,-242,86,1
r2q1r2/1pp3pk/p1nbb2p/3p1p1P/1P1PpPn1/PQP1P1P1/3NN1B1/R1B1K2R w KQ - 7 18,Nf1,-244,-344,-100,1
r2q1r2/1pp3pk/p1nbb2p/3p1p1P/1P1PpPn1/PQP1P1P1/4N1B1/R1B1KN1R b KQ - 8 18,b5,-328,-291,37,1
r2q1r2/2p3pk/p1nbb2p/1p1p1p1P/1P1PpPn1/PQP1P1P1/4N1B1/R1B1KN1R w KQ - 0 19,Bh3,-285,-334,-49,1
r2q1r2/2p3pk/p1nbb2p/1p1p1p1P/1P1PpPn1/PQP1P1PB/4N3/R1B1KN1R b KQ - 1 19,Nf6,-332,-320,12,1
r2q1r2/2p3pk/p1nbbn1p/1p1p1p1P/1P1PpP2/PQP1P1PB/4N3/R1B1KN1R w KQ - 2 20,Bg2,-309,-339,-30,1
r2q1r2/2p3pk/p1nbbn1p/1p1p1p1P/1P1PpP2/PQP1P1P1/4N1B1/R1B1KN1R b KQ - 3 20,Qd7,-356,-317,39,1
r4r2/2pq2pk/p1nbbn1p/1p1p1p1P/1P1PpP2/PQP1P1P1/4N1B1/R1B1KN1R w KQ - 4 21,Rh4,-337,-368,-31,1
r4r2/2pq2pk/p1nbbn1p/1p1p1p1P/1P1PpP1R/PQP1P1P1/4N1B1/R1B1KN2 b Q - 5 21,a5,-374,-371,3,1
r4r2/2pq2pk/2nbbn1p/pp1p1p1P/1P1PpP1R/PQP1P1P1/4N1B1/R1B1KN2 w Q - 0 22,Bb2,-382,-354,28,1
r4r2/2pq2pk/2nbbn1p/pp1p1p1P/1P1PpP1R/PQP1P1P1/1B2N1B1/R3KN2 b Q - 1 22,axb4,-360,-340,20,1
r4r2/2pq2pk/2nbbn1p/1p1p1p1P/1p1PpP1R/PQP1P1P1/1B2N1B1/R3KN2 w Q - 0 23,axb4,-341,-376,-35,1
r4r2/2pq2pk/2nbbn1p/1p1p1p1P/1P1PpP1R/1QP1P1P1/1B2N1B1/R3KN2 b Q - 0 23,Rxa1+,-364,-351,13,1
5r2/2pq2pk/2nbbn1p/1p1p1p1P/1P1PpP1R/1QP1P1P1/1B2N1B1/r3KN2 w - - 0 24,Bxa1,-358,-345,13,1
5r2/2pq2pk/2nbbn1p/1p1p1p1P/1P1PpP1R/1QP1P1P1/4N1B1/B3KN2 b - - 0 24,Ra8,-370,-357,13,1
r7/2pq2pk/2nbbn1p/1p1p1p1P/1P1PpP1R/1QP1P1P1/4N1B1/B3KN2 w - - 1 25,Bb2,-359,-363,-4,1
r7/2pq2pk/2nbbn1p/1p1p1p1P/1P1PpP1R/1QP1P1P1/1B2N1B1/4KN2 b - - 2 25,Qc8,-366,-358,8,1
r1q5/2p3pk/2nbbn1p/1p1p1p1P/1P1PpP1R/1QP1P1P1/1B2N1B1/4KN2 w - - 3 26,Nd2,-354,-371,-17,1
r1q5/2p3pk/2nbbn1p/1p1p1p1P/1P1PpP1R/1QP1P1P1/1B1NN1B1/4K3 b - - 4 26,Qa6,-368,-334,34,1
r7/2p3pk/q1nbbn1p/1p1p1p1P/1P1PpP1R/1QP1P1P1/1B1NN1B1/4K3 w - - 5 27,Kf2,-329,-366,-37,1
r7/2p3pk/q1nbbn1p/1p1p1p1P/1P1PpP1R/1QP1P1P1/1B1NNKB1/8 b - - 6 27,Ng4+,-374,-18,356,1
r7/2p3pk/q1nbb2p/1p1p1p1P/1P1PpPnR/1QP1P1P1/1B1NNKB1/8 w - - 7 28,Rxg4,-3,0,3,1
r7/2p3pk/q1nbb2p/1p1p1p1P/1P1PpPR1/1QP1P1P1/1B1NNKB1/8 b - - 0 28,fxg4,0,0,0,1
r7/2p3pk/q1nbb2p/1p1p3P/1P1PpPp1/1QP1P1P1/1B1NNKB1/8 w - - 0 29,Nc1,0,-283,-283,0
r7/2p3pk/q1nbb2p/1p1p3P/1P1PpPp1/1QP1P1P1/1B1N1KB1/2N5 b - - 1 29,Ne7,-295,-225,70,1
r7/2p1n1pk/q2bb2p/1p1p3P/1P1PpPp1/1QP1P1P1/1B1N1KB1/2N5 w - - 2 30,Qc2,-245,-428,-183,0
r7/2p1n1pk/q2bb2p/1p1p3P/1P1PpPp1/2P1P1P1/1BQN1KB1/2N5 b - - 3 30,Bf5,-403,-380,23,1
r7/2p1n1pk/q2b3p/1p1p1b1P/1P1PpPp1/2P1P1P1/1BQN1KB1/2N5 w - - 4 31,Ndb3,-386,-426,-40,1
r7/2p1n1pk/q2b3p/1p1p1b1P/1P1PpPp1/1NP1P1P1/1BQ2KB1/2N5 b - - 5 31,Qa4,-416,-333,83,1
r7/2p1n1pk/3b3p/1p1p1b1P/qP1PpPp1/1NP1P1P1/1BQ2KB1/2N5 w - - 6 32,Qb1,-377,-386,-9,1
r7/2p1n1pk/3b3p/1p1p1b1P/qP1PpPp1/1NP1P1P1/1B3KB1/1QN5 b - - 7 32,Nc6,-365,-324,41,1
r7/2p3pk/2nb3p/1p1p1b1P/qP1PpPp1/1NP1P1P1/1B3KB1/1QN5 w - - 8 33,Nc5,-295,-468,-173,0
r7/2p3pk/2nb3p/1pNp1b1P/qP1PpPp1/2P1P1P1/1B3KB1/1QN5 b - - 9 33,Bxc5,-451,-534,-83,1
r7/2p3pk/2n4p/1pbp1b1P/qP1PpPp1/2P1P1P1/1B3KB1/1QN5 w - - 0 34,dxc5,-487,-473,14,1
r7/2p3pk/2n4p/1pPp1b1P/qP2pPp1/2P1P1P1/1B3KB1/1QN5 b - - 0 34,Qd1,-446,-459,-13,1
r7/2p3pk/2n4p/1pPp1b1P/1P2pPp1/2P1P1P1/1B3KB1/1QNq4 w - - 1 35,Bf1,-473,-525,-52,1
r7/2p3pk/2n4p/1pPp1b1P/1P2pPp1/2P1P1P1/1B3K2/1QNq1B2 b - - 2 35,Qf3+,-549,-505,44,1
r7/2p3pk/2n4p/1pPp1b1P/1P2pPp1/2P1PqP1/1B3K2/1QN2B2 w - - 3 36,Ke1,-537,-532,5,1
r7/2p3pk/2n4p/1pPp1b1P/1P2pPp1/2P1PqP1/1B6/1QN1KB2 b - - 4 36,Qxg3+,-566,-474,92,1
r7/2p3pk/2n4p/1pPp1b1P/1P2pPp1/2P1P1q1/1B6/1QN1KB2 w - - 0 37,Kd1,-519,-670,-151,0
r7/2p3pk/2n4p/1pPp1b1P/1P2pPp1/2P1P1q1/1B6/1QNK1B2 b - - 1 37,Qxe3,-656,-626,30,1
r7/2p3pk/2n4p/1pPp1b1P/1P2pPp1/2P1q3/1B6/1QNK1B2 w - - 0 38,Ne2,-616,-782,-166,0
r7/2p3pk/2n4p/1pPp1b1P/1P2pPp1/2P1q3/1B2N3/1Q1K1B2 b - - 1 38,g3,-844,-661,183,1
r7/2p3pk/2n4p/1pPp1b1P/1P2pP2/2P1q1p1/1B2N3/1Q1K1B2 w - - 0 39,Qc1,-679,-809,-130,0
r7/2p3pk/2n4p/1pPp1b1P/1P2pP2/2P1q1p1/1B2N3/2QK1B2 b - - 1 39,Qf2,-754,-669,85,1
r7/2p3pk/2n4p/1pPp1b1P/1P2pP2/2P3p1/1B2Nq2/2QK1B2 w - - 2 40,Kd2,-660,-9998,-9338,0
r7/2p3pk/2n4p/1pPp1b1P/1P2pP2/2P3p1/1B1KNq2/2Q2B2 b - - 3 40,Ra2,-9998,-675,9323,1
8/2p3pk/2n4p/1pPp1b1P/1P2pP2/2P3p1/rB1KNq2/2Q2B2 w - - 4 41,Qb1,-727,-9998,-9271,0
8/2p3pk/2n4p/1pPp1b1P/1P2pP2/2P3p1/rB1KNq2/1Q3B2 b - - 5 41,e3+,-9998,-9999,-1,1
8/2p3pk/2n4p/1pPp1b1P/1P3P2/2P1p1p1/rB1KNq2/1Q3B2 w - - 0 42,Kc1,-9999,-9999,0,1
8/2p3pk/2n4p/1pPp1b1P/1P3P2/2P1p1p1/rB2Nq2/1QK2B2 b - - 1 42,Bxb1,-9999,-953,9046,1
8/2p3pk/2n4p/1pPp3P/1P3P2/2P1p1p1/rB2Nq2/1bK2B2 w - - 0 43,Kxb1,-957,-995,-38,1
8/2p3pk/2n4p/1pPp3P/1P3P2/2P1p1p1/rB2Nq2/1K3B2 b - - 0 43,Rxb2+,-953,-897,56,1
8/2p3pk/2n4p/1pPp3P/1P3P2/2P1p1p1/1r2Nq2/1K3B2 w - - 0 44,Kxb2,-988,-9991,-9003,0
8/2p3pk/2n4p/1pPp3P/1P3P2/2P1p1p1/1K2Nq2/5B2 b - - 0 44,Qxf1,-9992,-909,9083,1
rnbqkbnr/pppppppp/8/8/8/8/PPPPPPPP/RNBQKBNR w KQkq - 0 1,e4,27,30,3,1
rnbqkbnr/pppppppp/8/8/4P3/8/PPPP1PPP/RNBQKBNR b KQkq - 0 1,c5,27,31,4,1
rnbqkbnr/pp1ppppp/8/2p5/4P3/8/PPPP1PPP/RNBQKBNR w KQkq - 0 2,Nf3,39,28,-11,1
rnbqkbnr/pp1ppppp/8/2p5/4P3/5N2/PPPP1PPP/RNBQKB1R b KQkq - 1 2,Nc6,27,54,27,1
r1bqkbnr/pp1ppppp/2n5/2p5/4P3/5N2/PPPP1PPP/RNBQKB1R w KQkq - 2 3,d4,50,17,-33,1
r1bqkbnr/pp1ppppp/2n5/2p5/3PP3/5N2/PPP2PPP/RNBQKB1R b KQkq - 0 3,cxd4,20,27,7,1
r1bqkbnr/pp1ppppp/2n5/8/3pP3/5N2/PPP2PPP/RNBQKB1R w KQkq - 0 4,Nxd4,22,12,-10,1
r1bqkbnr/pp1ppppp/2n5/8/3NP3/8/PPP2PPP/RNBQKB1R b KQkq - 0 4,g6,19,65,46,1
r1bqkbnr/pp1ppp1p/2n3p1/8/3NP3/8/PPP2PPP/RNBQKB1R w KQkq - 0 5,Nc3,53,35,-18,1
r1bqkbnr/pp1ppp1p/2n3p1/8/3NP3/2N5/PPP2PPP/R1BQKB1R b KQkq - 1 5,Bg7,32,55,23,1
r1bqk1nr/pp1pppbp/2n3p1/8/3NP3/2N5/PPP2PPP/R1BQKB1R w KQkq - 2 6,Be3,30,29,-1,1
r1bqk1nr/pp1pppbp/2n3p1/8/3NP3/2N1B3/PPP2PPP/R2QKB1R b KQkq - 3 6,Nf6,34,21,-13,1
r1bqk2r/pp1pppbp/2n2np1/8/3NP3/2N1B3/PPP2PPP/R2QKB1R w KQkq - 4 7,f3,19,-1,-20,1
r1bqk2r/pp1pppbp/2n2np1/8/3NP3/2N1BP2/PPP3PP/R2QKB1R b KQkq - 0 7,O-O,-2,24,26,1
r1bq1rk1/pp1pppbp/2n2np1/8/3NP3/2N1BP2/PPP3PP/R2QKB1R w KQ - 1 8,Bc4,18,28,10,1
r1bq1rk1/pp1pppbp/2n2np1/8/2BNP3/2N1BP2/PPP3PP/R2QK2R b KQ - 2 8,Qb6,29,-12,-41,1
r1b2rk1/pp1pppbp/1qn2np1/8/2BNP3/2N1BP2/PPP3PP/R2QK2R w KQ - 3 9,Qd2,-12,-106,-94,1
r1b2rk1/pp1pppbp/1qn2np1/8/2BNP3/2N1BP2/PPPQ2PP/R3K2R b KQ - 4 9,Nxe4,-134,-120,14,1
r1b2rk1/pp1pppbp/1qn3p1/8/2BNn3/2N1BP2/PPPQ2PP/R3K2R w KQ - 0 10,fxe4,-127,-187,-60,1
r1b2rk1/pp1pppbp/1qn3p1/8/2BNP3/2N1B3/PPPQ2PP/R3K2R b KQ - 0 10,Bxd4,-131,-139,-8,1
r1b2rk1/pp1ppp1p/1qn3p1/8/2BbP3/2N1B3/PPPQ2PP/R3K2R w KQ - 0 11,Bxd4,-149,-136,13,1
r1b2rk1/pp1ppp1p/1qn3p1/8/2BBP3/2N5/PPPQ2PP/R3K2R b KQ - 0 11,Qxd4,-140,-114,26,1
r1b2rk1/pp1ppp1p/2n3p1/8/2BqP3/2N5/PPPQ2PP/R3K2R w KQ - 0 12,Qxd4,-128,-148,-20,1
r1b2rk1/pp1ppp1p/2n3p1/8/2BQP3/2N5/PPP3PP/R3K2R b KQ - 0 12,Nxd4,-139,-136,3,1
r1b2rk1/pp1ppp1p/6p1/8/2BnP3/2N5/PPP3PP/R3K2R w KQ - 0 13,O-O-O,-130,-140,-10,1
r1b2rk1/pp1ppp1p/6p1/8/2BnP3/2N5/PPP3PP/2KR3R b - - 1 13,Nc6,-136,-137,-1,1
r1b2rk1/pp1ppp1p/2n3p1/8/2B1P3/2N5/PPP3PP/2KR3R w - - 2 14,Rhf1,-135,-199,-64,1
r1b2rk1/pp1ppp1p/2n3p1/8/2B1P3/2N5/PPP3PP/2KR1R2 b - - 3 14,d6,-220,-211,9,1
r1b2rk1/pp2pp1p/2np2p1/8/2B1P3/2N5/PPP3PP/2KR1R2 w - - 0 15,Nd5,-210,-209,1,1
r1b2rk1/pp2pp1p/2np2p1/3N4/2B1P3/8/PPP3PP/2KR1R2 b - - 1 15,Be6,-199,-215,-16,1
r4rk1/pp2pp1p/2npb1p1/3N4/2B1P3/8/PPP3PP/2KR1R2 w - - 2 16,Bb5,-215,-186,29,1
r4rk1/pp2pp1p/2npb1p1/1B1N4/4P3/8/PPP3PP/2KR1R2 b - - 3 16,Bxd5,-225,-209,16,1
r4rk1/pp2pp1p/2np2p1/1B1b4/4P3/8/PPP3PP/2KR1R2 w - - 0 17,exd5,-177,-202,-25,1
r4rk1/pp2pp1p/2np2p1/1B1P4/8/8/PPP3PP/2KR1R2 b - - 0 17,Ne5,-221,-233,-12,1
r4rk1/pp2pp1p/3p2p1/1B1Pn3/8/8/PPP3PP/2KR1R2 w - - 1 18,Rf4,-204,-222,-18,1
r4rk1/pp2pp1p/3p2p1/1B1Pn3/5R2/8/PPP3PP/2KR4 b - - 2 18,Rac8,-233,-217,16,1
2r2rk1/pp2pp1p/3p2p1/1B1Pn3/5R2/8/PPP3PP/2KR4 w - - 3 19,Rdf1,-220,-397,-177,0
2r2rk1/pp2pp1p/3p2p1/1B1Pn3/5R2/8/PPP3PP/2K2R2 b - - 4 19,Rc5,-401,-361,40,1
rnbqkbnr/pppppppp/8/8/8/8/PPPPPPPP/RNBQKBNR w KQkq - 0 1,d4,31,18,-13,1
rnbqkbnr/pppppppp/8/8/3P4/8/PPP1PPPP/RNBQKBNR b KQkq - 0 1,d5,21,17,-4,1
rnbqkbnr/ppp1pppp/8/3p4/3P4/8/PPP1PPPP/RNBQKBNR w KQkq - 0 2,Nc3,24,-18,-42,1
rnbqkbnr/ppp1pppp/8/3p4/3P4/2N5/PPP1PPPP/R1BQKBNR b KQkq - 1 2,Nf6,-15,-19,-4,1
rnbqkb1r/ppp1pppp/5n2/3p4/3P4/2N5/PPP1PPPP/R1BQKBNR w KQkq - 2 3,f3,-18,-60,-42,1
rnbqkb1r/ppp1pppp/5n2/3p4/3P4/2N2P2/PPP1P1PP/R1BQKBNR b KQkq - 0 3,e6,-50,-56,-6,1
rnbqkb1r/ppp2ppp/4pn2/3p4/3P4/2N2P2/PPP1P1PP/R1BQKBNR w KQkq - 0 4,Bg5,-54,-85,-31,1
rnbqkb1r/ppp2ppp/4pn2/3p2B1/3P4/2N2P2/PPP1P1PP/R2QKBNR b KQkq - 1 4,Be7,-86,-37,49,1
rnbqk2r/ppp1bppp/4pn2/3p2B1/3P4/2N2P2/PPP1P1PP/R2QKBNR w KQkq - 2 5,Bxf6,-46,-89,-43,1
rnbqk2r/ppp1bppp/4pB2/3p4/3P4/2N2P2/PPP1P1PP/R2QKBNR b KQkq - 0 5,Bxf6,-115,-108,7,1
rnbqk2r/ppp2ppp/4pb2/3p4/3P4/2N2P2/PPP1P1PP/R2QKBNR w KQkq - 0 6,e4,-87,-225,-138,0
rnbqk2r/ppp2ppp/4pb2/3p4/3PP3/2N2P2/PPP3PP/R2QKBNR b KQkq - 0 6,Nd7,-233,-44,189,1
r1bqk2r/pppn1ppp/4pb2/3p4/3PP3/2N2P2/PPP3PP/R2QKBNR w KQkq - 1 7,e5,-17,-76,-59,1
r1bqk2r/pppn1ppp/4pb2/3pP3/3P4/2N2P2/PPP3PP/R2QKBNR b KQkq - 0 7,Be7,-69,-71,-2,1
r1bqk2r/pppnbppp/4p3/3pP3/3P4/2N2P2/PPP3PP/R2QKBNR w KQkq - 1 8,Bb5,-72,-145,-73,1
r1bqk2r/pppnbppp/4p3/1B1pP3/3P4/2N2P2/PPP3PP/R2QK1NR b KQkq - 2 8,c6,-151,-124,27,1
r1bqk2r/pp1nbppp/2p1p3/1B1pP3/3P4/2N2P2/PPP3PP/R2QK1NR w KQkq - 0 9,Bf1,-130,-150,-20,1
r1bqk2r/pp1nbppp/2p1p3/3pP3/3P4/2N2P2/PPP3PP/R2QKBNR b KQkq - 1 9,Bb4,-148,-54,94,1
r1bqk2r/pp1n1ppp/2p1p3/3pP3/1b1P4/2N2P2/PPP3PP/R2QKBNR w KQkq - 2 10,Qd3,-49,-91,-42,1
r1bqk2r/pp1n1ppp/2p1p3/3pP3/1b1P4/2NQ1P2/PPP3PP/R3KBNR b KQkq - 3 10,Qg5,-86,-1,85,1
r1b1k2r/pp1n1ppp/2p1p3/3pP1q1/1b1P4/2NQ1P2/PPP3PP/R3KBNR w KQkq - 4 11,a3,-6,-14,-8,1
r1b1k2r/pp1n1ppp/2p1p3/3pP1q1/1b1P4/P1NQ1P2/1PP3PP/R3KBNR b KQkq - 0 11,Ba5,-9,-12,-3,1
r1b1k2r/pp1n1ppp/2p1p3/b2pP1q1/3P4/P1NQ1P2/1PP3PP/R3KBNR w KQkq - 1 12,b4,-8,-86,-78,1
r1b1k2r/pp1n1ppp/2p1p3/b2pP1q1/1P1P4/P1NQ1P2/2P3PP/R3KBNR b KQkq - 0 12,Bb6,-59,-73,-14,1
r1b1k2r/pp1n1ppp/1bp1p3/3pP1q1/1P1P4/P1NQ1P2/2P3PP/R3KBNR w KQkq - 1 13,a4,-76,-386,-310,0
r1b1k2r/pp1n1ppp/1bp1p3/3pP1q1/PP1P4/2NQ1P2/2P3PP/R3KBNR b KQkq - 0 13,Qf4,-385,54,439,1
r1b1k2r/pp1n1ppp/1bp1p3/3pP3/PP1P1q2/2NQ1P2/2P3PP/R3KBNR w KQkq - 1 14,a5,42,46,4,1
r1b1k2r/pp1n1ppp/1bp1p3/P2pP3/1P1P1q2/2NQ1P2/2P3PP/R3KBNR b KQkq - 0 14,Bxd4,39,212,173,1
r1b1k2r/pp1n1ppp/2p1p3/P2pP3/1P1b1q2/2NQ1P2/2P3PP/R3KBNR w KQkq - 0 15,Nge2,181,-309,-490,0
r1b1k2r/pp1n1ppp/2p1p3/P2pP3/1P1b1q2/2NQ1P2/2P1N1PP/R3KB1R b KQkq - 1 15,Bxc3+,-317,-280,37,1
r1b1k2r/pp1n1ppp/2p1p3/P2pP3/1P3q2/2bQ1P2/2P1N1PP/R3KB1R w KQkq - 0 16,Qxc3,-281,-298,-17,1
r1b1k2r/pp1n1ppp/2p1p3/P2pP3/1P3q2/2Q2P2/2P1N1PP/R3KB1R b KQkq - 0 16,Qxe5,-290,-285,5,1
r1b1k2r/pp1n1ppp/2p1p3/P2pq3/1P6/2Q2P2/2P1N1PP/R3KB1R w KQkq - 0 17,Qxe5,-287,-270,17,1
r1b1k2r/pp1n1ppp/2p1p3/P2pQ3/1P6/5P2/2P1N1PP/R3KB1R b KQkq - 0 17,Nxe5,-277,-285,-8,1
r1b1k2r/pp3ppp/2p1p3/P2pn3/1P6/5P2/2P1N1PP/R3KB1R w KQkq - 0 18,Nd4,-276,-303,-27,1
r1b1k2r/pp3ppp/2p1p3/P2pn3/1P1N4/5P2/2P3PP/R3KB1R b KQkq - 1 18,O-O,-306,-241,65,1
r1b2rk1/pp3ppp/2p1p3/P2pn3/1P1N4/5P2/2P3PP/R3KB1R w KQ - 2 19,Bd3,-242,-260,-18,1
r1b2rk1/pp3ppp/2p1p3/P2pn3/1P1N4/3B1P2/2P3PP/R3K2R b KQ - 3 19,Nxd3+,-258,-243,15,1
r1b2rk1/pp3ppp/2p1p3/P2p4/1P1N4/3n1P2/2P3PP/R3K2R w KQ - 0 20,cxd3,-247,-244,3,1
r1b2rk1/pp3ppp/2p1p3/P2p4/1P1N4/3P1P2/6PP/R3K2R b KQ - 0 20,e5,-237,-235,2,1
r1b2rk1/pp3ppp/2p5/P2pp3/1P1N4/3P1P2/6PP/R3K2R w KQ - 0 21,Nc2,-227,-341,-114,0
r1b2rk1/pp3ppp/2p5/P2pp3/1P6/3P1P2/2N3PP/R3K2R b KQ - 1 21,Bf5,-319,-309,10,1
r4rk1/pp3ppp/2p5/P2ppb2/1P6/3P1P2/2N3PP/R3K2R w KQ - 2 22,Rd1,-317,-356,-39,1
r4rk1/pp3ppp/2p5/P2ppb2/1P6/3P1P2/2N3PP/3RK2R b K - 3 22,Rae8,-362,-321,41,1
4rrk1/pp3ppp/2p5/P2ppb2/1P6/3P1P2/2N3PP/3RK2R w K - 4 23,O-O,-320,-392,-72,1
4rrk1/pp3ppp/2p5/P2ppb2/1P6/3P1P2/2N3PP/3R1RK1 b - - 5 23,e4,-358,-174,184,1
4rrk1/pp3ppp/2p5/P2p1b2/1P2p3/3P1P2/2N3PP/3R1RK1 w - - 0 24,d4,-182,-326,-144,0
4rrk1/pp3ppp/2p5/P2p1b2/1P1Pp3/5P2/2N3PP/3R1RK1 b - - 0 24,exf3,-325,-346,-21,1
4rrk1/pp3ppp/2p5/P2p1b2/1P1P4/5p2/2N3PP/3R1RK1 w - - 0 25,Rxf3,-332,-537,-205,0
4rrk1/pp3ppp/2p5/P2p1b2/1P1P4/5R2/2N3PP/3R2K1 b - - 0 25,Bxc2,-561,-589,-28,1
4rrk1/pp3ppp/2p5/P2p4/1P1P4/5R2/2b3PP/3R2K1 w - - 0 26,Rd2,-570,-611,-41,1
4rrk1/pp3ppp/2p5/P2p4/1P1P4/5R2/2bR2PP/6K1 b - - 1 26,Bb3,-579,-385,194,1
4rrk1/pp3ppp/2p5/P2p4/1P1P4/1b3R2/3R2PP/6K1 w - - 2 27,Rdd3,-393,-624,-231,0
4rrk1/pp3ppp/2p5/P2p4/1P1P4/1b1R1R2/6PP/6K1 b - - 3 27,Bc4,-591,-566,25,1
4rrk1/pp3ppp/2p5/P2p4/1PbP4/3R1R2/6PP/6K1 w - - 4 28,Rc3,-597,-573,24,1
4rrk1/pp3ppp/2p5/P2p4/1PbP4/2R2R2/6PP/6K1 b - - 5 28,Re2,-650,-544,106,1
5rk1/pp3ppp/2p5/P2p4/1PbP4/2R2R2/4r1PP/6K1 w - - 6 29,h3,-501,-651,-150,0
5rk1/pp3ppp/2p5/P2p4/1PbP4/2R2R1P/4r1P1/6K1 b - - 0 29,Rfe8,-622,-598,24,1
4r1k1/pp3ppp/2p5/P2p4/1PbP4/2R2R1P/4r1P1/6K1 w - - 1 30,Kh2,-603,-635,-32,1
4r1k1/pp3ppp/2p5/P2p4/1PbP4/2R2R1P/4r1PK/8 b - - 2 30,f6,-626,-573,53,1
4r1k1/pp4pp/2p2p2/P2p4/1PbP4/2R2R1P/4r1PK/8 w - - 0 31,Ra3,-582,-641,-59,1
4r1k1/pp4pp/2p2p2/P2p4/1PbP4/R4R1P/4r1PK/8 b - - 1 31,Kf7,-659,-595,64,1
4r3/pp3kpp/2p2p2/P2p4/1PbP4/R4R1P/4r1PK/8 w - - 2 32,Kg3,-593,-702,-109,0
4r3/pp3kpp/2p2p2/P2p4/1PbP4/R4RKP/4r1P1/8 b - - 3 32,g5,-630,-613,17,1
4r3/pp3k1p/2p2p2/P2p2p1/1PbP4/R4RKP/4r1P1/8 w - - 0 33,a6,-621,-680,-59,1
4r3/pp3k1p/P1p2p2/3p2p1/1PbP4/R4RKP/4r1P1/8 b - - 0 33,Bxa6,-684,-660,24,1
4r3/pp3k1p/b1p2p2/3p2p1/1P1P4/R4RKP/4r1P1/8 w - - 0 34,Kg4,-685,-792,-107,0
4r3/pp3k1p/b1p2p2/3p2p1/1P1P2K1/R4R1P/4r1P1/8 b - - 1 34,R8e4+,-837,-742,95,1
8/pp3k1p/b1p2p2/3p2p1/1P1Pr1K1/R4R1P/4r1P1/8 w - - 2 35,Kh5,-715,-9999,-9284,0
8/pp3k1p/b1p2p2/3p2pK/1P1Pr3/R4R1P/4r1P1/8 b - - 3 35,Rxd4,-9999,-740,9259,1
8/pp3k1p/b1p2p2/3p2pK/1P1r4/R4R1P/4r1P1/8 w - - 0 36,Rae3,-713,-9999,-9286,0
8/pp3k1p/b1p2p2/3p2pK/1P1r4/4RR1P/4r1P1/8 b - - 1 36,Rh4#,-9999,-10000,-1,1
rnbqkbnr/pppppppp/8/8/8/8/PPPPPPPP/RNBQKBNR w KQkq - 0 1,g3,34,10,-24,1
rnbqkbnr/pppppppp/8/8/8/6P1/PPPPPP1P/RNBQKBNR b KQkq - 0 1,e5,12,23,11,1
rnbqkbnr/pppp1ppp/8/4p3/8/6P1/PPPPPP1P/RNBQKBNR w KQkq - 0 2,d4,18,-27,-45,1
rnbqkbnr/pppp1ppp/8/4p3/3P4/6P1/PPP1PP1P/RNBQKBNR b KQkq - 0 2,e4,-20,37,57,1
rnbqkbnr/pppp1ppp/8/8/3Pp3/6P1/PPP1PP1P/RNBQKBNR w KQkq - 0 3,f3,20,-25,-45,1
rnbqkbnr/pppp1ppp/8/8/3Pp3/5PP1/PPP1P2P/RNBQKBNR b KQkq - 0 3,exf3,-36,41,77,1
rnbqkbnr/pppp1ppp/8/8/3P4/5pP1/PPP1P2P/RNBQKBNR w KQkq - 0 4,exf3,34,-46,-80,1
rnbqkbnr/pppp1ppp/8/8/3P4/5PP1/PPP4P/RNBQKBNR b KQkq - 0 4,Nf6,-37,27,64,1
rnbqkb1r/pppp1ppp/5n2/8/3P4/5PP1/PPP4P/RNBQKBNR w KQkq - 1 5,Bg2,32,-33,-65,1
rnbqkb1r/pppp1ppp/5n2/8/3P4/5PP1/PPP3BP/RNBQK1NR b KQkq - 2 5,d5,-36,-45,-9,1
rnbqkb1r/ppp2ppp/5n2/3p4/3P4/5PP1/PPP3BP/RNBQK1NR w KQkq - 0 6,Nc3,-43,-49,-6,1
rnbqkb1r/ppp2ppp/5n2/3p4/3P4/2N2PP1/PPP3BP/R1BQK1NR b KQkq - 1 6,Bb4,-50,-32,18,1
rnbqk2r/ppp2ppp/5n2/3p4/1b1P4/2N2PP1/PPP3BP/R1BQK1NR w KQkq - 2 7,Bd2,-41,-54,-13,1
rnbqk2r/ppp2ppp/5n2/3p4/1b1P4/2N2PP1/PPPB2BP/R2QK1NR b KQkq - 3 7,Bxc3,-50,34,84,1
rnbqk2r/ppp2ppp/5n2/3p4/3P4/2b2PP1/PPPB2BP/R2QK1NR w KQkq - 0 8,Bxc3,27,29,2,1
rnbqk2r/ppp2ppp/5n2/3p4/3P4/2B2PP1/PPP3BP/R2QK1NR b KQkq - 0 8,O-O,34,42,8,1
rnbq1rk1/ppp2ppp/5n2/3p4/3P4/2B2PP1/PPP3BP/R2QK1NR w KQ - 1 9,Qd3,40,0,-40,1
rnbq1rk1/ppp2ppp/5n2/3p4/3P4/2BQ1PP1/PPP3BP/R3K1NR b KQ - 2 9,Re8+,-9,-7,2,1
rnbqr1k1/ppp2ppp/5n2/3p4/3P4/2BQ1PP1/PPP3BP/R3K1NR w KQ - 3 10,Ne2,-5,-35,-30,1
rnbqr1k1/ppp2ppp/5n2/3p4/3P4/2BQ1PP1/PPP1N1BP/R3K2R b KQ - 4 10,Nbd7,-16,30,46,1
r1bqr1k1/pppn1ppp/5n2/3p4/3P4/2BQ1PP1/PPP1N1BP/R3K2R w KQ - 5 11,O-O-O,29,-21,-50,1
r1bqr1k1/pppn1ppp/5n2/3p4/3P4/2BQ1PP1/PPP1N1BP/2KR3R b - - 6 11,c6,18,37,19,1
r1bqr1k1/pp1n1ppp/2p2n2/3p4/3P4/2BQ1PP1/PPP1N1BP/2KR3R w - - 0 12,h4,45,0,-45,1
r1bqr1k1/pp1n1ppp/2p2n2/3p4/3P3P/2BQ1PP1/PPP1N1B1/2KR3R b - - 0 12,a5,3,-7,-10,1
r1bqr1k1/1p1n1ppp/2p2n2/p2p4/3P3P/2BQ1PP1/PPP1N1B1/2KR3R w - - 0 13,g4,-9,0,9,1
r1bqr1k1/1p1n1ppp/2p2n2/p2p4/3P2PP/2BQ1P2/PPP1N1B1/2KR3R b - - 0 13,a4,0,42,42,1
r1bqr1k1/1p1n1ppp/2p2n2/3p4/p2P2PP/2BQ1P2/PPP1N1B1/2KR3R w - - 0 14,a3,42,52,10,1
r1bqr1k1/1p1n1ppp/2p2n2/3p4/p2P2PP/P1BQ1P2/1PP1N1B1/2KR3R b - - 0 14,b5,45,77,32,1
r1bqr1k1/3n1ppp/2p2n2/1p1p4/p2P2PP/P1BQ1P2/1PP1N1B1/2KR3R w - - 0 15,Bb4,94,4,-90,1
r1bqr1k1/3n1ppp/2p2n2/1p1p4/pB1P2PP/P2Q1P2/1PP1N1B1/2KR3R b - - 1 15,Nb6,1,26,25,1
r1bqr1k1/5ppp/1np2n2/1p1p4/pB1P2PP/P2Q1P2/1PP1N1B1/2KR3R w - - 2 16,Nf4,0,-66,-66,1
r1bqr1k1/5ppp/1np2n2/1p1p4/pB1P1NPP/P2Q1P2/1PP3B1/2KR3R b - - 3 16,Bxg4,-69,336,405,1
r2qr1k1/5ppp/1np2n2/1p1p4/pB1P1NbP/P2Q1P2/1PP3B1/2KR3R w - - 0 17,fxg4,337,354,17,1
r2qr1k1/5ppp/1np2n2/1p1p4/pB1P1NPP/P2Q4/1PP3B1/2KR3R b - - 0 17,Nxg4,374,354,-20,1
r2qr1k1/5ppp/1np5/1p1p4/pB1P1NnP/P2Q4/1PP3B1/2KR3R w - - 0 18,Nh3,328,250,-78,1
r2qr1k1/5ppp/1np5/1p1p4/pB1P2nP/P2Q3N/1PP3B1/2KR3R b - - 1 18,Qxh4,257,250,-7,1
r3r1k1/5ppp/1np5/1p1p4/pB1P2nq/P2Q3N/1PP3B1/2KR3R w - - 0 19,Rhg1,246,51,-195,0
r3r1k1/5ppp/1np5/1p1p4/pB1P2nq/P2Q3N/1PP3B1/2KR2R1 b - - 1 19,Re3,36,189,153,1
r5k1/5ppp/1np5/1p1p4/pB1P2nq/P2Qr2N/1PP3B1/2KR2R1 w - - 2 20,Qf5,152,143,-9,1
r5k1/5ppp/1np5/1p1p1Q2/pB1P2nq/P3r2N/1PP3B1/2KR2R1 b - - 3 20,Rxh3,175,357,182,1
r5k1/5ppp/1np5/1p1p1Q2/pB1P2nq/P6r/1PP3B1/2KR2R1 w - - 0 21,Bxh3,407,418,11,1
r5k1/5ppp/1np5/1p1p1Q2/pB1P2nq/P6B/1PP5/2KR2R1 b - - 0 21,Qxh3,410,429,19,1
r5k1/5ppp/1np5/1p1p1Q2/pB1P2n1/P6q/1PP5/2KR2R1 w - - 0 22,Rxg4,451,453,2,1
r5k1/5ppp/1np5/1p1p1Q2/pB1P2R1/P6q/1PP5/2KR4 b - - 0 22,Nc4,459,876,417,1
r5k1/5ppp/2p5/1p1p1Q2/pBnP2R1/P6q/1PP5/2KR4 w - - 1 23,Rxg7+,9993,9994,1,1
rnbqkbnr/pppppppp/8/8/8/8/PPPPPPPP/RNBQKBNR w KQkq - 0 1,e4,33,27,-6,1
rnbqkbnr/pppppppp/8/8/4P3/8/PPPP1PPP/RNBQKBNR b KQkq - 0 1,e6,36,64,28,1
rnbqkbnr/pppp1ppp/4p3/8/4P3/8/PPPP1PPP/RNBQKBNR w KQkq - 0 2,d4,42,38,-4,1
rnbqkbnr/pppp1ppp/4p3/8/3PP3/8/PPP2PPP/RNBQKBNR b KQkq - 0 2,d6,29,79,50,1
rnbqkbnr/ppp2ppp/3pp3/8/3PP3/8/PPP2PPP/RNBQKBNR w KQkq - 0 3,e5,83,-47,-130,0
rnbqkbnr/ppp2ppp/3pp3/4P3/3P4/8/PPP2PPP/RNBQKBNR b KQkq - 0 3,d5,-52,85,137,1
rnbqkbnr/ppp2ppp/4p3/3pP3/3P4/8/PPP2PPP/RNBQKBNR w KQkq - 0 4,Nf3,81,84,3,1
rnbqkbnr/ppp2ppp/4p3/3pP3/3P4/5N2/PPP2PPP/RNBQKB1R b KQkq - 1 4,h6,86,98,12,1
rnbqkbnr/ppp2pp1/4p2p/3pP3/3P4/5N2/PPP2PPP/RNBQKB1R w KQkq - 0 5,Nc3,102,71,-31,1
rnbqkbnr/ppp2pp1/4p2p/3pP3/3P4/2N2N2/PPP2PPP/R1BQKB1R b KQkq - 1 5,a6,64,74,10,1
rnbqkbnr/1pp2pp1/p3p2p/3pP3/3P4/2N2N2/PPP2PPP/R1BQKB1R w KQkq - 0 6,Bd3,60,48,-12,1
rnbqkbnr/1pp2pp1/p3p2p/3pP3/3P4/2NB1N2/PPP2PPP/R1BQK2R b KQkq - 1 6,b6,44,176,132,1
rnbqkbnr/2p2pp1/pp2p2p/3pP3/3P4/2NB1N2/PPP2PPP/R1BQK2R w KQkq - 0 7,O-O,155,91,-64,1
rnbqkbnr/2p2pp1/pp2p2p/3pP3/3P4/2NB1N2/PPP2PPP/R1BQ1RK1 b kq - 1 7,g5,88,172,84,1
rnbqkbnr/2p2p2/pp2p2p/3pP1p1/3P4/2NB1N2/PPP2PPP/R1BQ1RK1 w kq - 0 8,h3,192,161,-31,1
rnbqkbnr/2p2p2/pp2p2p/3pP1p1/3P4/2NB1N1P/PPP2PP1/R1BQ1RK1 b kq - 0 8,Be7,165,224,59,1
rnbqk1nr/2p1bp2/pp2p2p/3pP1p1/3P4/2NB1N1P/PPP2PP1/R1BQ1RK1 w kq - 1 9,Ne2,214,228,14,1
rnbqk1nr/2p1bp2/pp2p2p/3pP1p1/3P4/3B1N1P/PPP1NPP1/R1BQ1RK1 b kq - 2 9,Bb7,221,232,11,1
rn1qk1nr/1bp1bp2/pp2p2p/3pP1p1/3P4/3B1N1P/PPP1NPP1/R1BQ1RK1 w kq - 3 10,Ng3,227,225,-2,1
rn1qk1nr/1bp1bp2/pp2p2p/3pP1p1/3P4/3B1NNP/PPP2PP1/R1BQ1RK1 b kq - 4 10,f6,235,370,135,1
rn1qk1nr/1bp1b3/pp2pp1p/3pP1p1/3P4/3B1NNP/PPP2PP1/R1BQ1RK1 w kq - 0 11,c4,337,219,-118,0
rn1qk1nr/1bp1b3/pp2pp1p/3pP1p1/2PP4/3B1NNP/PP3PP1/R1BQ1RK1 b kq - 0 11,f5,194,217,23,1
rn1qk1nr/1bp1b3/pp2p2p/3pPpp1/2PP4/3B1NNP/PP3PP1/R1BQ1RK1 w kq - 0 12,Ne1,253,183,-70,1
rn1qk1nr/1bp1b3/pp2p2p/3pPpp1/2PP4/3B2NP/PP3PP1/R1BQNRK1 b kq - 1 12,Nd7,181,383,202,1
r2qk1nr/1bpnb3/pp2p2p/3pPpp1/2PP4/3B2NP/PP3PP1/R1BQNRK1 w kq - 2 13,Qh5+,436,375,-61,1
r2qk1nr/1bpnb3/pp2p2p/3pPppQ/2PP4/3B2NP/PP3PP1/R1B1NRK1 b kq - 3 13,Kf8,406,422,16,1
r2q1knr/1bpnb3/pp2p2p/3pPppQ/2PP4/3B2NP/PP3PP1/R1B1NRK1 w - - 4 14,f4,409,250,-159,0
r2q1knr/1bpnb3/pp2p2p/3pPppQ/2PP1P2/3B2NP/PP4P1/R1B1NRK1 b - - 0 14,Qe8,232,259,27,1
r3qknr/1bpnb3/pp2p2p/3pPppQ/2PP1P2/3B2NP/PP4P1/R1B1NRK1 w - - 1 15,fxg5,296,164,-132,0
r3qknr/1bpnb3/pp2p2p/3pPpPQ/2PP4/3B2NP/PP4P1/R1B1NRK1 b - - 0 15,Qxh5,155,180,25,1
r4knr/1bpnb3/pp2p2p/3pPpPq/2PP4/3B2NP/PP4P1/R1B1NRK1 w - - 0 16,Nxh5,167,196,29,1
r4knr/1bpnb3/pp2p2p/3pPpPN/2PP4/3B3P/PP4P1/R1B1NRK1 b - - 0 16,Bxg5,177,236,59,1
r4knr/1bpn4/pp2p2p/3pPpbN/2PP4/3B3P/PP4P1/R1B1NRK1 w - - 0 17,Bxg5,264,42,-222,0
r4knr/1bpn4/pp2p2p/3pPpBN/2PP4/3B3P/PP4P1/R3NRK1 b - - 0 17,hxg5,26,32,6,1
r4knr/1bpn4/pp2p3/3pPppN/2PP4/3B3P/PP4P1/R3NRK1 w - - 0 18,Ng3,31,12,-19,1
r4knr/1bpn4/pp2p3/3pPpp1/2PP4/3B2NP/PP4P1/R3NRK1 b - - 1 18,g4,0,308,308,1
r4knr/1bpn4/pp2p3/3pPp2/2PP2p1/3B2NP/PP4P1/R3NRK1 w - - 0 19,hxg4,298,341,43,1
r4knr/1bpn4/pp2p3/3pPp2/2PP2P1/3B2N1/PP4P1/R3NRK1 b - - 0 19,Ke7,336,332,-4,1
r5nr/1bpnk3/pp2p3/3pPp2/2PP2P1/3B2N1/PP4P1/R3NRK1 w - - 1 20,gxf5,317,320,3,1
r5nr/1bpnk3/pp2p3/3pPP2/2PP4/3B2N1/PP4P1/R3NRK1 b - - 0 20,exf5,337,402,65,1
r5nr/1bpnk3/pp6/3pPp2/2PP4/3B2N1/PP4P1/R3NRK1 w - - 0 21,Nxf5+,433,380,-53,1
r5nr/1bpnk3/pp6/3pPN2/2PP4/3B4/PP4P1/R3NRK1 b - - 0 21,Ke6,426,523,97,1
r5nr/1bpn4/pp2k3/3pPN2/2PP4/3B4/PP4P1/R3NRK1 w - - 1 22,Ng7+,515,415,-100,1
r5nr/1bpn2N1/pp2k3/3pP3/2PP4/3B4/PP4P1/R3NRK1 b - - 2 22,Ke7,412,426,14,1
r5nr/1bpnk1N1/pp6/3pP3/2PP4/3B4/PP4P1/R3NRK1 w - - 3 23,e6,431,351,-80,1
r5nr/1bpnk1N1/pp2P3/3p4/2PP4/3B4/PP4P1/R3NRK1 b - - 0 23,Nf8,312,550,238,1
r4nnr/1bp1k1N1/pp2P3/3p4/2PP4/3B4/PP4P1/R3NRK1 w - - 1 24,Nc2,514,432,-82,1
r4nnr/1bp1k1N1/pp2P3/3p4/2PP4/3B4/PPN3P1/R4RK1 b - - 2 24,Nxe6,401,483,82,1
r5nr/1bp1k1N1/pp2n3/3p4/2PP4/3B4/PPN3P1/R4RK1 w - - 0 25,Nxe6,482,372,-110,0
r5nr/1bp1k3/pp2N3/3p4/2PP4/3B4/PPN3P1/R4RK1 b - - 0 25,Kxe6,364,380,16,1
r5nr/1bp5/pp2k3/3p4/2PP4/3B4/PPN3P1/R4RK1 w - - 0 26,Rae1+,361,385,24,1
r5nr/1bp5/pp2k3/3p4/2PP4/3B4/PPN3P1/4RRK1 b - - 1 26,Kd6,355,399,44,1
r5nr/1bp5/pp1k4/3p4/2PP4/3B4/PPN3P1/4RRK1 w - - 2 27,Bf5,372,315,-57,1
r5nr/1bp5/pp1k4/3p1B2/2PP4/8/PPN3P1/4RRK1 b - - 3 27,Bc8,348,403,55,1
r1b3nr/2p5/pp1k4/3p1B2/2PP4/8/PPN3P1/4RRK1 w - - 4 28,Ne3,379,243,-136,0
r1b3nr/2p5/pp1k4/3p1B2/2PP4/4N3/PP4P1/4RRK1 b - - 5 28,Nh6,244,432,188,1
r1b4r/2p5/pp1k3n/3p1B2/2PP4/4N3/PP4P1/4RRK1 w - - 6 29,Rf3,472,-21,-493,0
r1b4r/2p5/pp1k3n/3p1B2/2PP4/4NR2/PP4P1/4R1K1 b - - 7 29,Nxf5,-28,6,34,1
r1b4r/2p5/pp1k4/3p1n2/2PP4/4NR2/PP4P1/4R1K1 w - - 0 30,Nxf5+,33,1,-32,1
r1b4r/2p5/pp1k4/3p1N2/2PP4/5R2/PP4P1/4R1K1 b - - 0 30,Bxf5,-8,-5,3,1
r6r/2p5/pp1k4/3p1b2/2PP4/5R2/PP4P1/4R1K1 w - - 0 31,Rxf5,0,0,0,1
r6r/2p5/pp1k4/3p1R2/2PP4/8/PP4P1/4R1K1 b - - 0 31,c6,0,263,263,1
r6r/8/pppk4/3p1R2/2PP4/8/PP4P1/4R1K1 w - - 0 32,Rf6+,255,281,26,1
r6r/8/pppk1R2/3p4/2PP4/8/PP4P1/4R1K1 b - - 1 32,Kc7,244,337,93,1
r6r/2k5/ppp2R2/3p4/2PP4/8/PP4P1/4R1K1 w - - 2 33,Re7+,329,285,-44,1
r6r/2k1R3/ppp2R2/3p4/2PP4/8/PP4P1/6K1 b - - 3 33,Kc8,308,426,118,1
r1k4r/4R3/ppp2R2/3p4/2PP4/8/PP4P1/6K1 w - - 4 34,Rxc6+,447,447,0,1
r1k4r/4R3/ppR5/3p4/2PP4/8/PP4P1/6K1 b - - 0 34,Kd8,441,417,-24,1
r2k3r/4R3/ppR5/3p4/2PP4/8/PP4P1/6K1 w - - 1 35,Rce6,435,331,-104,0
r2k3r/4R3/pp2R3/3p4/2PP4/8/PP4P1/6K1 b - - 2 35,dxc4,325,336,11,1
r2k3r/4R3/pp2R3/8/2pP4/8/PP4P1/6K1 w - - 0 36,Rb7,327,328,1,1
r2k3r/1R6/pp2R3/8/2pP4/8/PP4P1/6K1 b - - 1 36,b5,332,322,-10,1
r2k3r/1R6/p3R3/1p6/2pP4/8/PP4P1/6K1 w - - 0 37,Ree7,329,290,-39,1
r2k3r/1R2R3/p7/1p6/2pP4/8/PP4P1/6K1 b - - 1 37,Rc8,286,9999,9713,1
2rk3r/1R2R3/p7/1p6/2pP4/8/PP4P1/6K1 w - - 2 38,Rbd7#,9999,10000,1,1
rnbqkbnr/pppppppp/8/8/8/8/PPPPPPPP/RNBQKBNR w KQkq - 0 1,e4,33,30,-3,1
rnbqkbnr/pppppppp/8/8/4P3/8/PPPP1PPP/RNBQKBNR b KQkq - 0 1,g6,23,58,35,1
rnbqkbnr/pppppp1p/6p1/8/4P3/8/PPPP1PPP/RNBQKBNR w KQkq - 0 2,d4,66,70,4,1
rnbqkbnr/pppppp1p/6p1/8/3PP3/8/PPP2PPP/RNBQKBNR b KQkq - 0 2,d6,62,65,3,1
rnbqkbnr/ppp1pp1p/3p2p1/8/3PP3/8/PPP2PPP/RNBQKBNR w KQkq - 0 3,f4,73,43,-30,1
rnbqkbnr/ppp1pp1p/3p2p1/8/3PPP2/8/PPP3PP/RNBQKBNR b KQkq - 0 3,Nf6,53,61,8,1
rnbqkb1r/ppp1pp1p/3p1np1/8/3PPP2/8/PPP3PP/RNBQKBNR w KQkq - 1 4,Nc3,75,48,-27,1
rnbqkb1r/ppp1pp1p/3p1np1/8/3PPP2/2N5/PPP3PP/R1BQKBNR b KQkq - 2 4,Bg7,64,53,-11,1
rnbqk2r/ppp1ppbp/3p1np1/8/3PPP2/2N5/PPP3PP/R1BQKBNR w KQkq - 3 5,e5,61,21,-40,1
rnbqk2r/ppp1ppbp/3p1np1/4P3/3P1P2/2N5/PPP3PP/R1BQKBNR b KQkq - 0 5,dxe5,-4,44,48,1
rnbqk2r/ppp1ppbp/5np1/4p3/3P1P2/2N5/PPP3PP/R1BQKBNR w KQkq - 0 6,fxe5,57,-7,-64,1
rnbqk2r/ppp1ppbp/5np1/4P3/3P4/2N5/PPP3PP/R1BQKBNR b KQkq - 0 6,Nd5,1,37,36,1
rnbqk2r/ppp1ppbp/6p1/3nP3/3P4/2N5/PPP3PP/R1BQKBNR w KQkq - 1 7,Qf3,47,-105,-152,0
rnbqk2r/ppp1ppbp/6p1/3nP3/3P4/2N2Q2/PPP3PP/R1B1KBNR b KQkq - 2 7,Nxc3,-103,30,133,1
rnbqk2r/ppp1ppbp/6p1/4P3/3P4/2n2Q2/PPP3PP/R1B1KBNR w KQkq - 0 8,Qxc3,29,39,10,1
rnbqk2r/ppp1ppbp/6p1/4P3/3P4/2Q5/PPP3PP/R1B1KBNR b KQkq - 0 8,Nc6,25,53,28,1
r1bqk2r/ppp1ppbp/2n3p1/4P3/3P4/2Q5/PPP3PP/R1B1KBNR w KQkq - 1 9,Bb5,64,-16,-80,1
r1bqk2r/ppp1ppbp/2n3p1/1B2P3/3P4/2Q5/PPP3PP/R1B1K1NR b KQkq - 2 9,Bd7,-20,83,103,1
r2qk2r/pppbppbp/2n3p1/1B2P3/3P4/2Q5/PPP3PP/R1B1K1NR w KQkq - 3 10,Nh3,88,-273,-361,0
r2qk2r/pppbppbp/2n3p1/1B2P3/3P4/2Q4N/PPP3PP/R1B1K2R b KQkq - 4 10,Nxe5,-306,-217,89,1
r2qk2r/pppbppbp/6p1/1B2n3/3P4/2Q4N/PPP3PP/R1B1K2R w KQkq - 0 11,dxe5,-210,-233,-23,1
r2qk2r/pppbppbp/6p1/1B2P3/8/2Q4N/PPP3PP/R1B1K2R b KQkq - 0 11,Bxb5,-215,-218,-3,1
r2qk2r/ppp1ppbp/6p1/1b2P3/8/2Q4N/PPP3PP/R1B1K2R w KQkq - 0 12,Bd2,-209,-365,-156,0
r2qk2r/ppp1ppbp/6p1/1b2P3/8/2Q4N/PPPB2PP/R3K2R b KQkq - 1 12,O-O,-364,-214,150,1
r2q1rk1/ppp1ppbp/6p1/1b2P3/8/2Q4N/PPPB2PP/R3K2R w KQ - 2 13,O-O-O,-207,-287,-80,1
r2q1rk1/ppp1ppbp/6p1/1b2P3/8/2Q4N/PPPB2PP/2KR3R b - - 3 13,Qd5,-327,-321,6,1
r4rk1/ppp1ppbp/6p1/1b1qP3/8/2Q4N/PPPB2PP/2KR3R w - - 4 14,Bh6,-312,-443,-131,0
r4rk1/ppp1ppbp/6pB/1b1qP3/8/2Q4N/PPP3PP/2KR3R b - - 5 14,Qxa2,-443,-491,-48,1
r4rk1/ppp1ppbp/6pB/1b2P3/8/2Q4N/qPP3PP/2KR3R w - - 0 15,Bxg7,-458,-593,-135,0
r4rk1/ppp1ppBp/6p1/1b2P3/8/2Q4N/qPP3PP/2KR3R b - - 0 15,Kxg7,-578,-334,244,1
r4r2/ppp1ppkp/6p1/1b2P3/8/2Q4N/qPP3PP/2KR3R w - - 0 16,b3,-339,-327,12,1
r4r2/ppp1ppkp/6p1/1b2P3/8/1PQ4N/q1P3PP/2KR3R b - - 0 16,Qa3+,-342,-311,31,1
r4r2/ppp1ppkp/6p1/1b2P3/8/qPQ4N/2P3PP/2KR3R w - - 1 17,Kb1,-348,-309,39,1
r4r2/ppp1ppkp/6p1/1b2P3/8/qPQ4N/2P3PP/1K1R3R b - - 2 17,e6,-359,-133,226,1
r4r2/ppp2pkp/4p1p1/1b2P3/8/qPQ4N/2P3PP/1K1R3R w - - 0 18,Ng5,-145,-210,-65,1
r4r2/ppp2pkp/4p1p1/1b2P1N1/8/qPQ5/2P3PP/1K1R3R b - - 1 18,a5,-212,-202,10,1
r4r2/1pp2pkp/4p1p1/pb2P1N1/8/qPQ5/2P3PP/1K1R3R w - - 0 19,Qa1,-206,-384,-178,0
r4r2/1pp2pkp/4p1p1/pb2P1N1/8/qP6/2P3PP/QK1R3R b - - 1 19,Qxa1+,-366,-371,-5,1
r4r2/1pp2pkp/4p1p1/pb2P1N1/8/1P6/2P3PP/qK1R3R w - - 0 20,Kxa1,-359,-389,-30,1
r4r2/1pp2pkp/4p1p1/pb2P1N1/8/1P6/2P3PP/K2R3R b - - 0 20,Bc6,-376,-368,8,1
r4r2/1pp2pkp/2b1p1p1/p3P1N1/8/1P6/2P3PP/K2R3R w - - 1 21,Kb2,-361,-401,-40,1
r4r2/1pp2pkp/2b1p1p1/p3P1N1/8/1P6/1KP3PP/3R3R b - - 2 21,Bxg2,-375,-384,-9,1
r4r2/1pp2pkp/4p1p1/p3P1N1/8/1P6/1KP3bP/3R3R w - - 0 22,Rhg1,-379,-411,-32,1
r4r2/1pp2pkp/4p1p1/p3P1N1/8/1P6/1KP3bP/3R2R1 b - - 1 22,Bd5,-428,-351,77,1
r4r2/1pp2pkp/4p1p1/p2bP1N1/8/1P6/1KP4P/3R2R1 w - - 2 23,h4,-372,-329,43,1
r4r2/1pp2pkp/4p1p1/p2bP1N1/7P/1P6/1KP5/3R2R1 b - - 0 23,a4,-352,-332,20,1
r4r2/1pp2pkp/4p1p1/3bP1N1/p6P/1P6/1KP5/3R2R1 w - - 0 24,b4,-371,-429,-58,1
r4r2/1pp2pkp/4p1p1/3bP1N1/pP5P/8/1KP5/3R2R1 b - - 0 24,a3+,-462,-420,42,1
r4r2/1pp2pkp/4p1p1/3bP1N1/1P5P/p7/1KP5/3R2R1 w - - 0 25,Kc3,-381,-470,-89,1
r4r2/1pp2pkp/4p1p1/3bP1N1/1P5P/p1K5/2P5/3R2R1 b - - 1 25,a2,-496,-453,43,1
r4r2/1pp2pkp/4p1p1/3bP1N1/1P5P/2K5/p1P5/3R2R1 w - - 0 26,Kd4,-447,-551,-104,0
r4r2/1pp2pkp/4p1p1/3bP1N1/1P1K3P/8/p1P5/3R2R1 b - - 1 26,Ra4,-527,-484,43,1
5r2/1pp2pkp/4p1p1/3bP1N1/rP1K3P/8/p1P5/3R2R1 w - - 2 27,c3,-517,-527,-10,1
5r2/1pp2pkp/4p1p1/3bP1N1/rP1K3P/2P5/p7/3R2R1 b - - 0 27,Rfa8,-546,-439,107,1
r7/1pp2pkp/4p1p1/3bP1N1/rP1K3P/2P5/p7/3R2R1 w - - 1 28,Kc5,-467,-695,-228,0
r7/1pp2pkp/4p1p1/2KbP1N1/rP5P/2P5/p7/3R2R1 b - - 2 28,a1=Q,-679,-712,-33,1
r7/1pp2pkp/4p1p1/2KbP1N1/rP5P/2P5/8/q2R2R1 w - - 0 29,Rxa1,-702,-702,0,1
r7/1pp2pkp/4p1p1/2KbP1N1/rP5P/2P5/8/R5R1 b - - 0 29,Rxa1,-690,-688,2,1
r7/1pp2pkp/4p1p1/2KbP1N1/1P5P/2P5/8/r5R1 w - - 0 30,Rg2,-658,-882,-224,0
r7/1pp2pkp/4p1p1/2KbP1N1/1P5P/2P5/6R1/r7 b - - 1 30,Bxg2,-846,-872,-26,1
rnbqkbnr/pppppppp/8/8/8/8/PPPPPPPP/RNBQKBNR w KQkq - 0 1,f4,28,-37,-65,1
rnbqkbnr/pppppppp/8/8/5P2/8/PPPPP1PP/RNBQKBNR b KQkq - 0 1,d5,-28,-30,-2,1
rnbqkbnr/ppp1pppp/8/3p4/5P2/8/PPPPP1PP/RNBQKBNR w KQkq - 0 2,Nf3,-39,-38,1,1
rnbqkbnr/ppp1pppp/8/3p4/5P2/5N2/PPPPP1PP/RNBQKB1R b KQkq - 1 2,e6,-33,-19,14,1
rnbqkbnr/ppp2ppp/4p3/3p4/5P2/5N2/PPPPP1PP/RNBQKB1R w KQkq - 0 3,b3,-28,-37,-9,1
rnbqkbnr/ppp2ppp/4p3/3p4/5P2/1P3N2/P1PPP1PP/RNBQKB1R b KQkq - 0 3,Be7,-24,-9,15,1
rnbqk1nr/ppp1bppp/4p3/3p4/5P2/1P3N2/P1PPP1PP/RNBQKB1R w KQkq - 1 4,Bb2,-24,-17,7,1
rnbqk1nr/ppp1bppp/4p3/3p4/5P2/1P3N2/PBPPP1PP/RN1QKB1R b KQkq - 2 4,Bh4+,-23,155,178,1
rnbqk1nr/ppp2ppp/4p3/3p4/5P1b/1P3N2/PBPPP1PP/RN1QKB1R w KQkq - 3 5,g3,123,72,-51,1
rnbqk1nr/ppp2ppp/4p3/3p4/5P1b/1P3NP1/PBPPP2P/RN1QKB1R b KQkq - 0 5,Bf6,78,63,-15,1
rnbqk1nr/ppp2ppp/4pb2/3p4/5P2/1P3NP1/PBPPP2P/RN1QKB1R w KQkq - 1 6,Bh3,62,-575,-637,0
rnbqk1nr/ppp2ppp/4pb2/3p4/5P2/1P3NPB/PBPPP2P/RN1QK2R b KQkq - 2 6,Bxb2,-580,-555,25,1
rnbqk1nr/ppp2ppp/4p3/3p4/5P2/1P3NPB/PbPPP2P/RN1QK2R w KQkq - 0 7,Nc3,-580,-601,-21,1
rnbqk1nr/ppp2ppp/4p3/3p4/5P2/1PN2NPB/PbPPP2P/R2QK2R b KQkq - 1 7,Bxa1,-572,-559,13,1
rnbqk1nr/ppp2ppp/4p3/3p4/5P2/1PN2NPB/P1PPP2P/b2QK2R w Kkq - 0 8,Qxa1,-533,-519,14,1
rnbqk1nr/ppp2ppp/4p3/3p4/5P2/1PN2NPB/P1PPP2P/Q3K2R b Kkq - 0 8,Nf6,-515,-518,-3,1
rnbqk2r/ppp2ppp/4pn2/3p4/5P2/1PN2NPB/P1PPP2P/Q3K2R w Kkq - 1 9,e4,-528,-530,-2,1
rnbqk2r/ppp2ppp/4pn2/3p4/4PP2/1PN2NPB/P1PP3P/Q3K2R b Kkq - 0 9,dxe4,-540,-549,-9,1
rnbqk2r/ppp2ppp/4pn2/8/4pP2/1PN2NPB/P1PP3P/Q3K2R w Kkq - 0 10,Nxe4,-525,-625,-100,1
rnbqk2r/ppp2ppp/4pn2/8/4NP2/1P3NPB/P1PP3P/Q3K2R b Kkq - 0 10,Nxe4,-661,-648,13,1
rnbqk2r/ppp2ppp/4p3/8/4nP2/1P3NPB/P1PP3P/Q3K2R w Kkq - 0 11,Qxg7,-628,-635,-7,1
rnbqk2r/ppp2pQp/4p3/8/4nP2/1P3NPB/P1PP3P/4K2R b Kkq - 0 11,Qf6,-651,-625,26,1
rnbqkbnr/pppppppp/8/8/8/8/PPPPPPPP/RNBQKBNR w KQkq - 0 1,c4,26,8,-18,1
rnbqkbnr/pppppppp/8/8/2P5/8/PP1PPPPP/RNBQKBNR b KQkq - 0 1,c6,15,42,27,1
rnbqkbnr/pp1ppppp/2p5/8/2P5/8/PP1PPPPP/RNBQKBNR w KQkq - 0 2,e4,52,41,-11,1
rnbqkbnr/pp1ppppp/2p5/8/2P1P3/8/PP1P1PPP/RNBQKBNR b KQkq - 0 2,d5,53,49,-4,1
rnbqkbnr/pp2pppp/2p5/3p4/2P1P3/8/PP1P1PPP/RNBQKBNR w KQkq - 0 3,cxd5,45,30,-15,1
rnbqkbnr/pp2pppp/2p5/3P4/4P3/8/PP1P1PPP/RNBQKBNR b KQkq - 0 3,cxd5,17,20,3,1
rnbqkbnr/pp2pppp/8/3p4/4P3/8/PP1P1PPP/RNBQKBNR w KQkq - 0 4,exd5,24,27,3,1
rnbqkbnr/pp2pppp/8/3P4/8/8/PP1P1PPP/RNBQKBNR b KQkq - 0 4,Nf6,24,19,-5,1
rnbqkb1r/pp2pppp/5n2/3P4/8/8/PP1P1PPP/RNBQKBNR w KQkq - 1 5,Bc4,18,16,-2,1
rnbqkb1r/pp2pppp/5n2/3P4/2B5/8/PP1P1PPP/RNBQK1NR b KQkq - 2 5,Nxd5,20,20,0,1
rnbqkb1r/pp2pppp/8/3n4/2B5/8/PP1P1PPP/RNBQK1NR w KQkq - 0 6,Nc3,15,6,-9,1
rnbqkb1r/pp2pppp/8/3n4/2B5/2N5/PP1P1PPP/R1BQK1NR b KQkq - 1 6,Nc6,-1,438,439,1
r1bqkb1r/pp2pppp/2n5/3n4/2B5/2N5/PP1P1PPP/R1BQK1NR w KQkq - 2 7,Nxd5,479,369,-110,0
r1bqkb1r/pp2pppp/2n5/3N4/2B5/8/PP1P1PPP/R1BQK1NR b KQkq - 0 7,e6,380,394,14,1
r1bqkb1r/pp3ppp/2n1p3/3N4/2B5/8/PP1P1PPP/R1BQK1NR w KQkq - 0 8,Nc3,430,457,27,1
r1bqkb1r/pp3ppp/2n1p3/8/2B5/2N5/PP1P1PPP/R1BQK1NR b KQkq - 1 8,Bd6,453,471,18,1
r1bqk2r/pp3ppp/2nbp3/8/2B5/2N5/PP1P1PPP/R1BQK1NR w KQkq - 2 9,Nf3,463,444,-19,1
r1bqk2r/pp3ppp/2nbp3/8/2B5/2N2N2/PP1P1PPP/R1BQK2R b KQkq - 3 9,O-O,468,459,-9,1
r1bq1rk1/pp3ppp/2nbp3/8/2B5/2N2N2/PP1P1PPP/R1BQK2R w KQ - 4 10,O-O,454,452,-2,1
r1bq1rk1/pp3ppp/2nbp3/8/2B5/2N2N2/PP1P1PPP/R1BQ1RK1 b - - 5 10,a6,445,503,58,1
r1bq1rk1/1p3ppp/p1nbp3/8/2B5/2N2N2/PP1P1PPP/R1BQ1RK1 w - - 0 11,Ne4,519,457,-62,1
r1bq1rk1/1p3ppp/p1nbp3/8/2B1N3/5N2/PP1P1PPP/R1BQ1RK1 b - - 1 11,b5,476,447,-29,1
r1bq1rk1/5ppp/p1nbp3/1p6/2B1N3/5N2/PP1P1PPP/R1BQ1RK1 w - - 0 12,Bb3,479,487,8,1
r1bq1rk1/5ppp/p1nbp3/1p6/4N3/1B3N2/PP1P1PPP/R1BQ1RK1 b - - 1 12,Bc7,457,511,54,1
r1bq1rk1/2b2ppp/p1n1p3/1p6/4N3/1B3N2/PP1P1PPP/R1BQ1RK1 w - - 2 13,d4,502,554,52,1
r1bq1rk1/2b2ppp/p1n1p3/1p6/3PN3/1B3N2/PP3PPP/R1BQ1RK1 b - - 0 13,Bb7,525,528,3,1
r2q1rk1/1bb2ppp/p1n1p3/1p6/3PN3/1B3N2/PP3PPP/R1BQ1RK1 w - - 1 14,Nc5,555,573,18,1
r2q1rk1/1bb2ppp/p1n1p3/1pN5/3P4/1B3N2/PP3PPP/R1BQ1RK1 b - - 2 14,Bc8,549,590,41,1
r1bq1rk1/2b2ppp/p1n1p3/1pN5/3P4/1B3N2/PP3PPP/R1BQ1RK1 w - - 3 15,Bg5,596,624,28,1
r1bq1rk1/2b2ppp/p1n1p3/1pN3B1/3P4/1B3N2/PP3PPP/R2Q1RK1 b - - 4 15,f6,612,597,-15,1
r1bq1rk1/2b3pp/p1n1pp2/1pN3B1/3P4/1B3N2/PP3PPP/R2Q1RK1 w - - 0 16,Bh4,587,545,-42,1
r1bq1rk1/2b3pp/p1n1pp2/1pN5/3P3B/1B3N2/PP3PPP/R2Q1RK1 b - - 1 16,Kh8,513,510,-3,1
r1bq1r1k/2b3pp/p1n1pp2/1pN5/3P3B/1B3N2/PP3PPP/R2Q1RK1 w - - 2 17,Bg3,549,511,-38,1
r1bq1r1k/2b3pp/p1n1pp2/1pN5/3P4/1B3NB1/PP3PPP/R2Q1RK1 b - - 3 17,Bxg3,491,560,69,1
r1bq1r1k/6pp/p1n1pp2/1pN5/3P4/1B3Nb1/PP3PPP/R2Q1RK1 w - - 0 18,hxg3,548,551,3,1
r1bq1r1k/6pp/p1n1pp2/1pN5/3P4/1B3NP1/PP3PP1/R2Q1RK1 b - - 0 18,Re8,540,596,56,1
r1bqr2k/6pp/p1n1pp2/1pN5/3P4/1B3NP1/PP3PP1/R2Q1RK1 w - - 1 19,Re1,589,549,-40,1
r1bqr2k/6pp/p1n1pp2/1pN5/3P4/1B3NP1/PP3PP1/R2QR1K1 b - - 2 19,Qd6,545,717,172,1
r1b1r2k/6pp/p1nqpp2/1pN5/3P4/1B3NP1/PP3PP1/R2QR1K1 w - - 3 20,Ne4,648,583,-65,1
r1b1r2k/6pp/p1nqpp2/1p6/3PN3/1B3NP1/PP3PP1/R2QR1K1 b - - 4 20,Qc7,632,691,59,1
r1b1r2k/2q3pp/p1n1pp2/1p6/3PN3/1B3NP1/PP3PP1/R2QR1K1 w - - 5 21,Nc5,659,604,-55,1
r1b1r2k/2q3pp/p1n1pp2/1pN5/3P4/1B3NP1/PP3PP1/R2QR1K1 b - - 6 21,Qd6,560,652,92,1
r1b1r2k/6pp/p1nqpp2/1pN5/3P4/1B3NP1/PP3PP1/R2QR1K1 w - - 7 22,Ne4,642,605,-37,1
r1b1r2k/6pp/p1nqpp2/1p6/3PN3/1B3NP1/PP3PP1/R2QR1K1 b - - 8 22,Qc7,592,640,48,1
r1b1r2k/2q3pp/p1n1pp2/1p6/3PN3/1B3NP1/PP3PP1/R2QR1K1 w - - 9 23,Nc5,636,567,-69,1
r1b1r2k/2q3pp/p1n1pp2/1pN5/3P4/1B3NP1/PP3PP1/R2QR1K1 b - - 10 23,Qd6,575,659,84,1
r1b1r2k/6pp/p1nqpp2/1pN5/3P4/1B3NP1/PP3PP1/R2QR1K1 w - - 11 24,Ne4,609,578,-31,1
rnbqkbnr/pppppppp/8/8/8/8/PPPPPPPP/RNBQKBNR w KQkq - 0 1,e4,27,33,6,1
rnbqkbnr/pppppppp/8/8/4P3/8/PPPP1PPP/RNBQKBNR b KQkq - 0 1,e5,36,35,-1,1
rnbqkbnr/pppp1ppp/8/4p3/4P3/8/PPPP1PPP/RNBQKBNR w KQkq - 0 2,Nf3,37,33,-4,1
rnbqkbnr/pppp1ppp/8/4p3/4P3/5N2/PPPP1PPP/RNBQKB1R b KQkq - 1 2,d6,45,40,-5,1
rnbqkbnr/ppp2ppp/3p4/4p3/4P3/5N2/PPPP1PPP/RNBQKB1R w KQkq - 0 3,Be2,52,3,-49,1
rnbqkbnr/ppp2ppp/3p4/4p3/4P3/5N2/PPPPBPPP/RNBQK2R b KQkq - 1 3,Nf6,-12,-4,8,1
rnbqkb1r/ppp2ppp/3p1n2/4p3/4P3/5N2/PPPPBPPP/RNBQK2R w KQkq - 2 4,Nc3,-6,-3,3,1
rnbqkb1r/ppp2ppp/3p1n2/4p3/4P3/2N2N2/PPPPBPPP/R1BQK2R b KQkq - 3 4,a6,4,59,55,1
rnbqkb1r/1pp2ppp/p2p1n2/4p3/4P3/2N2N2/PPPPBPPP/R1BQK2R w KQkq - 0 5,O-O,44,7,-37,1
rnbqkb1r/1pp2ppp/p2p1n2/4p3/4P3/2N2N2/PPPPBPPP/R1BQ1RK1 b kq - 1 5,b5,4,125,121,1
rnbqkb1r/2p2ppp/p2p1n2/1p2p3/4P3/2N2N2/PPPPBPPP/R1BQ1RK1 w kq - 0 6,a3,122,-44,-166,0
rnbqkb1r/2p2ppp/p2p1n2/1p2p3/4P3/P1N2N2/1PPPBPPP/R1BQ1RK1 b kq - 0 6,Bb7,-20,18,38,1
rn1qkb1r/1bp2ppp/p2p1n2/1p2p3/4P3/P1N2N2/1PPPBPPP/R1BQ1RK1 w kq - 1 7,d3,0,-21,-21,1
rn1qkb1r/1bp2ppp/p2p1n2/1p2p3/4P3/P1NP1N2/1PP1BPPP/R1BQ1RK1 b kq - 0 7,Be7,-30,-33,-3,1
rn1qk2r/1bp1bppp/p2p1n2/1p2p3/4P3/P1NP1N2/1PP1BPPP/R1BQ1RK1 w kq - 1 8,Be3,-26,-41,-15,1
rn1qk2r/1bp1bppp/p2p1n2/1p2p3/4P3/P1NPBN2/1PP1BPPP/R2Q1RK1 b kq - 2 8,h6,-41,-14,27,1
rn1qk2r/1bp1bpp1/p2p1n1p/1p2p3/4P3/P1NPBN2/1PP1BPPP/R2Q1RK1 w kq - 0 9,b4,-11,-34,-23,1
rn1qk2r/1bp1bpp1/p2p1n1p/1p2p3/1P2P3/P1NPBN2/2P1BPPP/R2Q1RK1 b kq - 0 9,Ng4,-28,24,52,1
rn1qk2r/1bp1bpp1/p2p3p/1p2p3/1P2P1n1/P1NPBN2/2P1BPPP/R2Q1RK1 w kq - 1 10,Qd2,22,-29,-51,1
rn1qk2r/1bp1bpp1/p2p3p/1p2p3/1P2P1n1/P1NPBN2/2PQBPPP/R4RK1 b kq - 2 10,O-O,-19,-19,0,1
rn1q1rk1/1bp1bpp1/p2p3p/1p2p3/1P2P1n1/P1NPBN2/2PQBPPP/R4RK1 w - - 3 11,h3,-23,-32,-9,1
rn1q1rk1/1bp1bpp1/p2p3p/1p2p3/1P2P1n1/P1NPBN1P/2PQBPP1/R4RK1 b - - 0 11,Nxe3,-45,-49,-4,1
rn1q1rk1/1bp1bpp1/p2p3p/1p2p3/1P2P3/P1NPnN1P/2PQBPP1/R4RK1 w - - 0 12,Qxe3,-39,-57,-18,1
rn1q1rk1/1bp1bpp1/p2p3p/1p2p3/1P2P3/P1NPQN1P/2P1BPP1/R4RK1 b - - 0 12,Nd7,-48,-56,-8,1
r2q1rk1/1bpnbpp1/p2p3p/1p2p3/1P2P3/P1NPQN1P/2P1BPP1/R4RK1 w - - 1 13,d4,-56,-46,10,1
r2q1rk1/1bpnbpp1/p2p3p/1p2p3/1P1PP3/P1N1QN1P/2P1BPP1/R4RK1 b - - 0 13,exd4,-58,-37,21,1
r2q1rk1/1bpnbpp1/p2p3p/1p6/1P1pP3/P1N1QN1P/2P1BPP1/R4RK1 w - - 0 14,Qxd4,-32,-128,-96,1
r2q1rk1/1bpnbpp1/p2p3p/1p6/1P1QP3/P1N2N1P/2P1BPP1/R4RK1 b - - 0 14,Bf6,-123,-106,17,1
r2q1rk1/1bpn1pp1/p2p1b1p/1p6/1P1QP3/P1N2N1P/2P1BPP1/R4RK1 w - - 1 15,Qd3,-105,-122,-17,1
r2q1rk1/1bpn1pp1/p2p1b1p/1p6/1P2P3/P1NQ1N1P/2P1BPP1/R4RK1 b - - 2 15,Re8,-115,-123,-8,1
r2qr1k1/1bpn1pp1/p2p1b1p/1p6/1P2P3/P1NQ1N1P/2P1BPP1/R4RK1 w - - 3 16,Rad1,-147,-166,-19,1
r2qr1k1/1bpn1pp1/p2p1b1p/1p6/1P2P3/P1NQ1N1P/2P1BPP1/3R1RK1 b - - 4 16,Bxc3,-151,-112,39,1
r2qr1k1/1bpn1pp1/p2p3p/1p6/1P2P3/P1bQ1N1P/2P1BPP1/3R1RK1 w - - 0 17,Qxc3,-106,-124,-18,1
r2qr1k1/1bpn1pp1/p2p3p/1p6/1P2P3/P1Q2N1P/2P1BPP1/3R1RK1 b - - 0 17,Bxe4,-110,-108,2,1
r2qr1k1/2pn1pp1/p2p3p/1p6/1P2b3/P1Q2N1P/2P1BPP1/3R1RK1 w - - 0 18,Rfe1,-99,-98,1,1
r2qr1k1/2pn1pp1/p2p3p/1p6/1P2b3/P1Q2N1P/2P1BPP1/3RR1K1 b - - 1 18,Bxf3,-106,-34,72,1
r2qr1k1/2pn1pp1/p2p3p/1p6/1P6/P1Q2b1P/2P1BPP1/3RR1K1 w - - 0 19,Bxf3,-50,-47,3,1
r2qr1k1/2pn1pp1/p2p3p/1p6/1P6/P1Q2B1P/2P2PP1/3RR1K1 b - - 0 19,Rb8,-50,210,260,1
1r1qr1k1/2pn1pp1/p2p3p/1p6/1P6/P1Q2B1P/2P2PP1/3RR1K1 w - - 1 20,Bc6,217,-53,-270,0
1r1qr1k1/2pn1pp1/p1Bp3p/1p6/1P6/P1Q4P/2P2PP1/3RR1K1 b - - 2 20,Rxe1+,-50,-38,12,1
1r1q2k1/2pn1pp1/p1Bp3p/1p6/1P6/P1Q4P/2P2PP1/3Rr1K1 w - - 0 21,Rxe1,-44,-50,-6,1
1r1q2k1/2pn1pp1/p1Bp3p/1p6/1P6/P1Q4P/2P2PP1/4R1K1 b - - 0 21,Ne5,-50,-28,22,1
1r1q2k1/2p2pp1/p1Bp3p/1p2n3/1P6/P1Q4P/2P2PP1/4R1K1 w - - 1 22,Bf3,-30,-120,-90,1
1r1q2k1/2p2pp1/p2p3p/1p2n3/1P6/P1Q2B1P/2P2PP1/4R1K1 b - - 2 22,Qf6,-114,0,114,1
1r4k1/2p2pp1/p2p1q1p/1p2n3/1P6/P1Q2B1P/2P2PP1/4R1K1 w - - 3 23,Bd1,-14,-145,-131,0
1r4k1/2p2pp1/p2p1q1p/1p2n3/1P6/P1Q4P/2P2PP1/3BR1K1 b - - 4 23,Re8,-140,-152,-12,1
4r1k1/2p2pp1/p2p1q1p/1p2n3/1P6/P1Q4P/2P2PP1/3BR1K1 w - - 5 24,Kf1,-153,-180,-27,1
4r1k1/2p2pp1/p2p1q1p/1p2n3/1P6/P1Q4P/2P2PP1/3BRK2 b - - 6 24,Qd8,-188,-132,56,1
3qr1k1/2p2pp1/p2p3p/1p2n3/1P6/P1Q4P/2P2PP1/3BRK2 w - - 7 25,f4,-125,-227,-102,0
3qr1k1/2p2pp1/p2p3p/1p2n3/1P3P2/P1Q4P/2P3P1/3BRK2 b - - 0 25,Nc4,-228,-234,-6,1
3qr1k1/2p2pp1/p2p3p/1p6/1Pn2P2/P1Q4P/2P3P1/3BRK2 w - - 1 26,Qg3,-235,-301,-66,1
3qr1k1/2p2pp1/p2p3p/1p6/1Pn2P2/P5QP/2P3P1/3BRK2 b - - 2 26,Rxe1+,-288,-311,-23,1
3q2k1/2p2pp1/p2p3p/1p6/1Pn2P2/P5QP/2P3P1/3BrK2 w - - 0 27,Qxe1,-287,-297,-10,1
3q2k1/2p2pp1/p2p3p/1p6/1Pn2P2/P6P/2P3P1/3BQK2 b - - 0 27,Kf8,-289,-257,32,1
3q1k2/2p2pp1/p2p3p/1p6/1Pn2P2/P6P/2P3P1/3BQK2 w - - 1 28,Be2,-267,-321,-54,1
3q1k2/2p2pp1/p2p3p/1p6/1Pn2P2/P6P/2P1B1P1/4QK2 b - - 2 28,Nxa3,-297,-60,237,1
3q1k2/2p2pp1/p2p3p/1p6/1P3P2/n6P/2P1B1P1/4QK2 w - - 0 29,Qc3,-102,-92,10,1
3q1k2/2p2pp1/p2p3p/1p6/1P3P2/n1Q4P/2P1B1P1/5K2 b - - 1 29,Nc4,-93,-88,5,1
3q1k2/2p2pp1/p2p3p/1p6/1Pn2P2/2Q4P/2P1B1P1/5K2 w - - 2 30,Bxc4,-75,-86,-11,1
3q1k2/2p2pp1/p2p3p/1p6/1PB2P2/2Q4P/2P3P1/5K2 b - - 0 30,bxc4,-89,-101,-12,1
3q1k2/2p2pp1/p2p3p/8/1Pp2P2/2Q4P/2P3P1/5K2 w - - 0 31,Qxc4,-86,-85,1,1
3q1k2/2p2pp1/p2p3p/8/1PQ2P2/7P/2P3P1/5K2 b - - 0 31,Qd7,-74,14,88,1
5k2/2pq1pp1/p2p3p/8/1PQ2P2/7P/2P3P1/5K2 w - - 1 32,Qxa6,0,0,0,1
5k2/2pq1pp1/Q2p3p/8/1P3P2/7P/2P3P1/5K2 b - - 0 32,Qf5,-2,7,9,1
5k2/2p2pp1/Q2p3p/5q2/1P3P2/7P/2P3P1/5K2 w - - 1 33,Qc4,0,5,5,1
5k2/2p2pp1/3p3p/5q2/1PQ2P2/7P/2P3P1/5K2 b - - 2 33,c6,0,0,0,1
5k2/5pp1/2pp3p/5q2/1PQ2P2/7P/2P3P1/5K2 w - - 0 34,Qxc6,0,-168,-168,0
5k2/5pp1/2Qp3p/5q2/1P3P2/7P/2P3P1/5K2 b - - 0 34,Qxf4+,-187,-181,6,1
5k2/5pp1/2Qp3p/8/1P3q2/7P/2P3P1/5K2 w - - 0 35,Kg1,-187,-193,-6,1
5k2/5pp1/2Qp3p/8/1P3q2/7P/2P3P1/6K1 b - - 1 35,Qxb4,-195,-195,0,1
5k2/5pp1/2Qp3p/8/1q6/7P/2P3P1/6K1 w - - 0 36,c4,-195,-436,-241,0
5k2/5pp1/2Qp3p/8/1qP5/7P/6P1/6K1 b - - 0 36,Ke7,-459,-103,356,1
8/4kpp1/2Qp3p/8/1qP5/7P/6P1/6K1 w - - 1 37,Qc7+,-81,-168,-87,1
8/2Q1kpp1/3p3p/8/1qP5/7P/6P1/6K1 b - - 2 37,Kf6,-170,-176,-6,1
8/2Q2pp1/3p1k1p/8/1qP5/7P/6P1/6K1 w - - 3 38,Kh2,-179,-255,-76,1
8/2Q2pp1/3p1k1p/8/1qP5/7P/6PK/8 b - - 4 38,Qc5,-243,-181,62,1
8/2Q2pp1/3p1k1p/2q5/2P5/7P/6PK/8 w - - 5 39,Qd8+,-186,-191,-5,1
3Q4/5pp1/3p1k1p/2q5/2P5/7P/6PK/8 b - - 6 39,Kg6,-191,-166,25,1
3Q4/5pp1/3p2kp/2q5/2P5/7P/6PK/8 w - - 7 40,Kh1,-209,-210,-1,1
3Q4/5pp1/3p2kp/2q5/2P5/7P/6P1/7K b - - 8 40,Qxc4,-214,-51,163,1
3Q4/5pp1/3p2kp/8/2q5/7P/6P1/7K w - - 0 41,Qxd6+,-42,-22,20,1
8/5pp1/3Q2kp/8/2q5/7P/6P1/7K b - - 0 41,Qe6,-42,-43,-1,1
8/5pp1/3Qq1kp/8/8/7P/6P1/7K w - - 1 42,Qd3+,-44,-31,13,1
8/5pp1/4q1kp/8/8/3Q3P/6P1/7K b - - 2 42,Kf6,-42,-37,5,1
8/5pp1/4qk1p/8/8/3Q3P/6P1/7K w - - 3 43,Qf3+,-42,-38,4,1
8/5pp1/4qk1p/8/8/5Q1P/6P1/7K b - - 4 43,Qf5,-35,-37,-2,1
8/5pp1/5k1p/5q2/8/5Q1P/6P1/7K w - - 5 44,Qc6+,-41,-40,1,1
8/5pp1/2Q2k1p/5q2/8/7P/6P1/7K b - - 6 44,Qe6,-38,-40,-2,1
8/5pp1/2Q1qk1p/8/8/7P/6P1/7K w - - 7 45,Qf3+,-41,-37,4,1
8/5pp1/4qk1p/8/8/5Q1P/6P1/7K b - - 8 45,Kg6,-38,-31,7,1
8/5pp1/4q1kp/8/8/5Q1P/6P1/7K w - - 9 46,Qg3+,-40,-41,-1,1
8/5pp1/4q1kp/8/8/6QP/6P1/7K b - - 10 46,Kf6,-34,-33,1,1
8/5pp1/4qk1p/8/8/6QP/6P1/7K w - - 11 47,Qf3+,-35,-37,-2,1
8/5pp1/4qk1p/8/8/5Q1P/6P1/7K b - - 12 47,Ke7,-30,-30,0,1
8/4kpp1/4q2p/8/8/5Q1P/6P1/7K w - - 13 48,Qb7+,-36,-30,6,1
8/1Q2kpp1/4q2p/8/8/7P/6P1/7K b - - 14 48,Kf8,-32,-27,5,1
5k2/1Q3pp1/4q2p/8/8/7P/6P1/7K w - - 15 49,Qb8+,-29,-29,0,1
1Q3k2/5pp1/4q2p/8/8/7P/6P1/7K b - - 16 49,Qe8,-29,-35,-6,1
1Q2qk2/5pp1/7p/8/8/7P/6P1/7K w - - 17 50,Qb4+,-41,-37,4,1
4qk2/5pp1/7p/8/1Q6/7P/6P1/7K b - - 18 50,Kg8,-36,-33,3,1
4q1k1/5pp1/7p/8/1Q6/7P/6P1/7K w - - 19 51,Qd4,-33,-37,-4,1
4q1k1/5pp1/7p/8/3Q4/7P/6P1/7K b - - 20 51,f6,-34,-30,4,1
4q1k1/6p1/5p1p/8/3Q4/7P/6P1/7K w - - 0 52,Qd5+,-29,-28,1,1
4q1k1/6p1/5p1p/3Q4/8/7P/6P1/7K b - - 1 52,Kh8,-32,-31,1,1
4q2k/6p1/5p1p/3Q4/8/7P/6P1/7K w - - 2 53,Qd3,-31,-32,-1,1
4q2k/6p1/5p1p/8/8/3Q3P/6P1/7K b - - 3 53,Qe1+,-26,-24,2,1
7k/6p1/5p1p/8/8/3Q3P/6P1/4q2K w - - 4 54,Kh2,-25,-23,2,1
7k/6p1/5p1p/8/8/3Q3P/6PK/4q3 b - - 5 54,Qe5+,-25,-29,-4,1
7k/6p1/5p1p/4q3/8/3Q3P/6PK/8 w - - 6 55,Kh1,-35,-42,-7,1
7k/6p1/5p1p/4q3/8/3Q3P/6P1/7K b - - 7 55,Qe7,-41,-39,2,1
7k/4q1p1/5p1p/8/8/3Q3P/6P1/7K w - - 8 56,Qc2,-51,-49,2,1
7k/4q1p1/5p1p/8/8/7P/2Q3P1/7K b - - 9 56,Qe6,-37,-40,-3,1
7k/6p1/4qp1p/8/8/7P/2Q3P1/7K w - - 10 57,Qb1,-39,-38,1,1
7k/6p1/4qp1p/8/8/7P/6P1/1Q5K b - - 11 57,f5,-35,-23,12,1
7k/6p1/4q2p/5p2/8/7P/6P1/1Q5K w - - 0 58,Qb8+,-35,-34,1,1
1Q5k/6p1/4q2p/5p2/8/7P/6P1/7K b - - 1 58,Kh7,-37,-36,1,1
1Q6/6pk/4q2p/5p2/8/7P/6P1/7K w - - 2 59,Qf4,-41,-37,4,1
8/6pk/4q2p/5p2/5Q2/7P/6P1/7K b - - 3 59,Qe4,-41,-42,-1,1
8/6pk/7p/5p2/4qQ2/7P/6P1/7K w - - 4 60,Qc7,-39,-35,4,1
8/2Q3pk/7p/5p2/4q3/7P/6P1/7K b - - 5 60,f4,-32,-36,-4,1
8/2Q3pk/7p/8/4qp2/7P/6P1/7K w - - 0 61,Qc3,-30,-21,9,1
8/6pk/7p/8/4qp2/2Q4P/6P1/7K b - - 1 61,h5,-11,-21,-10,1
8/6pk/8/7p/4qp2/2Q4P/6P1/7K w - - 0 62,Kh2,-33,-31,2,1
8/6pk/8/7p/4qp2/2Q4P/6PK/8 b - - 1 62,Qe3,-26,-15,11,1
8/6pk/8/7p/5p2/2Q1q2P/6PK/8 w - - 2 63,Qc2+,11,-79,-90,1
8/6pk/8/7p/5p2/4q2P/2Q3PK/8 b - - 3 63,g6,-11,0,11,1
8/7k/6p1/7p/5p2/4q2P/2Q3PK/8 w - - 0 64,Qc7+,0,0,0,1
8/2Q4k/6p1/7p/5p2/4q2P/6PK/8 b - - 1 64,Kh6,0,0,0,1
8/2Q5/6pk/7p/5p2/4q2P/6PK/8 w - - 2 65,Qd8,0,0,0,1
3Q4/8/6pk/7p/5p2/4q2P/6PK/8 b - - 3 65,Qg3+,0,0,0,1
3Q4/8/6pk/7p/5p2/6qP/6PK/8 w - - 4 66,Kh1,0,0,0,1
3Q4/8/6pk/7p/5p2/6qP/6P1/7K b - - 5 66,f3,0,0,0,1
3Q4/8/6pk/7p/8/5pqP/6P1/7K w - - 0 67,Qh8+,0,-6,-6,1
7Q/8/6pk/7p/8/5pqP/6P1/7K b - - 1 67,Kg5,0,-12,-12,1
7Q/8/6p1/6kp/8/5pqP/6P1/7K w - - 2 68,gxf3,-20,-170,-150,0
7Q/8/6p1/6kp/8/5PqP/8/7K b - - 0 68,Qxf3+,-219,-50,169,1
7Q/8/6p1/6kp/8/5q1P/8/7K w - - 0 69,Kh2,-43,-35,8,1
7Q/8/6p1/6kp/8/5q1P/7K/8 b - - 1 69,h4,-40,-20,20,1
7Q/8/6p1/6k1/7p/5q1P/7K/8 w - - 0 70,Qd8+,-19,-14,5,1
3Q4/8/6p1/6k1/7p/5q1P/7K/8 b - - 1 70,Kh5,-19,-8,11,1
3Q4/8/6p1/7k/7p/5q1P/7K/8 w - - 2 71,Qh8+,-15,-20,-5,1
7Q/8/6p1/7k/7p/5q1P/7K/8 b - - 3 71,Kg5,-19,-13,6,1
7Q/8/6p1/6k1/7p/5q1P/7K/8 w - - 4 72,Qd8+,-17,-16,1,1
3Q4/8/6p1/6k1/7p/5q1P/7K/8 b - - 5 72,Qf6,-17,-12,5,1
3Q4/8/5qp1/6k1/7p/7P/7K/8 w - - 6 73,Qd2+,-13,-697,-684,0
8/8/5qp1/6k1/7p/7P/3Q3K/8 b - - 7 73,Kh5,-849,-10,839,1
8/8/5qp1/7k/7p/7P/3Q3K/8 w - - 8 74,Qd5+,-14,-17,-3,1
8/8/5qp1/3Q3k/7p/7P/7K/8 b - - 9 74,Qf5,-18,-17,1,1
8/8/6p1/3Q1q1k/7p/7P/7K/8 w - - 10 75,Qd1+,-19,-17,2,1
8/8/6p1/5q1k/7p/7P/7K/3Q4 b - - 11 75,Kh6,-18,-19,-1,1
8/8/6pk/5q2/7p/7P/7K/3Q4 w - - 12 76,Qd2+,-15,-19,-4,1
8/8/6pk/5q2/7p/7P/3Q3K/8 b - - 13 76,g5,-22,-20,2,1
8/8/7k/5qp1/7p/7P/3Q3K/8 w - - 0 77,Qd6+,-17,-12,5,1
8/8/3Q3k/5qp1/7p/7P/7K/8 b - - 1 77,Kh5,-12,-12,0,1
8/8/3Q4/5qpk/7p/7P/7K/8 w - - 2 78,Qd1+,-6,-18,-12,1
8/8/8/5qpk/7p/7P/7K/3Q4 b - - 3 78,Kg6,-20,-7,13,1
8/8/6k1/5qp1/7p/7P/7K/3Q4 w - - 4 79,Qd6+,-12,-11,1,1
8/8/3Q2k1/5qp1/7p/7P/7K/8 b - - 5 79,Qf6,-11,-6,5,1
8/8/3Q1qk1/6p1/7p/7P/7K/8 w - - 6 80,Qd3+,-12,-10,2,1
8/8/5qk1/6p1/7p/3Q3P/7K/8 b - - 7 80,Qf5,-10,-10,0,1
8/8/6k1/5qp1/7p/3Q3P/7K/8 w - - 8 81,Qd6+,-10,-10,0,1
8/8/3Q2k1/5qp1/7p/7P/7K/8 b - - 9 81,Qf6,-10,-9,1,1
8/8/3Q1qk1/6p1/7p/7P/7K/8 w - - 10 82,Qd3+,-9,-10,-1,1
8/8/5qk1/6p1/7p/3Q3P/7K/8 b - - 11 82,Kh5,-9,0,9,1
rnbqkbnr/pppppppp/8/8/8/8/PPPPPPPP/RNBQKBNR w KQkq - 0 1,e4,34,30,-4,1
rnbqkbnr/pppppppp/8/8/4P3/8/PPPP1PPP/RNBQKBNR b KQkq - 0 1,Nc6,24,47,23,1
r1bqkbnr/pppppppp/2n5/8/4P3/8/PPPP1PPP/RNBQKBNR w KQkq - 1 2,Bc4,42,-13,-55,1
r1bqkbnr/pppppppp/2n5/8/2B1P3/8/PPPP1PPP/RNBQK1NR b KQkq - 2 2,e5,-35,20,55,1
r1bqkbnr/pppp1ppp/2n5/4p3/2B1P3/8/PPPP1PPP/RNBQK1NR w KQkq - 0 3,d3,18,17,-1,1
r1bqkbnr/pppp1ppp/2n5/4p3/2B1P3/3P4/PPP2PPP/RNBQK1NR b KQkq - 0 3,Bc5,20,22,2,1
r1bqk1nr/pppp1ppp/2n5/2b1p3/2B1P3/3P4/PPP2PPP/RNBQK1NR w KQkq - 1 4,Nc3,22,12,-10,1
r1bqk1nr/pppp1ppp/2n5/2b1p3/2B1P3/2NP4/PPP2PPP/R1BQK1NR b KQkq - 2 4,h6,11,54,43,1
r1bqk1nr/pppp1pp1/2n4p/2b1p3/2B1P3/2NP4/PPP2PPP/R1BQK1NR w KQkq - 0 5,Nf3,53,13,-40,1
r1bqk1nr/pppp1pp1/2n4p/2b1p3/2B1P3/2NP1N2/PPP2PPP/R1BQK2R b KQkq - 1 5,Nf6,9,20,11,1
r1bqk2r/pppp1pp1/2n2n1p/2b1p3/2B1P3/2NP1N2/PPP2PPP/R1BQK2R w KQkq - 2 6,O-O,15,8,-7,1
r1bqk2r/pppp1pp1/2n2n1p/2b1p3/2B1P3/2NP1N2/PPP2PPP/R1BQ1RK1 b kq - 3 6,a6,4,17,13,1
r1bqk2r/1ppp1pp1/p1n2n1p/2b1p3/2B1P3/2NP1N2/PPP2PPP/R1BQ1RK1 w kq - 0 7,d4,10,-117,-127,0
r1bqk2r/1ppp1pp1/p1n2n1p/2b1p3/2BPP3/2N2N2/PPP2PPP/R1BQ1RK1 b kq - 0 7,exd4,-132,-111,21,1
r1bqk2r/1ppp1pp1/p1n2n1p/2b5/2BpP3/2N2N2/PPP2PPP/R1BQ1RK1 w kq - 0 8,Nd5,-137,-144,-7,1
r1bqk2r/1ppp1pp1/p1n2n1p/2bN4/2BpP3/5N2/PPP2PPP/R1BQ1RK1 b kq - 1 8,Nxe4,-123,311,434,1
r1bqk2r/1ppp1pp1/p1n4p/2bN4/2Bpn3/5N2/PPP2PPP/R1BQ1RK1 w kq - 0 9,c3,248,-34,-282,0
r1bqk2r/1ppp1pp1/p1n4p/2bN4/2Bpn3/2P2N2/PP3PPP/R1BQ1RK1 b kq - 0 9,f5,-25,189,214,1
r1bqk2r/1ppp2p1/p1n4p/2bN1p2/2Bpn3/2P2N2/PP3PPP/R1BQ1RK1 w kq - 0 10,cxd4,209,226,17,1
r1bqk2r/1ppp2p1/p1n4p/2bN1p2/2BPn3/5N2/PP3PPP/R1BQ1RK1 b kq - 0 10,Bxd4,225,535,310,1
r1bqk2r/1ppp2p1/p1n4p/3N1p2/2Bbn3/5N2/PP3PPP/R1BQ1RK1 w kq - 0 11,Nxd4,463,531,68,1
r1bqk2r/1ppp2p1/p1n4p/3N1p2/2BNn3/8/PP3PPP/R1BQ1RK1 b kq - 0 11,Ne5,516,537,21,1
r1bqk2r/1ppp2p1/p6p/3Nnp2/2BNn3/8/PP3PPP/R1BQ1RK1 w kq - 1 12,Nxf5,537,540,3,1
r1bqk2r/1ppp2p1/p6p/3NnN2/2B1n3/8/PP3PPP/R1BQ1RK1 b kq - 0 12,Nxc4,461,621,160,1
r1bqk2r/1ppp2p1/p6p/3N1N2/2n1n3/8/PP3PPP/R1BQ1RK1 w kq - 0 13,Qh5+,630,514,-116,0
r1bqk2r/1ppp2p1/p6p/3N1N1Q/2n1n3/8/PP3PPP/R1B2RK1 b kq - 1 13,Kf8,646,668,22,1
r1bq1k1r/1ppp2p1/p6p/3N1N1Q/2n1n3/8/PP3PPP/R1B2RK1 w - - 2 14,Qf3,649,334,-315,0
r1bq1k1r/1ppp2p1/p6p/3N1N2/2n1n3/5Q2/PP3PPP/R1B2RK1 b - - 3 14,Nf6,360,410,50,1
r1bq1k1r/1ppp2p1/p4n1p/3N1N2/2n5/5Q2/PP3PPP/R1B2RK1 w - - 4 15,Nxf6,420,72,-348,0
r1bq1k1r/1ppp2p1/p4N1p/5N2/2n5/5Q2/PP3PPP/R1B2RK1 b - - 0 15,Qxf6,63,73,10,1
r1b2k1r/1ppp2p1/p4q1p/5N2/2n5/5Q2/PP3PPP/R1B2RK1 w - - 0 16,b3,76,34,-42,1
r1b2k1r/1ppp2p1/p4q1p/5N2/2n5/1P3Q2/P4PPP/R1B2RK1 b - - 0 16,Ne5,32,68,36,1
r1b2k1r/1ppp2p1/p4q1p/4nN2/8/1P3Q2/P4PPP/R1B2RK1 w - - 1 17,Qf4,61,-47,-108,0
r1b2k1r/1ppp2p1/p4q1p/4nN2/5Q2/1P6/P4PPP/R1B2RK1 b - - 2 17,d6,-48,-26,22,1
r1b2k1r/1pp3p1/p2p1q1p/4nN2/5Q2/1P6/P4PPP/R1B2RK1 w - - 0 18,Bb2,-51,-332,-281,0
r1b2k1r/1pp3p1/p2p1q1p/4nN2/5Q2/1P6/PB3PPP/R4RK1 b - - 1 18,Qxf5,-302,-285,17,1
r1b2k1r/1pp3p1/p2p3p/4nq2/5Q2/1P6/PB3PPP/R4RK1 w - - 0 19,Qxf5+,-289,-420,-131,0
r1b2k1r/1pp3p1/p2p3p/4nQ2/8/1P6/PB3PPP/R4RK1 b - - 0 19,Bxf5,-397,-423,-26,1
r4k1r/1pp3p1/p2p3p/4nb2/8/1P6/PB3PPP/R4RK1 w - - 0 20,f4,-446,-449,-3,1
r4k1r/1pp3p1/p2p3p/4nb2/5P2/1P6/PB4PP/R4RK1 b - - 0 20,Nd3,-477,-439,38,1
r4k1r/1pp3p1/p2p3p/5b2/5P2/1P1n4/PB4PP/R4RK1 w - - 1 21,Bc3,-451,-458,-7,1
r4k1r/1pp3p1/p2p3p/5b2/5P2/1PBn4/P5PP/R4RK1 b - - 2 21,c5,-459,-455,4,1
r4k1r/1p4p1/p2p3p/2p2b2/5P2/1PBn4/P5PP/R4RK1 w - - 0 22,Rad1,-461,-506,-45,1
r4k1r/1p4p1/p2p3p/2p2b2/5P2/1PBn4/P5PP/3R1RK1 b - - 1 22,b5,-476,-424,52,1
r4k1r/6p1/p2p3p/1pp2b2/5P2/1PBn4/P5PP/3R1RK1 w - - 0 23,Rf3,-445,-435,10,1
r4k1r/6p1/p2p3p/1pp2b2/5P2/1PBn1R2/P5PP/3R2K1 b - - 1 23,b4,-470,-434,36,1
r4k1r/6p1/p2p3p/2p2b2/1p3P2/1PBn1R2/P5PP/3R2K1 w - - 0 24,Ba1,-466,-421,45,1
r4k1r/6p1/p2p3p/2p2b2/1p3P2/1P1n1R2/P5PP/B2R2K1 b - - 1 24,Re8,-433,-438,-5,1
4rk1r/6p1/p2p3p/2p2b2/1p3P2/1P1n1R2/P5PP/B2R2K1 w - - 2 25,Rg3,-453,-443,10,1
4rk1r/6p1/p2p3p/2p2b2/1p3P2/1P1n2R1/P5PP/B2R2K1 b - - 3 25,Nxf4,-530,-355,175,1
4rk1r/6p1/p2p3p/2p2b2/1p3n2/1P4R1/P5PP/B2R2K1 w - - 0 26,Bxg7+,-348,-451,-103,0
4rk1r/6B1/p2p3p/2p2b2/1p3n2/1P4R1/P5PP/3R2K1 b - - 0 26,Kg8,-422,-26,396,1
4r1kr/6B1/p2p3p/2p2b2/1p3n2/1P4R1/P5PP/3R2K1 w - - 1 27,Be5+,-11,-31,-20,1
4r1kr/8/p2p3p/2p1Bb2/1p3n2/1P4R1/P5PP/3R2K1 b - - 2 27,Ng6,-34,-25,9,1
4r1kr/8/p2p2np/2p1Bb2/1p6/1P4R1/P5PP/3R2K1 w - - 3 28,Bxh8,-35,-35,0,1
4r1kB/8/p2p2np/2p2b2/1p6/1P4R1/P5PP/3R2K1 b - - 0 28,Kxh8,-42,-34,8,1
4r2k/8/p2p2np/2p2b2/1p6/1P4R1/P5PP/3R2K1 w - - 0 29,Rxd6,-33,-45,-12,1
4r2k/8/p2R2np/2p2b2/1p6/1P4R1/P5PP/6K1 b - - 0 29,Re1+,-35,3,38,1
7k/8/p2R2np/2p2b2/1p6/1P4R1/P5PP/4r1K1 w - - 1 30,Kf2,0,-4,-4,1
7k/8/p2R2np/2p2b2/1p6/1P4R1/P4KPP/4r3 b - - 2 30,Ra1,0,0,0,1
7k/8/p2R2np/2p2b2/1p6/1P4R1/P4KPP/r7 w - - 3 31,Rxa6,33,21,-12,1
7k/8/R5np/2p2b2/1p6/1P4R1/P4KPP/r7 b - - 0 31,Rb1,11,72,61,1
7k/8/R5np/2p2b2/1p6/1P4R1/P4KPP/1r6 w - - 1 32,Rf3,104,-3,-107,0
7k/8/R5np/2p2b2/1p6/1P3R2/P4KPP/1r6 b - - 2 32,Rb2+,21,28,7,1
7k/8/R5np/2p2b2/1p6/1P3R2/Pr3KPP/8 w - - 3 33,Ke1,5,0,-5,1
7k/8/R5np/2p2b2/1p6/1P3R2/Pr4PP/4K3 b - - 4 33,Bc2,0,93,93,1
7k/8/R5np/2p5/1p6/1P3R2/Prb3PP/4K3 w - - 5 34,Ra8+,106,110,4,1
R6k/8/6np/2p5/1p6/1P3R2/Prb3PP/4K3 b - - 6 34,Kg7,99,102,3,1
R7/6k1/6np/2p5/1p6/1P3R2/Prb3PP/4K3 w - - 7 35,Ra7+,108,100,-8,1
8/R5k1/6np/2p5/1p6/1P3R2/Prb3PP/4K3 b - - 8 35,Kg8,104,114,10,1
rnbqkbnr/pppppppp/8/8/8/8/PPPPPPPP/RNBQKBNR w KQkq - 0 1,d4,36,-4,-40,1
rnbqkbnr/pppppppp/8/8/3P4/8/PPP1PPPP/RNBQKBNR b KQkq - 0 1,d5,15,26,11,1
rnbqkbnr/ppp1pppp/8/3p4/3P4/8/PPP1PPPP/RNBQKBNR w KQkq - 0 2,c4,16,15,-1,1
rnbqkbnr/ppp1pppp/8/3p4/2PP4/8/PP2PPPP/RNBQKBNR b KQkq - 0 2,dxc4,16,31,15,1
rnbqkbnr/ppp1pppp/8/8/2pP4/8/PP2PPPP/RNBQKBNR w KQkq - 0 3,Nc3,39,12,-27,1
rnbqkbnr/ppp1pppp/8/8/2pP4/2N5/PP2PPPP/R1BQKBNR b KQkq - 1 3,c6,18,15,-3,1
rnbqkbnr/pp2pppp/2p5/8/2pP4/2N5/PP2PPPP/R1BQKBNR w KQkq - 0 4,e4,17,-12,-29,1
rnbqkbnr/pp2pppp/2p5/8/2pPP3/2N5/PP3PPP/R1BQKBNR b KQkq - 0 4,Nf6,-20,119,139,1
rnbqkb1r/pp2pppp/2p2n2/8/2pPP3/2N5/PP3PPP/R1BQKBNR w KQkq - 1 5,Bxc4,123,125,2,1
rnbqkb1r/pp2pppp/2p2n2/8/2BPP3/2N5/PP3PPP/R1BQK1NR b KQkq - 0 5,e6,114,142,28,1
rnbqkb1r/pp3ppp/2p1pn2/8/2BPP3/2N5/PP3PPP/R1BQK1NR w KQkq - 0 6,a3,143,105,-38,1
rnbqkb1r/pp3ppp/2p1pn2/8/2BPP3/P1N5/1P3PPP/R1BQK1NR b KQkq - 0 6,Be7,87,170,83,1
rnbqk2r/pp2bppp/2p1pn2/8/2BPP3/P1N5/1P3PPP/R1BQK1NR w KQkq - 1 7,Bg5,164,26,-138,0
rnbqk2r/pp2bppp/2p1pn2/6B1/2BPP3/P1N5/1P3PPP/R2QK1NR b KQkq - 2 7,O-O,-9,81,90,1
rnbq1rk1/pp2bppp/2p1pn2/6B1/2BPP3/P1N5/1P3PPP/R2QK1NR w KQ - 3 8,Nf3,89,69,-20,1
rnbq1rk1/pp2bppp/2p1pn2/6B1/2BPP3/P1N2N2/1P3PPP/R2QK2R b KQ - 4 8,Nbd7,51,129,78,1
r1bq1rk1/pp1nbppp/2p1pn2/6B1/2BPP3/P1N2N2/1P3PPP/R2QK2R w KQ - 5 9,O-O,132,145,13,1
r1bq1rk1/pp1nbppp/2p1pn2/6B1/2BPP3/P1N2N2/1P3PPP/R2Q1RK1 b - - 6 9,b5,138,145,7,1
r1bq1rk1/p2nbppp/2p1pn2/1p4B1/2BPP3/P1N2N2/1P3PPP/R2Q1RK1 w - - 0 10,Bb3,151,74,-77,1
r1bq1rk1/p2nbppp/2p1pn2/1p4B1/3PP3/PBN2N2/1P3PPP/R2Q1RK1 b - - 1 10,a5,78,114,36,1
r1bq1rk1/3nbppp/2p1pn2/pp4B1/3PP3/PBN2N2/1P3PPP/R2Q1RK1 w - - 0 11,Bc2,122,92,-30,1
r1bq1rk1/3nbppp/2p1pn2/pp4B1/3PP3/P1N2N2/1PB2PPP/R2Q1RK1 b - - 1 11,a4,130,196,66,1
r1bq1rk1/3nbppp/2p1pn2/1p4B1/p2PP3/P1N2N2/1PB2PPP/R2Q1RK1 w - - 0 12,Qd3,168,57,-111,0
r1bq1rk1/3nbppp/2p1pn2/1p4B1/p2PP3/P1NQ1N2/1PB2PPP/R4RK1 b - - 1 12,Ba6,34,30,-4,1
r2q1rk1/3nbppp/b1p1pn2/1p4B1/p2PP3/P1NQ1N2/1PB2PPP/R4RK1 w - - 2 13,e5,41,-137,-178,0
r2q1rk1/3nbppp/b1p1pn2/1p2P1B1/p2P4/P1NQ1N2/1PB2PPP/R4RK1 b - - 0 13,g6,-86,325,411,1
r2q1rk1/3nbp1p/b1p1pnp1/1p2P1B1/p2P4/P1NQ1N2/1PB2PPP/R4RK1 w - - 0 14,exf6,303,362,59,1
r2q1rk1/3nbp1p/b1p1pPp1/1p4B1/p2P4/P1NQ1N2/1PB2PPP/R4RK1 b - - 0 14,Bxf6,371,350,-21,1
r2q1rk1/3n1p1p/b1p1pbp1/1p4B1/p2P4/P1NQ1N2/1PB2PPP/R4RK1 w - - 0 15,Bxf6,336,335,-1,1
r2q1rk1/3n1p1p/b1p1pBp1/1p6/p2P4/P1NQ1N2/1PB2PPP/R4RK1 b - - 0 15,Nxf6,363,373,10,1
r2q1rk1/5p1p/b1p1pnp1/1p6/p2P4/P1NQ1N2/1PB2PPP/R4RK1 w - - 0 16,Ne4,394,216,-178,0
r2q1rk1/5p1p/b1p1pnp1/1p6/p2PN3/P2Q1N2/1PB2PPP/R4RK1 b - - 1 16,b4,189,206,17,1
r2q1rk1/5p1p/b1p1pnp1/8/pp1PN3/P2Q1N2/1PB2PPP/R4RK1 w - - 0 17,Nxf6+,221,174,-47,1
r2q1rk1/5p1p/b1p1pNp1/8/pp1P4/P2Q1N2/1PB2PPP/R4RK1 b - - 0 17,Qxf6,189,197,8,1
r4rk1/5p1p/b1p1pqp1/8/pp1P4/P2Q1N2/1PB2PPP/R4RK1 w - - 0 18,Qe4,215,158,-57,1
r4rk1/5p1p/b1p1pqp1/8/pp1PQ3/P4N2/1PB2PPP/R4RK1 b - - 1 18,Bxf1,179,161,-18,1
r4rk1/5p1p/2p1pqp1/8/pp1PQ3/P4N2/1PB2PPP/R4bK1 w - - 0 19,Rxf1,178,181,3,1
r4rk1/5p1p/2p1pqp1/8/pp1PQ3/P4N2/1PB2PPP/5RK1 b - - 0 19,Rad8,176,256,80,1
3r1rk1/5p1p/2p1pqp1/8/pp1PQ3/P4N2/1PB2PPP/5RK1 w - - 1 20,Bxa4,262,247,-15,1
3r1rk1/5p1p/2p1pqp1/8/Bp1PQ3/P4N2/1P3PPP/5RK1 b - - 0 20,Rc8,254,353,99,1
2r2rk1/5p1p/2p1pqp1/8/Bp1PQ3/P4N2/1P3PPP/5RK1 w - - 1 21,axb4,366,369,3,1
2r2rk1/5p1p/2p1pqp1/8/BP1PQ3/5N2/1P3PPP/5RK1 b - - 0 21,Rb8,371,377,6,1
1r3rk1/5p1p/2p1pqp1/8/BP1PQ3/5N2/1P3PPP/5RK1 w - - 1 22,Bxc6,406,325,-81,1
1r3rk1/5p1p/2B1pqp1/8/1P1PQ3/5N2/1P3PPP/5RK1 b - - 0 22,Rxb4,282,302,20,1
5rk1/5p1p/2B1pqp1/8/1r1PQ3/5N2/1P3PPP/5RK1 w - - 0 23,Ne5,301,280,-21,1
5rk1/5p1p/2B1pqp1/4N3/1r1PQ3/8/1P3PPP/5RK1 b - - 1 23,Rc8,293,316,23,1
2r3k1/5p1p/2B1pqp1/4N3/1r1PQ3/8/1P3PPP/5RK1 w - - 2 24,Bd7,291,219,-72,1
2r3k1/3B1p1p/4pqp1/4N3/1r1PQ3/8/1P3PPP/5RK1 b - - 3 24,Rcb8,287,346,59,1
1r4k1/3B1p1p/4pqp1/4N3/1r1PQ3/8/1P3PPP/5RK1 w - - 4 25,Rb1,407,96,-311,0
1r4k1/3B1p1p/4pqp1/4N3/1r1PQ3/8/1P3PPP/1R4K1 b - - 5 25,Rxb2,157,131,-26,1
1r4k1/3B1p1p/4pqp1/4N3/3PQ3/8/1r3PPP/1R4K1 w - - 0 26,Rxb2,161,58,-103,0
1r4k1/3B1p1p/4pqp1/4N3/3PQ3/8/1R3PPP/6K1 b - - 0 26,Rxb2,1,24,23,1
6k1/3B1p1p/4pqp1/4N3/3PQ3/8/1r3PPP/6K1 w - - 0 27,Nf3,35,-79,-114,0
6k1/3B1p1p/4pqp1/8/3PQ3/5N2/1r3PPP/6K1 b - - 1 27,Qe7,-88,40,128,1
6k1/3Bqp1p/4p1p1/8/3PQ3/5N2/1r3PPP/6K1 w - - 2 28,Bc6,56,35,-21,1
rnbqkbnr/pppppppp/8/8/8/8/PPPPPPPP/RNBQKBNR w KQkq - 0 1,e4,35,29,-6,1
rnbqkbnr/pppppppp/8/8/4P3/8/PPPP1PPP/RNBQKBNR b KQkq - 0 1,e5,32,35,3,1
rnbqkbnr/pppp1ppp/8/4p3/4P3/8/PPPP1PPP/RNBQKBNR w KQkq - 0 2,Nf3,34,28,-6,1
rnbqkbnr/pppp1ppp/8/4p3/4P3/5N2/PPPP1PPP/RNBQKB1R b KQkq - 1 2,Nc6,29,28,-1,1
r1bqkbnr/pppp1ppp/2n5/4p3/4P3/5N2/PPPP1PPP/RNBQKB1R w KQkq - 2 3,Bc4,35,20,-15,1
r1bqkbnr/pppp1ppp/2n5/4p3/2B1P3/5N2/PPPP1PPP/RNBQK2R b KQkq - 3 3,d6,14,27,13,1
r1bqkbnr/ppp2ppp/2np4/4p3/2B1P3/5N2/PPPP1PPP/RNBQK2R w KQkq - 0 4,d3,43,-7,-50,1
r1bqkbnr/ppp2ppp/2np4/4p3/2B1P3/3P1N2/PPP2PPP/RNBQK2R b KQkq - 0 4,Be7,9,46,37,1
r1bqk1nr/ppp1bppp/2np4/4p3/2B1P3/3P1N2/PPP2PPP/RNBQK2R w KQkq - 1 5,Nc3,36,-17,-53,1
r1bqk1nr/ppp1bppp/2np4/4p3/2B1P3/2NP1N2/PPP2PPP/R1BQK2R b KQkq - 2 5,Nf6,-12,38,50,1
r1bqk2r/ppp1bppp/2np1n2/4p3/2B1P3/2NP1N2/PPP2PPP/R1BQK2R w KQkq - 3 6,h3,41,4,-37,1
r1bqk2r/ppp1bppp/2np1n2/4p3/2B1P3/2NP1N1P/PPP2PP1/R1BQK2R b KQkq - 0 6,O-O,3,33,30,1
r1bq1rk1/ppp1bppp/2np1n2/4p3/2B1P3/2NP1N1P/PPP2PP1/R1BQK2R w KQ - 1 7,Ng5,37,-44,-81,1
r1bq1rk1/ppp1bppp/2np1n2/4p1N1/2B1P3/2NP3P/PPP2PP1/R1BQK2R b KQ - 2 7,Nd4,-44,-6,38,1
r1bq1rk1/ppp1bppp/3p1n2/4p1N1/2BnP3/2NP3P/PPP2PP1/R1BQK2R w KQ - 3 8,Nxf7,-11,-208,-197,0
r1bq1rk1/ppp1bNpp/3p1n2/4p3/2BnP3/2NP3P/PPP2PP1/R1BQK2R b KQ - 0 8,Rxf7,-220,-228,-8,1
r1bq2k1/ppp1brpp/3p1n2/4p3/2BnP3/2NP3P/PPP2PP1/R1BQK2R w KQ - 0 9,Bxf7+,-229,-219,10,1
r1bq2k1/ppp1bBpp/3p1n2/4p3/3nP3/2NP3P/PPP2PP1/R1BQK2R b KQ - 0 9,Kxf7,-225,-197,28,1
r1bq4/ppp1bkpp/3p1n2/4p3/3nP3/2NP3P/PPP2PP1/R1BQK2R w KQ - 0 10,Ne2,-205,-229,-24,1
r1bq4/ppp1bkpp/3p1n2/4p3/3nP3/3P3P/PPP1NPP1/R1BQK2R b KQ - 1 10,c5,-234,-226,8,1
r1bq4/pp2bkpp/3p1n2/2p1p3/3nP3/3P3P/PPP1NPP1/R1BQK2R w KQ - 0 11,Nxd4,-233,-241,-8,1
r1bq4/pp2bkpp/3p1n2/2p1p3/3NP3/3P3P/PPP2PP1/R1BQK2R b KQ - 0 11,cxd4,-249,-251,-2,1
r1bq4/pp2bkpp/3p1n2/4p3/3pP3/3P3P/PPP2PP1/R1BQK2R w KQ - 0 12,Qf3,-235,-326,-91,1
r1bq4/pp2bkpp/3p1n2/4p3/3pP3/3P1Q1P/PPP2PP1/R1B1K2R b KQ - 1 12,Kg8,-299,-286,13,1
r1bq2k1/pp2b1pp/3p1n2/4p3/3pP3/3P1Q1P/PPP2PP1/R1B1K2R w KQ - 2 13,O-O,-289,-285,4,1
r1bq2k1/pp2b1pp/3p1n2/4p3/3pP3/3P1Q1P/PPP2PP1/R1B2RK1 b - - 3 13,Be6,-279,-284,-5,1
r2q2k1/pp2b1pp/3pbn2/4p3/3pP3/3P1Q1P/PPP2PP1/R1B2RK1 w - - 4 14,c3,-279,-290,-11,1
r2q2k1/pp2b1pp/3pbn2/4p3/3pP3/2PP1Q1P/PP3PP1/R1B2RK1 b - - 0 14,dxc3,-278,-277,1,1
r2q2k1/pp2b1pp/3pbn2/4p3/4P3/2pP1Q1P/PP3PP1/R1B2RK1 w - - 0 15,bxc3,-297,-277,20,1
r2q2k1/pp2b1pp/3pbn2/4p3/4P3/2PP1Q1P/P4PP1/R1B2RK1 b - - 0 15,Qc7,-281,-245,36,1
r5k1/ppq1b1pp/3pbn2/4p3/4P3/2PP1Q1P/P4PP1/R1B2RK1 w - - 1 16,c4,-239,-250,-11,1
r5k1/ppq1b1pp/3pbn2/4p3/2P1P3/3P1Q1P/P4PP1/R1B2RK1 b - - 0 16,Rf8,-247,-252,-5,1
5rk1/ppq1b1pp/3pbn2/4p3/2P1P3/3P1Q1P/P4PP1/R1B2RK1 w - - 1 17,Qg3,-223,-292,-69,1
5rk1/ppq1b1pp/3pbn2/4p3/2P1P3/3P2QP/P4PP1/R1B2RK1 b - - 2 17,a6,-289,-246,43,1
5rk1/1pq1b1pp/p2pbn2/4p3/2P1P3/3P2QP/P4PP1/R1B2RK1 w - - 0 18,Bh6,-251,-568,-317,0
5rk1/1pq1b1pp/p2pbn1B/4p3/2P1P3/3P2QP/P4PP1/R4RK1 b - - 1 18,Rf7,-546,-374,172,1
6k1/1pq1brpp/p2pbn1B/4p3/2P1P3/3P2QP/P4PP1/R4RK1 w - - 2 19,Rad1,-350,-506,-156,0
6k1/1pq1brpp/p2pbn1B/4p3/2P1P3/3P2QP/P4PP1/3R1RK1 b - - 3 19,Nh5,-567,-568,-1,1
6k1/1pq1brpp/p2pb2B/4p2n/2P1P3/3P2QP/P4PP1/3R1RK1 w - - 4 20,Qe3,-560,-547,13,1
6k1/1pq1brpp/p2pb2B/4p2n/2P1P3/3PQ2P/P4PP1/3R1RK1 b - - 5 20,gxh6,-541,-521,20,1
6k1/1pq1br1p/p2pb2p/4p2n/2P1P3/3PQ2P/P4PP1/3R1RK1 w - - 0 21,Qxh6,-522,-603,-81,1
6k1/1pq1br1p/p2pb2Q/4p2n/2P1P3/3P3P/P4PP1/3R1RK1 b - - 0 21,Nf6,-565,-399,166,1
6k1/1pq1br1p/p2pbn1Q/4p3/2P1P3/3P3P/P4PP1/3R1RK1 w - - 1 22,f4,-428,-428,0,1
6k1/1pq1br1p/p2pbn1Q/4p3/2P1PP2/3P3P/P5P1/3R1RK1 b - - 0 22,Rg7,-431,-336,95,1
6k1/1pq1b1rp/p2pbn1Q/4p3/2P1PP2/3P3P/P5P1/3R1RK1 w - - 1 23,fxe5,-380,-360,20,1
6k1/1pq1b1rp/p2pbn1Q/4P3/2P1P3/3P3P/P5P1/3R1RK1 b - - 0 23,dxe5,-362,-293,69,1
6k1/1pq1b1rp/p3bn1Q/4p3/2P1P3/3P3P/P5P1/3R1RK1 w - - 0 24,Rf2,-295,-505,-210,0
6k1/1pq1b1rp/p3bn1Q/4p3/2P1P3/3P3P/P4RP1/3R2K1 b - - 1 24,Rg6,-502,-499,3,1
6k1/1pq1b2p/p3bnrQ/4p3/2P1P3/3P3P/P4RP1/3R2K1 w - - 2 25,Qe3,-486,-546,-60,1
6k1/1pq1b2p/p3bnr1/4p3/2P1P3/3PQ2P/P4RP1/3R2K1 b - - 3 25,Qd7,-514,-479,35,1
6k1/1p1qb2p/p3bnr1/4p3/2P1P3/3PQ2P/P4RP1/3R2K1 w - - 4 26,Rdf1,-455,-491,-36,1
6k1/1p1qb2p/p3bnr1/4p3/2P1P3/3PQ2P/P4RP1/5RK1 b - - 5 26,Bxh3,-480,-434,46,1
rnbqkbnr/pppppppp/8/8/8/8/PPPPPPPP/RNBQKBNR w KQkq - 0 1,d4,32,23,-9,1
rnbqkbnr/pppppppp/8/8/3P4/8/PPP1PPPP/RNBQKBNR b KQkq - 0 1,e6,27,49,22,1
rnbqkbnr/pppp1ppp/4p3/8/3P4/8/PPP1PPPP/RNBQKBNR w KQkq - 0 2,c4,40,22,-18,1
rnbqkbnr/pppp1ppp/4p3/8/2PP4/8/PP2PPPP/RNBQKBNR b KQkq - 0 2,Nf6,21,19,-2,1
rnbqkb1r/pppp1ppp/4pn2/8/2PP4/8/PP2PPPP/RNBQKBNR w KQkq - 1 3,Nf3,22,20,-2,1
rnbqkb1r/pppp1ppp/4pn2/8/2PP4/5N2/PP2PPPP/RNBQKB1R b KQkq - 2 3,c5,21,76,55,1
rnbqkb1r/pp1p1ppp/4pn2/2p5/2PP4/5N2/PP2PPPP/RNBQKB1R w KQkq - 0 4,d5,90,47,-43,1
rnbqkb1r/pp1p1ppp/4pn2/2pP4/2P5/5N2/PP2PPPP/RNBQKB1R b KQkq - 0 4,exd5,64,83,19,1
rnbqkb1r/pp1p1ppp/5n2/2pp4/2P5/5N2/PP2PPPP/RNBQKB1R w KQkq - 0 5,cxd5,91,83,-8,1
rnbqkb1r/pp1p1ppp/5n2/2pP4/8/5N2/PP2PPPP/RNBQKB1R b KQkq - 0 5,d6,87,87,0,1
rnbqkb1r/pp3ppp/3p1n2/2pP4/8/5N2/PP2PPPP/RNBQKB1R w KQkq - 0 6,Nc3,96,89,-7,1
rnbqkb1r/pp3ppp/3p1n2/2pP4/8/2N2N2/PP2PPPP/R1BQKB1R b KQkq - 1 6,Be7,87,103,16,1
rnbqk2r/pp2bppp/3p1n2/2pP4/8/2N2N2/PP2PPPP/R1BQKB1R w KQkq - 2 7,e4,100,92,-8,1
rnbqk2r/pp2bppp/3p1n2/2pP4/4P3/2N2N2/PP3PPP/R1BQKB1R b KQkq - 0 7,O-O,114,113,-1,1
rnbq1rk1/pp2bppp/3p1n2/2pP4/4P3/2N2N2/PP3PPP/R1BQKB1R w KQ - 1 8,h3,111,112,1,1
rnbq1rk1/pp2bppp/3p1n2/2pP4/4P3/2N2N1P/PP3PP1/R1BQKB1R b KQ - 0 8,a6,104,112,8,1
rnbq1rk1/1p2bppp/p2p1n2/2pP4/4P3/2N2N1P/PP3PP1/R1BQKB1R w KQ - 0 9,Bd3,108,41,-67,1
rnbq1rk1/1p2bppp/p2p1n2/2pP4/4P3/2NB1N1P/PP3PP1/R1BQK2R b KQ - 1 9,b5,78,75,-3,1
rnbq1rk1/4bppp/p2p1n2/1ppP4/4P3/2NB1N1P/PP3PP1/R1BQK2R w KQ - 0 10,O-O,89,85,-4,1
rnbq1rk1/4bppp/p2p1n2/1ppP4/4P3/2NB1N1P/PP3PP1/R1BQ1RK1 b - - 1 10,Re8,83,85,2,1
rnbqr1k1/4bppp/p2p1n2/1ppP4/4P3/2NB1N1P/PP3PP1/R1BQ1RK1 w - - 2 11,Re1,91,69,-22,1
rnbqr1k1/4bppp/p2p1n2/1ppP4/4P3/2NB1N1P/PP3PP1/R1BQR1K1 b - - 3 11,Bb7,68,114,46,1
rn1qr1k1/1b2bppp/p2p1n2/1ppP4/4P3/2NB1N1P/PP3PP1/R1BQR1K1 w - - 4 12,Bf4,94,96,2,1
rn1qr1k1/1b2bppp/p2p1n2/1ppP4/4PB2/2NB1N1P/PP3PP1/R2QR1K1 b - - 5 12,Nfd7,103,157,54,1
rn1qr1k1/1b1nbppp/p2p4/1ppP4/4PB2/2NB1N1P/PP3PP1/R2QR1K1 w - - 6 13,e5,137,56,-81,1
rn1qr1k1/1b1nbppp/p2p4/1ppPP3/5B2/2NB1N1P/PP3PP1/R2QR1K1 b - - 0 13,Nxe5,49,105,56,1
rn1qr1k1/1b2bppp/p2p4/1ppPn3/5B2/2NB1N1P/PP3PP1/R2QR1K1 w - - 0 14,Nxe5,159,-3,-162,0
rn1qr1k1/1b2bppp/p2p4/1ppPN3/5B2/2NB3P/PP3PP1/R2QR1K1 b - - 0 14,dxe5,2,10,8,1
rn1qr1k1/1b2bppp/p7/1ppPp3/5B2/2NB3P/PP3PP1/R2QR1K1 w - - 0 15,Bxe5,10,5,-5,1
rn1qr1k1/1b2bppp/p7/1ppPB3/8/2NB3P/PP3PP1/R2QR1K1 b - - 0 15,Nd7,4,9,5,1
r2qr1k1/1b1nbppp/p7/1ppPB3/8/2NB3P/PP3PP1/R2QR1K1 w - - 1 16,d6,9,-100,-109,0
r2qr1k1/1b1nbppp/p2P4/1pp1B3/8/2NB3P/PP3PP1/R2QR1K1 b - - 0 16,Bf6,-31,-12,19,1
r2qr1k1/1b1n1ppp/p2P1b2/1pp1B3/8/2NB3P/PP3PP1/R2QR1K1 w - - 1 17,Bg3,-13,-73,-60,1
r2qr1k1/1b1n1ppp/p2P1b2/1pp5/8/2NB2BP/PP3PP1/R2QR1K1 b - - 2 17,c4,-73,61,134,1
r2qr1k1/1b1n1ppp/p2P1b2/1p6/2p5/2NB2BP/PP3PP1/R2QR1K1 w - - 0 18,Be4,62,-275,-337,0
r2qr1k1/1b1n1ppp/p2P1b2/1p6/2p1B3/2N3BP/PP3PP1/R2QR1K1 b - - 1 18,Bxe4,-290,-99,191,1
r2qr1k1/3n1ppp/p2P1b2/1p6/2p1b3/2N3BP/PP3PP1/R2QR1K1 w - - 0 19,Nxe4,-115,-102,13,1
r2qr1k1/3n1ppp/p2P1b2/1p6/2p1N3/6BP/PP3PP1/R2QR1K1 b - - 0 19,Be5,-104,78,182,1
r2qr1k1/3n1ppp/p2P4/1p2b3/2p1N3/6BP/PP3PP1/R2QR1K1 w - - 1 20,Bxe5,65,72,7,1
r2qr1k1/3n1ppp/p2P4/1p2B3/2p1N3/7P/PP3PP1/R2QR1K1 b - - 0 20,Rxe5,59,58,-1,1
r2q2k1/3n1ppp/p2P4/1p2r3/2p1N3/7P/PP3PP1/R2QR1K1 w - - 0 21,Qd4,74,-7,-81,1
r2q2k1/3n1ppp/p2P4/1p2r3/2pQN3/7P/PP3PP1/R3R1K1 b - - 1 21,Re8,-13,115,128,1
r2qr1k1/3n1ppp/p2P4/1p6/2pQN3/7P/PP3PP1/R3R1K1 w - - 2 22,Re3,115,55,-60,1
r2qr1k1/3n1ppp/p2P4/1p6/2pQN3/4R2P/PP3PP1/R5K1 b - - 3 22,Qb6,49,41,-8,1
r3r1k1/3n1ppp/pq1P4/1p6/2pQN3/4R2P/PP3PP1/R5K1 w - - 4 23,Qxb6,33,27,-6,1
r3r1k1/3n1ppp/pQ1P4/1p6/2p1N3/4R2P/PP3PP1/R5K1 b - - 0 23,Nxb6,33,48,15,1
r3r1k1/5ppp/pn1P4/1p6/2p1N3/4R2P/PP3PP1/R5K1 w - - 0 24,Rd1,39,-12,-51,1
r3r1k1/5ppp/pn1P4/1p6/2p1N3/4R2P/PP3PP1/3R2K1 b - - 1 24,Rad8,11,86,75,1
3rr1k1/5ppp/pn1P4/1p6/2p1N3/4R2P/PP3PP1/3R2K1 w - - 2 25,Nc5,88,92,4,1
3rr1k1/5ppp/pn1P4/1pN5/2p5/4R2P/PP3PP1/3R2K1 b - - 3 25,Rxe3,70,67,-3,1
3r2k1/5ppp/pn1P4/1pN5/2p5/4r2P/PP3PP1/3R2K1 w - - 0 26,fxe3,57,52,-5,1
3r2k1/5ppp/pn1P4/1pN5/2p5/4P2P/PP4P1/3R2K1 b - - 0 26,Nd7,52,129,77,1
3r2k1/3n1ppp/p2P4/1pN5/2p5/4P2P/PP4P1/3R2K1 w - - 1 27,Nb7,95,-65,-160,0
3r2k1/1N1n1ppp/p2P4/1p6/2p5/4P2P/PP4P1/3R2K1 b - - 2 27,Rb8,-86,-69,17,1
1r4k1/1N1n1ppp/p2P4/1p6/2p5/4P2P/PP4P1/3R2K1 w - - 3 28,Na5,-73,-63,10,1
1r4k1/3n1ppp/p2P4/Np6/2p5/4P2P/PP4P1/3R2K1 b - - 4 28,Kf8,-79,-50,29,1
1r3k2/3n1ppp/p2P4/Np6/2p5/4P2P/PP4P1/3R2K1 w - - 5 29,Nc6,-33,-81,-48,1
1r3k2/3n1ppp/p1NP4/1p6/2p5/4P2P/PP4P1/3R2K1 b - - 6 29,Rc8,-125,-51,74,1
2r2k2/3n1ppp/p1NP4/1p6/2p5/4P2P/PP4P1/3R2K1 w - - 7 30,Nd4,-30,-104,-74,1
2r2k2/3n1ppp/p2P4/1p6/2pN4/4P2P/PP4P1/3R2K1 b - - 8 30,f6,-105,24,129,1
2r2k2/3n2pp/p2P1p2/1p6/2pN4/4P2P/PP4P1/3R2K1 w - - 0 31,Kf2,29,-54,-83,1
2r2k2/3n2pp/p2P1p2/1p6/2pN4/4P2P/PP3KP1/3R4 b - - 1 31,Kf7,-72,-44,28,1
2r5/3n1kpp/p2P1p2/1p6/2pN4/4P2P/PP3KP1/3R4 w - - 2 32,Kf3,-50,-111,-61,1
2r5/3n1kpp/p2P1p2/1p6/2pN4/4PK1P/PP4P1/3R4 b - - 3 32,Rd8,-86,-37,49,1
3r4/3n1kpp/p2P1p2/1p6/2pN4/4PK1P/PP4P1/3R4 w - - 4 33,Ke4,-49,-55,-6,1
3r4/3n1kpp/p2P1p2/1p6/2pNK3/4P2P/PP4P1/3R4 b - - 5 33,Nc5+,-52,0,52,1
3r4/5kpp/p2P1p2/1pn5/2pNK3/4P2P/PP4P1/3R4 w - - 6 34,Kd5,0,0,0,1
3r4/5kpp/p2P1p2/1pnK4/2pN4/4P2P/PP4P1/3R4 b - - 7 34,Nb7,0,121,121,1
3r4/1n3kpp/p2P1p2/1p1K4/2pN4/4P2P/PP4P1/3R4 w - - 8 35,Kc6,184,190,6,1
3r4/1n3kpp/p1KP1p2/1p6/2pN4/4P2P/PP4P1/3R4 b - - 9 35,Nxd6,144,176,32,1
3r4/5kpp/p1Kn1p2/1p6/2pN4/4P2P/PP4P1/3R4 w - - 0 36,Nf5,195,160,-35,1
3r4/5kpp/p1Kn1p2/1p3N2/2p5/4P2P/PP4P1/3R4 b - - 1 36,Nb7,152,145,-7,1
3r4/1n3kpp/p1K2p2/1p3N2/2p5/4P2P/PP4P1/3R4 w - - 2 37,Rxd8,164,137,-27,1
3R4/1n3kpp/p1K2p2/1p3N2/2p5/4P2P/PP4P1/8 b - - 0 37,Nxd8+,132,140,8,1
3n4/5kpp/p1K2p2/1p3N2/2p5/4P2P/PP4P1/8 w - - 0 38,Kb6,145,149,4,1
3n4/5kpp/pK3p2/1p3N2/2p5/4P2P/PP4P1/8 b - - 1 38,g6,165,197,32,1
3n4/5k1p/pK3pp1/1p3N2/2p5/4P2P/PP4P1/8 w - - 0 39,Nh6+,198,-15,-213,0
3n4/5k1p/pK3ppN/1p6/2p5/4P2P/PP4P1/8 b - - 1 39,Kg7,-4,49,53,1
3n4/6kp/pK3ppN/1p6/2p5/4P2P/PP4P1/8 w - - 2 40,Ng4,85,59,-26,1
3n4/6kp/pK3pp1/1p6/2p3N1/4P2P/PP4P1/8 b - - 3 40,f5,52,118,66,1
3n4/6kp/pK4p1/1p3p2/2p3N1/4P2P/PP4P1/8 w - - 0 41,Ne5,146,15,-131,0
3n4/6kp/pK4p1/1p2Np2/2p5/4P2P/PP4P1/8 b - - 1 41,Kf6,13,48,35,1
3n4/7p/pK3kp1/1p2Np2/2p5/4P2P/PP4P1/8 w - - 2 42,Nd7+,108,43,-65,1
3n4/3N3p/pK3kp1/1p3p2/2p5/4P2P/PP4P1/8 b - - 3 42,Ke7,19,-2,-21,1
3n4/3Nk2p/pK4p1/1p3p2/2p5/4P2P/PP4P1/8 w - - 4 43,Nc5,9,4,-5,1
3n4/4k2p/pK4p1/1pN2p2/2p5/4P2P/PP4P1/8 b - - 5 43,Kd6,0,204,204,1
3n4/7p/pK1k2p1/1pN2p2/2p5/4P2P/PP4P1/8 w - - 6 44,Nxa6,219,211,-8,1
3n4/7p/NK1k2p1/1p3p2/2p5/4P2P/PP4P1/8 b - - 0 44,Ke5,184,303,119,1
3n4/7p/NK4p1/1p2kp2/2p5/4P2P/PP4P1/8 w - - 1 45,Kxb5,332,309,-23,1
3n4/7p/N5p1/1K2kp2/2p5/4P2P/PP4P1/8 b - - 0 45,Ke4,339,337,-2,1
3n4/7p/N5p1/1K3p2/2p1k3/4P2P/PP4P1/8 w - - 1 46,Kxc4,359,236,-123,0
3n4/7p/N5p1/5p2/2K1k3/4P2P/PP4P1/8 b - - 0 46,Kxe3,295,305,10,1
3n4/7p/N5p1/5p2/2K5/4k2P/PP4P1/8 w - - 0 47,b4,311,316,5,1
3n4/7p/N5p1/5p2/1PK5/4k2P/P5P1/8 b - - 0 47,Nb7,285,387,102,1
8/1n5p/N5p1/5p2/1PK5/4k2P/P5P1/8 w - - 1 48,b5,408,243,-165,0
8/1n5p/N5p1/1P3p2/2K5/4k2P/P5P1/8 b - - 0 48,Nd6+,330,382,52,1
8/7p/N2n2p1/1P3p2/2K5/4k2P/P5P1/8 w - - 1 49,Kc5,362,350,-12,1
8/7p/N2n2p1/1PK2p2/8/4k2P/P5P1/8 b - - 2 49,Nb7+,373,434,61,1
8/1n5p/N5p1/1PK2p2/8/4k2P/P5P1/8 w - - 3 50,Kc6,457,454,-3,1
8/1n5p/N1K3p1/1P3p2/8/4k2P/P5P1/8 b - - 4 50,Na5+,430,456,26,1
8/7p/N1K3p1/nP3p2/8/4k2P/P5P1/8 w - - 5 51,Kc7,471,312,-159,0
8/2K4p/N5p1/nP3p2/8/4k2P/P5P1/8 b - - 6 51,f4,314,295,-19,1
8/2K4p/N5p1/nP6/5p2/4k2P/P5P1/8 w - - 0 52,b6,341,84,-257,0
8/2K4p/NP4p1/n7/5p2/4k2P/P5P1/8 b - - 0 52,Kf2,76,33,-43,1
8/2K4p/NP4p1/n7/5p2/7P/P4kP1/8 w - - 1 53,b7,23,-2,-25,1
8/1PK4p/N5p1/n7/5p2/7P/P4kP1/8 b - - 0 53,Nxb7,-11,0,11,1
8/1nK4p/N5p1/8/5p2/7P/P4kP1/8 w - - 0 54,Kxb7,0,0,0,1
8/1K5p/N5p1/8/5p2/7P/P4kP1/8 b - - 0 54,Kxg2,0,0,0,1
8/1K5p/N5p1/8/5p2/7P/P5k1/8 w - - 0 55,a4,0,-239,-239,0
8/1K5p/N5p1/8/P4p2/7P/6k1/8 b - - 0 55,f3,-237,-317,-80,1
8/1K5p/N5p1/8/P7/5p1P/6k1/8 w - - 0 56,Nc5,-293,-403,-110,0
8/1K5p/6p1/2N5/P7/5p1P/6k1/8 b - - 1 56,f2,-455,-454,1,1
8/1K5p/6p1/2N5/P7/7P/5pk1/8 w - - 0 57,a5,-509,-554,-45,1
8/1K5p/6p1/P1N5/8/7P/5pk1/8 b - - 0 57,f1=Q,-518,-569,-51,1
8/1K5p/6p1/P1N5/8/7P/6k1/5q2 w - - 0 58,a6,-552,-766,-214,0
8/1K5p/P5p1/2N5/8/7P/6k1/5q2 b - - 0 58,Qb5+,-815,-838,-23,1
rnbqkbnr/pppppppp/8/8/8/8/PPPPPPPP/RNBQKBNR w KQkq - 0 1,d4,41,17,-24,1
rnbqkbnr/pppppppp/8/8/3P4/8/PPP1PPPP/RNBQKBNR b KQkq - 0 1,d5,13,13,0,1
rnbqkbnr/ppp1pppp/8/3p4/3P4/8/PPP1PPPP/RNBQKBNR w KQkq - 0 2,e3,14,11,-3,1
rnbqkbnr/ppp1pppp/8/3p4/3P4/4P3/PPP2PPP/RNBQKBNR b KQkq - 0 2,a6,11,15,4,1
rnbqkbnr/1pp1pppp/p7/3p4/3P4/4P3/PPP2PPP/RNBQKBNR w KQkq - 0 3,Nf3,18,14,-4,1
rnbqkbnr/1pp1pppp/p7/3p4/3P4/4PN2/PPP2PPP/RNBQKB1R b KQkq - 1 3,Nc6,7,63,56,1
r1bqkbnr/1pp1pppp/p1n5/3p4/3P4/4PN2/PPP2PPP/RNBQKB1R w KQkq - 2 4,Be2,79,41,-38,1
r1bqkbnr/1pp1pppp/p1n5/3p4/3P4/4PN2/PPP1BPPP/RNBQK2R b KQkq - 3 4,Nf6,43,41,-2,1
r1bqkb1r/1pp1pppp/p1n2n2/3p4/3P4/4PN2/PPP1BPPP/RNBQK2R w KQkq - 4 5,a3,42,44,2,1
r1bqkb1r/1pp1pppp/p1n2n2/3p4/3P4/P3PN2/1PP1BPPP/RNBQK2R b KQkq - 0 5,e6,38,48,10,1
r1bqkb1r/1pp2ppp/p1n1pn2/3p4/3P4/P3PN2/1PP1BPPP/RNBQK2R w KQkq - 0 6,Nbd2,46,32,-14,1
r1bqkb1r/1pp2ppp/p1n1pn2/3p4/3P4/P3PN2/1PPNBPPP/R1BQK2R b KQkq - 1 6,Be7,40,72,32,1
r1bqk2r/1pp1bppp/p1n1pn2/3p4/3P4/P3PN2/1PPNBPPP/R1BQK2R w KQkq - 2 7,c4,64,61,-3,1
r1bqk2r/1pp1bppp/p1n1pn2/3p4/2PP4/P3PN2/1P1NBPPP/R1BQK2R b KQkq - 0 7,Ne4,44,78,34,1
r1bqk2r/1pp1bppp/p1n1p3/3p4/2PPn3/P3PN2/1P1NBPPP/R1BQK2R w KQkq - 1 8,Nxe4,81,57,-24,1
r1bqk2r/1pp1bppp/p1n1p3/3p4/2PPN3/P3PN2/1P2BPPP/R1BQK2R b KQkq - 0 8,dxe4,87,113,26,1
r1bqk2r/1pp1bppp/p1n1p3/8/2PPp3/P3PN2/1P2BPPP/R1BQK2R w KQkq - 0 9,Nd2,94,88,-6,1
r1bqk2r/1pp1bppp/p1n1p3/8/2PPp3/P3P3/1P1NBPPP/R1BQK2R b KQkq - 1 9,f5,93,87,-6,1
r1bqk2r/1pp1b1pp/p1n1p3/5p2/2PPp3/P3P3/1P1NBPPP/R1BQK2R w KQkq - 0 10,O-O,93,49,-44,1
r1bqk2r/1pp1b1pp/p1n1p3/5p2/2PPp3/P3P3/1P1NBPPP/R1BQ1RK1 b kq - 1 10,O-O,57,74,17,1
r1bq1rk1/1pp1b1pp/p1n1p3/5p2/2PPp3/P3P3/1P1NBPPP/R1BQ1RK1 w - - 2 11,f3,74,25,-49,1
r1bq1rk1/1pp1b1pp/p1n1p3/5p2/2PPp3/P3PP2/1P1NB1PP/R1BQ1RK1 b - - 0 11,Bf6,35,135,100,1
r1bq1rk1/1pp3pp/p1n1pb2/5p2/2PPp3/P3PP2/1P1NB1PP/R1BQ1RK1 w - - 1 12,fxe4,142,145,3,1
r1bq1rk1/1pp3pp/p1n1pb2/5p2/2PPP3/P3P3/1P1NB1PP/R1BQ1RK1 b - - 0 12,f4,151,294,143,1
r1bq1rk1/1pp3pp/p1n1pb2/8/2PPPp2/P3P3/1P1NB1PP/R1BQ1RK1 w - - 0 13,e5,276,272,-4,1
r1bq1rk1/1pp3pp/p1n1pb2/4P3/2PP1p2/P3P3/1P1NB1PP/R1BQ1RK1 b - - 0 13,Bg5,263,297,34,1
r1bq1rk1/1pp3pp/p1n1p3/4P1b1/2PP1p2/P3P3/1P1NB1PP/R1BQ1RK1 w - - 1 14,Ne4,260,219,-41,1
r1bq1rk1/1pp3pp/p1n1p3/4P1b1/2PPNp2/P3P3/1P2B1PP/R1BQ1RK1 b - - 2 14,Bh6,227,216,-11,1
r1bq1rk1/1pp3pp/p1n1p2b/4P3/2PPNp2/P3P3/1P2B1PP/R1BQ1RK1 w - - 3 15,exf4,210,164,-46,1
r1bq1rk1/1pp3pp/p1n1p2b/4P3/2PPNP2/P7/1P2B1PP/R1BQ1RK1 b - - 0 15,Qe7,168,449,281,1
r1b2rk1/1pp1q1pp/p1n1p2b/4P3/2PPNP2/P7/1P2B1PP/R1BQ1RK1 w - - 1 16,d5,416,346,-70,1
r1b2rk1/1pp1q1pp/p1n1p2b/3PP3/2P1NP2/P7/1P2B1PP/R1BQ1RK1 b - - 0 16,exd5,360,379,19,1
r1b2rk1/1pp1q1pp/p1n4b/3pP3/2P1NP2/P7/1P2B1PP/R1BQ1RK1 w - - 0 17,cxd5,412,377,-35,1
r1b2rk1/1pp1q1pp/p1n4b/3PP3/4NP2/P7/1P2B1PP/R1BQ1RK1 b - - 0 17,Na7,400,538,138,1
r1b2rk1/npp1q1pp/p6b/3PP3/4NP2/P7/1P2B1PP/R1BQ1RK1 w - - 1 18,Bc4,522,501,-21,1
r1b2rk1/npp1q1pp/p6b/3PP3/2B1NP2/P7/1P4PP/R1BQ1RK1 b - - 2 18,Bf5,515,670,155,1
r4rk1/npp1q1pp/p6b/3PPb2/2B1NP2/P7/1P4PP/R1BQ1RK1 w - - 3 19,d6+,702,658,-44,1
r4rk1/npp1q1pp/p2P3b/4Pb2/2B1NP2/P7/1P4PP/R1BQ1RK1 b - - 0 19,Qf7,680,631,-49,1
r4rk1/npp2qpp/p2P3b/4Pb2/2B1NP2/P7/1P4PP/R1BQ1RK1 w - - 1 20,Bxf7+,660,703,43,1
r4rk1/npp2Bpp/p2P3b/4Pb2/4NP2/P7/1P4PP/R1BQ1RK1 b - - 0 20,Rxf7,719,658,-61,1
r5k1/npp2rpp/p2P3b/4Pb2/4NP2/P7/1P4PP/R1BQ1RK1 w - - 0 21,dxc7,724,517,-207,0
r5k1/npP2rpp/p6b/4Pb2/4NP2/P7/1P4PP/R1BQ1RK1 b - - 0 21,Rc8,577,669,92,1
2r3k1/npP2rpp/p6b/4Pb2/4NP2/P7/1P4PP/R1BQ1RK1 w - - 1 22,Qd8+,718,696,-22,1
2rQ2k1/npP2rpp/p6b/4Pb2/4NP2/P7/1P4PP/R1B2RK1 b - - 2 22,Rxd8,663,799,136,1
3r2k1/npP2rpp/p6b/4Pb2/4NP2/P7/1P4PP/R1B2RK1 w - - 0 23,cxd8=Q+,833,843,10,1
3Q2k1/np3rpp/p6b/4Pb2/4NP2/P7/1P4PP/R1B2RK1 b - - 0 23,Rf8,904,875,-29,1
3Q1rk1/np4pp/p6b/4Pb2/4NP2/P7/1P4PP/R1B2RK1 w - - 1 24,Qd5+,871,865,-6,1
5rk1/np4pp/p6b/3QPb2/4NP2/P7/1P4PP/R1B2RK1 b - - 2 24,Kh8,835,861,26,1
5r1k/np4pp/p6b/3QPb2/4NP2/P7/1P4PP/R1B2RK1 w - - 3 25,Nd6,877,866,-11,1
5r1k/np4pp/p2N3b/3QPb2/5P2/P7/1P4PP/R1B2RK1 b - - 4 25,Bg6,863,910,47,1
5r1k/np4pp/p2N2bb/3QP3/5P2/P7/1P4PP/R1B2RK1 w - - 5 26,Qxb7,902,803,-99,1
5r1k/nQ4pp/p2N2bb/4P3/5P2/P7/1P4PP/R1B2RK1 b - - 0 26,Nb5,866,822,-44,1
5r1k/1Q4pp/p2N2bb/1n2P3/5P2/P7/1P4PP/R1B2RK1 w - - 1 27,Nxb5,858,828,-30,1
5r1k/1Q4pp/p5bb/1N2P3/5P2/P7/1P4PP/R1B2RK1 b - - 0 27,axb5,835,829,-6,1
5r1k/1Q4pp/6bb/1p2P3/5P2/P7/1P4PP/R1B2RK1 w - - 0 28,Qxb5,849,843,-6,1
5r1k/6pp/6bb/1Q2P3/5P2/P7/1P4PP/R1B2RK1 b - - 0 28,Bf5,815,815,0,1
5r1k/6pp/7b/1Q2Pb2/5P2/P7/1P4PP/R1B2RK1 w - - 1 29,Be3,878,793,-85,1
5r1k/6pp/7b/1Q2Pb2/5P2/P3B3/1P4PP/R4RK1 b - - 2 29,g6,847,862,15,1
5r1k/7p/6pb/1Q2Pb2/5P2/P3B3/1P4PP/R4RK1 w - - 0 30,Bd4,911,746,-165,0
5r1k/7p/6pb/1Q2Pb2/3B1P2/P7/1P4PP/R4RK1 b - - 1 30,Bg7,789,846,57,1
5r1k/6bp/6p1/1Q2Pb2/3B1P2/P7/1P4PP/R4RK1 w - - 2 31,Qd5,816,743,-73,1
5r1k/6bp/6p1/3QPb2/3B1P2/P7/1P4PP/R4RK1 b - - 3 31,h6,845,820,-25,1
5r1k/6b1/6pp/3QPb2/3B1P2/P7/1P4PP/R4RK1 w - - 0 32,Rad1,808,773,-35,1
5r1k/6b1/6pp/3QPb2/3B1P2/P7/1P4PP/3R1RK1 b - - 1 32,Re8,811,824,13,1
4r2k/6b1/6pp/3QPb2/3B1P2/P7/1P4PP/3R1RK1 w - - 2 33,Qf7,854,861,7,1
4r2k/5Qb1/6pp/4Pb2/3B1P2/P7/1P4PP/3R1RK1 b - - 3 33,Rf8,865,869,4,1
5r1k/5Qb1/6pp/4Pb2/3B1P2/P7/1P4PP/3R1RK1 w - - 4 34,Qe7,857,766,-91,1
5r1k/4Q1b1/6pp/4Pb2/3B1P2/P7/1P4PP/3R1RK1 b - - 5 34,Kh7,815,921,106,1
5r2/4Q1bk/6pp/4Pb2/3B1P2/P7/1P4PP/3R1RK1 w - - 6 35,e6,971,969,-2,1
5r2/4Q1bk/4P1pp/5b2/3B1P2/P7/1P4PP/3R1RK1 b - - 0 35,Rg8,976,991,15,1
6r1/4Q1bk/4P1pp/5b2/3B1P2/P7/1P4PP/3R1RK1 w - - 1 36,Qd6,982,814,-168,0
6r1/6bk/3QP1pp/5b2/3B1P2/P7/1P4PP/3R1RK1 b - - 2 36,h5,862,894,32,1
6r1/6bk/3QP1p1/5b1p/3B1P2/P7/1P4PP/3R1RK1 w - - 0 37,Bxg7,974,954,-20,1
6r1/6Bk/3QP1p1/5b1p/5P2/P7/1P4PP/3R1RK1 b - - 0 37,Rxg7,928,931,3,1
8/6rk/3QP1p1/5b1p/5P2/P7/1P4PP/3R1RK1 w - - 0 38,e7,919,913,-6,1
8/4P1rk/3Q2p1/5b1p/5P2/P7/1P4PP/3R1RK1 b - - 0 38,Bg4,927,931,4,1
8/4P1rk/3Q2p1/7p/5Pb1/P7/1P4PP/3R1RK1 w - - 1 39,e8=Q,952,1117,165,1
4Q3/6rk/3Q2p1/7p/5Pb1/P7/1P4PP/3R1RK1 b - - 0 39,Bxd1,1127,9994,8867,1
4Q3/6rk/3Q2p1/7p/5P2/P7/1P4PP/3b1RK1 w - - 0 40,Rxd1,9997,9995,-2,1
4Q3/6rk/3Q2p1/7p/5P2/P7/1P4PP/3R2K1 b - - 0 40,h4,9995,9995,0,1
4Q3/6rk/3Q2p1/8/5P1p/P7/1P4PP/3R2K1 w - - 0 41,Qf6,9995,9997,2,1
4Q3/6rk/5Qp1/8/5P1p/P7/1P4PP/3R2K1 b - - 1 41,g5,9997,9998,1,1
4Q3/6rk/5Q2/6p1/5P1p/P7/1P4PP/3R2K1 w - - 0 42,Rd7,9998,9999,1,1
4Q3/3R2rk/5Q2/6p1/5P1p/P7/1P4PP/6K1 b - - 1 42,Rxd7,9999,9999,0,1
4Q3/3r3k/5Q2/6p1/5P1p/P7/1P4PP/6K1 w - - 0 43,Qeh8#,9999,10000,1,1
rnbqkbnr/pppppppp/8/8/8/8/PPPPPPPP/RNBQKBNR w KQkq - 0 1,h4,35,-57,-92,1
rnbqkbnr/pppppppp/8/8/7P/8/PPPPPPP1/RNBQKBNR b KQkq - 0 1,e5,-43,-43,0,1
rnbqkbnr/pppp1ppp/8/4p3/7P/8/PPPPPPP1/RNBQKBNR w KQkq - 0 2,a4,-49,-133,-84,1
rnbqkbnr/pppp1ppp/8/4p3/P6P/8/1PPPPPP1/RNBQKBNR b KQkq - 0 2,d5,-127,-135,-8,1
rnbqkbnr/ppp2ppp/8/3pp3/P6P/8/1PPPPPP1/RNBQKBNR w KQkq - 0 3,b3,-123,-173,-50,1
rnbqkbnr/ppp2ppp/8/3pp3/P6P/1P6/2PPPPP1/RNBQKBNR b KQkq - 0 3,Bc5,-159,-142,17,1
rnbqk1nr/ppp2ppp/8/2bpp3/P6P/1P6/2PPPPP1/RNBQKBNR w KQkq - 1 4,Ba3,-128,-174,-46,1
rnbqk1nr/ppp2ppp/8/2bpp3/P6P/BP6/2PPPPP1/RN1QKBNR b KQkq - 2 4,Bxa3,-178,-154,24,1
rnbqk1nr/ppp2ppp/8/3pp3/P6P/bP6/2PPPPP1/RN1QKBNR w KQkq - 0 5,Rxa3,-174,-200,-26,1
rnbqk1nr/ppp2ppp/8/3pp3/P6P/RP6/2PPPPP1/1N1QKBNR b Kkq - 0 5,Nf6,-215,-208,7,1
rnbqk2r/ppp2ppp/5n2/3pp3/P6P/RP6/2PPPPP1/1N1QKBNR w Kkq - 1 6,g3,-186,-210,-24,1
rnbqk2r/ppp2ppp/5n2/3pp3/P6P/RP4P1/2PPPP2/1N1QKBNR b Kkq - 0 6,c5,-232,-205,27,1
rnbqk2r/pp3ppp/5n2/2ppp3/P6P/RP4P1/2PPPP2/1N1QKBNR w Kkq - 0 7,Bh3,-209,-249,-40,1
rnbqk2r/pp3ppp/5n2/2ppp3/P6P/RP4PB/2PPPP2/1N1QK1NR b Kkq - 1 7,O-O,-239,-260,-21,1
rnbq1rk1/pp3ppp/5n2/2ppp3/P6P/RP4PB/2PPPP2/1N1QK1NR w K - 2 8,Bxc8,-246,-280,-34,1
rnBq1rk1/pp3ppp/5n2/2ppp3/P6P/RP4P1/2PPPP2/1N1QK1NR b K - 0 8,Qxc8,-272,-292,-20,1
rnq2rk1/pp3ppp/5n2/2ppp3/P6P/RP4P1/2PPPP2/1N1QK1NR w K - 0 9,h5,-279,-291,-12,1
rnq2rk1/pp3ppp/5n2/2ppp2P/P7/RP4P1/2PPPP2/1N1QK1NR b K - 0 9,h6,-285,-270,15,1
rnq2rk1/pp3pp1/5n1p/2ppp2P/P7/RP4P1/2PPPP2/1N1QK1NR w K - 0 10,e3,-287,-305,-18,1
rnq2rk1/pp3pp1/5n1p/2ppp2P/P7/RP2P1P1/2PP1P2/1N1QK1NR b K - 0 10,Nc6,-309,-303,6,1
r1q2rk1/pp3pp1/2n2n1p/2ppp2P/P7/RP2P1P1/2PP1P2/1N1QK1NR w K - 1 11,Rh4,-302,-294,8,1
r1q2rk1/pp3pp1/2n2n1p/2ppp2P/P6R/RP2P1P1/2PP1P2/1N1QK1N1 b - - 2 11,Qd7,-295,-261,34,1
r4rk1/pp1q1pp1/2n2n1p/2ppp2P/P6R/RP2P1P1/2PP1P2/1N1QK1N1 w - - 3 12,g4,-257,-393,-136,0
r4rk1/pp1q1pp1/2n2n1p/2ppp2P/P5PR/RP2P3/2PP1P2/1N1QK1N1 b - - 0 12,d4,-411,-344,67,1
r4rk1/pp1q1pp1/2n2n1p/2p1p2P/P2p2PR/RP2P3/2PP1P2/1N1QK1N1 w - - 0 13,g5,-376,-513,-137,0
r4rk1/pp1q1pp1/2n2n1p/2p1p1PP/P2p3R/RP2P3/2PP1P2/1N1QK1N1 b - - 0 13,Nd5,-445,-301,144,1
r4rk1/pp1q1pp1/2n4p/2pnp1PP/P2p3R/RP2P3/2PP1P2/1N1QK1N1 w - - 1 14,gxh6,-297,-290,7,1
r4rk1/pp1q1pp1/2n4P/2pnp2P/P2p3R/RP2P3/2PP1P2/1N1QK1N1 b - - 0 14,dxe3,-320,-61,259,1
r4rk1/pp1q1pp1/2n4P/2pnp2P/P6R/RP2p3/2PP1P2/1N1QK1N1 w - - 0 15,hxg7,-57,-199,-142,0
r4rk1/pp1q1pP1/2n5/2pnp2P/P6R/RP2p3/2PP1P2/1N1QK1N1 b - - 0 15,exf2+,-207,-205,2,1
r4rk1/pp1q1pP1/2n5/2pnp2P/P6R/RP6/2PP1p2/1N1QK1N1 w - - 0 16,Kxf2,-204,-198,6,1
r4rk1/pp1q1pP1/2n5/2pnp2P/P6R/RP6/2PP1K2/1N1Q2N1 b - - 0 16,Qf5+,-197,-60,137,1
r4rk1/pp3pP1/2n5/2pnpq1P/P6R/RP6/2PP1K2/1N1Q2N1 w - - 1 17,Kg2,-65,-281,-216,0
r4rk1/pp3pP1/2n5/2pnpq1P/P6R/RP6/2PP2K1/1N1Q2N1 b - - 2 17,Qg5+,-281,195,476,1
r4rk1/pp3pP1/2n5/2pnp1qP/P6R/RP6/2PP2K1/1N1Q2N1 w - - 3 18,Kh1,236,-665,-901,0
r4rk1/pp3pP1/2n5/2pnp1qP/P6R/RP6/2PP4/1N1Q2NK b - - 4 18,Qxh4+,-668,-654,14,1
r4rk1/pp3pP1/2n5/2pnp2P/P6q/RP6/2PP4/1N1Q2NK w - - 0 19,Kg2,-675,-709,-34,1
r4rk1/pp3pP1/2n5/2pnp2P/P6q/RP6/2PP2K1/1N1Q2N1 b - - 1 19,Nf4+,-702,-653,49,1
r4rk1/pp3pP1/2n5/2p1p2P/P4n1q/RP6/2PP2K1/1N1Q2N1 w - - 2 20,Kf1,-643,-645,-2,1
r4rk1/pp3pP1/2n5/2p1p2P/P4n1q/RP6/2PP4/1N1Q1KN1 b - - 3 20,Qh1,-665,-333,332,1
r4rk1/pp3pP1/2n5/2p1p2P/P4n2/RP6/2PP4/1N1Q1KNq w - - 4 21,Qf3,-360,-593,-233,0
r4rk1/pp3pP1/2n5/2p1p2P/P4n2/RP3Q2/2PP4/1N3KNq b - - 5 21,Nd4,-638,527,1165,1
r4rk1/pp3pP1/8/2p1p2P/P2n1n2/RP3Q2/2PP4/1N3KNq w - - 6 22,Qg3,592,-629,-1221,0
r4rk1/pp3pP1/8/2p1p2P/P2n1n2/RP4Q1/2PP4/1N3KNq b - - 7 22,Qe4,-651,-380,271,1
r4rk1/pp3pP1/8/2p1p2P/P2nqn2/RP4Q1/2PP4/1N3KN1 w - - 8 23,gxf8=Q+,-374,-385,-11,1
r4Qk1/pp3p2/8/2p1p2P/P2nqn2/RP4Q1/2PP4/1N3KN1 b - - 0 23,Kxf8,-363,-399,-36,1
r4k2/pp3p2/8/2p1p2P/P2nqn2/RP4Q1/2PP4/1N3KN1 w - - 0 24,b4,-390,-509,-119,0
r4k2/pp3p2/8/2p1p2P/PP1nqn2/R5Q1/2PP4/1N3KN1 b - - 0 24,Qxc2,-515,-507,8,1
r4k2/pp3p2/8/2p1p2P/PP1n1n2/R5Q1/2qP4/1N3KN1 w - - 0 25,Ra1,-533,-542,-9,1
r4k2/pp3p2/8/2p1p2P/PP1n1n2/6Q1/2qP4/RN3KN1 b - - 1 25,Qc1+,-582,-511,71,1
r4k2/pp3p2/8/2p1p2P/PP1n1n2/6Q1/3P4/RNq2KN1 w - - 2 26,Qe1,-455,-615,-160,0
r4k2/pp3p2/8/2p1p2P/PP1n1n2/8/3P4/RNq1QKN1 b - - 3 26,Qc4+,-645,-675,-30,1
r4k2/pp3p2/8/2p1p2P/PPqn1n2/8/3P4/RN2QKN1 w - - 4 27,Kf2,-703,-850,-147,0
r4k2/pp3p2/8/2p1p2P/PPqn1n2/8/3P1K2/RN2Q1N1 b - - 5 27,Nd3+,-860,-874,-14,1
r4k2/pp3p2/8/2p1p2P/PPqn4/3n4/3P1K2/RN2Q1N1 w - - 6 28,Ke3,-843,-942,-99,1
r4k2/pp3p2/8/2p1p2P/PPqn4/3nK3/3P4/RN2Q1N1 b - - 7 28,Nxe1,-916,-916,0,1
rnbqkbnr/pppppppp/8/8/8/8/PPPPPPPP/RNBQKBNR w KQkq - 0 1,d4,35,25,-10,1
rnbqkbnr/pppppppp/8/8/3P4/8/PPP1PPPP/RNBQKBNR b KQkq - 0 1,d5,21,16,-5,1
rnbqkbnr/ppp1pppp/8/3p4/3P4/8/PPP1PPPP/RNBQKBNR w KQkq - 0 2,e3,15,13,-2,1
rnbqkbnr/ppp1pppp/8/3p4/3P4/4P3/PPP2PPP/RNBQKBNR b KQkq - 0 2,Nf6,11,-3,-14,1
rnbqkb1r/ppp1pppp/5n2/3p4/3P4/4P3/PPP2PPP/RNBQKBNR w KQkq - 1 3,Nf3,-6,-7,-1,1
rnbqkb1r/ppp1pppp/5n2/3p4/3P4/4PN2/PPP2PPP/RNBQKB1R b KQkq - 2 3,Nc6,-7,40,47,1
r1bqkb1r/ppp1pppp/2n2n2/3p4/3P4/4PN2/PPP2PPP/RNBQKB1R w KQkq - 3 4,Be2,61,34,-27,1
r1bqkb1r/ppp1pppp/2n2n2/3p4/3P4/4PN2/PPP1BPPP/RNBQK2R b KQkq - 4 4,Bf5,36,35,-1,1
r2qkb1r/ppp1pppp/2n2n2/3p1b2/3P4/4PN2/PPP1BPPP/RNBQK2R w KQkq - 5 5,O-O,39,36,-3,1
r2qkb1r/ppp1pppp/2n2n2/3p1b2/3P4/4PN2/PPP1BPPP/RNBQ1RK1 b kq - 6 5,e6,36,32,-4,1
r2qkb1r/ppp2ppp/2n1pn2/3p1b2/3P4/4PN2/PPP1BPPP/RNBQ1RK1 w kq - 0 6,Nc3,35,-31,-66,1
r2qkb1r/ppp2ppp/2n1pn2/3p1b2/3P4/2N1PN2/PPP1BPPP/R1BQ1RK1 b kq - 1 6,Qd6,-26,33,59,1
r3kb1r/ppp2ppp/2nqpn2/3p1b2/3P4/2N1PN2/PPP1BPPP/R1BQ1RK1 w kq - 2 7,Bd3,40,-2,-42,1
r3kb1r/ppp2ppp/2nqpn2/3p1b2/3P4/2NBPN2/PPP2PPP/R1BQ1RK1 b kq - 3 7,O-O-O,-3,8,11,1
2kr1b1r/ppp2ppp/2nqpn2/3p1b2/3P4/2NBPN2/PPP2PPP/R1BQ1RK1 w - - 4 8,Bxf5,11,-66,-77,1
2kr1b1r/ppp2ppp/2nqpn2/3p1B2/3P4/2N1PN2/PPP2PPP/R1BQ1RK1 b - - 0 8,g6,-70,529,599,1
2kr1b1r/ppp2p1p/2nqpnp1/3p1B2/3P4/2N1PN2/PPP2PPP/R1BQ1RK1 w - - 0 9,Bd3,501,525,24,1
2kr1b1r/ppp2p1p/2nqpnp1/3p4/3P4/2NBPN2/PPP2PPP/R1BQ1RK1 b - - 1 9,Bh6,515,578,63,1
2kr3r/ppp2p1p/2nqpnpb/3p4/3P4/2NBPN2/PPP2PPP/R1BQ1RK1 w - - 2 10,Re1,577,470,-107,0
2kr3r/ppp2p1p/2nqpnpb/3p4/3P4/2NBPN2/PPP2PPP/R1BQR1K1 b - - 3 10,e5,490,570,80,1
2kr3r/ppp2p1p/2nq1npb/3pp3/3P4/2NBPN2/PPP2PPP/R1BQR1K1 w - - 0 11,e4,505,469,-36,1
2kr3r/ppp2p1p/2nq1npb/3pp3/3PP3/2NB1N2/PPP2PPP/R1BQR1K1 b - - 0 11,exd4,475,596,121,1
2kr3r/ppp2p1p/2nq1npb/3p4/3pP3/2NB1N2/PPP2PPP/R1BQR1K1 w - - 0 12,Bxh6,601,467,-134,0
2kr3r/ppp2p1p/2nq1npB/3p4/3pP3/2NB1N2/PPP2PPP/R2QR1K1 b - - 0 12,dxe4,507,628,121,1
2kr3r/ppp2p1p/2nq1npB/8/3pp3/2NB1N2/PPP2PPP/R2QR1K1 w - - 0 13,Bxe4,661,494,-167,0
2kr3r/ppp2p1p/2nq1npB/8/3pB3/2N2N2/PPP2PPP/R2QR1K1 b - - 0 13,Rde8,461,571,110,1
2k1r2r/ppp2p1p/2nq1npB/8/3pB3/2N2N2/PPP2PPP/R2QR1K1 w - - 1 14,Bxc6,557,584,27,1
2k1r2r/ppp2p1p/2Bq1npB/8/3p4/2N2N2/PPP2PPP/R2QR1K1 b - - 0 14,dxc3,649,685,36,1
2k1r2r/ppp2p1p/2Bq1npB/8/8/2p2N2/PPP2PPP/R2QR1K1 w - - 0 15,Rxe8+,683,586,-97,1
rnbqkbnr/pppppppp/8/8/8/8/PPPPPPPP/RNBQKBNR w KQkq - 0 1,e4,27,31,4,1
rnbqkbnr/pppppppp/8/8/4P3/8/PPPP1PPP/RNBQKBNR b KQkq - 0 1,e6,36,40,4,1
rnbqkbnr/pppp1ppp/4p3/8/4P3/8/PPPP1PPP/RNBQKBNR w KQkq - 0 2,Bc4,46,-32,-78,1
rnbqkbnr/pppp1ppp/4p3/8/2B1P3/8/PPPP1PPP/RNBQK1NR b KQkq - 1 2,Qh4,-32,118,150,1
rnb1kbnr/pppp1ppp/4p3/8/2B1P2q/8/PPPP1PPP/RNBQK1NR w KQkq - 2 3,Qf3,115,-62,-177,0
rnb1kbnr/pppp1ppp/4p3/8/2B1P2q/5Q2/PPPP1PPP/RNB1K1NR b KQkq - 3 3,Nf6,-64,5,69,1
rnb1kb1r/pppp1ppp/4pn2/8/2B1P2q/5Q2/PPPP1PPP/RNB1K1NR w KQkq - 4 4,d3,-3,-33,-30,1
rnb1kb1r/pppp1ppp/4pn2/8/2B1P2q/3P1Q2/PPP2PPP/RNB1K1NR b KQkq - 0 4,d5,-12,27,39,1
rnb1kb1r/ppp2ppp/4pn2/3p4/2B1P2q/3P1Q2/PPP2PPP/RNB1K1NR w KQkq - 0 5,exd5,37,11,-26,1
rnb1kb1r/ppp2ppp/4pn2/3P4/2B4q/3P1Q2/PPP2PPP/RNB1K1NR b KQkq - 0 5,exd5,-10,47,57,1
rnb1kb1r/ppp2ppp/5n2/3p4/2B4q/3P1Q2/PPP2PPP/RNB1K1NR w KQkq - 0 6,Bxd5,40,15,-25,1
rnb1kb1r/ppp2ppp/5n2/3B4/7q/3P1Q2/PPP2PPP/RNB1K1NR b KQkq - 0 6,Nxd5,4,12,8,1
rnb1kb1r/ppp2ppp/8/3n4/7q/3P1Q2/PPP2PPP/RNB1K1NR w KQkq - 0 7,Qxd5,10,1,-9,1
rnb1kb1r/ppp2ppp/8/3Q4/7q/3P4/PPP2PPP/RNB1K1NR b KQkq - 0 7,Qe7+,-7,37,44,1
rnb1kb1r/ppp1qppp/8/3Q4/8/3P4/PPP2PPP/RNB1K1NR w KQkq - 1 8,Ne2,38,36,-2,1
rnb1kb1r/ppp1qppp/8/3Q4/8/3P4/PPP1NPPP/RNB1K2R b KQkq - 2 8,Bg4,35,157,122,1
rn2kb1r/ppp1qppp/8/3Q4/6b1/3P4/PPP1NPPP/RNB1K2R w KQkq - 3 9,f3,158,160,2,1
rn2kb1r/ppp1qppp/8/3Q4/6b1/3P1P2/PPP1N1PP/RNB1K2R b KQkq - 0 9,Qd6,165,493,328,1
rn2kb1r/ppp2ppp/3q4/3Q4/6b1/3P1P2/PPP1N1PP/RNB1K2R w KQkq - 1 10,Qxd6,460,485,25,1
rn2kb1r/ppp2ppp/3Q4/8/6b1/3P1P2/PPP1N1PP/RNB1K2R b KQkq - 0 10,Bxd6,477,481,4,1
rn2k2r/ppp2ppp/3b4/8/6b1/3P1P2/PPP1N1PP/RNB1K2R w KQkq - 0 11,fxg4,501,518,17,1
rn2k2r/ppp2ppp/3b4/8/6P1/3P4/PPP1N1PP/RNB1K2R b KQkq - 0 11,O-O,500,510,10,1
rn3rk1/ppp2ppp/3b4/8/6P1/3P4/PPP1N1PP/RNB1K2R w KQ - 1 12,O-O,514,473,-41,1
rn3rk1/ppp2ppp/3b4/8/6P1/3P4/PPP1N1PP/RNB2RK1 b - - 2 12,Nc6,475,500,25,1
r4rk1/ppp2ppp/2nb4/8/6P1/3P4/PPP1N1PP/RNB2RK1 w - - 3 13,Bf4,512,483,-29,1
r4rk1/ppp2ppp/2nb4/8/5BP1/3P4/PPP1N1PP/RN3RK1 b - - 4 13,Bc5+,482,487,5,1
r4rk1/ppp2ppp/2n5/2b5/5BP1/3P4/PPP1N1PP/RN3RK1 w - - 5 14,Kh1,489,480,-9,1
r4rk1/ppp2ppp/2n5/2b5/5BP1/3P4/PPP1N1PP/RN3R1K b - - 6 14,Rae8,501,500,-1,1
4rrk1/ppp2ppp/2n5/2b5/5BP1/3P4/PPP1N1PP/RN3R1K w - - 7 15,Nbc3,482,491,9,1
4rrk1/ppp2ppp/2n5/2b5/5BP1/2NP4/PPP1N1PP/R4R1K b - - 8 15,Re6,476,558,82,1
5rk1/ppp2ppp/2n1r3/2b5/5BP1/2NP4/PPP1N1PP/R4R1K w - - 9 16,Bxc7,546,452,-94,1
5rk1/ppB2ppp/2n1r3/2b5/6P1/2NP4/PPP1N1PP/R4R1K b - - 0 16,Rfe8,520,529,9,1
4r1k1/ppB2ppp/2n1r3/2b5/6P1/2NP4/PPP1N1PP/R4R1K w - - 1 17,Nf4,546,551,5,1
4r1k1/ppB2ppp/2n1r3/2b5/5NP1/2NP4/PPP3PP/R4R1K b - - 2 17,Rg6,540,625,85,1
4r1k1/ppB2ppp/2n3r1/2b5/5NP1/2NP4/PPP3PP/R4R1K w - - 3 18,Nxg6,649,659,10,1
4r1k1/ppB2ppp/2n3N1/2b5/6P1/2NP4/PPP3PP/R4R1K b - - 0 18,fxg6,656,672,16,1
4r1k1/ppB3pp/2n3p1/2b5/6P1/2NP4/PPP3PP/R4R1K w - - 0 19,Ne4,696,665,-31,1
4r1k1/ppB3pp/2n3p1/2b5/4N1P1/3P4/PPP3PP/R4R1K b - - 1 19,Bd4,715,755,40,1
4r1k1/ppB3pp/2n3p1/8/3bN1P1/3P4/PPP3PP/R4R1K w - - 2 20,c3,726,640,-86,1
4r1k1/ppB3pp/2n3p1/8/3bN1P1/2PP4/PP4PP/R4R1K b - - 0 20,Bb6,660,755,95,1
4r1k1/ppB3pp/1bn3p1/8/4N1P1/2PP4/PP4PP/R4R1K w - - 1 21,Bxb6,708,724,16,1
4r1k1/pp4pp/1Bn3p1/8/4N1P1/2PP4/PP4PP/R4R1K b - - 0 21,axb6,688,734,46,1
4r1k1/1p4pp/1pn3p1/8/4N1P1/2PP4/PP4PP/R4R1K w - - 0 22,Nd6,719,708,-11,1
4r1k1/1p4pp/1pnN2p1/8/6P1/2PP4/PP4PP/R4R1K b - - 1 22,Rd8,728,671,-57,1
3r2k1/1p4pp/1pnN2p1/8/6P1/2PP4/PP4PP/R4R1K w - - 2 23,Nxb7,648,663,15,1
3r2k1/1N4pp/1pn3p1/8/6P1/2PP4/PP4PP/R4R1K b - - 0 23,Rxd3,684,684,0,1
6k1/1N4pp/1pn3p1/8/6P1/2Pr4/PP4PP/R4R1K w - - 0 24,Rad1,648,629,-19,1
6k1/1N4pp/1pn3p1/8/6P1/2Pr4/PP4PP/3R1R1K b - - 1 24,Re3,665,715,50,1
6k1/1N4pp/1pn3p1/8/6P1/2P1r3/PP4PP/3R1R1K w - - 2 25,Rfe1,736,733,-3,1
6k1/1N4pp/1pn3p1/8/6P1/2P1r3/PP4PP/3RR2K b - - 3 25,Re5,712,707,-5,1
6k1/1N4pp/1pn3p1/4r3/6P1/2P5/PP4PP/3RR2K w - - 4 26,Rxe5,700,678,-22,1
6k1/1N4pp/1pn3p1/4R3/6P1/2P5/PP4PP/3R3K b - - 0 26,Nxe5,704,687,-17,1
6k1/1N4pp/1p4p1/4n3/6P1/2P5/PP4PP/3R3K w - - 0 27,h3,706,659,-47,1
6k1/1N4pp/1p4p1/4n3/6P1/2P4P/PP4P1/3R3K b - - 0 27,Nc4,677,700,23,1
6k1/1N4pp/1p4p1/8/2n3P1/2P4P/PP4P1/3R3K w - - 1 28,b3,681,714,33,1
6k1/1N4pp/1p4p1/8/2n3P1/1PP4P/P5P1/3R3K b - - 0 28,Nb2,704,730,26,1
6k1/1N4pp/1p4p1/8/6P1/1PP4P/Pn4P1/3R3K w - - 1 29,Rd2,769,776,7,1
6k1/1N4pp/1p4p1/8/6P1/1PP4P/Pn1R2P1/7K b - - 2 29,h5,796,832,36,1
6k1/1N4p1/1p4p1/7p/6P1/1PP4P/Pn1R2P1/7K w - - 0 30,Rxb2,782,790,8,1
6k1/1N4p1/1p4p1/7p/6P1/1PP4P/PR4P1/7K b - - 0 30,hxg4,792,791,-1,1
6k1/1N4p1/1p4p1/8/6p1/1PP4P/PR4P1/7K w - - 0 31,hxg4,821,831,10,1
6k1/1N4p1/1p4p1/8/6P1/1PP5/PR4P1/7K b - - 0 31,Kf7,830,834,4,1
8/1N3kp1/1p4p1/8/6P1/1PP5/PR4P1/7K w - - 1 32,Re2,819,843,24,1
rnbqkbnr/pppppppp/8/8/8/8/PPPPPPPP/RNBQKBNR w KQkq - 0 1,e4,39,37,-2,1
rnbqkbnr/pppppppp/8/8/4P3/8/PPPP1PPP/RNBQKBNR b KQkq - 0 1,e6,21,50,29,1
rnbqkbnr/pppp1ppp/4p3/8/4P3/8/PPPP1PPP/RNBQKBNR w KQkq - 0 2,d4,56,43,-13,1
rnbqkbnr/pppp1ppp/4p3/8/3PP3/8/PPP2PPP/RNBQKBNR b KQkq - 0 2,d5,38,49,11,1
rnbqkbnr/ppp2ppp/4p3/3p4/3PP3/8/PPP2PPP/RNBQKBNR w KQkq - 0 3,e5,48,8,-40,1
rnbqkbnr/ppp2ppp/4p3/3pP3/3P4/8/PPP2PPP/RNBQKBNR b KQkq - 0 3,f6,21,113,92,1
rnbqkbnr/ppp3pp/4pp2/3pP3/3P4/8/PPP2PPP/RNBQKBNR w KQkq - 0 4,Nf3,87,78,-9,1
rnbqkbnr/ppp3pp/4pp2/3pP3/3P4/5N2/PPP2PPP/RNBQKB1R b KQkq - 1 4,fxe5,75,70,-5,1
rnbqkbnr/ppp3pp/4p3/3pp3/3P4/5N2/PPP2PPP/RNBQKB1R w KQkq - 0 5,Nxe5,66,58,-8,1
rnbqkbnr/ppp3pp/4p3/3pN3/3P4/8/PPP2PPP/RNBQKB1R b KQkq - 0 5,Nc6,66,216,150,1
r1bqkbnr/ppp3pp/2n1p3/3pN3/3P4/8/PPP2PPP/RNBQKB1R w KQkq - 1 6,Nxc6,227,48,-179,0
r1bqkbnr/ppp3pp/2N1p3/3p4/3P4/8/PPP2PPP/RNBQKB1R b KQkq - 0 6,bxc6,39,49,10,1
r1bqkbnr/p1p3pp/2p1p3/3p4/3P4/8/PPP2PPP/RNBQKB1R w KQkq - 0 7,Nc3,50,-19,-69,1
r1bqkbnr/p1p3pp/2p1p3/3p4/3P4/2N5/PPP2PPP/R1BQKB1R b KQkq - 1 7,Nf6,-17,-4,13,1
r1bqkb1r/p1p3pp/2p1pn2/3p4/3P4/2N5/PPP2PPP/R1BQKB1R w KQkq - 2 8,Bg5,-15,-48,-33,1
r1bqkb1r/p1p3pp/2p1pn2/3p2B1/3P4/2N5/PPP2PPP/R2QKB1R b KQkq - 3 8,Bd6,-54,-45,9,1
r1bqk2r/p1p3pp/2pbpn2/3p2B1/3P4/2N5/PPP2PPP/R2QKB1R w KQkq - 4 9,Bxf6,-37,-252,-215,0
r1bqk2r/p1p3pp/2pbpB2/3p4/3P4/2N5/PPP2PPP/R2QKB1R b KQkq - 0 9,Qxf6,-237,-241,-4,1
r1b1k2r/p1p3pp/2pbpq2/3p4/3P4/2N5/PPP2PPP/R2QKB1R w KQkq - 0 10,Qe2,-240,-340,-100,1
r1b1k2r/p1p3pp/2pbpq2/3p4/3P4/2N5/PPP1QPPP/R3KB1R b KQkq - 1 10,O-O,-326,-295,31,1
r1b2rk1/p1p3pp/2pbpq2/3p4/3P4/2N5/PPP1QPPP/R3KB1R w KQ - 2 11,O-O-O,-335,-252,83,1
r1b2rk1/p1p3pp/2pbpq2/3p4/3P4/2N5/PPP1QPPP/2KR1B1R b - - 3 11,e5,-307,-291,16,1
r1b2rk1/p1p3pp/2pb1q2/3pp3/3P4/2N5/PPP1QPPP/2KR1B1R w - - 0 12,dxe5,-278,-264,14,1
r1b2rk1/p1p3pp/2pb1q2/3pP3/8/2N5/PPP1QPPP/2KR1B1R b - - 0 12,Bxe5,-250,-281,-31,1
r1b2rk1/p1p3pp/2p2q2/3pb3/8/2N5/PPP1QPPP/2KR1B1R w - - 0 13,Qd3,-280,-434,-154,0
r1b2rk1/p1p3pp/2p2q2/3pb3/8/2NQ4/PPP2PPP/2KR1B1R b - - 1 13,Re8,-421,-300,121,1
r1b1r1k1/p1p3pp/2p2q2/3pb3/8/2NQ4/PPP2PPP/2KR1B1R w - - 2 14,f3,-291,-390,-99,1
r1b1r1k1/p1p3pp/2p2q2/3pb3/8/2NQ1P2/PPP3PP/2KR1B1R b - - 0 14,Bf4+,-445,-411,34,1
r1b1r1k1/p1p3pp/2p2q2/3p4/5b2/2NQ1P2/PPP3PP/2KR1B1R w - - 1 15,Kb1,-412,-423,-11,1
r1b1r1k1/p1p3pp/2p2q2/3p4/5b2/2NQ1P2/PPP3PP/1K1R1B1R b - - 2 15,Be6,-421,-143,278,1
r3r1k1/p1p3pp/2p1bq2/3p4/5b2/2NQ1P2/PPP3PP/1K1R1B1R w - - 3 16,Qd4,-125,-447,-322,0
r3r1k1/p1p3pp/2p1bq2/3p4/3Q1b2/2N2P2/PPP3PP/1K1R1B1R b - - 4 16,Qh6,-417,-136,281,1
r3r1k1/p1p3pp/2p1b2q/3p4/3Q1b2/2N2P2/PPP3PP/1K1R1B1R w - - 5 17,g3,-132,-183,-51,1
r3r1k1/p1p3pp/2p1b2q/3p4/3Q1b2/2N2PP1/PPP4P/1K1R1B1R b - - 0 17,Bd6,-156,0,156,1
r3r1k1/p1p3pp/2pbb2q/3p4/3Q4/2N2PP1/PPP4P/1K1R1B1R w - - 1 18,f4,0,-258,-258,0
r3r1k1/p1p3pp/2pbb2q/3p4/3Q1P2/2N3P1/PPP4P/1K1R1B1R b - - 0 18,Rab8,-218,-173,45,1
1r2r1k1/p1p3pp/2pbb2q/3p4/3Q1P2/2N3P1/PPP4P/1K1R1B1R w - - 1 19,Ka1,-164,-256,-92,1
1r2r1k1/p1p3pp/2pbb2q/3p4/3Q1P2/2N3P1/PPP4P/K2R1B1R b - - 2 19,c5,-186,-114,72,1
1r2r1k1/p1p3pp/3bb2q/2pp4/3Q1P2/2N3P1/PPP4P/K2R1B1R w - - 0 20,Qd2,-142,-146,-4,1
1r2r1k1/p1p3pp/3bb2q/2pp4/5P2/2N3P1/PPPQ3P/K2R1B1R b - - 1 20,d4,-143,-110,33,1
1r2r1k1/p1p3pp/3bb2q/2p5/3p1P2/2N3P1/PPPQ3P/K2R1B1R w - - 0 21,Ne4,-119,-92,27,1
1r2r1k1/p1p3pp/3bb2q/2p5/3pNP2/6P1/PPPQ3P/K2R1B1R b - - 1 21,Qg6,-100,55,155,1
1r2r1k1/p1p3pp/3bb1q1/2p5/3pNP2/6P1/PPPQ3P/K2R1B1R w - - 2 22,Nxd6,59,-79,-138,0
1r2r1k1/p1p3pp/3Nb1q1/2p5/3p1P2/6P1/PPPQ3P/K2R1B1R b - - 0 22,cxd6,-87,-95,-8,1
1r2r1k1/p5pp/3pb1q1/2p5/3p1P2/6P1/PPPQ3P/K2R1B1R w - - 0 23,Bd3,-103,-112,-9,1
1r2r1k1/p5pp/3pb1q1/2p5/3p1P2/3B2P1/PPPQ3P/K2R3R b - - 1 23,Qf7,-73,-57,16,1
1r2r1k1/p4qpp/3pb3/2p5/3p1P2/3B2P1/PPPQ3P/K2R3R w - - 2 24,b3,-54,-48,6,1
1r2r1k1/p4qpp/3pb3/2p5/3p1P2/1P1B2P1/P1PQ3P/K2R3R b - - 0 24,Qc7,-37,17,54,1
1r2r1k1/p1q3pp/3pb3/2p5/3p1P2/1P1B2P1/P1PQ3P/K2R3R w - - 1 25,Kb2,3,-256,-259,0
1r2r1k1/p1q3pp/3pb3/2p5/3p1P2/1P1B2P1/PKPQ3P/3R3R b - - 2 25,Qc6,-274,-94,180,1
1r2r1k1/p5pp/2qpb3/2p5/3p1P2/1P1B2P1/PKPQ3P/3R3R w - - 3 26,Rb1,-104,-412,-308,0
1r2r1k1/p5pp/2qpb3/2p5/3p1P2/1P1B2P1/PKPQ3P/1R5R b - - 4 26,d5,-382,-253,129,1
1r2r1k1/p5pp/2q1b3/2pp4/3p1P2/1P1B2P1/PKPQ3P/1R5R w - - 0 27,Rhe1,-255,-353,-98,1
1r2r1k1/p5pp/2q1b3/2pp4/3p1P2/1P1B2P1/PKPQ3P/1R2R3 b - - 1 27,c4,-380,-408,-28,1
1r2r1k1/p5pp/2q1b3/3p4/2pp1P2/1P1B2P1/PKPQ3P/1R2R3 w - - 0 28,Kc1,-379,-539,-160,0
1r2r1k1/p5pp/2q1b3/3p4/2pp1P2/1P1B2P1/P1PQ3P/1RK1R3 b - - 1 28,cxd3,-532,-577,-45,1
1r2r1k1/p5pp/2q1b3/3p4/3p1P2/1P1p2P1/P1PQ3P/1RK1R3 w - - 0 29,Qxd3,-557,-591,-34,1
1r2r1k1/p5pp/2q1b3/3p4/3p1P2/1P1Q2P1/P1P4P/1RK1R3 b - - 0 29,Qc3,-576,-606,-30,1
1r2r1k1/p5pp/4b3/3p4/3p1P2/1PqQ2P1/P1P4P/1RK1R3 w - - 1 30,Qxc3,-586,-579,7,1
1r2r1k1/p5pp/4b3/3p4/3p1P2/1PQ3P1/P1P4P/1RK1R3 b - - 0 30,dxc3,-592,-577,15,1
1r2r1k1/p5pp/4b3/3p4/5P2/1Pp3P1/P1P4P/1RK1R3 w - - 0 31,Re5,-580,-645,-65,1
1r2r1k1/p5pp/4b3/3pR3/5P2/1Pp3P1/P1P4P/1RK5 b - - 1 31,g6,-604,-559,45,1
1r2r1k1/p6p/4b1p1/3pR3/5P2/1Pp3P1/P1P4P/1RK5 w - - 0 32,Kd1,-599,-578,21,1
1r2r1k1/p6p/4b1p1/3pR3/5P2/1Pp3P1/P1P4P/1R1K4 b - - 1 32,Bf5,-532,-589,-57,1
1r2r1k1/p6p/6p1/3pRb2/5P2/1Pp3P1/P1P4P/1R1K4 w - - 2 33,Rxe8+,-591,-9996,-9405,0
1r2R1k1/p6p/6p1/3p1b2/5P2/1Pp3P1/P1P4P/1R1K4 b - - 0 33,Rxe8,-9996,-9997,-1,1
4r1k1/p6p/6p1/3p1b2/5P2/1Pp3P1/P1P4P/1R1K4 w - - 0 34,a4,-9997,-9998,-1,1
4r1k1/p6p/6p1/3p1b2/P4P2/1Pp3P1/2P4P/1R1K4 b - - 0 34,Rb8,-9998,-556,9442,1
1r4k1/p6p/6p1/3p1b2/P4P2/1Pp3P1/2P4P/1R1K4 w - - 1 35,Ke2,-570,-564,6,1
1r4k1/p6p/6p1/3p1b2/P4P2/1Pp3P1/2P1K2P/1R6 b - - 2 35,a6,-542,-497,45,1
1r4k1/7p/p5p1/3p1b2/P4P2/1Pp3P1/2P1K2P/1R6 w - - 0 36,Kf3,-515,-611,-96,1
1r4k1/7p/p5p1/3p1b2/P4P2/1Pp2KP1/2P4P/1R6 b - - 1 36,a5,-515,-474,41,1
1r4k1/7p/6p1/p2p1b2/P4P2/1Pp2KP1/2P4P/1R6 w - - 0 37,g4,-489,-552,-63,1
rnbqkbnr/pppppppp/8/8/8/8/PPPPPPPP/RNBQKBNR w KQkq - 0 1,d4,20,15,-5,1
rnbqkbnr/pppppppp/8/8/3P4/8/PPP1PPPP/RNBQKBNR b KQkq - 0 1,Nf6,16,17,1,1
rnbqkb1r/pppppppp/5n2/8/3P4/8/PPP1PPPP/RNBQKBNR w KQkq - 1 2,Nd2,25,-10,-35,1
rnbqkb1r/pppppppp/5n2/8/3P4/8/PPPNPPPP/R1BQKBNR b KQkq - 2 2,d5,0,-7,-7,1
rnbqkb1r/ppp1pppp/5n2/3p4/3P4/8/PPPNPPPP/R1BQKBNR w KQkq - 0 3,Nb3,1,-40,-41,1
rnbqkb1r/ppp1pppp/5n2/3p4/3P4/1N6/PPP1PPPP/R1BQKBNR b KQkq - 1 3,g6,-44,-12,32,1
rnbqkb1r/ppp1pp1p/5np1/3p4/3P4/1N6/PPP1PPPP/R1BQKBNR w KQkq - 0 4,Bg5,-13,-43,-30,1
rnbqkb1r/ppp1pp1p/5np1/3p2B1/3P4/1N6/PPP1PPPP/R2QKBNR b KQkq - 1 4,Bg7,-56,-18,38,1
rnbqk2r/ppp1ppbp/5np1/3p2B1/3P4/1N6/PPP1PPPP/R2QKBNR w KQkq - 2 5,Bxf6,-32,-57,-25,1
rnbqk2r/ppp1ppbp/5Bp1/3p4/3P4/1N6/PPP1PPPP/R2QKBNR b KQkq - 0 5,Bxf6,-54,-69,-15,1
rnbqk2r/ppp1pp1p/5bp1/3p4/3P4/1N6/PPP1PPPP/R2QKBNR w KQkq - 0 6,e3,-67,-60,7,1
rnbqk2r/ppp1pp1p/5bp1/3p4/3P4/1N2P3/PPP2PPP/R2QKBNR b KQkq - 0 6,O-O,-77,-56,21,1
rnbq1rk1/ppp1pp1p/5bp1/3p4/3P4/1N2P3/PPP2PPP/R2QKBNR w KQ - 1 7,Bd3,-52,-82,-30,1
rnbq1rk1/ppp1pp1p/5bp1/3p4/3P4/1N1BP3/PPP2PPP/R2QK1NR b KQ - 2 7,e6,-77,-47,30,1
rnbq1rk1/ppp2p1p/4pbp1/3p4/3P4/1N1BP3/PPP2PPP/R2QK1NR w KQ - 0 8,Qe2,-26,-87,-61,1
rnbq1rk1/ppp2p1p/4pbp1/3p4/3P4/1N1BP3/PPP1QPPP/R3K1NR b KQ - 1 8,Bg7,-75,-2,73,1
rnbq1rk1/ppp2pbp/4p1p1/3p4/3P4/1N1BP3/PPP1QPPP/R3K1NR w KQ - 2 9,O-O-O,-19,-138,-119,0
rnbq1rk1/ppp2pbp/4p1p1/3p4/3P4/1N1BP3/PPP1QPPP/2KR2NR b - - 3 9,Nd7,-171,-131,40,1
r1bq1rk1/pppn1pbp/4p1p1/3p4/3P4/1N1BP3/PPP1QPPP/2KR2NR w - - 4 10,Nf3,-138,-150,-12,1
r1bq1rk1/pppn1pbp/4p1p1/3p4/3P4/1N1BPN2/PPP1QPPP/2KR3R b - - 5 10,Nf6,-153,-51,102,1
r1bq1rk1/ppp2pbp/4pnp1/3p4/3P4/1N1BPN2/PPP1QPPP/2KR3R w - - 6 11,h4,-77,-93,-16,1
r1bq1rk1/ppp2pbp/4pnp1/3p4/3P3P/1N1BPN2/PPP1QPP1/2KR3R b - - 0 11,h6,-76,91,167,1
r1bq1rk1/ppp2pb1/4pnpp/3p4/3P3P/1N1BPN2/PPP1QPP1/2KR3R w - - 0 12,Ne5,68,63,-5,1
r1bq1rk1/ppp2pb1/4pnpp/3pN3/3P3P/1N1BP3/PPP1QPP1/2KR3R b - - 1 12,c6,61,135,74,1
r1bq1rk1/pp3pb1/2p1pnpp/3pN3/3P3P/1N1BP3/PPP1QPP1/2KR3R w - - 0 13,g4,144,147,3,1
r1bq1rk1/pp3pb1/2p1pnpp/3pN3/3P2PP/1N1BP3/PPP1QP2/2KR3R b - - 0 13,Nd7,144,144,0,1
r1bq1rk1/pp1n1pb1/2p1p1pp/3pN3/3P2PP/1N1BP3/PPP1QP2/2KR3R w - - 1 14,Nxd7,142,109,-33,1
r1bq1rk1/pp1N1pb1/2p1p1pp/3p4/3P2PP/1N1BP3/PPP1QP2/2KR3R b - - 0 14,Bxd7,82,105,23,1
r2q1rk1/pp1b1pb1/2p1p1pp/3p4/3P2PP/1N1BP3/PPP1QP2/2KR3R w - - 0 15,h5,101,72,-29,1
r2q1rk1/pp1b1pb1/2p1p1pp/3p3P/3P2P1/1N1BP3/PPP1QP2/2KR3R b - - 0 15,Qg5,80,340,260,1
r4rk1/pp1b1pb1/2p1p1pp/3p2qP/3P2P1/1N1BP3/PPP1QP2/2KR3R w - - 1 16,Nc5,340,318,-22,1
r4rk1/pp1b1pb1/2p1p1pp/2Np2qP/3P2P1/3BP3/PPP1QP2/2KR3R b - - 2 16,Bc8,212,374,162,1
r1b2rk1/pp3pb1/2p1p1pp/2Np2qP/3P2P1/3BP3/PPP1QP2/2KR3R w - - 3 17,Rdg1,372,14,-358,0
r1b2rk1/pp3pb1/2p1p1pp/2Np2qP/3P2P1/3BP3/PPP1QP2/2K3RR b - - 4 17,Rd8,-20,454,474,1
r1br2k1/pp3pb1/2p1p1pp/2Np2qP/3P2P1/3BP3/PPP1QP2/2K3RR w - - 5 18,f4,453,329,-124,0
r1br2k1/pp3pb1/2p1p1pp/2Np2qP/3P1PP1/3BP3/PPP1Q3/2K3RR b - - 0 18,Qe7,326,308,-18,1
r1br2k1/pp2qpb1/2p1p1pp/2Np3P/3P1PP1/3BP3/PPP1Q3/2K3RR w - - 1 19,hxg6,288,290,2,1
r1br2k1/pp2qpb1/2p1p1Pp/2Np4/3P1PP1/3BP3/PPP1Q3/2K3RR b - - 0 19,fxg6,268,597,329,1
r1br2k1/pp2q1b1/2p1p1pp/2Np4/3P1PP1/3BP3/PPP1Q3/2K3RR w - - 0 20,Bxg6,521,537,16,1
r1br2k1/pp2q1b1/2p1p1Bp/2Np4/3P1PP1/4P3/PPP1Q3/2K3RR b - - 0 20,b6,547,554,7,1
r1br2k1/p3q1b1/1pp1p1Bp/2Np4/3P1PP1/4P3/PPP1Q3/2K3RR w - - 0 21,Nd3,569,552,-17,1
r1br2k1/p3q1b1/1pp1p1Bp/3p4/3P1PP1/3NP3/PPP1Q3/2K3RR b - - 1 21,c5,584,627,43,1
r1br2k1/p3q1b1/1p2p1Bp/2pp4/3P1PP1/3NP3/PPP1Q3/2K3RR w - - 0 22,dxc5,636,405,-231,0
r1br2k1/p3q1b1/1p2p1Bp/2Pp4/5PP1/3NP3/PPP1Q3/2K3RR b - - 0 22,bxc5,395,375,-20,1
r1br2k1/p3q1b1/4p1Bp/2pp4/5PP1/3NP3/PPP1Q3/2K3RR w - - 0 23,Ne5,417,321,-96,1
r1br2k1/p3q1b1/4p1Bp/2ppN3/5PP1/4P3/PPP1Q3/2K3RR b - - 1 23,Bxe5,358,402,44,1
r1br2k1/p3q3/4p1Bp/2ppb3/5PP1/4P3/PPP1Q3/2K3RR w - - 0 24,fxe5,383,378,-5,1
r1br2k1/p3q3/4p1Bp/2ppP3/6P1/4P3/PPP1Q3/2K3RR b - - 0 24,c4,380,577,197,1
r1br2k1/p3q3/4p1Bp/3pP3/2p3P1/4P3/PPP1Q3/2K3RR w - - 0 25,g5,567,533,-34,1
r1br2k1/p3q3/4p1Bp/3pP1P1/2p5/4P3/PPP1Q3/2K3RR b - - 0 25,hxg5,459,880,421,1
r1br2k1/p3q3/4p1B1/3pP1p1/2p5/4P3/PPP1Q3/2K3RR w - - 0 26,Qh5,9989,9990,1,1
r1br2k1/p3q3/4p1B1/3pP1pQ/2p5/4P3/PPP5/2K3RR b - - 1 26,Qg7,9990,9990,0,1
r1br2k1/p5q1/4p1B1/3pP1pQ/2p5/4P3/PPP5/2K3RR w - - 2 27,Rxg5,9990,938,-9052,0
r1br2k1/p5q1/4p1B1/3pP1RQ/2p5/4P3/PPP5/2K4R b - - 0 27,Kf8,1053,876,-177,0
r1br1k2/p5q1/4p1B1/3pP1RQ/2p5/4P3/PPP5/2K4R w - - 1 28,Rf1+,1089,840,-249,0
r1br1k2/p5q1/4p1B1/3pP1RQ/2p5/4P3/PPP5/2K2R2 b - - 2 28,Ke7,903,931,28,1
r1br4/p3k1q1/4p1B1/3pP1RQ/2p5/4P3/PPP5/2K2R2 w - - 3 29,Bh7,878,730,-148,0
r1br4/p3k1qB/4p3/3pP1RQ/2p5/4P3/PPP5/2K2R2 b - - 4 29,Qh8,714,9999,9285,1
r1br3q/p3k2B/4p3/3pP1RQ/2p5/4P3/PPP5/2K2R2 w - - 5 30,Qf7#,9999,10000,1,1
rnbqkbnr/pppppppp/8/8/8/8/PPPPPPPP/RNBQKBNR w KQkq - 0 1,Nf3,21,17,-4,1
rnbqkbnr/pppppppp/8/8/8/5N2/PPPPPPPP/RNBQKB1R b KQkq - 1 1,c5,22,34,12,1
rnbqkbnr/pp1ppppp/8/2p5/8/5N2/PPPPPPPP/RNBQKB1R w KQkq - 0 2,c3,32,-17,-49,1
rnbqkbnr/pp1ppppp/8/2p5/8/2P2N2/PP1PPPPP/RNBQKB1R b KQkq - 0 2,Nc6,-7,25,32,1
r1bqkbnr/pp1ppppp/2n5/2p5/8/2P2N2/PP1PPPPP/RNBQKB1R w KQkq - 1 3,d4,27,22,-5,1
r1bqkbnr/pp1ppppp/2n5/2p5/3P4/2P2N2/PP2PPPP/RNBQKB1R b KQkq - 0 3,cxd4,7,4,-3,1
r1bqkbnr/pp1ppppp/2n5/8/3p4/2P2N2/PP2PPPP/RNBQKB1R w KQkq - 0 4,cxd4,3,2,-1,1
r1bqkbnr/pp1ppppp/2n5/8/3P4/5N2/PP2PPPP/RNBQKB1R b KQkq - 0 4,d5,18,25,7,1
r1bqkbnr/pp2pppp/2n5/3p4/3P4/5N2/PP2PPPP/RNBQKB1R w KQkq - 0 5,e3,25,4,-21,1
r1bqkbnr/pp2pppp/2n5/3p4/3P4/4PN2/PP3PPP/RNBQKB1R b KQkq - 0 5,g6,4,17,13,1
r1bqkbnr/pp2pp1p/2n3p1/3p4/3P4/4PN2/PP3PPP/RNBQKB1R w KQkq - 0 6,Nc3,17,19,2,1
r1bqkbnr/pp2pp1p/2n3p1/3p4/3P4/2N1PN2/PP3PPP/R1BQKB1R b KQkq - 1 6,Bg7,16,18,2,1
r1bqk1nr/pp2ppbp/2n3p1/3p4/3P4/2N1PN2/PP3PPP/R1BQKB1R w KQkq - 2 7,Qb3,26,22,-4,1
r1bqk1nr/pp2ppbp/2n3p1/3p4/3P4/1QN1PN2/PP3PPP/R1B1KB1R b KQkq - 3 7,Nf6,14,18,4,1
r1bqk2r/pp2ppbp/2n2np1/3p4/3P4/1QN1PN2/PP3PPP/R1B1KB1R w KQkq - 4 8,Bb5,10,-17,-27,1
r1bqk2r/pp2ppbp/2n2np1/1B1p4/3P4/1QN1PN2/PP3PPP/R1B1K2R b KQkq - 5 8,a6,-17,9,26,1
r1bqk2r/1p2ppbp/p1n2np1/1B1p4/3P4/1QN1PN2/PP3PPP/R1B1K2R w KQkq - 0 9,Bxc6+,13,6,-7,1
r1bqk2r/1p2ppbp/p1B2np1/3p4/3P4/1QN1PN2/PP3PPP/R1B1K2R b KQkq - 0 9,bxc6,10,23,13,1
r1bqk2r/4ppbp/p1p2np1/3p4/3P4/1QN1PN2/PP3PPP/R1B1K2R w KQkq - 0 10,Ne5,12,14,2,1
r1bqk2r/4ppbp/p1p2np1/3pN3/3P4/1QN1P3/PP3PPP/R1B1K2R b KQkq - 1 10,Bd7,17,82,65,1
r2qk2r/3bppbp/p1p2np1/3pN3/3P4/1QN1P3/PP3PPP/R1B1K2R w KQkq - 2 11,Qa4,62,5,-57,1
r2qk2r/3bppbp/p1p2np1/3pN3/Q2P4/2N1P3/PP3PPP/R1B1K2R b KQkq - 3 11,Qc7,-2,21,23,1
r3k2r/2qbppbp/p1p2np1/3pN3/Q2P4/2N1P3/PP3PPP/R1B1K2R w KQkq - 4 12,O-O,20,-18,-38,1
r3k2r/2qbppbp/p1p2np1/3pN3/Q2P4/2N1P3/PP3PPP/R1B2RK1 b kq - 5 12,O-O,-15,-9,6,1
r4rk1/2qbppbp/p1p2np1/3pN3/Q2P4/2N1P3/PP3PPP/R1B2RK1 w - - 6 13,Bd2,-11,-44,-33,1
r4rk1/2qbppbp/p1p2np1/3pN3/Q2P4/2N1P3/PP1B1PPP/R4RK1 b - - 7 13,Ng4,-23,8,31,1
r4rk1/2qbppbp/p1p3p1/3pN3/Q2P2n1/2N1P3/PP1B1PPP/R4RK1 w - - 8 14,Nxg4,18,16,-2,1
r4rk1/2qbppbp/p1p3p1/3p4/Q2P2N1/2N1P3/PP1B1PPP/R4RK1 b - - 0 14,Bxg4,8,7,-1,1
r4rk1/2q1ppbp/p1p3p1/3p4/Q2P2b1/2N1P3/PP1B1PPP/R4RK1 w - - 0 15,Rac1,16,8,-8,1
r4rk1/2q1ppbp/p1p3p1/3p4/Q2P2b1/2N1P3/PP1B1PPP/2R2RK1 b - - 1 15,e5,7,139,132,1
r4rk1/2q2pbp/p1p3p1/3pp3/Q2P2b1/2N1P3/PP1B1PPP/2R2RK1 w - - 0 16,Nxd5,145,112,-33,1
r4rk1/2q2pbp/p1p3p1/3Np3/Q2P2b1/4P3/PP1B1PPP/2R2RK1 b - - 0 16,Qb7,107,237,130,1
r4rk1/1q3pbp/p1p3p1/3Np3/Q2P2b1/4P3/PP1B1PPP/2R2RK1 w - - 1 17,Qxc6,273,249,-24,1
r4rk1/1q3pbp/p1Q3p1/3Np3/3P2b1/4P3/PP1B1PPP/2R2RK1 b - - 0 17,Qxb2,212,387,175,1
r4rk1/5pbp/p1Q3p1/3Np3/3P2b1/4P3/Pq1B1PPP/2R2RK1 w - - 0 18,Bc3,382,153,-229,0
r4rk1/5pbp/p1Q3p1/3Np3/3P2b1/2B1P3/Pq3PPP/2R2RK1 b - - 1 18,Qxa2,156,157,1,1
r4rk1/5pbp/p1Q3p1/3Np3/3P2b1/2B1P3/q4PPP/2R2RK1 w - - 0 19,dxe5,161,152,-9,1
r4rk1/5pbp/p1Q3p1/3NP3/6b1/2B1P3/q4PPP/2R2RK1 b - - 0 19,Be6,148,141,-7,1
r4rk1/5pbp/p1Q1b1p1/3NP3/8/2B1P3/q4PPP/2R2RK1 w - - 1 20,Nc7,140,133,-7,1
r4rk1/2N2pbp/p1Q1b1p1/4P3/8/2B1P3/q4PPP/2R2RK1 b - - 2 20,Rac8,140,170,30,1
2r2rk1/2N2pbp/p1Q1b1p1/4P3/8/2B1P3/q4PPP/2R2RK1 w - - 3 21,Qb7,161,54,-107,0
2r2rk1/1QN2pbp/p3b1p1/4P3/8/2B1P3/q4PPP/2R2RK1 b - - 4 21,Bc4,64,81,17,1
2r2rk1/1QN2pbp/p5p1/4P3/2b5/2B1P3/q4PPP/2R2RK1 w - - 5 22,Rfe1,102,85,-17,1
2r2rk1/1QN2pbp/p5p1/4P3/2b5/2B1P3/q4PPP/2R1R1K1 b - - 6 22,Rfd8,84,89,5,1
2rr2k1/1QN2pbp/p5p1/4P3/2b5/2B1P3/q4PPP/2R1R1K1 w - - 7 23,Bd4,77,62,-15,1
2rr2k1/1QN2pbp/p5p1/4P3/2bB4/4P3/q4PPP/2R1R1K1 b - - 8 23,Rb8,74,223,149,1
1r1r2k1/1QN2pbp/p5p1/4P3/2bB4/4P3/q4PPP/2R1R1K1 w - - 9 24,Qc6,228,203,-25,1
1r1r2k1/2N2pbp/p1Q3p1/4P3/2bB4/4P3/q4PPP/2R1R1K1 b - - 10 24,Rdc8,227,413,186,1
1rr3k1/2N2pbp/p1Q3p1/4P3/2bB4/4P3/q4PPP/2R1R1K1 w - - 11 25,Qxc4,418,418,0,1
1rr3k1/2N2pbp/p5p1/4P3/2QB4/4P3/q4PPP/2R1R1K1 b - - 0 25,Qa5,434,476,42,1
1rr3k1/2N2pbp/p5p1/q3P3/2QB4/4P3/5PPP/2R1R1K1 w - - 1 26,Qc6,507,421,-86,1
1rr3k1/2N2pbp/p1Q3p1/q3P3/3B4/4P3/5PPP/2R1R1K1 b - - 2 26,Bxe5,397,446,49,1
1rr3k1/2N2p1p/p1Q3p1/q3b3/3B4/4P3/5PPP/2R1R1K1 w - - 0 27,Bxe5,466,383,-83,1
1rr3k1/2N2p1p/p1Q3p1/q3B3/8/4P3/5PPP/2R1R1K1 b - - 0 27,Qxe5,355,363,8,1
1rr3k1/2N2p1p/p1Q3p1/4q3/8/4P3/5PPP/2R1R1K1 w - - 0 28,Qd7,360,349,-11,1
1rr3k1/2NQ1p1p/p5p1/4q3/8/4P3/5PPP/2R1R1K1 b - - 1 28,Rd8,325,349,24,1
1r1r2k1/2NQ1p1p/p5p1/4q3/8/4P3/5PPP/2R1R1K1 w - - 2 29,Qc6,356,326,-30,1
1r1r2k1/2N2p1p/p1Q3p1/4q3/8/4P3/5PPP/2R1R1K1 b - - 3 29,Rbc8,318,394,76,1
2rr2k1/2N2p1p/p1Q3p1/4q3/8/4P3/5PPP/2R1R1K1 w - - 4 30,Qb7,366,346,-20,1
2rr2k1/1QN2p1p/p5p1/4q3/8/4P3/5PPP/2R1R1K1 b - - 5 30,Qa5,339,411,72,1
2rr2k1/1QN2p1p/p5p1/q7/8/4P3/5PPP/2R1R1K1 w - - 6 31,Nxa6,444,306,-138,0
2rr2k1/1Q3p1p/N5p1/q7/8/4P3/5PPP/2R1R1K1 b - - 0 31,Rxc1,324,340,16,1
3r2k1/1Q3p1p/N5p1/q7/8/4P3/5PPP/2r1R1K1 w - - 0 32,Rxc1,338,335,-3,1
3r2k1/1Q3p1p/N5p1/q7/8/4P3/5PPP/2R3K1 b - - 0 32,Qd2,337,366,29,1
3r2k1/1Q3p1p/N5p1/8/8/4P3/3q1PPP/2R3K1 w - - 1 33,Rf1,360,373,13,1
3r2k1/1Q3p1p/N5p1/8/8/4P3/3q1PPP/5RK1 b - - 2 33,Rd3,390,462,72,1
6k1/1Q3p1p/N5p1/8/8/3rP3/3q1PPP/5RK1 w - - 3 34,h3,477,414,-63,1
6k1/1Q3p1p/N5p1/8/8/3rP2P/3q1PP1/5RK1 b - - 0 34,h5,405,489,84,1
6k1/1Q3p2/N5p1/7p/8/3rP2P/3q1PP1/5RK1 w - - 0 35,Nc5,484,503,19,1
6k1/1Q3p2/6p1/2N4p/8/3rP2P/3q1PP1/5RK1 b - - 1 35,Rd5,456,582,126,1
6k1/1Q3p2/6p1/2Nr3p/8/4P2P/3q1PP1/5RK1 w - - 2 36,Qc8+,647,450,-197,0
2Q3k1/5p2/6p1/2Nr3p/8/4P2P/3q1PP1/5RK1 b - - 3 36,Kg7,457,447,-10,1
2Q5/5pk1/6p1/2Nr3p/8/4P2P/3q1PP1/5RK1 w - - 4 37,Ne4,447,430,-17,1
2Q5/5pk1/6p1/3r3p/4N3/4P2P/3q1PP1/5RK1 b - - 5 37,Qa5,452,492,40,1
2Q5/5pk1/6p1/q2r3p/4N3/4P2P/5PP1/5RK1 w - - 6 38,Rc1,510,471,-39,1
2Q5/5pk1/6p1/q2r3p/4N3/4P2P/5PP1/2R3K1 b - - 7 38,Re5,487,480,-7,1
2Q5/5pk1/6p1/q3r2p/4N3/4P2P/5PP1/2R3K1 w - - 8 39,Nd6,501,422,-79,1
2Q5/5pk1/3N2p1/q3r2p/8/4P2P/5PP1/2R3K1 b - - 9 39,Rg5,488,566,78,1
2Q5/5pk1/3N2p1/q5rp/8/4P2P/5PP1/2R3K1 w - - 10 40,Ne8+,604,450,-154,0
2Q1N3/5pk1/6p1/q5rp/8/4P2P/5PP1/2R3K1 b - - 11 40,Kh6,495,616,121,1
2Q1N3/5p2/6pk/q5rp/8/4P2P/5PP1/2R3K1 w - - 12 41,Nd6,603,633,30,1
2Q5/5p2/3N2pk/q5rp/8/4P2P/5PP1/2R3K1 b - - 13 41,Qd5,618,9999,9381,1
2Q5/5p2/3N2pk/3q2rp/8/4P2P/5PP1/2R3K1 w - - 14 42,e4,9999,530,-9469,0
rnbqkbnr/pppppppp/8/8/8/8/PPPPPPPP/RNBQKBNR w KQkq - 0 1,f4,32,-17,-49,1
rnbqkbnr/pppppppp/8/8/5P2/8/PPPPP1PP/RNBQKBNR b KQkq - 0 1,d5,-22,-20,2,1
rnbqkbnr/ppp1pppp/8/3p4/5P2/8/PPPPP1PP/RNBQKBNR w KQkq - 0 2,d3,-14,-30,-16,1
rnbqkbnr/ppp1pppp/8/3p4/5P2/3P4/PPP1P1PP/RNBQKBNR b KQkq - 0 2,Nd7,-42,10,52,1
r1bqkbnr/pppnpppp/8/3p4/5P2/3P4/PPP1P1PP/RNBQKBNR w KQkq - 1 3,e4,13,-3,-16,1
r1bqkbnr/pppnpppp/8/3p4/4PP2/3P4/PPP3PP/RNBQKBNR b KQkq - 0 3,e5,-3,4,7,1
r1bqkbnr/pppn1ppp/8/3pp3/4PP2/3P4/PPP3PP/RNBQKBNR w KQkq - 0 4,g3,9,-98,-107,0
r1bqkbnr/pppn1ppp/8/3pp3/4PP2/3P2P1/PPP4P/RNBQKBNR b KQkq - 0 4,dxe4,-100,-61,39,1
r1bqkbnr/pppn1ppp/8/4p3/4pP2/3P2P1/PPP4P/RNBQKBNR w KQkq - 0 5,dxe4,-57,-54,3,1
r1bqkbnr/pppn1ppp/8/4p3/4PP2/6P1/PPP4P/RNBQKBNR b KQkq - 0 5,exf4,-51,-43,8,1
r1bqkbnr/pppn1ppp/8/8/4Pp2/6P1/PPP4P/RNBQKBNR w KQkq - 0 6,gxf4,-44,-381,-337,0
r1bqkbnr/pppn1ppp/8/8/4PP2/8/PPP4P/RNBQKBNR b KQkq - 0 6,Bc5,-368,-66,302,1
r1bqk1nr/pppn1ppp/8/2b5/4PP2/8/PPP4P/RNBQKBNR w KQkq - 1 7,Nf3,-62,-87,-25,1
r1bqk1nr/pppn1ppp/8/2b5/4PP2/5N2/PPP4P/RNBQKB1R b KQkq - 2 7,Ndf6,-101,66,167,1
r1bqk1nr/ppp2ppp/5n2/2b5/4PP2/5N2/PPP4P/RNBQKB1R w KQkq - 3 8,e5,65,-207,-272,0
r1bqk1nr/ppp2ppp/5n2/2b1P3/5P2/5N2/PPP4P/RNBQKB1R b KQkq - 0 8,Bb4+,-159,94,253,1
r1bqk1nr/ppp2ppp/5n2/4P3/1b3P2/5N2/PPP4P/RNBQKB1R w KQkq - 1 9,c3,125,112,-13,1
r1bqk1nr/ppp2ppp/5n2/4P3/1b3P2/2P2N2/PP5P/RNBQKB1R b KQkq - 0 9,Bd6,113,358,245,1
r1bqk1nr/ppp2ppp/3b1n2/4P3/5P2/2P2N2/PP5P/RNBQKB1R w KQkq - 1 10,exd6,350,351,1,1
r1bqk1nr/ppp2ppp/3P1n2/8/5P2/2P2N2/PP5P/RNBQKB1R b KQkq - 0 10,cxd6,339,366,27,1
r1bqk1nr/pp3ppp/3p1n2/8/5P2/2P2N2/PP5P/RNBQKB1R w KQkq - 0 11,Bb5+,392,348,-44,1
r1bqk1nr/pp3ppp/3p1n2/1B6/5P2/2P2N2/PP5P/RNBQK2R b KQkq - 1 11,Bd7,338,364,26,1
r2qk1nr/pp1b1ppp/3p1n2/1B6/5P2/2P2N2/PP5P/RNBQK2R w KQkq - 2 12,c4,330,322,-8,1
r2qk1nr/pp1b1ppp/3p1n2/1B6/2P2P2/5N2/PP5P/RNBQK2R b KQkq - 0 12,d5,303,355,52,1
r2qk1nr/pp1b1ppp/5n2/1B1p4/2P2P2/5N2/PP5P/RNBQK2R w KQkq - 0 13,Qd4,375,249,-126,0
r2qk1nr/pp1b1ppp/5n2/1B1p4/2PQ1P2/5N2/PP5P/RNB1K2R b KQkq - 1 13,dxc4,226,378,152,1
r2qk1nr/pp1b1ppp/5n2/1B6/2pQ1P2/5N2/PP5P/RNB1K2R w KQkq - 0 14,Qxc4,355,262,-93,1
r2qk1nr/pp1b1ppp/5n2/1B6/2Q2P2/5N2/PP5P/RNB1K2R b KQkq - 0 14,Rc8,248,283,35,1
2rqk1nr/pp1b1ppp/5n2/1B6/2Q2P2/5N2/PP5P/RNB1K2R w KQk - 1 15,Qd3,269,-463,-732,0
2rqk1nr/pp1b1ppp/5n2/1B6/5P2/3Q1N2/PP5P/RNB1K2R b KQk - 2 15,Rxc1+,-434,-466,-32,1
3qk1nr/pp1b1ppp/5n2/1B6/5P2/3Q1N2/PP5P/RNr1K2R w KQk - 0 16,Kf2,-446,-447,-1,1
3qk1nr/pp1b1ppp/5n2/1B6/5P2/3Q1N2/PP3K1P/RNr4R b k - 1 16,Rxh1,-448,-434,14,1
3qk1nr/pp1b1ppp/5n2/1B6/5P2/3Q1N2/PP3K1P/RN5r w k - 0 17,Qe3+,-453,-610,-157,0
3qk1nr/pp1b1ppp/5n2/1B6/5P2/4QN2/PP3K1P/RN5r b k - 1 17,Ne7,-661,-656,5,1
3qk2r/pp1bnppp/5n2/1B6/5P2/4QN2/PP3K1P/RN5r w k - 2 18,Nc3,-675,-786,-111,0
3qk2r/pp1bnppp/5n2/1B6/5P2/2N1QN2/PP3K1P/R6r b k - 3 18,Rxa1,-766,-737,29,1
3qk2r/pp1bnppp/5n2/1B6/5P2/2N1QN2/PP3K1P/r7 w k - 0 19,Ne5,-765,-817,-52,1
3qk2r/pp1bnppp/5n2/1B2N3/5P2/2N1Q3/PP3K1P/r7 b k - 1 19,Bxb5,-848,-859,-11,1
3qk2r/pp2nppp/5n2/1b2N3/5P2/2N1Q3/PP3K1P/r7 w k - 0 20,Nxb5,-845,-868,-23,1
3qk2r/pp2nppp/5n2/1N2N3/5P2/4Q3/PP3K1P/r7 b k - 0 20,Rxa2,-861,-830,31,1
3qk2r/pp2nppp/5n2/1N2N3/5P2/4Q3/rP3K1P/8 w k - 0 21,Qd4,-822,-843,-21,1
3qk2r/pp2nppp/5n2/1N2N3/3Q1P2/8/rP3K1P/8 b k - 1 21,Qxd4+,-846,-849,-3,1
4k2r/pp2nppp/5n2/1N2N3/3q1P2/8/rP3K1P/8 w k - 0 22,Nxd4,-855,-844,11,1
4k2r/pp2nppp/5n2/4N3/3N1P2/8/rP3K1P/8 b k - 0 22,Rxb2+,-865,-869,-4,1
4k2r/pp2nppp/5n2/4N3/3N1P2/8/1r3K1P/8 w k - 0 23,Kf3,-829,-893,-64,1
4k2r/pp2nppp/5n2/4N3/3N1P2/5K2/1r5P/8 b k - 1 23,O-O,-862,-866,-4,1
5rk1/pp2nppp/5n2/4N3/3N1P2/5K2/1r5P/8 w - - 2 24,Kg3,-889,-891,-2,1
5rk1/pp2nppp/5n2/4N3/3N1P2/6K1/1r5P/8 b - - 3 24,Rb4,-912,-859,53,1
5rk1/pp2nppp/5n2/4N3/1r1N1P2/6K1/7P/8 w - - 4 25,Ndf3,-882,-879,3,1
5rk1/pp2nppp/5n2/4N3/1r3P2/5NK1/7P/8 b - - 5 25,Ne4+,-875,-888,-13,1
5rk1/pp2nppp/8/4N3/1r2nP2/5NK1/7P/8 w - - 6 26,Kg4,-880,-924,-44,1
5rk1/pp2nppp/8/4N3/1r2nPK1/5N2/7P/8 b - - 7 26,Ng6,-899,-838,61,1
5rk1/pp3ppp/6n1/4N3/1r2nPK1/5N2/7P/8 w - - 8 27,Kf5,-828,-907,-79,1
5rk1/pp3ppp/6n1/4NK2/1r2nP2/5N2/7P/8 b - - 9 27,Nxf4,-947,-811,136,1
5rk1/pp3ppp/8/4NK2/1r2nn2/5N2/7P/8 w - - 0 28,Kxf4,-796,-835,-39,1
5rk1/pp3ppp/8/4N3/1r2nK2/5N2/7P/8 b - - 0 28,Re8,-807,-816,-9,1
4r1k1/pp3ppp/8/4N3/1r2nK2/5N2/7P/8 w - - 1 29,Nd3,-838,-825,13,1
4r1k1/pp3ppp/8/8/1r2nK2/3N1N2/7P/8 b - - 2 29,a5,-807,-808,-1,1
4r1k1/1p3ppp/8/p7/1r2nK2/3N1N2/7P/8 w - - 0 30,h4,-805,-850,-45,1
4r1k1/1p3ppp/8/p7/1r2nK1P/3N1N2/8/8 b - - 0 30,Rb5,-840,-851,-11,1
4r1k1/1p3ppp/8/pr6/4nK1P/3N1N2/8/8 w - - 1 31,Kg4,-827,-885,-58,1
4r1k1/1p3ppp/8/pr6/4n1KP/3N1N2/8/8 b - - 2 31,a4,-874,-825,49,1
4r1k1/1p3ppp/8/1r6/p3n1KP/3N1N2/8/8 w - - 0 32,h5,-852,-863,-11,1
4r1k1/1p3ppp/8/1r5P/p3n1K1/3N1N2/8/8 b - - 0 32,g6,-942,-826,116,1
4r1k1/1p3p1p/6p1/1r5P/p3n1K1/3N1N2/8/8 w - - 0 33,Nfe5,-814,-779,35,1
rnbqkbnr/pppppppp/8/8/8/8/PPPPPPPP/RNBQKBNR w KQkq - 0 1,e3,31,12,-19,1
rnbqkbnr/pppppppp/8/8/8/4P3/PPPP1PPP/RNBQKBNR b KQkq - 0 1,d5,6,10,4,1
rnbqkbnr/ppp1pppp/8/3p4/8/4P3/PPPP1PPP/RNBQKBNR w KQkq - 0 2,d3,3,-52,-55,1
rnbqkbnr/ppp1pppp/8/3p4/8/3PP3/PPP2PPP/RNBQKBNR b KQkq - 0 2,e6,-52,-11,41,1
rnbqkbnr/ppp2ppp/4p3/3p4/8/3PP3/PPP2PPP/RNBQKBNR w KQkq - 0 3,Be2,-7,-14,-7,1
rnbqkbnr/ppp2ppp/4p3/3p4/8/3PP3/PPP1BPPP/RNBQK1NR b KQkq - 1 3,Nc6,-13,10,23,1
r1bqkbnr/ppp2ppp/2n1p3/3p4/8/3PP3/PPP1BPPP/RNBQK1NR w KQkq - 2 4,Nf3,6,-4,-10,1
r1bqkbnr/ppp2ppp/2n1p3/3p4/8/3PPN2/PPP1BPPP/RNBQK2R b KQkq - 3 4,Nf6,-3,11,14,1
r1bqkb1r/ppp2ppp/2n1pn2/3p4/8/3PPN2/PPP1BPPP/RNBQK2R w KQkq - 4 5,d4,21,15,-6,1
r1bqkb1r/ppp2ppp/2n1pn2/3p4/3P4/4PN2/PPP1BPPP/RNBQK2R b KQkq - 0 5,Ne4,16,45,29,1
r1bqkb1r/ppp2ppp/2n1p3/3p4/3Pn3/4PN2/PPP1BPPP/RNBQK2R w KQkq - 1 6,Bb5,42,-13,-55,1
r1bqkb1r/ppp2ppp/2n1p3/1B1p4/3Pn3/4PN2/PPP2PPP/RNBQK2R b KQkq - 2 6,Bb4+,-25,15,40,1
r1bqk2r/ppp2ppp/2n1p3/1B1p4/1b1Pn3/4PN2/PPP2PPP/RNBQK2R w KQkq - 3 7,Bd2,19,1,-18,1
r1bqk2r/ppp2ppp/2n1p3/1B1p4/1b1Pn3/4PN2/PPPB1PPP/RN1QK2R b KQkq - 4 7,Bd7,-10,40,50,1
r2qk2r/pppb1ppp/2n1p3/1B1p4/1b1Pn3/4PN2/PPPB1PPP/RN1QK2R w KQkq - 5 8,Bxb4,34,31,-3,1
r2qk2r/pppb1ppp/2n1p3/1B1p4/1B1Pn3/4PN2/PPP2PPP/RN1QK2R b KQkq - 0 8,Nxb4,12,19,7,1
r2qk2r/pppb1ppp/4p3/1B1p4/1n1Pn3/4PN2/PPP2PPP/RN1QK2R w KQkq - 0 9,Bxd7+,17,24,7,1
r2qk2r/pppB1ppp/4p3/3p4/1n1Pn3/4PN2/PPP2PPP/RN1QK2R b KQkq - 0 9,Qxd7,21,25,4,1
r3k2r/pppq1ppp/4p3/3p4/1n1Pn3/4PN2/PPP2PPP/RN1QK2R w KQkq - 0 10,c3,22,21,-1,1
r3k2r/pppq1ppp/4p3/3p4/1n1Pn3/2P1PN2/PP3PPP/RN1QK2R b KQkq - 0 10,Nc6,20,20,0,1
r3k2r/pppq1ppp/2n1p3/3p4/3Pn3/2P1PN2/PP3PPP/RN1QK2R w KQkq - 1 11,Na3,16,-47,-63,1
r3k2r/pppq1ppp/2n1p3/3p4/3Pn3/N1P1PN2/PP3PPP/R2QK2R b KQkq - 2 11,O-O,-41,3,44,1
r4rk1/pppq1ppp/2n1p3/3p4/3Pn3/N1P1PN2/PP3PPP/R2QK2R w KQ - 3 12,Nb5,5,-33,-38,1
r4rk1/pppq1ppp/2n1p3/1N1p4/3Pn3/2P1PN2/PP3PPP/R2QK2R b KQ - 4 12,Rfe8,-26,-13,13,1
r3r1k1/pppq1ppp/2n1p3/1N1p4/3Pn3/2P1PN2/PP3PPP/R2QK2R w KQ - 5 13,O-O,-25,-34,-9,1
r3r1k1/pppq1ppp/2n1p3/1N1p4/3Pn3/2P1PN2/PP3PPP/R2Q1RK1 b - - 6 13,e5,-26,-11,15,1
r3r1k1/pppq1ppp/2n5/1N1pp3/3Pn3/2P1PN2/PP3PPP/R2Q1RK1 w - - 0 14,Nxe5,-16,-414,-398,0
r3r1k1/pppq1ppp/2n5/1N1pN3/3Pn3/2P1P3/PP3PPP/R2Q1RK1 b - - 0 14,Nxe5,-368,-405,-37,1
r3r1k1/pppq1ppp/8/1N1pn3/3Pn3/2P1P3/PP3PPP/R2Q1RK1 w - - 0 15,dxe5,-370,-469,-99,1
r3r1k1/pppq1ppp/8/1N1pP3/4n3/2P1P3/PP3PPP/R2Q1RK1 b - - 0 15,Qxb5,-455,-452,3,1
r3r1k1/ppp2ppp/8/1q1pP3/4n3/2P1P3/PP3PPP/R2Q1RK1 w - - 0 16,b3,-464,-473,-9,1
r3r1k1/ppp2ppp/8/1q1pP3/4n3/1PP1P3/P4PPP/R2Q1RK1 b - - 0 16,Nxc3,-471,-489,-18,1
r3r1k1/ppp2ppp/8/1q1pP3/8/1Pn1P3/P4PPP/R2Q1RK1 w - - 0 17,Qd4,-488,-735,-247,0
r3r1k1/ppp2ppp/8/1q1pP3/3Q4/1Pn1P3/P4PPP/R4RK1 b - - 1 17,Ne2+,-736,-720,16,1
rnbqkbnr/pppppppp/8/8/8/8/PPPPPPPP/RNBQKBNR w KQkq - 0 1,f3,36,-90,-126,0
rnbqkbnr/pppppppp/8/8/8/5P2/PPPPP1PP/RNBQKBNR b KQkq - 0 1,e6,-90,-39,51,1
rnbqkbnr/pppp1ppp/4p3/8/8/5P2/PPPPP1PP/RNBQKBNR w KQkq - 0 2,Kf2,-47,-145,-98,1
rnbqkbnr/pppp1ppp/4p3/8/8/5P2/PPPPPKPP/RNBQ1BNR b kq - 1 2,d5,-152,-136,16,1
rnbqkbnr/ppp2ppp/4p3/3p4/8/5P2/PPPPPKPP/RNBQ1BNR w kq - 0 3,e3,-127,-110,17,1
rnbqkbnr/ppp2ppp/4p3/3p4/8/4PP2/PPPP1KPP/RNBQ1BNR b kq - 0 3,Nf6,-118,-133,-15,1
rnbqkb1r/ppp2ppp/4pn2/3p4/8/4PP2/PPPP1KPP/RNBQ1BNR w kq - 1 4,c3,-126,-185,-59,1
rnbqkb1r/ppp2ppp/4pn2/3p4/8/2P1PP2/PP1P1KPP/RNBQ1BNR b kq - 0 4,h5,-175,-97,78,1
rnbqkb1r/ppp2pp1/4pn2/3p3p/8/2P1PP2/PP1P1KPP/RNBQ1BNR w kq - 0 5,d4,-118,-113,5,1
rnbqkb1r/ppp2pp1/4pn2/3p3p/3P4/2P1PP2/PP3KPP/RNBQ1BNR b kq - 0 5,h4,-116,-76,40,1
rnbqkb1r/ppp2pp1/4pn2/3p4/3P3p/2P1PP2/PP3KPP/RNBQ1BNR w kq - 0 6,Be2,-69,-82,-13,1
rnbqkb1r/ppp2pp1/4pn2/3p4/3P3p/2P1PP2/PP2BKPP/RNBQ2NR b kq - 1 6,h3,-104,41,145,1
rnbqkb1r/ppp2pp1/4pn2/3p4/3P4/2P1PP1p/PP2BKPP/RNBQ2NR w kq - 0 7,g3,63,-94,-157,0
rnbqkb1r/ppp2pp1/4pn2/3p4/3P4/2P1PPPp/PP2BK1P/RNBQ2NR b kq - 0 7,g5,-78,-14,64,1
rnbqkb1r/ppp2p2/4pn2/3p2p1/3P4/2P1PPPp/PP2BK1P/RNBQ2NR w kq - 0 8,Bd3,-19,-157,-138,0
rnbqkb1r/ppp2p2/4pn2/3p2p1/3P4/2PBPPPp/PP3K1P/RNBQ2NR b kq - 1 8,g4,-154,-136,18,1
rnbqkb1r/ppp2p2/4pn2/3p4/3P2p1/2PBPPPp/PP3K1P/RNBQ2NR w kq - 0 9,Nd2,-165,-162,3,1
rnbqkb1r/ppp2p2/4pn2/3p4/3P2p1/2PBPPPp/PP1N1K1P/R1BQ2NR b kq - 1 9,gxf3,-153,6,159,1
rnbqkb1r/ppp2p2/4pn2/3p4/3P4/2PBPpPp/PP1N1K1P/R1BQ2NR w kq - 0 10,Ngxf3,-1,-18,-17,1
rnbqkb1r/ppp2p2/4pn2/3p4/3P4/2PBPNPp/PP1N1K1P/R1BQ3R b kq - 0 10,Be7,-33,-18,15,1
rnbqk2r/ppp1bp2/4pn2/3p4/3P4/2PBPNPp/PP1N1K1P/R1BQ3R w kq - 1 11,Qc2,-5,-149,-144,0
rnbqk2r/ppp1bp2/4pn2/3p4/3P4/2PBPNPp/PPQN1K1P/R1B4R b kq - 2 11,c6,-153,-37,116,1
rnbqk2r/pp2bp2/2p1pn2/3p4/3P4/2PBPNPp/PPQN1K1P/R1B4R w kq - 0 12,e4,-46,-55,-9,1
rnbqk2r/pp2bp2/2p1pn2/3p4/3PP3/2PB1NPp/PPQN1K1P/R1B4R b kq - 0 12,Nbd7,-58,105,163,1
r1bqk2r/pp1nbp2/2p1pn2/3p4/3PP3/2PB1NPp/PPQN1K1P/R1B4R w kq - 1 13,e5,98,99,1,1
r1bqk2r/pp1nbp2/2p1pn2/3pP3/3P4/2PB1NPp/PPQN1K1P/R1B4R b kq - 0 13,Ne4+,71,352,281,1
r1bqk2r/pp1nbp2/2p1p3/3pP3/3Pn3/2PB1NPp/PPQN1K1P/R1B4R w kq - 1 14,Bxe4,345,337,-8,1
r1bqk2r/pp1nbp2/2p1p3/3pP3/3PB3/2P2NPp/PPQN1K1P/R1B4R b kq - 0 14,dxe4,309,331,22,1
r1bqk2r/pp1nbp2/2p1p3/4P3/3Pp3/2P2NPp/PPQN1K1P/R1B4R w kq - 0 15,Nxe4,318,328,10,1
r1bqk2r/pp1nbp2/2p1p3/4P3/3PN3/2P2NPp/PPQ2K1P/R1B4R b kq - 0 15,Nb6,321,414,93,1
r1bqk2r/pp2bp2/1np1p3/4P3/3PN3/2P2NPp/PPQ2K1P/R1B4R w kq - 1 16,Nf6+,398,208,-190,0
r1bqk2r/pp2bp2/1np1pN2/4P3/3P4/2P2NPp/PPQ2K1P/R1B4R b kq - 2 16,Bxf6,177,227,50,1
r1bqk2r/pp3p2/1np1pb2/4P3/3P4/2P2NPp/PPQ2K1P/R1B4R w kq - 0 17,exf6,195,197,2,1
r1bqk2r/pp3p2/1np1pP2/8/3P4/2P2NPp/PPQ2K1P/R1B4R b kq - 0 17,Qxf6,202,213,11,1
r1b1k2r/pp3p2/1np1pq2/8/3P4/2P2NPp/PPQ2K1P/R1B4R w kq - 0 18,Rf1,193,98,-95,1
r1b1k2r/pp3p2/1np1pq2/8/3P4/2P2NPp/PPQ2K1P/R1B2R2 b kq - 1 18,Nd5,105,236,131,1
r1b1k2r/pp3p2/2p1pq2/3n4/3P4/2P2NPp/PPQ2K1P/R1B2R2 w kq - 2 19,Kg1,220,164,-56,1
r1b1k2r/pp3p2/2p1pq2/3n4/3P4/2P2NPp/PPQ4P/R1B2RK1 b kq - 3 19,Qe7,161,290,129,1
r1b1k2r/pp2qp2/2p1p3/3n4/3P4/2P2NPp/PPQ4P/R1B2RK1 w kq - 4 20,Ne5,285,292,7,1
r1b1k2r/pp2qp2/2p1p3/3nN3/3P4/2P3Pp/PPQ4P/R1B2RK1 b kq - 5 20,Bd7,293,439,146,1
r3k2r/pp1bqp2/2p1p3/3nN3/3P4/2P3Pp/PPQ4P/R1B2RK1 w kq - 6 21,Nxf7,457,428,-29,1
r3k2r/pp1bqN2/2p1p3/3n4/3P4/2P3Pp/PPQ4P/R1B2RK1 b kq - 0 21,Rf8,465,519,54,1
r3kr2/pp1bqN2/2p1p3/3n4/3P4/2P3Pp/PPQ4P/R1B2RK1 w q - 1 22,Ne5,552,201,-351,0
r3kr2/pp1bq3/2p1p3/3nN3/3P4/2P3Pp/PPQ4P/R1B2RK1 b q - 2 22,Rxf1+,165,186,21,1
r3k3/pp1bq3/2p1p3/3nN3/3P4/2P3Pp/PPQ4P/R1B2rK1 w q - 0 23,Kxf1,188,180,-8,1
r3k3/pp1bq3/2p1p3/3nN3/3P4/2P3Pp/PPQ4P/R1B2K2 b q - 0 23,O-O-O,195,183,-12,1
2kr4/pp1bq3/2p1p3/3nN3/3P4/2P3Pp/PPQ4P/R1B2K2 w - - 1 24,Kg1,220,162,-58,1
2kr4/pp1bq3/2p1p3/3nN3/3P4/2P3Pp/PPQ4P/R1B3K1 b - - 2 24,Rf8,176,245,69,1
2k2r2/pp1bq3/2p1p3/3nN3/3P4/2P3Pp/PPQ4P/R1B3K1 w - - 3 25,Qe4,228,168,-60,1
2k2r2/pp1bq3/2p1p3/3nN3/3PQ3/2P3Pp/PP5P/R1B3K1 b - - 4 25,Qf6,172,154,-18,1
2k2r2/pp1b4/2p1pq2/3nN3/3PQ3/2P3Pp/PP5P/R1B3K1 w - - 5 26,Qe2,171,153,-18,1
2k2r2/pp1b4/2p1pq2/3nN3/3P4/2P3Pp/PP2Q2P/R1B3K1 b - - 6 26,Be8,151,148,-3,1
2k1br2/pp6/2p1pq2/3nN3/3P4/2P3Pp/PP2Q2P/R1B3K1 w - - 7 27,Ng4,134,-375,-509,0
2k1br2/pp6/2p1pq2/3n4/3P2N1/2P3Pp/PP2Q2P/R1B3K1 b - - 8 27,Qf5,-404,205,609,1
2k1br2/pp6/2p1p3/3n1q2/3P2N1/2P3Pp/PP2Q2P/R1B3K1 w - - 9 28,Ne3,195,-410,-605,0
2k1br2/pp6/2p1p3/3n1q2/3P4/2P1N1Pp/PP2Q2P/R1B3K1 b - - 10 28,Qe4,-373,-409,-36,1
2k1br2/pp6/2p1p3/3n4/3Pq3/2P1N1Pp/PP2Q2P/R1B3K1 w - - 11 29,Bd2,-461,-505,-44,1
2k1br2/pp6/2p1p3/3n4/3Pq3/2P1N1Pp/PP1BQ2P/R5K1 b - - 12 29,Rf3,-536,-260,276,1
2k1b3/pp6/2p1p3/3n4/3Pq3/2P1NrPp/PP1BQ2P/R5K1 w - - 13 30,Re1,-351,-443,-92,1
2k1b3/pp6/2p1p3/3n4/3Pq3/2P1NrPp/PP1BQ2P/4R1K1 b - - 14 30,Bh5,-444,45,489,1
2k5/pp6/2p1p3/3n3b/3Pq3/2P1NrPp/PP1BQ2P/4R1K1 w - - 15 31,Nxd5,62,-242,-304,0
2k5/pp6/2p1p3/3N3b/3Pq3/2P2rPp/PP1BQ2P/4R1K1 b - - 0 31,Rxg3+,-264,-250,14,1
2k5/pp6/2p1p3/3N3b/3Pq3/2P3rp/PP1BQ2P/4R1K1 w - - 0 32,hxg3,-283,-279,4,1
2k5/pp6/2p1p3/3N3b/3Pq3/2P3Pp/PP1BQ3/4R1K1 b - - 0 32,Bxe2,-270,-282,-12,1
2k5/pp6/2p1p3/3N4/3Pq3/2P3Pp/PP1Bb3/4R1K1 w - - 0 33,Ne7+,-257,-9997,-9740,0
2k5/pp2N3/2p1p3/8/3Pq3/2P3Pp/PP1Bb3/4R1K1 b - - 1 33,Kd7,-9997,-9998,-1,1
8/pp1kN3/2p1p3/8/3Pq3/2P3Pp/PP1Bb3/4R1K1 w - - 2 34,Ng6,-9998,-9999,-1,1
8/pp1k4/2p1p1N1/8/3Pq3/2P3Pp/PP1Bb3/4R1K1 b - - 3 34,Qg2#,-9999,-10000,-1,1
rnbqkbnr/pppppppp/8/8/8/8/PPPPPPPP/RNBQKBNR w KQkq - 0 1,e4,42,43,1,1
rnbqkbnr/pppppppp/8/8/4P3/8/PPPP1PPP/RNBQKBNR b KQkq - 0 1,e5,32,36,4,1
rnbqkbnr/pppp1ppp/8/4p3/4P3/8/PPPP1PPP/RNBQKBNR w KQkq - 0 2,Nf3,33,25,-8,1
rnbqkbnr/pppp1ppp/8/4p3/4P3/5N2/PPPP1PPP/RNBQKB1R b KQkq - 1 2,d6,28,31,3,1
rnbqkbnr/ppp2ppp/3p4/4p3/4P3/5N2/PPPP1PPP/RNBQKB1R w KQkq - 0 3,Bc4,35,29,-6,1
rnbqkbnr/ppp2ppp/3p4/4p3/2B1P3/5N2/PPPP1PPP/RNBQK2R b KQkq - 1 3,Be7,20,27,7,1
rnbqk1nr/ppp1bppp/3p4/4p3/2B1P3/5N2/PPPP1PPP/RNBQK2R w KQkq - 2 4,d3,36,25,-11,1
rnbqk1nr/ppp1bppp/3p4/4p3/2B1P3/3P1N2/PPP2PPP/RNBQK2R b KQkq - 0 4,Nf6,30,20,-10,1
rnbqk2r/ppp1bppp/3p1n2/4p3/2B1P3/3P1N2/PPP2PPP/RNBQK2R w KQkq - 1 5,Ng5,26,-30,-56,1
rnbqk2r/ppp1bppp/3p1n2/4p1N1/2B1P3/3P4/PPP2PPP/RNBQK2R b KQkq - 2 5,O-O,-37,-31,6,1
rnbq1rk1/ppp1bppp/3p1n2/4p1N1/2B1P3/3P4/PPP2PPP/RNBQK2R w KQ - 3 6,Nc3,-29,-40,-11,1
rnbq1rk1/ppp1bppp/3p1n2/4p1N1/2B1P3/2NP4/PPP2PPP/R1BQK2R b KQ - 4 6,h6,-32,-31,1,1
rnbq1rk1/ppp1bpp1/3p1n1p/4p1N1/2B1P3/2NP4/PPP2PPP/R1BQK2R w KQ - 0 7,Nf3,-29,-32,-3,1
rnbq1rk1/ppp1bpp1/3p1n1p/4p3/2B1P3/2NP1N2/PPP2PPP/R1BQK2R b KQ - 1 7,Nc6,-49,-9,40,1
r1bq1rk1/ppp1bpp1/2np1n1p/4p3/2B1P3/2NP1N2/PPP2PPP/R1BQK2R w KQ - 2 8,Nd5,9,-101,-110,0
r1bq1rk1/ppp1bpp1/2np1n1p/3Np3/2B1P3/3P1N2/PPP2PPP/R1BQK2R b KQ - 3 8,Nxd5,-55,-56,-1,1
r1bq1rk1/ppp1bpp1/2np3p/3np3/2B1P3/3P1N2/PPP2PPP/R1BQK2R w KQ - 0 9,Bxd5,-57,-62,-5,1
r1bq1rk1/ppp1bpp1/2np3p/3Bp3/4P3/3P1N2/PPP2PPP/R1BQK2R b KQ - 0 9,Bd7,-56,-30,26,1
r2q1rk1/pppbbpp1/2np3p/3Bp3/4P3/3P1N2/PPP2PPP/R1BQK2R w KQ - 1 10,O-O,-21,-27,-6,1
r2q1rk1/pppbbpp1/2np3p/3Bp3/4P3/3P1N2/PPP2PPP/R1BQ1RK1 b - - 2 10,Rb8,-30,13,43,1
1r1q1rk1/pppbbpp1/2np3p/3Bp3/4P3/3P1N2/PPP2PPP/R1BQ1RK1 w - - 3 11,Be3,13,-18,-31,1
1r1q1rk1/pppbbpp1/2np3p/3Bp3/4P3/3PBN2/PPP2PPP/R2Q1RK1 b - - 4 11,b6,-20,24,44,1
1r1q1rk1/p1pbbpp1/1pnp3p/3Bp3/4P3/3PBN2/PPP2PPP/R2Q1RK1 w - - 0 12,b4,17,-118,-135,0
1r1q1rk1/p1pbbpp1/1pnp3p/3Bp3/1P2P3/3PBN2/P1P2PPP/R2Q1RK1 b - - 0 12,Nxb4,-131,-148,-17,1
1r1q1rk1/p1pbbpp1/1p1p3p/3Bp3/1n2P3/3PBN2/P1P2PPP/R2Q1RK1 w - - 0 13,Qb1,-142,-354,-212,0
1r1q1rk1/p1pbbpp1/1p1p3p/3Bp3/1n2P3/3PBN2/P1P2PPP/RQ3RK1 b - - 1 13,c5,-335,-174,161,1
1r1q1rk1/p2bbpp1/1p1p3p/2pBp3/1n2P3/3PBN2/P1P2PPP/RQ3RK1 w - - 0 14,a3,-197,-355,-158,0
1r1q1rk1/p2bbpp1/1p1p3p/2pBp3/1n2P3/P2PBN2/2P2PPP/RQ3RK1 b - - 0 14,Nxd5,-354,-343,11,1
1r1q1rk1/p2bbpp1/1p1p3p/2pnp3/4P3/P2PBN2/2P2PPP/RQ3RK1 w - - 0 15,exd5,-346,-348,-2,1
1r1q1rk1/p2bbpp1/1p1p3p/2pPp3/8/P2PBN2/2P2PPP/RQ3RK1 b - - 0 15,Bg4,-338,-268,70,1
1r1q1rk1/p3bpp1/1p1p3p/2pPp3/6b1/P2PBN2/2P2PPP/RQ3RK1 w - - 1 16,Qd1,-264,-383,-119,0
1r1q1rk1/p3bpp1/1p1p3p/2pPp3/6b1/P2PBN2/2P2PPP/R2Q1RK1 b - - 2 16,Bxf3,-376,-227,149,1
1r1q1rk1/p3bpp1/1p1p3p/2pPp3/8/P2PBb2/2P2PPP/R2Q1RK1 w - - 0 17,Qxf3,-229,-203,26,1
1r1q1rk1/p3bpp1/1p1p3p/2pPp3/8/P2PBQ2/2P2PPP/R4RK1 b - - 0 17,Bg5,-193,-161,32,1
1r1q1rk1/p4pp1/1p1p3p/2pPp1b1/8/P2PBQ2/2P2PPP/R4RK1 w - - 1 18,Qg3,-176,-252,-76,1
1r1q1rk1/p4pp1/1p1p3p/2pPp1b1/8/P2PB1Q1/2P2PPP/R4RK1 b - - 2 18,Bxe3,-220,-169,51,1
1r1q1rk1/p4pp1/1p1p3p/2pPp3/8/P2Pb1Q1/2P2PPP/R4RK1 w - - 0 19,Qxe3,-176,-183,-7,1
1r1q1rk1/p4pp1/1p1p3p/2pPp3/8/P2PQ3/2P2PPP/R4RK1 b - - 0 19,f5,-249,-144,105,1
1r1q1rk1/p5p1/1p1p3p/2pPpp2/8/P2PQ3/2P2PPP/R4RK1 w - - 0 20,Qh3,-142,-269,-127,0
1r1q1rk1/p5p1/1p1p3p/2pPpp2/8/P2P3Q/2P2PPP/R4RK1 b - - 1 20,f4,-246,-185,61,1
1r1q1rk1/p5p1/1p1p3p/2pPp3/5p2/P2P3Q/2P2PPP/R4RK1 w - - 0 21,Qe6+,-189,-202,-13,1
1r1q1rk1/p5p1/1p1pQ2p/2pPp3/5p2/P2P4/2P2PPP/R4RK1 b - - 1 21,Kh8,-192,-166,26,1
rnbqkbnr/pppppppp/8/8/8/8/PPPPPPPP/RNBQKBNR w KQkq - 0 1,e4,26,34,8,1
rnbqkbnr/pppppppp/8/8/4P3/8/PPPP1PPP/RNBQKBNR b KQkq - 0 1,c5,31,32,1,1
rnbqkbnr/pp1ppppp/8/2p5/4P3/8/PPPP1PPP/RNBQKBNR w KQkq - 0 2,f4,41,-20,-61,1
rnbqkbnr/pp1ppppp/8/2p5/4PP2/8/PPPP2PP/RNBQKBNR b KQkq - 0 2,d6,-10,28,38,1
rnbqkbnr/pp2pppp/3p4/2p5/4PP2/8/PPPP2PP/RNBQKBNR w KQkq - 0 3,Nf3,30,38,8,1
rnbqkbnr/pp2pppp/3p4/2p5/4PP2/5N2/PPPP2PP/RNBQKB1R b KQkq - 1 3,e6,28,30,2,1
rnbqkbnr/pp3ppp/3pp3/2p5/4PP2/5N2/PPPP2PP/RNBQKB1R w KQkq - 0 4,Bc4,51,-11,-62,1
rnbqkbnr/pp3ppp/3pp3/2p5/2B1PP2/5N2/PPPP2PP/RNBQK2R b KQkq - 1 4,Nf6,-31,18,49,1
rnbqkb1r/pp3ppp/3ppn2/2p5/2B1PP2/5N2/PPPP2PP/RNBQK2R w KQkq - 2 5,Nc3,18,-10,-28,1
rnbqkb1r/pp3ppp/3ppn2/2p5/2B1PP2/2N2N2/PPPP2PP/R1BQK2R b KQkq - 3 5,a6,-12,-18,-6,1
rnbqkb1r/1p3ppp/p2ppn2/2p5/2B1PP2/2N2N2/PPPP2PP/R1BQK2R w KQkq - 0 6,a4,-32,-53,-21,1
rnbqkb1r/1p3ppp/p2ppn2/2p5/P1B1PP2/2N2N2/1PPP2PP/R1BQK2R b KQkq - 0 6,Qc7,-77,15,92,1
rnb1kb1r/1pq2ppp/p2ppn2/2p5/P1B1PP2/2N2N2/1PPP2PP/R1BQK2R w KQkq - 1 7,d3,44,37,-7,1
rnb1kb1r/1pq2ppp/p2ppn2/2p5/P1B1PP2/2NP1N2/1PP3PP/R1BQK2R b KQkq - 0 7,Be7,37,61,24,1
rnb1k2r/1pq1bppp/p2ppn2/2p5/P1B1PP2/2NP1N2/1PP3PP/R1BQK2R w KQkq - 1 8,h4,76,-53,-129,0
rnb1k2r/1pq1bppp/p2ppn2/2p5/P1B1PP1P/2NP1N2/1PP3P1/R1BQK2R b KQkq - 0 8,Nc6,-64,-59,5,1
r1b1k2r/1pq1bppp/p1nppn2/2p5/P1B1PP1P/2NP1N2/1PP3P1/R1BQK2R w KQkq - 1 9,h5,-71,-103,-32,1
r1b1k2r/1pq1bppp/p1nppn2/2p4P/P1B1PP2/2NP1N2/1PP3P1/R1BQK2R b KQkq - 0 9,Bd7,-87,-69,18,1
r3k2r/1pqbbppp/p1nppn2/2p4P/P1B1PP2/2NP1N2/1PP3P1/R1BQK2R w KQkq - 1 10,h6,-57,-117,-60,1
r3k2r/1pqbbppp/p1nppn1P/2p5/P1B1PP2/2NP1N2/1PP3P1/R1BQK2R b KQkq - 0 10,g6,-117,-63,54,1
r3k2r/1pqbbp1p/p1nppnpP/2p5/P1B1PP2/2NP1N2/1PP3P1/R1BQK2R w KQkq - 0 11,Ng5,-33,-72,-39,1
r3k2r/1pqbbp1p/p1nppnpP/2p3N1/P1B1PP2/2NP4/1PP3P1/R1BQK2R b KQkq - 1 11,Rb8,-65,0,65,1
1r2k2r/1pqbbp1p/p1nppnpP/2p3N1/P1B1PP2/2NP4/1PP3P1/R1BQK2R w KQk - 2 12,Bd2,-18,-42,-24,1
1r2k2r/1pqbbp1p/p1nppnpP/2p3N1/P1B1PP2/2NP4/1PPB2P1/R2QK2R b KQk - 3 12,Nd4,-41,-22,19,1
1r2k2r/1pqbbp1p/p2ppnpP/2p3N1/P1BnPP2/2NP4/1PPB2P1/R2QK2R w KQk - 4 13,Be3,-19,-97,-78,1
1r2k2r/1pqbbp1p/p2ppnpP/2p3N1/P1BnPP2/2NPB3/1PP3P1/R2QK2R b KQk - 5 13,b5,-105,-79,26,1
1r2k2r/2qbbp1p/p2ppnpP/1pp3N1/P1BnPP2/2NPB3/1PP3P1/R2QK2R w KQk - 0 14,Bxd4,-83,-396,-313,0
1r2k2r/2qbbp1p/p2ppnpP/1pp3N1/P1BBPP2/2NP4/1PP3P1/R2QK2R b KQk - 0 14,cxd4,-350,-364,-14,1
1r2k2r/2qbbp1p/p2ppnpP/1p4N1/P1BpPP2/2NP4/1PP3P1/R2QK2R w KQk - 0 15,Nxb5,-341,-347,-6,1
1r2k2r/2qbbp1p/p2ppnpP/1N4N1/P1BpPP2/3P4/1PP3P1/R2QK2R b KQk - 0 15,axb5,-331,-385,-54,1
1r2k2r/2qbbp1p/3ppnpP/1p4N1/P1BpPP2/3P4/1PP3P1/R2QK2R w KQk - 0 16,axb5,-366,-364,2,1
1r2k2r/2qbbp1p/3ppnpP/1P4N1/2BpPP2/3P4/1PP3P1/R2QK2R b KQk - 0 16,Bxb5,-352,-281,71,1
1r2k2r/2q1bp1p/3ppnpP/1b4N1/2BpPP2/3P4/1PP3P1/R2QK2R w KQk - 0 17,Bb3,-270,-355,-85,1
1r2k2r/2q1bp1p/3ppnpP/1b4N1/3pPP2/1B1P4/1PP3P1/R2QK2R b KQk - 1 17,O-O,-365,-358,7,1
1r3rk1/2q1bp1p/3ppnpP/1b4N1/3pPP2/1B1P4/1PP3P1/R2QK2R w KQ - 2 18,g4,-332,-403,-71,1
1r3rk1/2q1bp1p/3ppnpP/1b4N1/3pPPP1/1B1P4/1PP5/R2QK2R b KQ - 0 18,Nd7,-380,-377,3,1
1r3rk1/2qnbp1p/3pp1pP/1b4N1/3pPPP1/1B1P4/1PP5/R2QK2R w KQ - 1 19,Nf3,-359,-401,-42,1
1r3rk1/2qnbp1p/3pp1pP/1b6/3pPPP1/1B1P1N2/1PP5/R2QK2R b KQ - 2 19,Bc6,-393,-370,23,1
1r3rk1/2qnbp1p/2bpp1pP/8/3pPPP1/1B1P1N2/1PP5/R2QK2R w KQ - 3 20,Nxd4,-365,-383,-18,1
1r3rk1/2qnbp1p/2bpp1pP/8/3NPPP1/1B1P4/1PP5/R2QK2R b KQ - 0 20,e5,-414,-340,74,1
1r3rk1/2qnbp1p/2bp2pP/4p3/3NPPP1/1B1P4/1PP5/R2QK2R w KQ - 0 21,Nxc6,-323,-347,-24,1
1r3rk1/2qnbp1p/2Np2pP/4p3/4PPP1/1B1P4/1PP5/R2QK2R b KQ - 0 21,Qxc6,-349,-326,23,1
1r3rk1/3nbp1p/2qp2pP/4p3/4PPP1/1B1P4/1PP5/R2QK2R w KQ - 0 22,f5,-334,-358,-24,1
1r3rk1/3nbp1p/2qp2pP/4pP2/4P1P1/1B1P4/1PP5/R2QK2R b KQ - 0 22,Nf6,-363,-274,89,1
1r3rk1/4bp1p/2qp1npP/4pP2/4P1P1/1B1P4/1PP5/R2QK2R w KQ - 1 23,g5,-276,-268,8,1
1r3rk1/4bp1p/2qp1npP/4pPP1/4P3/1B1P4/1PP5/R2QK2R b KQ - 0 23,Nxe4,-265,-107,158,1
1r3rk1/4bp1p/2qp2pP/4pPP1/4n3/1B1P4/1PP5/R2QK2R w KQ - 0 24,Qf3,-124,-121,3,1
1r3rk1/4bp1p/2qp2pP/4pPP1/4n3/1B1P1Q2/1PP5/R3K2R b KQ - 1 24,Nxg5,-132,447,579,1
1r3rk1/4bp1p/2qp2pP/4pPn1/8/1B1P1Q2/1PP5/R3K2R w KQ - 0 25,Qxc6,461,470,9,1
1r3rk1/4bp1p/2Qp2pP/4pPn1/8/1B1P4/1PP5/R3K2R b KQ - 0 25,Rbc8,458,555,97,1
2r2rk1/4bp1p/2Qp2pP/4pPn1/8/1B1P4/1PP5/R3K2R w KQ - 1 26,Qd7,550,455,-95,1
2r2rk1/3Qbp1p/3p2pP/4pPn1/8/1B1P4/1PP5/R3K2R b KQ - 2 26,Bf6,495,496,1,1
2r2rk1/3Q1p1p/3p1bpP/4pPn1/8/1B1P4/1PP5/R3K2R w KQ - 3 27,Qxd6,454,581,127,1
2r2rk1/5p1p/3Q1bpP/4pPn1/8/1B1P4/1PP5/R3K2R b KQ - 0 27,Rcd8,604,9996,9392,1
3r1rk1/5p1p/3Q1bpP/4pPn1/8/1B1P4/1PP5/R3K2R w KQ - 1 28,Qxf6,9996,9997,1,1
rnbqkbnr/pppppppp/8/8/8/8/PPPPPPPP/RNBQKBNR w KQkq - 0 1,e4,32,31,-1,1
rnbqkbnr/pppppppp/8/8/4P3/8/PPPP1PPP/RNBQKBNR b KQkq - 0 1,e5,35,29,-6,1
rnbqkbnr/pppp1ppp/8/4p3/4P3/8/PPPP1PPP/RNBQKBNR w KQkq - 0 2,Nf3,32,25,-7,1
rnbqkbnr/pppp1ppp/8/4p3/4P3/5N2/PPPP1PPP/RNBQKB1R b KQkq - 1 2,d5,31,83,52,1
rnbqkbnr/ppp2ppp/8/3pp3/4P3/5N2/PPPP1PPP/RNBQKB1R w KQkq - 0 3,exd5,68,72,4,1
rnbqkbnr/ppp2ppp/8/3Pp3/8/5N2/PPPP1PPP/RNBQKB1R b KQkq - 0 3,Qxd5,100,122,22,1
rnb1kbnr/ppp2ppp/8/3qp3/8/5N2/PPPP1PPP/RNBQKB1R w KQkq - 0 4,Nc3,110,119,9,1
rnb1kbnr/ppp2ppp/8/3qp3/8/2N2N2/PPPP1PPP/R1BQKB1R b KQkq - 1 4,Qe6,108,115,7,1
rnb1kbnr/ppp2ppp/4q3/4p3/8/2N2N2/PPPP1PPP/R1BQKB1R w KQkq - 2 5,Ng5,171,-31,-202,0
rnb1kbnr/ppp2ppp/4q3/4p1N1/8/2N5/PPPP1PPP/R1BQKB1R b KQkq - 3 5,Qg6,-26,112,138,1
rnb1kbnr/ppp2ppp/6q1/4p1N1/8/2N5/PPPP1PPP/R1BQKB1R w KQkq - 4 6,d4,118,108,-10,1
rnb1kbnr/ppp2ppp/6q1/4p1N1/3P4/2N5/PPP2PPP/R1BQKB1R b KQkq - 0 6,Be7,140,174,34,1
rnb1k1nr/ppp1bppp/6q1/4p1N1/3P4/2N5/PPP2PPP/R1BQKB1R w KQkq - 1 7,Nge4,172,-121,-293,0
rnb1k1nr/ppp1bppp/6q1/4p3/3PN3/2N5/PPP2PPP/R1BQKB1R b KQkq - 2 7,Bb4,-130,102,232,1
rnb1k1nr/ppp2ppp/6q1/4p3/1b1PN3/2N5/PPP2PPP/R1BQKB1R w KQkq - 3 8,f3,70,-70,-140,0
rnb1k1nr/ppp2ppp/6q1/4p3/1b1PN3/2N2P2/PPP3PP/R1BQKB1R b KQkq - 0 8,Bf5,-70,-88,-18,1
rn2k1nr/ppp2ppp/6q1/4pb2/1b1PN3/2N2P2/PPP3PP/R1BQKB1R w KQkq - 1 9,dxe5,-73,-94,-21,1
rn2k1nr/ppp2ppp/6q1/4Pb2/1b2N3/2N2P2/PPP3PP/R1BQKB1R b KQkq - 0 9,Bxe4,-103,-67,36,1
rn2k1nr/ppp2ppp/6q1/4P3/1b2b3/2N2P2/PPP3PP/R1BQKB1R w KQkq - 0 10,fxe4,-68,-68,0,1
rn2k1nr/ppp2ppp/6q1/4P3/1b2P3/2N5/PPP3PP/R1BQKB1R b KQkq - 0 10,Qxe4+,-74,-3,71,1
rn2k1nr/ppp2ppp/8/4P3/1b2q3/2N5/PPP3PP/R1BQKB1R w KQkq - 0 11,Be2,-10,-43,-33,1
rn2k1nr/ppp2ppp/8/4P3/1b2q3/2N5/PPP1B1PP/R1BQK2R b KQkq - 1 11,Qxg2,-20,251,271,1
rn2k1nr/ppp2ppp/8/4P3/1b6/2N5/PPP1B1qP/R1BQK2R w KQkq - 0 12,Rf1,221,-168,-389,0
rn2k1nr/ppp2ppp/8/4P3/1b6/2N5/PPP1B1qP/R1BQKR2 b Qkq - 1 12,Qxh2,-142,181,323,1
rn2k1nr/ppp2ppp/8/4P3/1b6/2N5/PPP1B2q/R1BQKR2 w Qkq - 0 13,Bd2,203,-396,-599,0
rn2k1nr/ppp2ppp/8/4P3/1b6/2N5/PPPBB2q/R2QKR2 b Qkq - 1 13,Qh4+,-478,-446,32,1
rn2k1nr/ppp2ppp/8/4P3/1b5q/2N5/PPPBB3/R2QKR2 w Qkq - 2 14,Rf2,-458,-445,13,1
rn2k1nr/ppp2ppp/8/4P3/1b5q/2N5/PPPBBR2/R2QK3 b Qkq - 3 14,Bc5,-464,-470,-6,1
rnbqkbnr/pppppppp/8/8/8/8/PPPPPPPP/RNBQKBNR w KQkq - 0 1,e4,34,30,-4,1
rnbqkbnr/pppppppp/8/8/4P3/8/PPPP1PPP/RNBQKBNR b KQkq - 0 1,e6,29,54,25,1
rnbqkbnr/pppp1ppp/4p3/8/4P3/8/PPPP1PPP/RNBQKBNR w KQkq - 0 2,d4,40,32,-8,1
rnbqkbnr/pppp1ppp/4p3/8/3PP3/8/PPP2PPP/RNBQKBNR b KQkq - 0 2,d5,26,35,9,1
rnbqkbnr/ppp2ppp/4p3/3p4/3PP3/8/PPP2PPP/RNBQKBNR w KQkq - 0 3,exd5,47,17,-30,1
rnbqkbnr/ppp2ppp/4p3/3P4/3P4/8/PPP2PPP/RNBQKBNR b KQkq - 0 3,exd5,19,19,0,1
rnbqkbnr/ppp2ppp/8/3p4/3P4/8/PPP2PPP/RNBQKBNR w KQkq - 0 4,c3,18,-19,-37,1
rnbqkbnr/ppp2ppp/8/3p4/3P4/2P5/PP3PPP/RNBQKBNR b KQkq - 0 4,c6,-2,28,30,1
rnbqkbnr/pp3ppp/2p5/3p4/3P4/2P5/PP3PPP/RNBQKBNR w KQkq - 0 5,Bd3,13,12,-1,1
rnbqkbnr/pp3ppp/2p5/3p4/3P4/2PB4/PP3PPP/RNBQK1NR b KQkq - 1 5,Bd6,11,6,-5,1
rnbqk1nr/pp3ppp/2pb4/3p4/3P4/2PB4/PP3PPP/RNBQK1NR w KQkq - 2 6,Qc2,8,-8,-16,1
rnbqk1nr/pp3ppp/2pb4/3p4/3P4/2PB4/PPQ2PPP/RNB1K1NR b KQkq - 3 6,Ne7,-17,12,29,1
rnbqk2r/pp2nppp/2pb4/3p4/3P4/2PB4/PPQ2PPP/RNB1K1NR w KQkq - 4 7,Ne2,15,14,-1,1
rnbqk2r/pp2nppp/2pb4/3p4/3P4/2PB4/PPQ1NPPP/RNB1K2R b KQkq - 5 7,h6,10,31,21,1
rnbqk2r/pp2npp1/2pb3p/3p4/3P4/2PB4/PPQ1NPPP/RNB1K2R w KQkq - 0 8,Be3,30,12,-18,1
rnbqk2r/pp2npp1/2pb3p/3p4/3P4/2PBB3/PPQ1NPPP/RN2K2R b KQkq - 1 8,Bg4,6,49,43,1
rn1qk2r/pp2npp1/2pb3p/3p4/3P2b1/2PBB3/PPQ1NPPP/RN2K2R w KQkq - 2 9,f3,52,15,-37,1
rn1qk2r/pp2npp1/2pb3p/3p4/3P2b1/2PBBP2/PPQ1N1PP/RN2K2R b KQkq - 0 9,Bh5,22,31,9,1
rn1qk2r/pp2npp1/2pb3p/3p3b/3P4/2PBBP2/PPQ1N1PP/RN2K2R w KQkq - 1 10,Nd2,47,16,-31,1
rn1qk2r/pp2npp1/2pb3p/3p3b/3P4/2PBBP2/PPQNN1PP/R3K2R b KQkq - 2 10,Nd7,17,24,7,1
r2qk2r/pp1nnpp1/2pb3p/3p3b/3P4/2PBBP2/PPQNN1PP/R3K2R w KQkq - 3 11,O-O-O,37,17,-20,1
r2qk2r/pp1nnpp1/2pb3p/3p3b/3P4/2PBBP2/PPQNN1PP/2KR3R b kq - 4 11,Qa5,13,88,75,1
r3k2r/pp1nnpp1/2pb3p/q2p3b/3P4/2PBBP2/PPQNN1PP/2KR3R w kq - 5 12,Kb1,80,52,-28,1
r3k2r/pp1nnpp1/2pb3p/q2p3b/3P4/2PBBP2/PPQNN1PP/1K1R3R b kq - 6 12,Bg6,62,67,5,1
r3k2r/pp1nnpp1/2pb2bp/q2p4/3P4/2PBBP2/PPQNN1PP/1K1R3R w kq - 7 13,Bxg6,68,54,-14,1
r3k2r/pp1nnpp1/2pb2Bp/q2p4/3P4/2P1BP2/PPQNN1PP/1K1R3R b kq - 0 13,Nxg6,55,49,-6,1
r3k2r/pp1n1pp1/2pb2np/q2p4/3P4/2P1BP2/PPQNN1PP/1K1R3R w kq - 0 14,Nb3,54,21,-33,1
r3k2r/pp1n1pp1/2pb2np/q2p4/3P4/1NP1BP2/PPQ1N1PP/1K1R3R b kq - 1 14,Qc7,36,34,-2,1
r3k2r/ppqn1pp1/2pb2np/3p4/3P4/1NP1BP2/PPQ1N1PP/1K1R3R w kq - 2 15,Rhe1,28,-41,-69,1
r3k2r/ppqn1pp1/2pb2np/3p4/3P4/1NP1BP2/PPQ1N1PP/1K1RR3 b kq - 3 15,O-O-O,-57,26,83,1
2kr3r/ppqn1pp1/2pb2np/3p4/3P4/1NP1BP2/PPQ1N1PP/1K1RR3 w - - 4 16,c4,26,-30,-56,1
2kr3r/ppqn1pp1/2pb2np/3p4/2PP4/1N2BP2/PPQ1N1PP/1K1RR3 b - - 0 16,dxc4,-34,-30,4,1
2kr3r/ppqn1pp1/2pb2np/8/2pP4/1N2BP2/PPQ1N1PP/1K1RR3 w - - 0 17,Qxc4,-30,-36,-6,1
2kr3r/ppqn1pp1/2pb2np/8/2QP4/1N2BP2/PP2N1PP/1K1RR3 b - - 0 17,Bxh2,-35,83,118,1
2kr3r/ppqn1pp1/2p3np/8/2QP4/1N2BP2/PP2N1Pb/1K1RR3 w - - 0 18,Qa4,97,-11,-108,0
2kr3r/ppqn1pp1/2p3np/8/Q2P4/1N2BP2/PP2N1Pb/1K1RR3 b - - 1 18,Bf4,-52,305,357,1
2kr3r/ppqn1pp1/2p3np/8/Q2P1b2/1N2BP2/PP2N1P1/1K1RR3 w - - 2 19,Nxf4,285,311,26,1
2kr3r/ppqn1pp1/2p3np/8/Q2P1N2/1N2BP2/PP4P1/1K1RR3 b - - 0 19,Nxf4,395,388,-7,1
2kr3r/ppqn1pp1/2p4p/8/Q2P1n2/1N2BP2/PP4P1/1K1RR3 w - - 0 20,Bxf4,342,39,-303,0
2kr3r/ppqn1pp1/2p4p/8/Q2P1B2/1N3P2/PP4P1/1K1RR3 b - - 0 20,Qxf4,24,18,-6,1
2kr3r/pp1n1pp1/2p4p/8/Q2P1q2/1N3P2/PP4P1/1K1RR3 w - - 0 21,Qxa7,17,14,-3,1
2kr3r/Qp1n1pp1/2p4p/8/3P1q2/1N3P2/PP4P1/1K1RR3 b - - 0 21,Rhe8,12,12,0,1
2krr3/Qp1n1pp1/2p4p/8/3P1q2/1N3P2/PP4P1/1K1RR3 w - - 1 22,Na5,14,-28,-42,1
2krr3/Qp1n1pp1/2p4p/N7/3P1q2/5P2/PP4P1/1K1RR3 b - - 2 22,Qb8,-34,-30,4,1
1qkrr3/Qp1n1pp1/2p4p/N7/3P4/5P2/PP4P1/1K1RR3 w - - 3 23,Qxb8+,-19,-20,-1,1
1Qkrr3/1p1n1pp1/2p4p/N7/3P4/5P2/PP4P1/1K1RR3 b - - 0 23,Nxb8,-18,-19,-1,1
1nkrr3/1p3pp1/2p4p/N7/3P4/5P2/PP4P1/1K1RR3 w - - 0 24,Rxe8,-18,-15,3,1
1nkrR3/1p3pp1/2p4p/N7/3P4/5P2/PP4P1/1K1R4 b - - 0 24,Rxe8,-11,-8,3,1
1nk1r3/1p3pp1/2p4p/N7/3P4/5P2/PP4P1/1K1R4 w - - 0 25,Rd2,-2,-36,-34,1
1nk1r3/1p3pp1/2p4p/N7/3P4/5P2/PP1R2P1/1K6 b - - 1 25,Kc7,-36,-21,15,1
1n2r3/1pk2pp1/2p4p/N7/3P4/5P2/PP1R2P1/1K6 w - - 2 26,Nc4,-24,-30,-6,1
1n2r3/1pk2pp1/2p4p/8/2NP4/5P2/PP1R2P1/1K6 b - - 3 26,f6,-27,-16,11,1
1n2r3/1pk3p1/2p2p1p/8/2NP4/5P2/PP1R2P1/1K6 w - - 0 27,b4,-12,-45,-33,1
1n2r3/1pk3p1/2p2p1p/8/1PNP4/5P2/P2R2P1/1K6 b - - 0 27,b5,-62,-66,-4,1
1n2r3/2k3p1/2p2p1p/1p6/1PNP4/5P2/P2R2P1/1K6 w - - 0 28,Na5,-58,-54,4,1
1n2r3/2k3p1/2p2p1p/Np6/1P1P4/5P2/P2R2P1/1K6 b - - 1 28,Re6,-45,-7,38,1
1n6/2k3p1/2p1rp1p/Np6/1P1P4/5P2/P2R2P1/1K6 w - - 2 29,Kc2,-17,-14,3,1
1n6/2k3p1/2p1rp1p/Np6/1P1P4/5P2/P1KR2P1/8 b - - 3 29,g6,-15,-12,3,1
1n6/2k5/2p1rppp/Np6/1P1P4/5P2/P1KR2P1/8 w - - 0 30,Kd3,-8,-42,-34,1
1n6/2k5/2p1rppp/Np6/1P1P4/3K1P2/P2R2P1/8 b - - 1 30,Nd7,-27,-24,3,1
8/2kn4/2p1rppp/Np6/1P1P4/3K1P2/P2R2P1/8 w - - 2 31,Rc2,-19,-88,-69,1
8/2kn4/2p1rppp/Np6/1P1P4/3K1P2/P1R3P1/8 b - - 3 31,Nb8,-87,-14,73,1
1n6/2k5/2p1rppp/Np6/1P1P4/3K1P2/P1R3P1/8 w - - 4 32,d5,6,-37,-43,1
1n6/2k5/2p1rppp/Np1P4/1P6/3K1P2/P1R3P1/8 b - - 0 32,Rd6,-31,-31,0,1
1n6/2k5/2pr1ppp/Np1P4/1P6/3K1P2/P1R3P1/8 w - - 1 33,Ke4,-19,-85,-66,1
1n6/2k5/2pr1ppp/Np1P4/1P2K3/5P2/P1R3P1/8 b - - 2 33,Kd7,-109,65,174,1
1n6/3k4/2pr1ppp/Np1P4/1P2K3/5P2/P1R3P1/8 w - - 3 34,dxc6+,2,-29,-31,1
1n6/3k4/2Pr1ppp/Np6/1P2K3/5P2/P1R3P1/8 b - - 0 34,Nxc6,-32,-28,4,1
8/3k4/2nr1ppp/Np6/1P2K3/5P2/P1R3P1/8 w - - 0 35,Nxc6,-24,-9,15,1
8/3k4/2Nr1ppp/1p6/1P2K3/5P2/P1R3P1/8 b - - 0 35,Rxc6,-12,-24,-12,1
8/3k4/2r2ppp/1p6/1P2K3/5P2/P1R3P1/8 w - - 0 36,Rd2+,-15,-23,-8,1
8/3k4/2r2ppp/1p6/1P2K3/5P2/P2R2P1/8 b - - 1 36,Ke6,-13,-3,10,1
8/8/2r1kppp/1p6/1P2K3/5P2/P2R2P1/8 w - - 2 37,Rd5,-23,-639,-616,0
8/8/2r1kppp/1p1R4/1P2K3/5P2/P5P1/8 b - - 3 37,Rc4+,-622,-238,384,1
8/8/4kppp/1p1R4/1Pr1K3/5P2/P5P1/8 w - - 4 38,Rd4,-288,-325,-37,1
8/8/4kppp/1p6/1PrRK3/5P2/P5P1/8 b - - 5 38,Rc2,-307,-136,171,1
8/8/4kppp/1p6/1P1RK3/5P2/P1r3P1/8 w - - 6 39,g4,-129,-194,-65,1
8/8/4kppp/1p6/1P1RK1P1/5P2/P1r5/8 b - - 0 39,Rxa2,-220,-179,41,1
8/8/4kppp/1p6/1P1RK1P1/5P2/r7/8 w - - 0 40,f4,-167,-181,-14,1
8/8/4kppp/1p6/1P1RKPP1/8/r7/8 b - - 0 40,Re2+,-158,-159,-1,1
8/8/4kppp/1p6/1P1RKPP1/8/4r3/8 w - - 1 41,Kf3,-164,-169,-5,1
8/8/4kppp/1p6/1P1R1PP1/5K2/4r3/8 b - - 2 41,Rb2,-161,-150,11,1
8/8/4kppp/1p6/1P1R1PP1/5K2/1r6/8 w - - 3 42,Ke4,-162,-165,-3,1
8/8/4kppp/1p6/1P1RKPP1/8/1r6/8 b - - 4 42,f5+,-182,-283,-101,0
8/8/4k1pp/1p3p2/1P1RKPP1/8/1r6/8 w - - 0 43,Kf3,-241,-498,-257,0
8/8/4k1pp/1p3p2/1P1R1PP1/5K2/1r6/8 b - - 1 43,fxg4+,-475,-353,122,1
8/8/4k1pp/1p6/1P1R1Pp1/5K2/1r6/8 w - - 0 44,Kxg4,-367,-328,39,1
8/8/4k1pp/1p6/1P1R1PK1/8/1r6/8 b - - 0 44,h5+,-344,-350,-6,1
rnbqkbnr/pppppppp/8/8/8/8/PPPPPPPP/RNBQKBNR w KQkq - 0 1,d4,35,15,-20,1
rnbqkbnr/pppppppp/8/8/3P4/8/PPP1PPPP/RNBQKBNR b KQkq - 0 1,d5,17,18,1,1
rnbqkbnr/ppp1pppp/8/3p4/3P4/8/PPP1PPPP/RNBQKBNR w KQkq - 0 2,Qd3,13,-63,-76,1
rnbqkbnr/ppp1pppp/8/3p4/3P4/3Q4/PPP1PPPP/RNB1KBNR b KQkq - 1 2,e6,-53,-40,13,1
rnbqkbnr/ppp2ppp/4p3/3p4/3P4/3Q4/PPP1PPPP/RNB1KBNR w KQkq - 0 3,e3,-39,-31,8,1
rnbqkbnr/ppp2ppp/4p3/3p4/3P4/3QP3/PPP2PPP/RNB1KBNR b KQkq - 0 3,c5,-26,-23,3,1
rnbqkbnr/pp3ppp/4p3/2pp4/3P4/3QP3/PPP2PPP/RNB1KBNR w KQkq - 0 4,e4,-38,-127,-89,1
rnbqkbnr/pp3ppp/4p3/2pp4/3PP3/3Q4/PPP2PPP/RNB1KBNR b KQkq - 0 4,c4,-111,-33,78,1
rnbqkbnr/pp3ppp/4p3/3p4/2pPP3/3Q4/PPP2PPP/RNB1KBNR w KQkq - 0 5,Qe2,-31,-16,15,1
rnbqkbnr/pp3ppp/4p3/3p4/2pPP3/8/PPP1QPPP/RNB1KBNR b KQkq - 1 5,Nf6,-27,-17,10,1
rnbqkb1r/pp3ppp/4pn2/3p4/2pPP3/8/PPP1QPPP/RNB1KBNR w KQkq - 2 6,exd5,-9,-26,-17,1
rnbqkb1r/pp3ppp/4pn2/3P4/2pP4/8/PPP1QPPP/RNB1KBNR b KQkq - 0 6,Qxd5,0,105,105,1
rnb1kb1r/pp3ppp/4pn2/3q4/2pP4/8/PPP1QPPP/RNB1KBNR w KQkq - 0 7,Nf3,116,46,-70,1
rnb1kb1r/pp3ppp/4pn2/3q4/2pP4/5N2/PPP1QPPP/RNB1KB1R b KQkq - 1 7,Qa5+,40,104,64,1
rnb1kb1r/pp3ppp/4pn2/q7/2pP4/5N2/PPP1QPPP/RNB1KB1R w KQkq - 2 8,Nc3,117,16,-101,0
rnb1kb1r/pp3ppp/4pn2/q7/2pP4/2N2N2/PPP1QPPP/R1B1KB1R b KQkq - 3 8,Bb4,22,121,99,1
rnb1k2r/pp3ppp/4pn2/q7/1bpP4/2N2N2/PPP1QPPP/R1B1KB1R w KQkq - 4 9,Bd2,124,36,-88,1
rnb1k2r/pp3ppp/4pn2/q7/1bpP4/2N2N2/PPPBQPPP/R3KB1R b KQkq - 5 9,Nc6,49,143,94,1
r1b1k2r/pp3ppp/2n1pn2/q7/1bpP4/2N2N2/PPPBQPPP/R3KB1R w KQkq - 6 10,Qxc4,152,149,-3,1
r1b1k2r/pp3ppp/2n1pn2/q7/1bQP4/2N2N2/PPPB1PPP/R3KB1R b KQkq - 0 10,Ne4,145,470,325,1
r1b1k2r/pp3ppp/2n1p3/q7/1bQPn3/2N2N2/PPPB1PPP/R3KB1R w KQkq - 1 11,Nxe4,444,483,39,1
r1b1k2r/pp3ppp/2n1p3/q7/1bQPN3/5N2/PPPB1PPP/R3KB1R b KQkq - 0 11,Bxd2+,502,481,-21,1
r1b1k2r/pp3ppp/2n1p3/q7/2QPN3/5N2/PPPb1PPP/R3KB1R w KQkq - 0 12,Nexd2,479,492,13,1
r1b1k2r/pp3ppp/2n1p3/q7/2QP4/5N2/PPPN1PPP/R3KB1R b KQkq - 0 12,Bd7,512,541,29,1
r3k2r/pp1b1ppp/2n1p3/q7/2QP4/5N2/PPPN1PPP/R3KB1R w KQkq - 1 13,Bd3,545,514,-31,1
r3k2r/pp1b1ppp/2n1p3/q7/2QP4/3B1N2/PPPN1PPP/R3K2R b KQkq - 2 13,b5,417,544,127,1
r3k2r/p2b1ppp/2n1p3/qp6/2QP4/3B1N2/PPPN1PPP/R3K2R w KQkq - 0 14,O-O,538,-418,-956,0
r3k2r/p2b1ppp/2n1p3/qp6/2QP4/3B1N2/PPPN1PPP/R4RK1 b kq - 1 14,O-O,-389,565,954,1
r4rk1/p2b1ppp/2n1p3/qp6/2QP4/3B1N2/PPPN1PPP/R4RK1 w - - 2 15,Qb3,606,564,-42,1
r4rk1/p2b1ppp/2n1p3/qp6/3P4/1Q1B1N2/PPPN1PPP/R4RK1 b - - 3 15,b4,544,597,53,1
r4rk1/p2b1ppp/2n1p3/q7/1p1P4/1Q1B1N2/PPPN1PPP/R4RK1 w - - 0 16,Nc4,585,611,26,1
r4rk1/p2b1ppp/2n1p3/q7/1pNP4/1Q1B1N2/PPP2PPP/R4RK1 b - - 1 16,a6,555,820,265,1
r4rk1/3b1ppp/p1n1p3/q7/1pNP4/1Q1B1N2/PPP2PPP/R4RK1 w - - 0 17,Be4,767,608,-159,0
r4rk1/3b1ppp/p1n1p3/q7/1pNPB3/1Q3N2/PPP2PPP/R4RK1 b - - 1 17,Rab8,599,795,196,1
1r3rk1/3b1ppp/p1n1p3/q7/1pNPB3/1Q3N2/PPP2PPP/R4RK1 w - - 2 18,Nxa5,797,769,-28,1
1r3rk1/3b1ppp/p1n1p3/N7/1p1PB3/1Q3N2/PPP2PPP/R4RK1 b - - 0 18,Nxa5,778,786,8,1
1r3rk1/3b1ppp/p3p3/n7/1p1PB3/1Q3N2/PPP2PPP/R4RK1 w - - 0 19,Qd3,767,683,-84,1
1r3rk1/3b1ppp/p3p3/n7/1p1PB3/3Q1N2/PPP2PPP/R4RK1 b - - 1 19,Bb5,646,674,28,1
1r3rk1/5ppp/p3p3/nb6/1p1PB3/3Q1N2/PPP2PPP/R4RK1 w - - 2 20,Qd2,722,677,-45,1
1r3rk1/5ppp/p3p3/nb6/1p1PB3/5N2/PPPQ1PPP/R4RK1 b - - 3 20,Bxf1,739,744,5,1
1r3rk1/5ppp/p3p3/n7/1p1PB3/5N2/PPPQ1PPP/R4bK1 w - - 0 21,Rxf1,744,743,-1,1
1r3rk1/5ppp/p3p3/n7/1p1PB3/5N2/PPPQ1PPP/5RK1 b - - 0 21,b3,711,785,74,1
1r3rk1/5ppp/p3p3/n7/3PB3/1p3N2/PPPQ1PPP/5RK1 w - - 0 22,cxb3,791,794,3,1
1r3rk1/5ppp/p3p3/n7/3PB3/1P3N2/PP1Q1PPP/5RK1 b - - 0 22,Nc6,773,835,62,1
1r3rk1/5ppp/p1n1p3/8/3PB3/1P3N2/PP1Q1PPP/5RK1 w - - 1 23,Bxc6,847,856,9,1
1r3rk1/5ppp/p1B1p3/8/3P4/1P3N2/PP1Q1PPP/5RK1 b - - 0 23,f5,865,894,29,1
1r3rk1/6pp/p1B1p3/5p2/3P4/1P3N2/PP1Q1PPP/5RK1 w - - 0 24,Ne5,893,878,-15,1
1r3rk1/6pp/p1B1p3/4Np2/3P4/1P6/PP1Q1PPP/5RK1 b - - 1 24,f4,857,844,-13,1
1r3rk1/6pp/p1B1p3/4N3/3P1p2/1P6/PP1Q1PPP/5RK1 w - - 0 25,Nd7,878,779,-99,1
1r3rk1/3N2pp/p1B1p3/8/3P1p2/1P6/PP1Q1PPP/5RK1 b - - 1 25,Rb6,783,849,66,1
5rk1/3N2pp/prB1p3/8/3P1p2/1P6/PP1Q1PPP/5RK1 w - - 2 26,Nxf8,803,806,3,1
5Nk1/6pp/prB1p3/8/3P1p2/1P6/PP1Q1PPP/5RK1 b - - 0 26,Rxc6,861,875,14,1
5Nk1/6pp/p1r1p3/8/3P1p2/1P6/PP1Q1PPP/5RK1 w - - 0 27,Qxf4,897,877,-20,1
5Nk1/6pp/p1r1p3/8/3P1Q2/1P6/PP3PPP/5RK1 b - - 0 27,Rc8,873,1011,138,1
2r2Nk1/6pp/p3p3/8/3P1Q2/1P6/PP3PPP/5RK1 w - - 1 28,Nxe6,1061,1033,-28,1
2r3k1/6pp/p3N3/8/3P1Q2/1P6/PP3PPP/5RK1 b - - 0 28,Re8,1008,1087,79,1
4r1k1/6pp/p3N3/8/3P1Q2/1P6/PP3PPP/5RK1 w - - 1 29,d5,1100,1032,-68,1
4r1k1/6pp/p3N3/3P4/5Q2/1P6/PP3PPP/5RK1 b - - 0 29,a5,981,1085,104,1
4r1k1/6pp/4N3/p2P4/5Q2/1P6/PP3PPP/5RK1 w - - 0 30,Qg5,1081,1053,-28,1
4r1k1/6pp/4N3/p2P2Q1/8/1P6/PP3PPP/5RK1 b - - 1 30,h6,9989,9999,10,1
4r1k1/6p1/4N2p/p2P2Q1/8/1P6/PP3PPP/5RK1 w - - 0 31,Qxg7#,9999,10000,1,1
rnbqkbnr/pppppppp/8/8/8/8/PPPPPPPP/RNBQKBNR w KQkq - 0 1,e4,36,32,-4,1
rnbqkbnr/pppppppp/8/8/4P3/8/PPPP1PPP/RNBQKBNR b KQkq - 0 1,c5,35,30,-5,1
rnbqkbnr/pp1ppppp/8/2p5/4P3/8/PPPP1PPP/RNBQKBNR w KQkq - 0 2,Bc4,20,-7,-27,1
rnbqkbnr/pp1ppppp/8/2p5/2B1P3/8/PPPP1PPP/RNBQK1NR b KQkq - 1 2,d5,-10,205,215,1
rnbqkbnr/pp2pppp/8/2pp4/2B1P3/8/PPPP1PPP/RNBQK1NR w KQkq - 0 3,exd5,184,140,-44,1
rnbqkbnr/pp2pppp/8/2pP4/2B5/8/PPPP1PPP/RNBQK1NR b KQkq - 0 3,Nd7,101,142,41,1
r1bqkbnr/pp1npppp/8/2pP4/2B5/8/PPPP1PPP/RNBQK1NR w KQkq - 1 4,Nf3,140,119,-21,1
r1bqkbnr/pp1npppp/8/2pP4/2B5/5N2/PPPP1PPP/RNBQK2R b KQkq - 2 4,Ngf6,129,175,46,1
r1bqkb1r/pp1npppp/5n2/2pP4/2B5/5N2/PPPP1PPP/RNBQK2R w KQkq - 3 5,O-O,178,76,-102,0
r1bqkb1r/pp1npppp/5n2/2pP4/2B5/5N2/PPPP1PPP/RNBQ1RK1 b kq - 4 5,Nb6,73,88,15,1
r1bqkb1r/pp2pppp/1n3n2/2pP4/2B5/5N2/PPPP1PPP/RNBQ1RK1 w kq - 5 6,Bb5+,128,62,-66,1
r1bqkb1r/pp2pppp/1n3n2/1BpP4/8/5N2/PPPP1PPP/RNBQ1RK1 b kq - 6 6,Bd7,109,114,5,1
r2qkb1r/pp1bpppp/1n3n2/1BpP4/8/5N2/PPPP1PPP/RNBQ1RK1 w kq - 7 7,Bxd7+,75,82,7,1
r2qkb1r/pp1Bpppp/1n3n2/2pP4/8/5N2/PPPP1PPP/RNBQ1RK1 b kq - 0 7,Qxd7,90,93,3,1
r3kb1r/pp1qpppp/1n3n2/2pP4/8/5N2/PPPP1PPP/RNBQ1RK1 w kq - 0 8,c4,92,45,-47,1
r3kb1r/pp1qpppp/1n3n2/2pP4/2P5/5N2/PP1P1PPP/RNBQ1RK1 b kq - 0 8,O-O-O,41,245,204,1
2kr1b1r/pp1qpppp/1n3n2/2pP4/2P5/5N2/PP1P1PPP/RNBQ1RK1 w - - 1 9,d3,228,180,-48,1
2kr1b1r/pp1qpppp/1n3n2/2pP4/2P5/3P1N2/PP3PPP/RNBQ1RK1 b - - 0 9,e6,168,185,17,1
2kr1b1r/pp1q1ppp/1n2pn2/2pP4/2P5/3P1N2/PP3PPP/RNBQ1RK1 w - - 0 10,Ne5,187,72,-115,0
2kr1b1r/pp1q1ppp/1n2pn2/2pPN3/2P5/3P4/PP3PPP/RNBQ1RK1 b - - 1 10,exd5,66,527,461,1
2kr1b1r/pp1q1ppp/1n3n2/2ppN3/2P5/3P4/PP3PPP/RNBQ1RK1 w - - 0 11,Nxd7,528,546,18,1
rnbqkbnr/pppppppp/8/8/8/8/PPPPPPPP/RNBQKBNR w KQkq - 0 1,e4,30,24,-6,1
rnbqkbnr/pppppppp/8/8/4P3/8/PPPP1PPP/RNBQKBNR b KQkq - 0 1,c5,22,20,-2,1
rnbqkbnr/pp1ppppp/8/2p5/4P3/8/PPPP1PPP/RNBQKBNR w KQkq - 0 2,Nf3,26,16,-10,1
rnbqkbnr/pp1ppppp/8/2p5/4P3/5N2/PPPP1PPP/RNBQKB1R b KQkq - 1 2,d6,11,9,-2,1
rnbqkbnr/pp2pppp/3p4/2p5/4P3/5N2/PPPP1PPP/RNBQKB1R w KQkq - 0 3,d4,17,22,5,1
rnbqkbnr/pp2pppp/3p4/2p5/3PP3/5N2/PPP2PPP/RNBQKB1R b KQkq - 0 3,cxd4,11,25,14,1
rnbqkbnr/pp2pppp/3p4/8/3pP3/5N2/PPP2PPP/RNBQKB1R w KQkq - 0 4,Nxd4,36,48,12,1
rnbqkbnr/pp2pppp/3p4/8/3NP3/8/PPP2PPP/RNBQKB1R b KQkq - 0 4,Nf6,32,44,12,1
rnbqkb1r/pp2pppp/3p1n2/8/3NP3/8/PPP2PPP/RNBQKB1R w KQkq - 1 5,Nc3,43,44,1,1
rnbqkb1r/pp2pppp/3p1n2/8/3NP3/2N5/PPP2PPP/R1BQKB1R b KQkq - 2 5,a6,39,45,6,1
rnbqkb1r/1p2pppp/p2p1n2/8/3NP3/2N5/PPP2PPP/R1BQKB1R w KQkq - 0 6,Be2,57,20,-37,1
rnbqkb1r/1p2pppp/p2p1n2/8/3NP3/2N5/PPP1BPPP/R1BQK2R b KQkq - 1 6,e5,23,30,7,1
rnbqkb1r/1p3ppp/p2p1n2/4p3/3NP3/2N5/PPP1BPPP/R1BQK2R w KQkq - 0 7,Nb3,24,18,-6,1
rnbqkb1r/1p3ppp/p2p1n2/4p3/4P3/1NN5/PPP1BPPP/R1BQK2R b KQkq - 1 7,Be7,20,25,5,1
rnbqk2r/1p2bppp/p2p1n2/4p3/4P3/1NN5/PPP1BPPP/R1BQK2R w KQkq - 2 8,g4,26,10,-16,1
rnbqk2r/1p2bppp/p2p1n2/4p3/4P1P1/1NN5/PPP1BP1P/R1BQK2R b KQkq - 0 8,b5,8,110,102,1
rnbqk2r/4bppp/p2p1n2/1p2p3/4P1P1/1NN5/PPP1BP1P/R1BQK2R w KQkq - 0 9,g5,103,77,-26,1
rnbqk2r/4bppp/p2p1n2/1p2p1P1/4P3/1NN5/PPP1BP1P/R1BQK2R b KQkq - 0 9,Nfd7,92,115,23,1
rnbqk2r/3nbppp/p2p4/1p2p1P1/4P3/1NN5/PPP1BP1P/R1BQK2R w KQkq - 1 10,h4,106,70,-36,1
rnbqk2r/3nbppp/p2p4/1p2p1P1/4P2P/1NN5/PPP1BP2/R1BQK2R b KQkq - 0 10,Bb7,77,138,61,1
rn1qk2r/1b1nbppp/p2p4/1p2p1P1/4P2P/1NN5/PPP1BP2/R1BQK2R w KQkq - 1 11,Be3,149,120,-29,1
rn1qk2r/1b1nbppp/p2p4/1p2p1P1/4P2P/1NN1B3/PPP1BP2/R2QK2R b KQkq - 2 11,b4,124,125,1,1
rn1qk2r/1b1nbppp/p2p4/4p1P1/1p2P2P/1NN1B3/PPP1BP2/R2QK2R w KQkq - 0 12,Nd5,166,139,-27,1
rn1qk2r/1b1nbppp/p2p4/3Np1P1/1p2P2P/1N2B3/PPP1BP2/R2QK2R b KQkq - 1 12,Bxd5,127,440,313,1
rn1qk2r/3nbppp/p2p4/3bp1P1/1p2P2P/1N2B3/PPP1BP2/R2QK2R w KQkq - 0 13,Qxd5,430,488,58,1
rn1qk2r/3nbppp/p2p4/3Qp1P1/1p2P2P/1N2B3/PPP1BP2/R3K2R b KQkq - 0 13,Nb6,477,477,0,1
rn1qk2r/4bppp/pn1p4/3Qp1P1/1p2P2P/1N2B3/PPP1BP2/R3K2R w KQkq - 1 14,Bxb6,492,481,-11,1
rn1qk2r/4bppp/pB1p4/3Qp1P1/1p2P2P/1N6/PPP1BP2/R3K2R b KQkq - 0 14,Qxb6,461,499,38,1
rn2k2r/4bppp/pq1p4/3Qp1P1/1p2P2P/1N6/PPP1BP2/R3K2R w KQkq - 0 15,Qxa8,487,488,1,1
Qn2k2r/4bppp/pq1p4/4p1P1/1p2P2P/1N6/PPP1BP2/R3K2R b KQk - 0 15,O-O,473,478,5,1
Qn3rk1/4bppp/pq1p4/4p1P1/1p2P2P/1N6/PPP1BP2/R3K2R w KQ - 1 16,Qd5,463,491,28,1
1n3rk1/4bppp/pq1p4/3Qp1P1/1p2P2P/1N6/PPP1BP2/R3K2R b KQ - 2 16,Nc6,470,515,45,1
5rk1/4bppp/pqnp4/3Qp1P1/1p2P2P/1N6/PPP1BP2/R3K2R w KQ - 3 17,O-O,511,438,-73,1
5rk1/4bppp/pqnp4/3Qp1P1/1p2P2P/1N6/PPP1BP2/R4RK1 b - - 4 17,Nd4,409,526,117,1
5rk1/4bppp/pq1p4/3Qp1P1/1p1nP2P/1N6/PPP1BP2/R4RK1 w - - 5 18,Nxd4,498,511,13,1
5rk1/4bppp/pq1p4/3Qp1P1/1p1NP2P/8/PPP1BP2/R4RK1 b - - 0 18,exd4,512,542,30,1
5rk1/4bppp/pq1p4/3Q2P1/1p1pP2P/8/PPP1BP2/R4RK1 w - - 0 19,Bc4,519,439,-80,1
5rk1/4bppp/pq1p4/3Q2P1/1pBpP2P/8/PPP2P2/R4RK1 b - - 1 19,g6,486,585,99,1
5rk1/4bp1p/pq1p2p1/3Q2P1/1pBpP2P/8/PPP2P2/R4RK1 w - - 0 20,Kg2,546,467,-79,1
5rk1/4bp1p/pq1p2p1/3Q2P1/1pBpP2P/8/PPP2PK1/R4R2 b - - 1 20,Kg7,481,541,60,1
5r2/4bpkp/pq1p2p1/3Q2P1/1pBpP2P/8/PPP2PK1/R4R2 w - - 2 21,e5,513,422,-91,1
5r2/4bpkp/pq1p2p1/3QP1P1/1pBp3P/8/PPP2PK1/R4R2 b - - 0 21,a5,455,496,41,1
5r2/4bpkp/1q1p2p1/p2QP1P1/1pBp3P/8/PPP2PK1/R4R2 w - - 0 22,Rad1,512,551,39,1
5r2/4bpkp/1q1p2p1/p2QP1P1/1pBp3P/8/PPP2PK1/3R1R2 b - - 1 22,dxe5,506,576,70,1
5r2/4bpkp/1q4p1/p2Qp1P1/1pBp3P/8/PPP2PK1/3R1R2 w - - 0 23,Qxe5+,590,584,-6,1
5r2/4bpkp/1q4p1/p3Q1P1/1pBp3P/8/PPP2PK1/3R1R2 b - - 0 23,Kg8,536,566,30,1
5rk1/4bp1p/1q4p1/p3Q1P1/1pBp3P/8/PPP2PK1/3R1R2 w - - 1 24,Qxd4,567,545,-22,1
5rk1/4bp1p/1q4p1/p5P1/1pBQ3P/8/PPP2PK1/3R1R2 b - - 0 24,Bc5,551,605,54,1
5rk1/5p1p/1q4p1/p1b3P1/1pBQ3P/8/PPP2PK1/3R1R2 w - - 1 25,Qd5,565,571,6,1
5rk1/5p1p/1q4p1/p1bQ2P1/1pB4P/8/PPP2PK1/3R1R2 b - - 2 25,Kg7,553,646,93,1
5r2/5pkp/1q4p1/p1bQ2P1/1pB4P/8/PPP2PK1/3R1R2 w - - 3 26,Rd3,638,604,-34,1
rnbqkbnr/pppppppp/8/8/8/8/PPPPPPPP/RNBQKBNR w KQkq - 0 1,e4,30,29,-1,1
rnbqkbnr/pppppppp/8/8/4P3/8/PPPP1PPP/RNBQKBNR b KQkq - 0 1,b6,37,108,71,1
rnbqkbnr/p1pppppp/1p6/8/4P3/8/PPPP1PPP/RNBQKBNR w KQkq - 0 2,Bc4,100,25,-75,1
rnbqkbnr/p1pppppp/1p6/8/2B1P3/8/PPPP1PPP/RNBQK1NR b KQkq - 1 2,Bb7,24,28,4,1
rn1qkbnr/pbpppppp/1p6/8/2B1P3/8/PPPP1PPP/RNBQK1NR w KQkq - 2 3,d3,30,7,-23,1
rn1qkbnr/pbpppppp/1p6/8/2B1P3/3P4/PPP2PPP/RNBQK1NR b KQkq - 0 3,g6,8,30,22,1
rn1qkbnr/pbpppp1p/1p4p1/8/2B1P3/3P4/PPP2PPP/RNBQK1NR w KQkq - 0 4,Nf3,30,35,5,1
rn1qkbnr/pbpppp1p/1p4p1/8/2B1P3/3P1N2/PPP2PPP/RNBQK2R b KQkq - 1 4,Bg7,39,36,-3,1
rn1qk1nr/pbppppbp/1p4p1/8/2B1P3/3P1N2/PPP2PPP/RNBQK2R w KQkq - 2 5,Nc3,35,32,-3,1
rn1qk1nr/pbppppbp/1p4p1/8/2B1P3/2NP1N2/PPP2PPP/R1BQK2R b KQkq - 3 5,e6,38,35,-3,1
rn1qk1nr/pbpp1pbp/1p2p1p1/8/2B1P3/2NP1N2/PPP2PPP/R1BQK2R w KQkq - 0 6,Bd2,41,-5,-46,1
rn1qk1nr/pbpp1pbp/1p2p1p1/8/2B1P3/2NP1N2/PPPB1PPP/R2QK2R b KQkq - 1 6,d5,-9,14,23,1
rn1qk1nr/pbp2pbp/1p2p1p1/3p4/2B1P3/2NP1N2/PPPB1PPP/R2QK2R w KQkq - 0 7,exd5,24,5,-19,1
rn1qk1nr/pbp2pbp/1p2p1p1/3P4/2B5/2NP1N2/PPPB1PPP/R2QK2R b KQkq - 0 7,exd5,6,7,1,1
rn1qk1nr/pbp2pbp/1p4p1/3p4/2B5/2NP1N2/PPPB1PPP/R2QK2R w KQkq - 0 8,Bb3,8,18,10,1
rn1qk1nr/pbp2pbp/1p4p1/3p4/8/1BNP1N2/PPPB1PPP/R2QK2R b KQkq - 1 8,d4,9,99,90,1
rn1qk1nr/pbp2pbp/1p4p1/8/3p4/1BNP1N2/PPPB1PPP/R2QK2R w KQkq - 0 9,Nb5,67,-45,-112,0
rn1qk1nr/pbp2pbp/1p4p1/1N6/3p4/1B1P1N2/PPPB1PPP/R2QK2R b KQkq - 1 9,Kf8,-53,151,204,1
rn1q1knr/pbp2pbp/1p4p1/1N6/3p4/1B1P1N2/PPPB1PPP/R2QK2R w KQ - 2 10,Qe2,136,99,-37,1
rn1q1knr/pbp2pbp/1p4p1/1N6/3p4/1B1P1N2/PPPBQPPP/R3K2R b KQ - 3 10,Bxf3,72,441,369,1
rn1q1knr/p1p2pbp/1p4p1/1N6/3p4/1B1P1b2/PPPBQPPP/R3K2R w KQ - 0 11,Qxf3,505,529,24,1
rn1q1knr/p1p2pbp/1p4p1/1N6/3p4/1B1P1Q2/PPPB1PPP/R3K2R b KQ - 0 11,c6,524,9999,9475,1
rn1q1knr/p4pbp/1pp3p1/1N6/3p4/1B1P1Q2/PPPB1PPP/R3K2R w KQ - 0 12,Qxf7#,9999,10000,1,1
rnbqkbnr/pppppppp/8/8/8/8/PPPPPPPP/RNBQKBNR w KQkq - 0 1,e4,30,29,-1,1
rnbqkbnr/pppppppp/8/8/4P3/8/PPPP1PPP/RNBQKBNR b KQkq - 0 1,e5,29,36,7,1
rnbqkbnr/pppp1ppp/8/4p3/4P3/8/PPPP1PPP/RNBQKBNR w KQkq - 0 2,Nf3,37,32,-5,1
rnbqkbnr/pppp1ppp/8/4p3/4P3/5N2/PPPP1PPP/RNBQKB1R b KQkq - 1 2,Nf6,38,39,1,1
rnbqkb1r/pppp1ppp/5n2/4p3/4P3/5N2/PPPP1PPP/RNBQKB1R w KQkq - 2 3,Nc3,57,14,-43,1
rnbqkb1r/pppp1ppp/5n2/4p3/4P3/2N2N2/PPPP1PPP/R1BQKB1R b KQkq - 3 3,Nc6,18,25,7,1
r1bqkb1r/pppp1ppp/2n2n2/4p3/4P3/2N2N2/PPPP1PPP/R1BQKB1R w KQkq - 4 4,d4,14,11,-3,1
r1bqkb1r/pppp1ppp/2n2n2/4p3/3PP3/2N2N2/PPP2PPP/R1BQKB1R b KQkq - 0 4,exd4,6,15,9,1
r1bqkb1r/pppp1ppp/2n2n2/8/3pP3/2N2N2/PPP2PPP/R1BQKB1R w KQkq - 0 5,Nxd4,14,11,-3,1
r1bqkb1r/pppp1ppp/2n2n2/8/3NP3/2N5/PPP2PPP/R1BQKB1R b KQkq - 0 5,Nxd4,7,82,75,1
r1bqkb1r/pppp1ppp/5n2/8/3nP3/2N5/PPP2PPP/R1BQKB1R w KQkq - 0 6,Qxd4,128,124,-4,1
r1bqkb1r/pppp1ppp/5n2/8/3QP3/2N5/PPP2PPP/R1B1KB1R b KQkq - 0 6,Be7,123,290,167,1
r1bqk2r/ppppbppp/5n2/8/3QP3/2N5/PPP2PPP/R1B1KB1R w KQkq - 1 7,Bc4,296,72,-224,0
r1bqk2r/ppppbppp/5n2/8/2BQP3/2N5/PPP2PPP/R1B1K2R b KQkq - 2 7,O-O,54,86,32,1
r1bq1rk1/ppppbppp/5n2/8/2BQP3/2N5/PPP2PPP/R1B1K2R w KQ - 3 8,O-O,78,44,-34,1
r1bq1rk1/ppppbppp/5n2/8/2BQP3/2N5/PPP2PPP/R1B2RK1 b - - 4 8,b6,47,138,91,1
r1bq1rk1/p1ppbppp/1p3n2/8/2BQP3/2N5/PPP2PPP/R1B2RK1 w - - 0 9,Re1,133,-11,-144,0
r1bq1rk1/p1ppbppp/1p3n2/8/2BQP3/2N5/PPP2PPP/R1B1R1K1 b - - 1 9,Bc5,-7,16,23,1
r1bq1rk1/p1pp1ppp/1p3n2/2b5/2BQP3/2N5/PPP2PPP/R1B1R1K1 w - - 2 10,Qd3,17,-22,-39,1
r1bq1rk1/p1pp1ppp/1p3n2/2b5/2B1P3/2NQ4/PPP2PPP/R1B1R1K1 b - - 3 10,Bb7,-25,104,129,1
r2q1rk1/pbpp1ppp/1p3n2/2b5/2B1P3/2NQ4/PPP2PPP/R1B1R1K1 w - - 4 11,e5,71,-81,-152,0
r2q1rk1/pbpp1ppp/1p3n2/2b1P3/2B5/2NQ4/PPP2PPP/R1B1R1K1 b - - 0 11,Ng4,-92,-98,-6,1
r2q1rk1/pbpp1ppp/1p6/2b1P3/2B3n1/2NQ4/PPP2PPP/R1B1R1K1 w - - 1 12,Be3,-110,-403,-293,0
r2q1rk1/pbpp1ppp/1p6/2b1P3/2B3n1/2NQB3/PPP2PPP/R3R1K1 b - - 2 12,Nxe3,-410,-186,224,1
r2q1rk1/pbpp1ppp/1p6/2b1P3/2B5/2NQn3/PPP2PPP/R3R1K1 w - - 0 13,fxe3,-211,-186,25,1
r2q1rk1/pbpp1ppp/1p6/2b1P3/2B5/2NQP3/PPP3PP/R3R1K1 b - - 0 13,Qg5,-171,-199,-28,1
r4rk1/pbpp1ppp/1p6/2b1P1q1/2B5/2NQP3/PPP3PP/R3R1K1 w - - 1 14,Bd5,-191,-220,-29,1
r4rk1/pbpp1ppp/1p6/2bBP1q1/8/2NQP3/PPP3PP/R3R1K1 b - - 2 14,Bxd5,-220,-236,-16,1
r4rk1/p1pp1ppp/1p6/2bbP1q1/8/2NQP3/PPP3PP/R3R1K1 w - - 0 15,Nxd5,-200,-292,-92,1
r4rk1/p1pp1ppp/1p6/2bNP1q1/8/3QP3/PPP3PP/R3R1K1 b - - 0 15,Qxe5,-265,-282,-17,1
r4rk1/p1pp1ppp/1p6/2bNq3/8/3QP3/PPP3PP/R3R1K1 w - - 0 16,Kh1,-297,-365,-68,1
r4rk1/p1pp1ppp/1p6/2bNq3/8/3QP3/PPP3PP/R3R2K b - - 1 16,c6,-381,-314,67,1
r4rk1/p2p1ppp/1pp5/2bNq3/8/3QP3/PPP3PP/R3R2K w - - 0 17,Nf4,-300,-355,-55,1
r4rk1/p2p1ppp/1pp5/2b1q3/5N2/3QP3/PPP3PP/R3R2K b - - 1 17,d5,-325,-289,36,1
r4rk1/p4ppp/1pp5/2bpq3/5N2/3QP3/PPP3PP/R3R2K w - - 0 18,Rad1,-329,-385,-56,1
r4rk1/p4ppp/1pp5/2bpq3/5N2/3QP3/PPP3PP/3RR2K b - - 1 18,Rfe8,-364,-332,32,1
r3r1k1/p4ppp/1pp5/2bpq3/5N2/3QP3/PPP3PP/3RR2K w - - 2 19,c3,-357,-394,-37,1
r3r1k1/p4ppp/1pp5/2bpq3/5N2/2PQP3/PP4PP/3RR2K b - - 0 19,Re7,-359,-302,57,1
r5k1/p3rppp/1pp5/2bpq3/5N2/2PQP3/PP4PP/3RR2K w - - 1 20,b4,-310,-386,-76,1
r5k1/p3rppp/1pp5/2bpq3/1P3N2/2PQP3/P5PP/3RR2K b - - 0 20,Bd6,-414,-283,131,1
r5k1/p3rppp/1ppb4/3pq3/1P3N2/2PQP3/P5PP/3RR2K w - - 1 21,g3,-296,-238,58,1
r5k1/p3rppp/1ppb4/3pq3/1P3N2/2PQP1P1/P6P/3RR2K b - - 0 21,Rae8,-235,-241,-6,1
4r1k1/p3rppp/1ppb4/3pq3/1P3N2/2PQP1P1/P6P/3RR2K w - - 1 22,Ng2,-244,-329,-85,1
4r1k1/p3rppp/1ppb4/3pq3/1P6/2PQP1P1/P5NP/3RR2K b - - 2 22,Qh5,-312,-301,11,1
4r1k1/p3rppp/1ppb4/3p3q/1P6/2PQP1P1/P5NP/3RR2K w - - 3 23,Kg1,-304,-297,7,1
4r1k1/p3rppp/1ppb4/3p3q/1P6/2PQP1P1/P5NP/3RR1K1 b - - 4 23,Qf3,-291,-230,61,1
4r1k1/p3rppp/1ppb4/3p4/1P6/2PQPqP1/P5NP/3RR1K1 w - - 5 24,Nh4,-236,-247,-11,1
4r1k1/p3rppp/1ppb4/3p4/1P5N/2PQPqP1/P6P/3RR1K1 b - - 6 24,Qg4,-221,-178,43,1
4r1k1/p3rppp/1ppb4/3p4/1P4qN/2PQP1P1/P6P/3RR1K1 w - - 7 25,Ng2,-202,-341,-139,0
4r1k1/p3rppp/1ppb4/3p4/1P4q1/2PQP1P1/P5NP/3RR1K1 b - - 8 25,g6,-324,-259,65,1
4r1k1/p3rp1p/1ppb2p1/3p4/1P4q1/2PQP1P1/P5NP/3RR1K1 w - - 0 26,Rd2,-308,-348,-40,1
4r1k1/p3rp1p/1ppb2p1/3p4/1P4q1/2PQP1P1/P2R2NP/4R1K1 b - - 1 26,Re4,-363,-272,91,1
4r1k1/p4p1p/1ppb2p1/3p4/1P2r1q1/2PQP1P1/P2R2NP/4R1K1 w - - 2 27,Rde2,-274,-354,-80,1
4r1k1/p4p1p/1ppb2p1/3p4/1P2r1q1/2PQP1P1/P3R1NP/4R1K1 b - - 3 27,h5,-399,-295,104,1
4r1k1/p4p2/1ppb2p1/3p3p/1P2r1q1/2PQP1P1/P3R1NP/4R1K1 w - - 0 28,Nf4,-337,-605,-268,0
4r1k1/p4p2/1ppb2p1/3p3p/1P2rNq1/2PQP1P1/P3R2P/4R1K1 b - - 1 28,h4,-586,-431,155,1
4r1k1/p4p2/1ppb2p1/3p4/1P2rNqp/2PQP1P1/P3R2P/4R1K1 w - - 0 29,Kh1,-509,-540,-31,1
4r1k1/p4p2/1ppb2p1/3p4/1P2rNqp/2PQP1P1/P3R2P/4R2K b - - 1 29,hxg3,-584,-518,66,1
4r1k1/p4p2/1ppb2p1/3p4/1P2rNq1/2PQP1p1/P3R2P/4R2K w - - 0 30,hxg3,-527,-670,-143,0
4r1k1/p4p2/1ppb2p1/3p4/1P2rNq1/2PQP1P1/P3R3/4R2K b - - 0 30,Qxg3,-687,-702,-15,1
4r1k1/p4p2/1ppb2p1/3p4/1P2rN2/2PQP1q1/P3R3/4R2K w - - 0 31,Ng2,-681,-9999,-9318,0
4r1k1/p4p2/1ppb2p1/3p4/1P2r3/2PQP1q1/P3R1N1/4R2K b - - 1 31,Qh3+,-9999,-843,9156,1
4r1k1/p4p2/1ppb2p1/3p4/1P2r3/2PQP2q/P3R1N1/4R2K w - - 2 32,Kg1,-772,-784,-12,1
4r1k1/p4p2/1ppb2p1/3p4/1P2r3/2PQP2q/P3R1N1/4R1K1 b - - 3 32,Qh2+,-783,-706,77,1
4r1k1/p4p2/1ppb2p1/3p4/1P2r3/2PQP3/P3R1Nq/4R1K1 w - - 4 33,Kf1,-654,-671,-17,1
4r1k1/p4p2/1ppb2p1/3p4/1P2r3/2PQP3/P3R1Nq/4RK2 b - - 5 33,Qh1+,-717,-724,-7,1
4r1k1/p4p2/1ppb2p1/3p4/1P2r3/2PQP3/P3R1N1/4RK1q w - - 6 34,Kf2,-733,-716,17,1
4r1k1/p4p2/1ppb2p1/3p4/1P2r3/2PQP3/P3RKN1/4R2q b - - 7 34,Qh3,-749,-745,4,1
4r1k1/p4p2/1ppb2p1/3p4/1P2r3/2PQP2q/P3RKN1/4R3 w - - 8 35,Kg1,-742,-814,-72,1
4r1k1/p4p2/1ppb2p1/3p4/1P2r3/2PQP2q/P3R1N1/4R1K1 b - - 9 35,Bh2+,-770,-731,39,1
4r1k1/p4p2/1pp3p1/3p4/1P2r3/2PQP2q/P3R1Nb/4R1K1 w - - 10 36,Kf1,-750,-746,4,1
4r1k1/p4p2/1pp3p1/3p4/1P2r3/2PQP2q/P3R1Nb/4RK2 b - - 11 36,Bg3,-779,-752,27,1
rnbqkbnr/pppppppp/8/8/8/8/PPPPPPPP/RNBQKBNR w KQkq - 0 1,e4,36,31,-5,1
rnbqkbnr/pppppppp/8/8/4P3/8/PPPP1PPP/RNBQKBNR b KQkq - 0 1,e6,25,38,13,1
rnbqkbnr/pppp1ppp/4p3/8/4P3/8/PPPP1PPP/RNBQKBNR w KQkq - 0 2,d4,44,37,-7,1
rnbqkbnr/pppp1ppp/4p3/8/3PP3/8/PPP2PPP/RNBQKBNR b KQkq - 0 2,d5,38,42,4,1
rnbqkbnr/ppp2ppp/4p3/3p4/3PP3/8/PPP2PPP/RNBQKBNR w KQkq - 0 3,e5,37,22,-15,1
rnbqkbnr/ppp2ppp/4p3/3pP3/3P4/8/PPP2PPP/RNBQKBNR b KQkq - 0 3,Bb4+,26,106,80,1
rnbqk1nr/ppp2ppp/4p3/3pP3/1b1P4/8/PPP2PPP/RNBQKBNR w KQkq - 1 4,Nc3,120,62,-58,1
rnbqk1nr/ppp2ppp/4p3/3pP3/1b1P4/2N5/PPP2PPP/R1BQKBNR b KQkq - 2 4,Nh6,63,108,45,1
rnbqk2r/ppp2ppp/4p2n/3pP3/1b1P4/2N5/PPP2PPP/R1BQKBNR w KQkq - 3 5,a3,119,111,-8,1
rnbqk2r/ppp2ppp/4p2n/3pP3/1b1P4/P1N5/1PP2PPP/R1BQKBNR b KQkq - 0 5,Bxc3+,106,108,2,1
rnbqk2r/ppp2ppp/4p2n/3pP3/3P4/P1b5/1PP2PPP/R1BQKBNR w KQkq - 0 6,bxc3,113,106,-7,1
rnbqk2r/ppp2ppp/4p2n/3pP3/3P4/P1P5/2P2PPP/R1BQKBNR b KQkq - 0 6,Nf5,98,94,-4,1
rnbqk2r/ppp2ppp/4p3/3pPn2/3P4/P1P5/2P2PPP/R1BQKBNR w KQkq - 1 7,a4,93,81,-12,1
rnbqk2r/ppp2ppp/4p3/3pPn2/P2P4/2P5/2P2PPP/R1BQKBNR b KQkq - 0 7,O-O,83,150,67,1
rnbq1rk1/ppp2ppp/4p3/3pPn2/P2P4/2P5/2P2PPP/R1BQKBNR w KQ - 1 8,Nh3,140,76,-64,1
rnbq1rk1/ppp2ppp/4p3/3pPn2/P2P4/2P4N/2P2PPP/R1BQKB1R b KQ - 2 8,f6,51,79,28,1
rnbq1rk1/ppp3pp/4pp2/3pPn2/P2P4/2P4N/2P2PPP/R1BQKB1R w KQ - 0 9,Bd3,89,44,-45,1
rnbq1rk1/ppp3pp/4pp2/3pPn2/P2P4/2PB3N/2P2PPP/R1BQK2R b KQ - 1 9,Nh4,44,243,199,1
rnbq1rk1/ppp3pp/4pp2/3pP3/P2P3n/2PB3N/2P2PPP/R1BQK2R w KQ - 2 10,O-O,232,249,17,1
rnbq1rk1/ppp3pp/4pp2/3pP3/P2P3n/2PB3N/2P2PPP/R1BQ1RK1 b - - 3 10,Nc6,244,289,45,1
r1bq1rk1/ppp3pp/2n1pp2/3pP3/P2P3n/2PB3N/2P2PPP/R1BQ1RK1 w - - 4 11,Qg4,281,205,-76,1
r1bq1rk1/ppp3pp/2n1pp2/3pP3/P2P2Qn/2PB3N/2P2PPP/R1B2RK1 b - - 5 11,fxe5,205,405,200,1
r1bq1rk1/ppp3pp/2n1p3/3pp3/P2P2Qn/2PB3N/2P2PPP/R1B2RK1 w - - 0 12,Bg5,397,407,10,1
r1bq1rk1/ppp3pp/2n1p3/3pp1B1/P2P2Qn/2PB3N/2P2PPP/R4RK1 b - - 1 12,Qd7,355,437,82,1
r1b2rk1/pppq2pp/2n1p3/3pp1B1/P2P2Qn/2PB3N/2P2PPP/R4RK1 w - - 2 13,Qxh4,452,451,-1,1
r1b2rk1/pppq2pp/2n1p3/3pp1B1/P2P3Q/2PB3N/2P2PPP/R4RK1 b - - 0 13,h6,453,453,0,1
r1b2rk1/pppq2p1/2n1p2p/3pp1B1/P2P3Q/2PB3N/2P2PPP/R4RK1 w - - 0 14,Be3,495,435,-60,1
r1b2rk1/pppq2p1/2n1p2p/3pp3/P2P3Q/2PBB2N/2P2PPP/R4RK1 b - - 1 14,exd4,424,448,24,1
r1b2rk1/pppq2p1/2n1p2p/3p4/P2p3Q/2PBB2N/2P2PPP/R4RK1 w - - 0 15,cxd4,450,434,-16,1
r1b2rk1/pppq2p1/2n1p2p/3p4/P2P3Q/3BB2N/2P2PPP/R4RK1 b - - 0 15,Qe7,461,516,55,1
r1b2rk1/ppp1q1p1/2n1p2p/3p4/P2P3Q/3BB2N/2P2PPP/R4RK1 w - - 1 16,Qxe7,521,539,18,1
r1b2rk1/ppp1Q1p1/2n1p2p/3p4/P2P4/3BB2N/2P2PPP/R4RK1 b - - 0 16,Nxe7,505,552,47,1
r1b2rk1/ppp1n1p1/4p2p/3p4/P2P4/3BB2N/2P2PPP/R4RK1 w - - 0 17,Nf4,561,554,-7,1
r1b2rk1/ppp1n1p1/4p2p/3p4/P2P1N2/3BB3/2P2PPP/R4RK1 b - - 1 17,Nf5,554,544,-10,1
r1b2rk1/ppp3p1/4p2p/3p1n2/P2P1N2/3BB3/2P2PPP/R4RK1 w - - 2 18,c3,574,523,-51,1
r1b2rk1/ppp3p1/4p2p/3p1n2/P2P1N2/2PBB3/5PPP/R4RK1 b - - 0 18,b6,511,559,48,1
r1b2rk1/p1p3p1/1p2p2p/3p1n2/P2P1N2/2PBB3/5PPP/R4RK1 w - - 0 19,Bxf5,547,535,-12,1
r1b2rk1/p1p3p1/1p2p2p/3p1B2/P2P1N2/2P1B3/5PPP/R4RK1 b - - 0 19,exf5,535,538,3,1
r1b2rk1/p1p3p1/1p5p/3p1p2/P2P1N2/2P1B3/5PPP/R4RK1 w - - 0 20,Nxd5,526,467,-59,1
r1b2rk1/p1p3p1/1p5p/3N1p2/P2P4/2P1B3/5PPP/R4RK1 b - - 0 20,Rf7,496,514,18,1
r1b3k1/p1p2rp1/1p5p/3N1p2/P2P4/2P1B3/5PPP/R4RK1 w - - 1 21,Bf4,501,460,-41,1
r1b3k1/p1p2rp1/1p5p/3N1p2/P2P1B2/2P5/5PPP/R4RK1 b - - 2 21,Bb7,510,497,-13,1
r5k1/pbp2rp1/1p5p/3N1p2/P2P1B2/2P5/5PPP/R4RK1 w - - 3 22,Nxc7,488,495,7,1
r5k1/pbN2rp1/1p5p/5p2/P2P1B2/2P5/5PPP/R4RK1 b - - 0 22,Rc8,509,504,-5,1
2r3k1/pbN2rp1/1p5p/5p2/P2P1B2/2P5/5PPP/R4RK1 w - - 1 23,Nb5,501,531,30,1
2r3k1/pb3rp1/1p5p/1N3p2/P2P1B2/2P5/5PPP/R4RK1 b - - 2 23,g5,519,529,10,1
2r3k1/pb3r2/1p5p/1N3pp1/P2P1B2/2P5/5PPP/R4RK1 w - - 0 24,Be5,528,525,-3,1
2r3k1/pb3r2/1p5p/1N2Bpp1/P2P4/2P5/5PPP/R4RK1 b - - 1 24,Ba6,528,526,-2,1
2r3k1/p4r2/bp5p/1N2Bpp1/P2P4/2P5/5PPP/R4RK1 w - - 2 25,Rac1,569,491,-78,1
2r3k1/p4r2/bp5p/1N2Bpp1/P2P4/2P5/5PPP/2R2RK1 b - - 3 25,Bxb5,495,516,21,1
2r3k1/p4r2/1p5p/1b2Bpp1/P2P4/2P5/5PPP/2R2RK1 w - - 0 26,axb5,542,529,-13,1
2r3k1/p4r2/1p5p/1P2Bpp1/3P4/2P5/5PPP/2R2RK1 b - - 0 26,Re8,520,526,6,1
4r1k1/p4r2/1p5p/1P2Bpp1/3P4/2P5/5PPP/2R2RK1 w - - 1 27,Ra1,543,496,-47,1
4r1k1/p4r2/1p5p/1P2Bpp1/3P4/2P5/5PPP/R4RK1 b - - 2 27,Rd7,528,561,33,1
4r1k1/p2r4/1p5p/1P2Bpp1/3P4/2P5/5PPP/R4RK1 w - - 3 28,Ra3,533,483,-50,1
4r1k1/p2r4/1p5p/1P2Bpp1/3P4/R1P5/5PPP/5RK1 b - - 4 28,Kf7,521,528,7,1
4r3/p2r1k2/1p5p/1P2Bpp1/3P4/R1P5/5PPP/5RK1 w - - 5 29,Rfa1,541,529,-12,1
4r3/p2r1k2/1p5p/1P2Bpp1/3P4/R1P5/5PPP/R5K1 b - - 6 29,Kg6,489,519,30,1
4r3/p2r4/1p4kp/1P2Bpp1/3P4/R1P5/5PPP/R5K1 w - - 7 30,Rxa7,551,525,-26,1
4r3/R2r4/1p4kp/1P2Bpp1/3P4/2P5/5PPP/R5K1 b - - 0 30,Rxa7,537,530,-7,1
4r3/r7/1p4kp/1P2Bpp1/3P4/2P5/5PPP/R5K1 w - - 0 31,Rxa7,553,538,-15,1
4r3/R7/1p4kp/1P2Bpp1/3P4/2P5/5PPP/6K1 b - - 0 31,Rc8,540,543,3,1
2r5/R7/1p4kp/1P2Bpp1/3P4/2P5/5PPP/6K1 w - - 1 32,Rc7,576,517,-59,1
2r5/2R5/1p4kp/1P2Bpp1/3P4/2P5/5PPP/6K1 b - - 2 32,Ra8,541,564,23,1
r7/2R5/1p4kp/1P2Bpp1/3P4/2P5/5PPP/6K1 w - - 3 33,g3,595,552,-43,1
r7/2R5/1p4kp/1P2Bpp1/3P4/2P3P1/5P1P/6K1 b - - 0 33,h5,556,639,83,1
r7/2R5/1p4k1/1P2Bppp/3P4/2P3P1/5P1P/6K1 w - - 0 34,Rc6+,637,606,-31,1
r7/8/1pR3k1/1P2Bppp/3P4/2P3P1/5P1P/6K1 b - - 1 34,Kh7,641,643,2,1
r7/7k/1pR5/1P2Bppp/3P4/2P3P1/5P1P/6K1 w - - 2 35,Rxb6,600,628,28,1
r7/7k/1R6/1P2Bppp/3P4/2P3P1/5P1P/6K1 b - - 0 35,h4,626,687,61,1
r7/7k/1R6/1P2Bpp1/3P3p/2P3P1/5P1P/6K1 w - - 0 36,Kg2,651,603,-48,1
r7/7k/1R6/1P2Bpp1/3P3p/2P3P1/5PKP/8 b - - 1 36,g4,592,680,88,1
r7/7k/1R6/1P2Bp2/3P2pp/2P3P1/5PKP/8 w - - 0 37,gxh4,663,684,21,1
rnbqkbnr/pppppppp/8/8/8/8/PPPPPPPP/RNBQKBNR w KQkq - 0 1,d4,23,20,-3,1
rnbqkbnr/pppppppp/8/8/3P4/8/PPP1PPPP/RNBQKBNR b KQkq - 0 1,Nf6,23,19,-4,1
rnbqkb1r/pppppppp/5n2/8/3P4/8/PPP1PPPP/RNBQKBNR w KQkq - 1 2,Nc3,25,-36,-61,1
rnbqkb1r/pppppppp/5n2/8/3P4/2N5/PPP1PPPP/R1BQKBNR b KQkq - 2 2,d5,-14,-10,4,1
rnbqkb1r/ppp1pppp/5n2/3p4/3P4/2N5/PPP1PPPP/R1BQKBNR w KQkq - 0 3,Bf4,-20,-29,-9,1
rnbqkb1r/ppp1pppp/5n2/3p4/3P1B2/2N5/PPP1PPPP/R2QKBNR b KQkq - 1 3,g6,-23,7,30,1
rnbqkb1r/ppp1pp1p/5np1/3p4/3P1B2/2N5/PPP1PPPP/R2QKBNR w KQkq - 0 4,Nb5,0,-24,-24,1
rnbqkb1r/ppp1pp1p/5np1/1N1p4/3P1B2/8/PPP1PPPP/R2QKBNR b KQkq - 1 4,c6,-19,421,440,1
rnbqkb1r/pp2pp1p/2p2np1/1N1p4/3P1B2/8/PPP1PPPP/R2QKBNR w KQkq - 0 5,Nc7+,407,367,-40,1
rnbqkb1r/ppN1pp1p/2p2np1/3p4/3P1B2/8/PPP1PPPP/R2QKBNR b KQkq - 1 5,Kd7,406,375,-31,1
rnbq1b1r/ppNkpp1p/2p2np1/3p4/3P1B2/8/PPP1PPPP/R2QKBNR w KQ - 2 6,Nxa8,419,406,-13,1
Nnbq1b1r/pp1kpp1p/2p2np1/3p4/3P1B2/8/PPP1PPPP/R2QKBNR b KQ - 0 6,Na6,401,379,-22,1
N1bq1b1r/pp1kpp1p/n1p2np1/3p4/3P1B2/8/PPP1PPPP/R2QKBNR w KQ - 1 7,Nf3,400,332,-68,1
N1bq1b1r/pp1kpp1p/n1p2np1/3p4/3P1B2/5N2/PPP1PPPP/R2QKB1R b KQ - 2 7,b5,369,496,127,1
N1bq1b1r/p2kpp1p/n1p2np1/1p1p4/3P1B2/5N2/PPP1PPPP/R2QKB1R w KQ - 0 8,Be5,438,437,-1,1
N1bq1b1r/p2kpp1p/n1p2np1/1p1pB3/3P4/5N2/PPP1PPPP/R2QKB1R b KQ - 1 8,Bb7,415,448,33,1
N2q1b1r/pb1kpp1p/n1p2np1/1p1pB3/3P4/5N2/PPP1PPPP/R2QKB1R w KQ - 2 9,e4,449,360,-89,1
N2q1b1r/pb1kpp1p/n1p2np1/1p1pB3/3PP3/5N2/PPP2PPP/R2QKB1R b KQ - 0 9,dxe4,378,391,13,1
N2q1b1r/pb1kpp1p/n1p2np1/1p2B3/3Pp3/5N2/PPP2PPP/R2QKB1R w KQ - 0 10,Ng5,404,339,-65,1
N2q1b1r/pb1kpp1p/n1p2np1/1p2B1N1/3Pp3/8/PPP2PPP/R2QKB1R b KQ - 1 10,Ke8,359,368,9,1
N2qkb1r/pb2pp1p/n1p2np1/1p2B1N1/3Pp3/8/PPP2PPP/R2QKB1R w KQ - 2 11,Nxe4,406,328,-78,1
N2qkb1r/pb2pp1p/n1p2np1/1p2B3/3PN3/8/PPP2PPP/R2QKB1R b KQ - 0 11,Bxa8,333,390,57,1
b2qkb1r/p3pp1p/n1p2np1/1p2B3/3PN3/8/PPP2PPP/R2QKB1R w KQ - 0 12,Qf3,386,372,-14,1
b2qkb1r/p3pp1p/n1p2np1/1p2B3/3PN3/5Q2/PPP2PPP/R3KB1R b KQ - 1 12,Bg7,354,351,-3,1
b2qk2r/p3ppbp/n1p2np1/1p2B3/3PN3/5Q2/PPP2PPP/R3KB1R w KQ - 2 13,O-O-O,349,348,-1,1
b2qk2r/p3ppbp/n1p2np1/1p2B3/3PN3/5Q2/PPP2PPP/2KR1B1R b - - 3 13,c5,347,553,206,1
b2qk2r/p3ppbp/n4np1/1pp1B3/3PN3/5Q2/PPP2PPP/2KR1B1R w - - 0 14,dxc5,570,616,46,1
b2qk2r/p3ppbp/n4np1/1pP1B3/4N3/5Q2/PPP2PPP/2KR1B1R b - - 0 14,Qa5,550,1068,518,1
b3k2r/p3ppbp/n4np1/qpP1B3/4N3/5Q2/PPP2PPP/2KR1B1R w - - 1 15,a3,1102,174,-928,0
b3k2r/p3ppbp/n4np1/qpP1B3/4N3/P4Q2/1PP2PPP/2KR1B1R b - - 0 15,Bxe4,227,235,8,1
4k2r/p3ppbp/n4np1/qpP1B3/4b3/P4Q2/1PP2PPP/2KR1B1R w - - 0 16,Qe3,256,189,-67,1
4k2r/p3ppbp/n4np1/qpP1B3/4b3/P3Q3/1PP2PPP/2KR1B1R b - - 1 16,Bc6,247,290,43,1
4k2r/p3ppbp/n1b2np1/qpP1B3/8/P3Q3/1PP2PPP/2KR1B1R w - - 2 17,Qd3,290,-240,-530,0
4k2r/p3ppbp/n1b2np1/qpP1B3/8/P2Q4/1PP2PPP/2KR1B1R b - - 3 17,Rg8,-225,329,554,1
4k1r1/p3ppbp/n1b2np1/qpP1B3/8/P2Q4/1PP2PPP/2KR1B1R w - - 4 18,Bc3,287,-34,-321,0
4k1r1/p3ppbp/n1b2np1/qpP5/8/P1BQ4/1PP2PPP/2KR1B1R b - - 5 18,Qc7,-24,154,178,1
4k1r1/p1q1ppbp/n1b2np1/1pP5/8/P1BQ4/1PP2PPP/2KR1B1R w - - 6 19,f3,6,-258,-264,0
4k1r1/p1q1ppbp/n1b2np1/1pP5/8/P1BQ1P2/1PP3PP/2KR1B1R b - - 0 19,Nxc5,-275,-202,73,1
4k1r1/p1q1ppbp/2b2np1/1pn5/8/P1BQ1P2/1PP3PP/2KR1B1R w - - 0 20,Qd4,-200,-398,-198,0
4k1r1/p1q1ppbp/2b2np1/1pn5/3Q4/P1B2P2/1PP3PP/2KR1B1R b - - 1 20,Nd5,-384,204,588,1
4k1r1/p1q1ppbp/2b3p1/1pnn4/3Q4/P1B2P2/1PP3PP/2KR1B1R w - - 2 21,Qxc5,204,182,-22,1
4k1r1/p1q1ppbp/2b3p1/1pQn4/8/P1B2P2/1PP3PP/2KR1B1R b - - 0 21,Nxc3,203,200,-3,1
4k1r1/p1q1ppbp/2b3p1/1pQ5/8/P1n2P2/1PP3PP/2KR1B1R w - - 0 22,Qxc3,222,-520,-742,0
4k1r1/p1q1ppbp/2b3p1/1p6/8/P1Q2P2/1PP3PP/2KR1B1R b - - 0 22,Bxc3,-541,-566,-25,1
4k1r1/p1q1pp1p/2b3p1/1p6/8/P1b2P2/1PP3PP/2KR1B1R w - - 0 23,bxc3,-559,-561,-2,1
4k1r1/p1q1pp1p/2b3p1/1p6/8/P1P2P2/2P3PP/2KR1B1R b - - 0 23,e6,-533,-521,12,1
4k1r1/p1q2p1p/2b1p1p1/1p6/8/P1P2P2/2P3PP/2KR1B1R w - - 0 24,Bd3,-545,-545,0,1
4k1r1/p1q2p1p/2b1p1p1/1p6/8/P1PB1P2/2P3PP/2KR3R b - - 1 24,Bd5,-547,-511,36,1
4k1r1/p1q2p1p/4p1p1/1p1b4/8/P1PB1P2/2P3PP/2KR3R w - - 2 25,Bxb5+,-526,-526,0,1
4k1r1/p1q2p1p/4p1p1/1B1b4/8/P1P2P2/2P3PP/2KR3R b - - 0 25,Ke7,-496,-520,-24,1
6r1/p1q1kp1p/4p1p1/1B1b4/8/P1P2P2/2P3PP/2KR3R w - - 1 26,Rd2,-543,-627,-84,1
6r1/p1q1kp1p/4p1p1/1B1b4/8/P1P2P2/2PR2PP/2K4R b - - 2 26,Qa5,-643,-532,111,1
6r1/p3kp1p/4p1p1/qB1b4/8/P1P2P2/2PR2PP/2K4R w - - 3 27,Bd3,-566,-730,-164,0
6r1/p3kp1p/4p1p1/q2b4/8/P1PB1P2/2PR2PP/2K4R b - - 4 27,Qxa3+,-746,-782,-36,1
6r1/p3kp1p/4p1p1/3b4/8/q1PB1P2/2PR2PP/2K4R w - - 0 28,Kd1,-780,-776,4,1
6r1/p3kp1p/4p1p1/3b4/8/q1PB1P2/2PR2PP/3K3R b - - 1 28,Qxc3,-769,-661,108,1
6r1/p3kp1p/4p1p1/3b4/8/2qB1P2/2PR2PP/3K3R w - - 0 29,Ke2,-666,-653,13,1
6r1/p3kp1p/4p1p1/3b4/8/2qB1P2/2PRK1PP/7R b - - 1 29,a5,-625,-566,59,1
6r1/4kp1p/4p1p1/p2b4/8/2qB1P2/2PRK1PP/7R w - - 0 30,Rb1,-557,-618,-61,1
6r1/4kp1p/4p1p1/p2b4/8/2qB1P2/2PRK1PP/1R6 b - - 1 30,a4,-557,-623,-66,1
6r1/4kp1p/4p1p1/3b4/p7/2qB1P2/2PRK1PP/1R6 w - - 0 31,Bb5,-581,-696,-115,0
6r1/4kp1p/4p1p1/1B1b4/p7/2q2P2/2PRK1PP/1R6 b - - 1 31,a3,-667,-663,4,1
6r1/4kp1p/4p1p1/1B1b4/8/p1q2P2/2PRK1PP/1R6 w - - 0 32,Rd3,-668,-838,-170,0
6r1/4kp1p/4p1p1/1B1b4/8/p1qR1P2/2P1K1PP/1R6 b - - 1 32,Qxc2+,-886,-897,-11,1
6r1/4kp1p/4p1p1/1B1b4/8/p2R1P2/2q1K1PP/1R6 w - - 0 33,Rd2,-901,-919,-18,1
6r1/4kp1p/4p1p1/1B1b4/8/p4P2/2qRK1PP/1R6 b - - 1 33,Qxb1,-926,-935,-9,1
rnbqkbnr/pppppppp/8/8/8/8/PPPPPPPP/RNBQKBNR w KQkq - 0 1,d4,27,26,-1,1
rnbqkbnr/pppppppp/8/8/3P4/8/PPP1PPPP/RNBQKBNR b KQkq - 0 1,d5,28,27,-1,1
rnbqkbnr/ppp1pppp/8/3p4/3P4/8/PPP1PPPP/RNBQKBNR w KQkq - 0 2,c4,27,29,2,1
rnbqkbnr/ppp1pppp/8/3p4/2PP4/8/PP2PPPP/RNBQKBNR b KQkq - 0 2,Nf6,30,53,23,1
rnbqkb1r/ppp1pppp/5n2/3p4/2PP4/8/PP2PPPP/RNBQKBNR w KQkq - 1 3,Nc3,61,17,-44,1
rnbqkb1r/ppp1pppp/5n2/3p4/2PP4/2N5/PP2PPPP/R1BQKBNR b KQkq - 2 3,dxc4,13,30,17,1
rnbqkb1r/ppp1pppp/5n2/8/2pP4/2N5/PP2PPPP/R1BQKBNR w KQkq - 0 4,e3,17,20,3,1
rnbqkb1r/ppp1pppp/5n2/8/2pP4/2N1P3/PP3PPP/R1BQKBNR b KQkq - 0 4,e6,19,14,-5,1
rnbqkb1r/ppp2ppp/4pn2/8/2pP4/2N1P3/PP3PPP/R1BQKBNR w KQkq - 0 5,Bxc4,28,25,-3,1
rnbqkb1r/ppp2ppp/4pn2/8/2BP4/2N1P3/PP3PPP/R1BQK1NR b KQkq - 0 5,Bb4,23,57,34,1
rnbqk2r/ppp2ppp/4pn2/8/1bBP4/2N1P3/PP3PPP/R1BQK1NR w KQkq - 1 6,Bd2,55,36,-19,1
rnbqk2r/ppp2ppp/4pn2/8/1bBP4/2N1P3/PP1B1PPP/R2QK1NR b KQkq - 2 6,a6,32,34,2,1
rnbqk2r/1pp2ppp/p3pn2/8/1bBP4/2N1P3/PP1B1PPP/R2QK1NR w KQkq - 0 7,Nf3,41,42,1,1
rnbqk2r/1pp2ppp/p3pn2/8/1bBP4/2N1PN2/PP1B1PPP/R2QK2R b KQkq - 1 7,O-O,42,58,16,1
rnbq1rk1/1pp2ppp/p3pn2/8/1bBP4/2N1PN2/PP1B1PPP/R2QK2R w KQ - 2 8,Bd3,61,28,-33,1
rnbq1rk1/1pp2ppp/p3pn2/8/1b1P4/2NBPN2/PP1B1PPP/R2QK2R b KQ - 3 8,Bxc3,29,101,72,1
rnbq1rk1/1pp2ppp/p3pn2/8/3P4/2bBPN2/PP1B1PPP/R2QK2R w KQ - 0 9,Bxc3,112,78,-34,1
rnbq1rk1/1pp2ppp/p3pn2/8/3P4/2BBPN2/PP3PPP/R2QK2R b KQ - 0 9,Nd5,86,136,50,1
rnbq1rk1/1pp2ppp/p3p3/3n4/3P4/2BBPN2/PP3PPP/R2QK2R w KQ - 1 10,O-O,135,50,-85,1
rnbq1rk1/1pp2ppp/p3p3/3n4/3P4/2BBPN2/PP3PPP/R2Q1RK1 b - - 2 10,Nc6,63,140,77,1
r1bq1rk1/1pp2ppp/p1n1p3/3n4/3P4/2BBPN2/PP3PPP/R2Q1RK1 w - - 3 11,e4,147,52,-95,1
r1bq1rk1/1pp2ppp/p1n1p3/3n4/3PP3/2BB1N2/PP3PPP/R2Q1RK1 b - - 0 11,Nf4,59,203,144,1
r1bq1rk1/1pp2ppp/p1n1p3/8/3PPn2/2BB1N2/PP3PPP/R2Q1RK1 w - - 1 12,d5,213,-117,-330,0
r1bq1rk1/1pp2ppp/p1n1p3/3P4/4Pn2/2BB1N2/PP3PPP/R2Q1RK1 b - - 0 12,exd5,-104,-84,20,1
r1bq1rk1/1pp2ppp/p1n5/3p4/4Pn2/2BB1N2/PP3PPP/R2Q1RK1 w - - 0 13,exd5,-87,-121,-34,1
r1bq1rk1/1pp2ppp/p1n5/3P4/5n2/2BB1N2/PP3PPP/R2Q1RK1 b - - 0 13,Nxd5,-156,-9,147,1
r1bq1rk1/1pp2ppp/p1n5/3n4/8/2BB1N2/PP3PPP/R2Q1RK1 w - - 0 14,Qc2,-28,-37,-9,1
r1bq1rk1/1pp2ppp/p1n5/3n4/8/2BB1N2/PPQ2PPP/R4RK1 b - - 1 14,h6,-45,28,73,1
r1bq1rk1/1pp2pp1/p1n4p/3n4/8/2BB1N2/PPQ2PPP/R4RK1 w - - 0 15,Rad1,33,16,-17,1
r1bq1rk1/1pp2pp1/p1n4p/3n4/8/2BB1N2/PPQ2PPP/3R1RK1 b - - 1 15,Bd7,29,504,475,1
r2q1rk1/1ppb1pp1/p1n4p/3n4/8/2BB1N2/PPQ2PPP/3R1RK1 w - - 2 16,Bh7+,486,532,46,1
r2q1rk1/1ppb1ppB/p1n4p/3n4/8/2B2N2/PPQ2PPP/3R1RK1 b - - 3 16,Kh8,535,527,-8,1
r2q1r1k/1ppb1ppB/p1n4p/3n4/8/2B2N2/PPQ2PPP/3R1RK1 w - - 4 17,Rxd5,522,518,-4,1
r2q1r1k/1ppb1ppB/p1n4p/3R4/8/2B2N2/PPQ2PPP/5RK1 b - - 0 17,f6,508,625,117,1
r2q1r1k/1ppb2pB/p1n2p1p/3R4/8/2B2N2/PPQ2PPP/5RK1 w - - 0 18,Bf5,619,527,-92,1
r2q1r1k/1ppb2p1/p1n2p1p/3R1B2/8/2B2N2/PPQ2PPP/5RK1 b - - 1 18,Ne5,546,648,102,1
r2q1r1k/1ppb2p1/p4p1p/3RnB2/8/2B2N2/PPQ2PPP/5RK1 w - - 2 19,Bxe5,658,481,-177,0
r2q1r1k/1ppb2p1/p4p1p/3RBB2/8/5N2/PPQ2PPP/5RK1 b - - 0 19,fxe5,468,636,168,1
r2q1r1k/1ppb2p1/p6p/3RpB2/8/5N2/PPQ2PPP/5RK1 w - - 0 20,Nxe5,691,255,-436,0
r2q1r1k/1ppb2p1/p6p/3RNB2/8/8/PPQ2PPP/5RK1 b - - 0 20,Bxf5,266,242,-24,1
r2q1r1k/1pp3p1/p6p/3RNb2/8/8/PPQ2PPP/5RK1 w - - 0 21,Rxd8,229,94,-135,0
r2R1r1k/1pp3p1/p6p/4Nb2/8/8/PPQ2PPP/5RK1 b - - 0 21,Bxc2,109,117,8,1
r2R1r1k/1pp3p1/p6p/4N3/8/8/PPb2PPP/5RK1 w - - 0 22,Nf7+,133,-19,-152,0
r2R1r1k/1pp2Np1/p6p/8/8/8/PPb2PPP/5RK1 b - - 1 22,Kh7,-25,-3,22,1
r2R1r2/1pp2Npk/p6p/8/8/8/PPb2PPP/5RK1 w - - 2 23,Rxa8,-10,-11,-1,1
R4r2/1pp2Npk/p6p/8/8/8/PPb2PPP/5RK1 b - - 0 23,Rxa8,-19,-13,6,1
r7/1pp2Npk/p6p/8/8/8/PPb2PPP/5RK1 w - - 0 24,Rc1,-12,-14,-2,1
r7/1pp2Npk/p6p/8/8/8/PPb2PPP/2R3K1 b - - 1 24,Bg6,-12,-1,11,1
r7/1pp2Npk/p5bp/8/8/8/PP3PPP/2R3K1 w - - 2 25,Ne5,-5,-19,-14,1
r7/1pp3pk/p5bp/4N3/8/8/PP3PPP/2R3K1 b - - 3 25,c6,-17,18,35,1
r7/1p4pk/p1p3bp/4N3/8/8/PP3PPP/2R3K1 w - - 0 26,g4,23,-32,-55,1
r7/1p4pk/p1p3bp/4N3/6P1/8/PP3P1P/2R3K1 b - - 0 26,a5,-20,34,54,1
r7/1p4pk/2p3bp/p3N3/6P1/8/PP3P1P/2R3K1 w - - 0 27,h4,37,-16,-53,1
r7/1p4pk/2p3bp/p3N3/6PP/8/PP3P2/2R3K1 b - - 0 27,Re8,-6,47,53,1
4r3/1p4pk/2p3bp/p3N3/6PP/8/PP3P2/2R3K1 w - - 1 28,f4,15,6,-9,1
4r3/1p4pk/2p3bp/p3N3/5PPP/8/PP6/2R3K1 b - - 0 28,Be4,7,41,34,1
4r3/1p4pk/2p4p/p3N3/4bPPP/8/PP6/2R3K1 w - - 1 29,Kf2,37,40,3,1
4r3/1p4pk/2p4p/p3N3/4bPPP/8/PP3K2/2R5 b - - 2 29,Rd8,34,67,33,1
3r4/1p4pk/2p4p/p3N3/4bPPP/8/PP3K2/2R5 w - - 3 30,Ke3,43,44,1,1
3r4/1p4pk/2p4p/p3N3/4bPPP/4K3/PP6/2R5 b - - 4 30,Bd5,46,43,-3,1
3r4/1p4pk/2p4p/p2bN3/5PPP/4K3/PP6/2R5 w - - 5 31,g5,55,26,-29,1
3r4/1p4pk/2p4p/p2bN1P1/5P1P/4K3/PP6/2R5 b - - 0 31,hxg5,44,49,5,1
3r4/1p4pk/2p5/p2bN1p1/5P1P/4K3/PP6/2R5 w - - 0 32,hxg5,69,53,-16,1
3r4/1p4pk/2p5/p2bN1P1/5P2/4K3/PP6/2R5 b - - 0 32,Bxa2,57,91,34,1
3r4/1p4pk/2p5/p3N1P1/5P2/4K3/bP6/2R5 w - - 0 33,Nf7,91,-398,-489,0
3r4/1p3Npk/2p5/p5P1/5P2/4K3/bP6/2R5 b - - 1 33,Re8+,-400,0,400,1
4r3/1p3Npk/2p5/p5P1/5P2/4K3/bP6/2R5 w - - 2 34,Ne5,4,-6,-10,1
4r3/1p4pk/2p5/p3N1P1/5P2/4K3/bP6/2R5 b - - 3 34,Bd5,-5,-5,0,1
4r3/1p4pk/2p5/p2bN1P1/5P2/4K3/1P6/2R5 w - - 4 35,g6+,-4,-33,-29,1
4r3/1p4pk/2p3P1/p2bN3/5P2/4K3/1P6/2R5 b - - 0 35,Kg8,-13,-3,10,1
4r1k1/1p4p1/2p3P1/p2bN3/5P2/4K3/1P6/2R5 w - - 1 36,f5,-10,-427,-417,0
4r1k1/1p4p1/2p3P1/p2bNP2/8/4K3/1P6/2R5 b - - 0 36,a4,-451,0,451,1
4r1k1/1p4p1/2p3P1/3bNP2/p7/4K3/1P6/2R5 w - - 0 37,Kf4,0,0,0,1
4r1k1/1p4p1/2p3P1/3bNP2/p4K2/8/1P6/2R5 b - - 1 37,b5,0,39,39,1
4r1k1/6p1/2p3P1/1p1bNP2/p4K2/8/1P6/2R5 w - - 0 38,Rf1,21,-42,-63,1
4r1k1/6p1/2p3P1/1p1bNP2/p4K2/8/1P6/5R2 b - - 1 38,b4,-48,-3,45,1
4r1k1/6p1/2p3P1/3bNP2/pp3K2/8/1P6/5R2 w - - 0 39,Rh1,0,-529,-529,0
4r1k1/6p1/2p3P1/3bNP2/pp3K2/8/1P6/7R b - - 1 39,Bxh1,-526,-515,11,1
4r1k1/6p1/2p3P1/4NP2/pp3K2/8/1P6/7b w - - 0 40,Nf7,-584,-593,-9,1
4r1k1/5Np1/2p3P1/5P2/pp3K2/8/1P6/7b b - - 1 40,a3,-542,-569,-27,1
rnbqkbnr/pppppppp/8/8/8/8/PPPPPPPP/RNBQKBNR w KQkq - 0 1,d4,24,26,2,1
rnbqkbnr/pppppppp/8/8/3P4/8/PPP1PPPP/RNBQKBNR b KQkq - 0 1,d5,14,30,16,1
rnbqkbnr/ppp1pppp/8/3p4/3P4/8/PPP1PPPP/RNBQKBNR w KQkq - 0 2,c4,27,24,-3,1
rnbqkbnr/ppp1pppp/8/3p4/2PP4/8/PP2PPPP/RNBQKBNR b KQkq - 0 2,c6,31,49,18,1
rnbqkbnr/pp2pppp/2p5/3p4/2PP4/8/PP2PPPP/RNBQKBNR w KQkq - 0 3,Nc3,31,32,1,1
rnbqkbnr/pp2pppp/2p5/3p4/2PP4/2N5/PP2PPPP/R1BQKBNR b KQkq - 1 3,Be6,37,89,52,1
rn1qkbnr/pp2pppp/2p1b3/3p4/2PP4/2N5/PP2PPPP/R1BQKBNR w KQkq - 2 4,Qb3,95,71,-24,1
rn1qkbnr/pp2pppp/2p1b3/3p4/2PP4/1QN5/PP2PPPP/R1B1KBNR b KQkq - 3 4,Qd7,74,128,54,1
rn2kbnr/pp1qpppp/2p1b3/3p4/2PP4/1QN5/PP2PPPP/R1B1KBNR w KQkq - 4 5,c5,146,59,-87,1
rn2kbnr/pp1qpppp/2p1b3/2Pp4/3P4/1QN5/PP2PPPP/R1B1KBNR b KQkq - 0 5,Nf6,65,61,-4,1
rn2kb1r/pp1qpppp/2p1bn2/2Pp4/3P4/1QN5/PP2PPPP/R1B1KBNR w KQkq - 1 6,Bf4,44,50,6,1
rn2kb1r/pp1qpppp/2p1bn2/2Pp4/3P1B2/1QN5/PP2PPPP/R3KBNR b KQkq - 2 6,Bf5,51,105,54,1
rn2kb1r/pp1qpppp/2p2n2/2Pp1b2/3P1B2/1QN5/PP2PPPP/R3KBNR w KQkq - 3 7,e3,89,49,-40,1
rn2kb1r/pp1qpppp/2p2n2/2Pp1b2/3P1B2/1QN1P3/PP3PPP/R3KBNR b KQkq - 0 7,e6,50,56,6,1
rn2kb1r/pp1q1ppp/2p1pn2/2Pp1b2/3P1B2/1QN1P3/PP3PPP/R3KBNR w KQkq - 0 8,Nf3,54,52,-2,1
rn2kb1r/pp1q1ppp/2p1pn2/2Pp1b2/3P1B2/1QN1PN2/PP3PPP/R3KB1R b KQkq - 1 8,Be7,59,59,0,1
rn2k2r/pp1qbppp/2p1pn2/2Pp1b2/3P1B2/1QN1PN2/PP3PPP/R3KB1R w KQkq - 2 9,Ne5,72,40,-32,1
rn2k2r/pp1qbppp/2p1pn2/2PpNb2/3P1B2/1QN1P3/PP3PPP/R3KB1R b KQkq - 3 9,Qc8,43,45,2,1
rnq1k2r/pp2bppp/2p1pn2/2PpNb2/3P1B2/1QN1P3/PP3PPP/R3KB1R w KQkq - 4 10,a3,47,-12,-59,1
rnq1k2r/pp2bppp/2p1pn2/2PpNb2/3P1B2/PQN1P3/1P3PPP/R3KB1R b KQkq - 0 10,O-O,-12,76,88,1
rnq2rk1/pp2bppp/2p1pn2/2PpNb2/3P1B2/PQN1P3/1P3PPP/R3KB1R w KQ - 1 11,Qd1,77,73,-4,1
rnq2rk1/pp2bppp/2p1pn2/2PpNb2/3P1B2/P1N1P3/1P3PPP/R2QKB1R b KQ - 2 11,Nbd7,51,81,30,1
r1q2rk1/pp1nbppp/2p1pn2/2PpNb2/3P1B2/P1N1P3/1P3PPP/R2QKB1R w KQ - 3 12,Bd3,69,-12,-81,1
r1q2rk1/pp1nbppp/2p1pn2/2PpNb2/3P1B2/P1NBP3/1P3PPP/R2QK2R b KQ - 4 12,Bxd3,-10,16,26,1
r1q2rk1/pp1nbppp/2p1pn2/2PpN3/3P1B2/P1NbP3/1P3PPP/R2QK2R w KQ - 0 13,Qxd3,32,-14,-46,1
r1q2rk1/pp1nbppp/2p1pn2/2PpN3/3P1B2/P1NQP3/1P3PPP/R3K2R b KQ - 0 13,Nh5,-24,-16,8,1
r1q2rk1/pp1nbppp/2p1p3/2PpN2n/3P1B2/P1NQP3/1P3PPP/R3K2R w KQ - 1 14,O-O,-25,-27,-2,1
r1q2rk1/pp1nbppp/2p1p3/2PpN2n/3P1B2/P1NQP3/1P3PPP/R4RK1 b - - 2 14,Nxf4,-11,3,14,1
r1q2rk1/pp1nbppp/2p1p3/2PpN3/3P1n2/P1NQP3/1P3PPP/R4RK1 w - - 0 15,exf4,3,-1,-4,1
r1q2rk1/pp1nbppp/2p1p3/2PpN3/3P1P2/P1NQ4/1P3PPP/R4RK1 b - - 0 15,Nf6,-8,34,42,1
r1q2rk1/pp2bppp/2p1pn2/2PpN3/3P1P2/P1NQ4/1P3PPP/R4RK1 w - - 1 16,b4,37,38,1,1
r1q2rk1/pp2bppp/2p1pn2/2PpN3/1P1P1P2/P1NQ4/5PPP/R4RK1 b - - 0 16,a6,30,54,24,1
r1q2rk1/1p2bppp/p1p1pn2/2PpN3/1P1P1P2/P1NQ4/5PPP/R4RK1 w - - 0 17,f3,71,37,-34,1
r1q2rk1/1p2bppp/p1p1pn2/2PpN3/1P1P1P2/P1NQ1P2/6PP/R4RK1 b - - 0 17,Nd7,35,38,3,1
r1q2rk1/1p1nbppp/p1p1p3/2PpN3/1P1P1P2/P1NQ1P2/6PP/R4RK1 w - - 1 18,g3,41,37,-4,1
r1q2rk1/1p1nbppp/p1p1p3/2PpN3/1P1P1P2/P1NQ1PP1/7P/R4RK1 b - - 0 18,Nf6,43,51,8,1
r1q2rk1/1p2bppp/p1p1pn2/2PpN3/1P1P1P2/P1NQ1PP1/7P/R4RK1 w - - 1 19,g4,52,1,-51,1
r1q2rk1/1p2bppp/p1p1pn2/2PpN3/1P1P1PP1/P1NQ1P2/7P/R4RK1 b - - 0 19,Nd7,12,12,0,1
r1q2rk1/1p1nbppp/p1p1p3/2PpN3/1P1P1PP1/P1NQ1P2/7P/R4RK1 w - - 1 20,Kg2,12,2,-10,1
r1q2rk1/1p1nbppp/p1p1p3/2PpN3/1P1P1PP1/P1NQ1P2/6KP/R4R2 b - - 2 20,Bh4,-4,20,24,1
r1q2rk1/1p1n1ppp/p1p1p3/2PpN3/1P1P1PPb/P1NQ1P2/6KP/R4R2 w - - 3 21,Ne2,20,29,9,1
r1q2rk1/1p1n1ppp/p1p1p3/2PpN3/1P1P1PPb/P2Q1P2/4N1KP/R4R2 b - - 4 21,Qd8,31,47,16,1
r2q1rk1/1p1n1ppp/p1p1p3/2PpN3/1P1P1PPb/P2Q1P2/4N1KP/R4R2 w - - 5 22,Ng3,54,18,-36,1
r2q1rk1/1p1n1ppp/p1p1p3/2PpN3/1P1P1PPb/P2Q1PN1/6KP/R4R2 b - - 6 22,Be7,19,66,47,1
r2q1rk1/1p1nbppp/p1p1p3/2PpN3/1P1P1PP1/P2Q1PN1/6KP/R4R2 w - - 7 23,g5,56,-12,-68,1
r2q1rk1/1p1nbppp/p1p1p3/2PpN1P1/1P1P1P2/P2Q1PN1/6KP/R4R2 b - - 0 23,Nf6,-20,395,415,1
r2q1rk1/1p2bppp/p1p1pn2/2PpN1P1/1P1P1P2/P2Q1PN1/6KP/R4R2 w - - 1 24,h4,353,157,-196,0
r2q1rk1/1p2bppp/p1p1pn2/2PpN1P1/1P1P1P1P/P2Q1PN1/6K1/R4R2 b - - 0 24,Nd7,169,155,-14,1
r2q1rk1/1p1nbppp/p1p1p3/2PpN1P1/1P1P1P1P/P2Q1PN1/6K1/R4R2 w - - 1 25,h5,147,61,-86,1
r2q1rk1/1p1nbppp/p1p1p3/2PpN1PP/1P1P1P2/P2Q1PN1/6K1/R4R2 b - - 0 25,f6,43,175,132,1
r2q1rk1/1p1nb1pp/p1p1pp2/2PpN1PP/1P1P1P2/P2Q1PN1/6K1/R4R2 w - - 0 26,Nxd7,197,-1,-198,0
r2q1rk1/1p1Nb1pp/p1p1pp2/2Pp2PP/1P1P1P2/P2Q1PN1/6K1/R4R2 b - - 0 26,Qxd7,29,38,9,1
r4rk1/1p1qb1pp/p1p1pp2/2Pp2PP/1P1P1P2/P2Q1PN1/6K1/R4R2 w - - 0 27,g6,46,-39,-85,1
r4rk1/1p1qb1pp/p1p1ppP1/2Pp3P/1P1P1P2/P2Q1PN1/6K1/R4R2 b - - 0 27,h6,-48,96,144,1
r4rk1/1p1qb1p1/p1p1ppPp/2Pp3P/1P1P1P2/P2Q1PN1/6K1/R4R2 w - - 0 28,f5,104,73,-31,1
r4rk1/1p1qb1p1/p1p1ppPp/2Pp1P1P/1P1P4/P2Q1PN1/6K1/R4R2 b - - 0 28,Rae8,82,334,252,1
4rrk1/1p1qb1p1/p1p1ppPp/2Pp1P1P/1P1P4/P2Q1PN1/6K1/R4R2 w - - 1 29,Rfe1,372,86,-286,0
4rrk1/1p1qb1p1/p1p1ppPp/2Pp1P1P/1P1P4/P2Q1PN1/6K1/R3R3 b - - 2 29,Bd8,64,257,193,1
3brrk1/1p1q2p1/p1p1ppPp/2Pp1P1P/1P1P4/P2Q1PN1/6K1/R3R3 w - - 3 30,Re2,291,53,-238,0
3brrk1/1p1q2p1/p1p1ppPp/2Pp1P1P/1P1P4/P2Q1PN1/4R1K1/R7 b - - 4 30,e5,39,37,-2,1
3brrk1/1p1q2p1/p1p2pPp/2PppP1P/1P1P4/P2Q1PN1/4R1K1/R7 w - - 0 31,Rae1,53,42,-11,1
3brrk1/1p1q2p1/p1p2pPp/2PppP1P/1P1P4/P2Q1PN1/4R1K1/4R3 b - - 1 31,e4,37,292,255,1
3brrk1/1p1q2p1/p1p2pPp/2Pp1P1P/1P1Pp3/P2Q1PN1/4R1K1/4R3 w - - 0 32,fxe4,267,283,16,1
3brrk1/1p1q2p1/p1p2pPp/2Pp1P1P/1P1PP3/P2Q2N1/4R1K1/4R3 b - - 0 32,dxe4,275,377,102,1
3brrk1/1p1q2p1/p1p2pPp/2P2P1P/1P1Pp3/P2Q2N1/4R1K1/4R3 w - - 0 33,Nxe4,339,327,-12,1
3brrk1/1p1q2p1/p1p2pPp/2P2P1P/1P1PN3/P2Q4/4R1K1/4R3 b - - 0 33,Rxe4,294,529,235,1
3b1rk1/1p1q2p1/p1p2pPp/2P2P1P/1P1Pr3/P2Q4/4R1K1/4R3 w - - 0 34,Qxe4,524,529,5,1
3b1rk1/1p1q2p1/p1p2pPp/2P2P1P/1P1PQ3/P7/4R1K1/4R3 b - - 0 34,Bc7,507,716,209,1
5rk1/1pbq2p1/p1p2pPp/2P2P1P/1P1PQ3/P7/4R1K1/4R3 w - - 1 35,Qe6+,692,630,-62,1
5rk1/1pbq2p1/p1p1QpPp/2P2P1P/1P1P4/P7/4R1K1/4R3 b - - 2 35,Qxe6,622,637,15,1
5rk1/1pb3p1/p1p1qpPp/2P2P1P/1P1P4/P7/4R1K1/4R3 w - - 0 36,fxe6,655,657,2,1
5rk1/1pb3p1/p1p1PpPp/2P4P/1P1P4/P7/4R1K1/4R3 b - - 0 36,Re8,670,636,-34,1
4r1k1/1pb3p1/p1p1PpPp/2P4P/1P1P4/P7/4R1K1/4R3 w - - 1 37,e7,631,623,-8,1
4r1k1/1pb1P1p1/p1p2pPp/2P4P/1P1P4/P7/4R1K1/4R3 b - - 0 37,Bf4,651,638,-13,1
4r1k1/1p2P1p1/p1p2pPp/2P4P/1P1P1b2/P7/4R1K1/4R3 w - - 1 38,Re6,647,654,7,1
4r1k1/1p2P1p1/p1p1RpPp/2P4P/1P1P1b2/P7/6K1/4R3 b - - 2 38,Bg5,677,869,192,1
4r1k1/1p2P1p1/p1p1RpPp/2P3bP/1P1P4/P7/6K1/4R3 w - - 3 39,Rd6,834,9990,9156,1
4r1k1/1p2P1p1/p1pR1pPp/2P3bP/1P1P4/P7/6K1/4R3 b - - 4 39,Bd2,9990,9998,8,1
4r1k1/1p2P1p1/p1pR1pPp/2P4P/1P1P4/P7/3b2K1/4R3 w - - 5 40,Rd8,9998,9999,1,1
rnbqkbnr/pppppppp/8/8/8/8/PPPPPPPP/RNBQKBNR w KQkq - 0 1,e4,20,18,-2,1
rnbqkbnr/pppppppp/8/8/4P3/8/PPPP1PPP/RNBQKBNR b KQkq - 0 1,e5,22,32,10,1
rnbqkbnr/pppp1ppp/8/4p3/4P3/8/PPPP1PPP/RNBQKBNR w KQkq - 0 2,Nf3,33,25,-8,1
rnbqkbnr/pppp1ppp/8/4p3/4P3/5N2/PPPP1PPP/RNBQKB1R b KQkq - 1 2,d6,37,44,7,1
rnbqkbnr/ppp2ppp/3p4/4p3/4P3/5N2/PPPP1PPP/RNBQKB1R w KQkq - 0 3,d4,72,48,-24,1
rnbqkbnr/ppp2ppp/3p4/4p3/3PP3/5N2/PPP2PPP/RNBQKB1R b KQkq - 0 3,Nd7,59,67,8,1
r1bqkbnr/pppn1ppp/3p4/4p3/3PP3/5N2/PPP2PPP/RNBQKB1R w KQkq - 1 4,Bc4,65,61,-4,1
r1bqkbnr/pppn1ppp/3p4/4p3/2BPP3/5N2/PPP2PPP/RNBQK2R b KQkq - 2 4,exd4,40,69,29,1
r1bqkbnr/pppn1ppp/3p4/8/2BpP3/5N2/PPP2PPP/RNBQK2R w KQkq - 0 5,Qxd4,73,50,-23,1
r1bqkbnr/pppn1ppp/3p4/8/2BQP3/5N2/PPP2PPP/RNB1K2R b KQkq - 0 5,Ngf6,48,55,7,1
r1bqkb1r/pppn1ppp/3p1n2/8/2BQP3/5N2/PPP2PPP/RNB1K2R w KQkq - 1 6,Nc3,75,66,-9,1
r1bqkb1r/pppn1ppp/3p1n2/8/2BQP3/2N2N2/PPP2PPP/R1B1K2R b KQkq - 2 6,Be7,82,68,-14,1
r1bqk2r/pppnbppp/3p1n2/8/2BQP3/2N2N2/PPP2PPP/R1B1K2R w KQkq - 3 7,Bg5,65,60,-5,1
r1bqk2r/pppnbppp/3p1n2/6B1/2BQP3/2N2N2/PPP2PPP/R3K2R b KQkq - 4 7,O-O,58,65,7,1
r1bq1rk1/pppnbppp/3p1n2/6B1/2BQP3/2N2N2/PPP2PPP/R3K2R w KQ - 5 8,O-O-O,83,62,-21,1
r1bq1rk1/pppnbppp/3p1n2/6B1/2BQP3/2N2N2/PPP2PPP/2KR3R b - - 6 8,c6,62,161,99,1
r1bq1rk1/pp1nbppp/2pp1n2/6B1/2BQP3/2N2N2/PPP2PPP/2KR3R w - - 0 9,Bf4,169,-39,-208,0
r1bq1rk1/pp1nbppp/2pp1n2/8/2BQPB2/2N2N2/PPP2PPP/2KR3R b - - 1 9,b5,-14,12,26,1
r1bq1rk1/p2nbppp/2pp1n2/1p6/2BQPB2/2N2N2/PPP2PPP/2KR3R w - - 0 10,Be2,-18,-25,-7,1
r1bq1rk1/p2nbppp/2pp1n2/1p6/3QPB2/2N2N2/PPP1BPPP/2KR3R b - - 1 10,c5,-14,39,53,1
r1bq1rk1/p2nbppp/3p1n2/1pp5/3QPB2/2N2N2/PPP1BPPP/2KR3R w - - 0 11,Qd3,23,-29,-52,1
r1bq1rk1/p2nbppp/3p1n2/1pp5/4PB2/2NQ1N2/PPP1BPPP/2KR3R b - - 1 11,b4,-29,39,68,1
r1bq1rk1/p2nbppp/3p1n2/2p5/1p2PB2/2NQ1N2/PPP1BPPP/2KR3R w - - 0 12,Nb5,55,-32,-87,1
r1bq1rk1/p2nbppp/3p1n2/1Np5/1p2PB2/3Q1N2/PPP1BPPP/2KR3R b - - 1 12,Qa5,-28,120,148,1
r1b2rk1/p2nbppp/3p1n2/qNp5/1p2PB2/3Q1N2/PPP1BPPP/2KR3R w - - 2 13,Kb1,136,-94,-230,0
r1b2rk1/p2nbppp/3p1n2/qNp5/1p2PB2/3Q1N2/PPP1BPPP/1K1R3R b - - 3 13,Ba6,-89,-69,20,1
r4rk1/p2nbppp/b2p1n2/qNp5/1p2PB2/3Q1N2/PPP1BPPP/1K1R3R w - - 4 14,c4,-41,-233,-192,0
r4rk1/p2nbppp/b2p1n2/qNp5/1pP1PB2/3Q1N2/PP2BPPP/1K1R3R b - c3 0 14,bxc3,-231,-220,11,1
r4rk1/p2nbppp/b2p1n2/qNp5/4PB2/2pQ1N2/PP2BPPP/1K1R3R w - - 0 15,Qxc3,-160,-168,-8,1
r4rk1/p2nbppp/b2p1n2/qNp5/4PB2/2Q2N2/PP2BPPP/1K1R3R b - - 0 15,Qxc3,-246,-152,94,1
r4rk1/p2nbppp/b2p1n2/1Np5/4PB2/2q2N2/PP2BPPP/1K1R3R w - - 0 16,Nxc3,-136,-145,-9,1
r4rk1/p2nbppp/b2p1n2/2p5/4PB2/2N2N2/PP2BPPP/1K1R3R b - - 0 16,Bxe2,-149,-140,9,1
r4rk1/p2nbppp/3p1n2/2p5/4PB2/2N2N2/PP2bPPP/1K1R3R w - - 0 17,Nxe2,-139,-139,0,1
r4rk1/p2nbppp/3p1n2/2p5/4PB2/5N2/PP2NPPP/1K1R3R b - - 0 17,Nxe4,-169,-141,28,1
r4rk1/p2nbppp/3p4/2p5/4nB2/5N2/PP2NPPP/1K1R3R w - - 0 18,Bxd6,-170,-412,-242,0
r4rk1/p2nbppp/3B4/2p5/4n3/5N2/PP2NPPP/1K1R3R b - - 0 18,Bxd6,-426,-385,41,1
r4rk1/p2n1ppp/3b4/2p5/4n3/5N2/PP2NPPP/1K1R3R w - - 0 19,Rxd6,-448,-433,15,1
r4rk1/p2n1ppp/3R4/2p5/4n3/5N2/PP2NPPP/1K5R b - - 0 19,Nxd6,-416,-407,9,1
r4rk1/p2n1ppp/3n4/2p5/8/5N2/PP2NPPP/1K5R w - - 0 20,Rd1,-419,-408,11,1
r4rk1/p2n1ppp/3n4/2p5/8/5N2/PP2NPPP/1K1R4 b - - 1 20,Ne4,-412,-380,32,1
r4rk1/p2n1ppp/8/2p5/4n3/5N2/PP2NPPP/1K1R4 w - - 2 21,Rxd7,-394,-416,-22,1
r4rk1/p2R1ppp/8/2p5/4n3/5N2/PP2NPPP/1K6 b - - 0 21,Rad8,-394,-328,66,1
3r1rk1/p2R1ppp/8/2p5/4n3/5N2/PP2NPPP/1K6 w - - 1 22,Rxa7,-326,-335,-9,1
3r1rk1/R4ppp/8/2p5/4n3/5N2/PP2NPPP/1K6 b - - 0 22,Nxf2,-346,-330,16,1
3r1rk1/R4ppp/8/2p5/8/5N2/PP2NnPP/1K6 w - - 0 23,Rc7,-320,-332,-12,1
3r1rk1/2R2ppp/8/2p5/8/5N2/PP2NnPP/1K6 b - - 1 23,Rc8,-359,-316,43,1
2r2rk1/2R2ppp/8/2p5/8/5N2/PP2NnPP/1K6 w - - 2 24,Rxc8,-311,-315,-4,1
2R2rk1/5ppp/8/2p5/8/5N2/PP2NnPP/1K6 b - - 0 24,Rxc8,-302,-302,0,1
2r3k1/5ppp/8/2p5/8/5N2/PP2NnPP/1K6 w - - 0 25,a4,-330,-357,-27,1
2r3k1/5ppp/8/2p5/P7/5N2/1P2NnPP/1K6 b - - 0 25,Ra8,-346,-299,47,1
r5k1/5ppp/8/2p5/P7/5N2/1P2NnPP/1K6 w - - 1 26,b3,-286,-332,-46,1
r5k1/5ppp/8/2p5/P7/1P3N2/4NnPP/1K6 b - - 0 26,Nd3,-354,-265,89,1
r5k1/5ppp/8/2p5/P7/1P1n1N2/4N1PP/1K6 w - - 1 27,Kc2,-254,-242,12,1
r5k1/5ppp/8/2p5/P7/1P1n1N2/2K1N1PP/8 b - - 2 27,Ne1+,-244,283,527,1
r5k1/5ppp/8/2p5/P7/1P3N2/2K1N1PP/4n3 w - - 3 28,Kc3,284,-238,-522,0
r5k1/5ppp/8/2p5/P7/1PK2N2/4N1PP/4n3 b - - 4 28,Re8,-295,-195,100,1
4r1k1/5ppp/8/2p5/P7/1PK2N2/4N1PP/4n3 w - - 5 29,Nf4,-166,-193,-27,1
4r1k1/5ppp/8/2p5/P4N2/1PK2N2/6PP/4n3 b - - 6 29,Nxf3,-250,-163,87,1
4r1k1/5ppp/8/2p5/P4N2/1PK2n2/6PP/8 w - - 0 30,gxf3,-177,-203,-26,1
4r1k1/5ppp/8/2p5/P4N2/1PK2P2/7P/8 b - - 0 30,Re3+,-225,-71,154,1
6k1/5ppp/8/2p5/P4N2/1PK1rP2/7P/8 w - - 1 31,Kc4,-98,-134,-36,1
6k1/5ppp/8/2p5/P1K2N2/1P2rP2/7P/8 b - - 2 31,Rxf3,-139,-87,52,1
6k1/5ppp/8/2p5/P1K2N2/1P3r2/7P/8 w - - 0 32,a5,-116,-379,-263,0
6k1/5ppp/8/P1p5/2K2N2/1P3r2/7P/8 b - - 0 32,Rxf4+,-402,-470,-68,1
6k1/5ppp/8/P1p5/2K2r2/1P6/7P/8 w - - 0 33,Kxc5,-482,-538,-56,1
6k1/5ppp/8/P1K5/5r2/1P6/7P/8 b - - 0 33,Rf1,-536,-514,22,1
rnbqkbnr/pppppppp/8/8/8/8/PPPPPPPP/RNBQKBNR w KQkq - 0 1,d4,21,20,-1,1
rnbqkbnr/pppppppp/8/8/3P4/8/PPP1PPPP/RNBQKBNR b KQkq - 0 1,e6,17,51,34,1
rnbqkbnr/pppp1ppp/4p3/8/3P4/8/PPP1PPPP/RNBQKBNR w KQkq - 0 2,e3,42,0,-42,1
rnbqkbnr/pppp1ppp/4p3/8/3P4/4P3/PPP2PPP/RNBQKBNR b KQkq - 0 2,d5,1,5,4,1
rnbqkbnr/ppp2ppp/4p3/3p4/3P4/4P3/PPP2PPP/RNBQKBNR w KQkq - 0 3,c4,10,10,0,1
rnbqkbnr/ppp2ppp/4p3/3p4/2PP4/4P3/PP3PPP/RNBQKBNR b KQkq - 0 3,c5,10,13,3,1
rnbqkbnr/pp3ppp/4p3/2pp4/2PP4/4P3/PP3PPP/RNBQKBNR w KQkq - 0 4,dxc5,12,-12,-24,1
rnbqkbnr/pp3ppp/4p3/2Pp4/2P5/4P3/PP3PPP/RNBQKBNR b KQkq - 0 4,Bxc5,4,0,-4,1
rnbqk1nr/pp3ppp/4p3/2bp4/2P5/4P3/PP3PPP/RNBQKBNR w KQkq - 0 5,cxd5,11,-1,-12,1
rnbqk1nr/pp3ppp/4p3/2bP4/8/4P3/PP3PPP/RNBQKBNR b KQkq - 0 5,Qxd5,-15,26,41,1
rnb1k1nr/pp3ppp/4p3/2bq4/8/4P3/PP3PPP/RNBQKBNR w KQkq - 0 6,Qxd5,18,8,-10,1
rnb1k1nr/pp3ppp/4p3/2bQ4/8/4P3/PP3PPP/RNB1KBNR b KQkq - 0 6,exd5,13,9,-4,1
rnb1k1nr/pp3ppp/8/2bp4/8/4P3/PP3PPP/RNB1KBNR w KQkq - 0 7,Nc3,11,16,5,1
rnb1k1nr/pp3ppp/8/2bp4/8/2N1P3/PP3PPP/R1B1KBNR b KQkq - 1 7,Nf6,13,10,-3,1
rnb1k2r/pp3ppp/5n2/2bp4/8/2N1P3/PP3PPP/R1B1KBNR w KQkq - 2 8,Nf3,14,5,-9,1
rnb1k2r/pp3ppp/5n2/2bp4/8/2N1PN2/PP3PPP/R1B1KB1R b KQkq - 3 8,O-O,-2,3,5,1
rnb2rk1/pp3ppp/5n2/2bp4/8/2N1PN2/PP3PPP/R1B1KB1R w KQ - 4 9,Be2,6,2,-4,1
rnb2rk1/pp3ppp/5n2/2bp4/8/2N1PN2/PP2BPPP/R1B1K2R b KQ - 5 9,Nc6,2,4,2,1
r1b2rk1/pp3ppp/2n2n2/2bp4/8/2N1PN2/PP2BPPP/R1B1K2R w KQ - 6 10,O-O,4,10,6,1
r1b2rk1/pp3ppp/2n2n2/2bp4/8/2N1PN2/PP2BPPP/R1B2RK1 b - - 7 10,Be6,15,16,1,1
r4rk1/pp3ppp/2n1bn2/2bp4/8/2N1PN2/PP2BPPP/R1B2RK1 w - - 8 11,a3,17,-1,-18,1
r4rk1/pp3ppp/2n1bn2/2bp4/8/P1N1PN2/1P2BPPP/R1B2RK1 b - - 0 11,Rac8,-5,25,30,1
2r2rk1/pp3ppp/2n1bn2/2bp4/8/P1N1PN2/1P2BPPP/R1B2RK1 w - - 1 12,b4,27,17,-10,1
2r2rk1/pp3ppp/2n1bn2/2bp4/1P6/P1N1PN2/4BPPP/R1B2RK1 b - - 0 12,Bd6,26,29,3,1
2r2rk1/pp3ppp/2nbbn2/3p4/1P6/P1N1PN2/4BPPP/R1B2RK1 w - - 1 13,Bb2,33,24,-9,1
2r2rk1/pp3ppp/2nbbn2/3p4/1P6/P1N1PN2/1B2BPPP/R4RK1 b - - 2 13,a6,29,36,7,1
2r2rk1/1p3ppp/p1nbbn2/3p4/1P6/P1N1PN2/1B2BPPP/R4RK1 w - - 0 14,Rfd1,30,30,0,1
2r2rk1/1p3ppp/p1nbbn2/3p4/1P6/P1N1PN2/1B2BPPP/R2R2K1 b - - 1 14,Be7,22,47,25,1
2r2rk1/1p2bppp/p1n1bn2/3p4/1P6/P1N1PN2/1B2BPPP/R2R2K1 w - - 2 15,Na4,50,20,-30,1
2r2rk1/1p2bppp/p1n1bn2/3p4/NP6/P3PN2/1B2BPPP/R2R2K1 b - - 3 15,b5,19,21,2,1
2r2rk1/4bppp/p1n1bn2/1p1p4/NP6/P3PN2/1B2BPPP/R2R2K1 w - - 0 16,Nc3,24,24,0,1
2r2rk1/4bppp/p1n1bn2/1p1p4/1P6/P1N1PN2/1B2BPPP/R2R2K1 b - - 1 16,Rfd8,14,25,11,1
2rr2k1/4bppp/p1n1bn2/1p1p4/1P6/P1N1PN2/1B2BPPP/R2R2K1 w - - 2 17,h3,15,-16,-31,1
2rr2k1/4bppp/p1n1bn2/1p1p4/1P6/P1N1PN1P/1B2BPP1/R2R2K1 b - - 0 17,Bf8,-15,28,43,1
2rr1bk1/5ppp/p1n1bn2/1p1p4/1P6/P1N1PN1P/1B2BPP1/R2R2K1 w - - 1 18,Bd3,23,33,10,1
2rr1bk1/5ppp/p1n1bn2/1p1p4/1P6/P1NBPN1P/1B3PP1/R2R2K1 b - - 2 18,Ne7,28,99,71,1
2rr1bk1/4nppp/p3bn2/1p1p4/1P6/P1NBPN1P/1B3PP1/R2R2K1 w - - 3 19,Ne2,87,94,7,1
2rr1bk1/4nppp/p3bn2/1p1p4/1P6/P2BPN1P/1B2NPP1/R2R2K1 b - - 4 19,Rc7,89,159,70,1
3r1bk1/2r1nppp/p3bn2/1p1p4/1P6/P2BPN1P/1B2NPP1/R2R2K1 w - - 5 20,Rac1,167,100,-67,1
3r1bk1/2r1nppp/p3bn2/1p1p4/1P6/P2BPN1P/1B2NPP1/2RR2K1 b - - 6 20,Rdc8,85,129,44,1
2r2bk1/2r1nppp/p3bn2/1p1p4/1P6/P2BPN1P/1B2NPP1/2RR2K1 w - - 7 21,Ned4,132,55,-77,1
2r2bk1/2r1nppp/p3bn2/1p1p4/1P1N4/P2BPN1P/1B3PP1/2RR2K1 b - - 8 21,Ne4,48,179,131,1
2r2bk1/2r1nppp/p3b3/1p1p4/1P1Nn3/P2BPN1P/1B3PP1/2RR2K1 w - - 9 22,Ne5,178,15,-163,0
2r2bk1/2r1nppp/p3b3/1p1pN3/1P1Nn3/P2BP2P/1B3PP1/2RR2K1 b - - 10 22,Rxc1,6,20,14,1
2r2bk1/4nppp/p3b3/1p1pN3/1P1Nn3/P2BP2P/1B3PP1/2rR2K1 w - - 0 23,Rxc1,14,-1,-15,1
2r2bk1/4nppp/p3b3/1p1pN3/1P1Nn3/P2BP2P/1B3PP1/2R3K1 b - - 0 23,Rxc1+,5,16,11,1
5bk1/4nppp/p3b3/1p1pN3/1P1Nn3/P2BP2P/1B3PP1/2r3K1 w - - 0 24,Bxc1,18,1,-17,1
5bk1/4nppp/p3b3/1p1pN3/1P1Nn3/P2BP2P/5PP1/2B3K1 b - - 0 24,Nd6,19,206,187,1
5bk1/4nppp/p2nb3/1p1pN3/1P1N4/P2BP2P/5PP1/2B3K1 w - - 1 25,Kf1,212,7,-205,0
5bk1/4nppp/p2nb3/1p1pN3/1P1N4/P2BP2P/5PP1/2B2K2 b - - 2 25,f6,10,273,263,1
5bk1/4n1pp/p2nbp2/1p1pN3/1P1N4/P2BP2P/5PP1/2B2K2 w - - 0 26,Nxe6,278,222,-56,1
5bk1/4n1pp/p2nNp2/1p1pN3/1P6/P2BP2P/5PP1/2B2K2 b - - 0 26,fxe5,212,206,-6,1
5bk1/4n1pp/p2nN3/1p1pp3/1P6/P2BP2P/5PP1/2B2K2 w - - 0 27,Nc7,185,305,120,1
5bk1/2N1n1pp/p2n4/1p1pp3/1P6/P2BP2P/5PP1/2B2K2 b - - 1 27,e4,305,273,-32,1
5bk1/2N1n1pp/p2n4/1p1p4/1P2p3/P2BP2P/5PP1/2B2K2 w - - 0 28,Be2,300,269,-31,1
5bk1/2N1n1pp/p2n4/1p1p4/1P2p3/P3P2P/4BPP1/2B2K2 b - - 1 28,Nc4,274,389,115,1
5bk1/2N1n1pp/p7/1p1p4/1Pn1p3/P3P2P/4BPP1/2B2K2 w - - 2 29,Nxa6,379,363,-16,1
5bk1/4n1pp/N7/1p1p4/1Pn1p3/P3P2P/4BPP1/2B2K2 b - - 0 29,Kf7,407,431,24,1
5b2/4nkpp/N7/1p1p4/1Pn1p3/P3P2P/4BPP1/2B2K2 w - - 1 30,Bxc4,427,337,-90,1
5b2/4nkpp/N7/1p1p4/1PB1p3/P3P2P/5PP1/2B2K2 b - - 0 30,dxc4,332,406,74,1
5b2/4nkpp/N7/1p6/1Pp1p3/P3P2P/5PP1/2B2K2 w - - 0 31,Nc7,387,409,22,1
5b2/2N1nkpp/8/1p6/1Pp1p3/P3P2P/5PP1/2B2K2 b - - 1 31,Nc6,400,467,67,1
5b2/2N2kpp/2n5/1p6/1Pp1p3/P3P2P/5PP1/2B2K2 w - - 2 32,Nxb5,464,456,-8,1
5b2/5kpp/2n5/1N6/1Pp1p3/P3P2P/5PP1/2B2K2 b - - 0 32,Nxb4,446,492,46,1
5b2/5kpp/8/1N6/1np1p3/P3P2P/5PP1/2B2K2 w - - 0 33,axb4,513,509,-4,1
5b2/5kpp/8/1N6/1Pp1p3/4P2P/5PP1/2B2K2 b - - 0 33,Bxb4,496,532,36,1
8/5kpp/8/1N6/1bp1p3/4P2P/5PP1/2B2K2 w - - 0 34,Ke2,539,524,-15,1
8/5kpp/8/1N6/1bp1p3/4P2P/4KPP1/2B5 b - - 1 34,Ke6,491,555,64,1
8/6pp/4k3/1N6/1bp1p3/4P2P/4KPP1/2B5 w - - 2 35,Bd2,533,519,-14,1
8/6pp/4k3/1N6/1bp1p3/4P2P/3BKPP1/8 b - - 3 35,Bc5,520,522,2,1
8/6pp/4k3/1Nb5/2p1p3/4P2P/3BKPP1/8 w - - 4 36,Bc3,526,536,10,1
8/6pp/4k3/1Nb5/2p1p3/2B1P2P/4KPP1/8 b - - 5 36,g6,507,536,29,1
8/7p/4k1p1/1Nb5/2p1p3/2B1P2P/4KPP1/8 w - - 0 37,Nd4+,547,547,0,1
8/7p/4k1p1/2b5/2pNp3/2B1P2P/4KPP1/8 b - - 1 37,Kd5,521,514,-7,1
8/7p/6p1/2bk4/2pNp3/2B1P2P/4KPP1/8 w - - 2 38,Nc2,543,532,-11,1
8/7p/6p1/2bk4/2p1p3/2B1P2P/2N1KPP1/8 b - - 3 38,h5,522,511,-11,1
8/8/6p1/2bk3p/2p1p3/2B1P2P/2N1KPP1/8 w - - 0 39,f3,503,465,-38,1
8/8/6p1/2bk3p/2p1p3/2B1PP1P/2N1K1P1/8 b - - 0 39,exf3+,491,548,57,1
8/8/6p1/2bk3p/2p5/2B1Pp1P/2N1K1P1/8 w - - 0 40,gxf3,522,499,-23,1
8/8/6p1/2bk3p/2p5/2B1PP1P/2N1K3/8 b - - 0 40,Be7,490,574,84,1
8/4b3/6p1/3k3p/2p5/2B1PP1P/2N1K3/8 w - - 1 41,e4+,558,550,-8,1
8/4b3/6p1/3k3p/2p1P3/2B2P1P/2N1K3/8 b - - 0 41,Kc5,527,648,121,1
8/4b3/6p1/2k4p/2p1P3/2B2P1P/2N1K3/8 w - - 1 42,f4,676,481,-195,0
8/4b3/6p1/2k4p/2p1PP2/2B4P/2N1K3/8 b - - 0 42,Kc6,549,582,33,1
8/4b3/2k3p1/7p/2p1PP2/2B4P/2N1K3/8 w - - 1 43,Kf3,532,553,21,1
8/4b3/2k3p1/7p/2p1PP2/2B2K1P/2N5/8 b - - 2 43,Kd7,560,555,-5,1
8/3kb3/6p1/7p/2p1PP2/2B2K1P/2N5/8 w - - 3 44,Ne3,539,531,-8,1
8/3kb3/6p1/7p/2p1PP2/2B1NK1P/8/8 b - - 4 44,Ke6,542,570,28,1
8/4b3/4k1p1/7p/2p1PP2/2B1NK1P/8/8 w - - 5 45,Nxc4,571,529,-42,1
8/4b3/4k1p1/7p/2N1PP2/2B2K1P/8/8 b - - 0 45,Bc5,545,573,28,1
8/8/4k1p1/2b4p/2N1PP2/2B2K1P/8/8 w - - 1 46,Ne5,556,589,33,1
8/8/4k1p1/2b1N2p/4PP2/2B2K1P/8/8 b - - 2 46,g5,599,578,-21,1
8/8/4k3/2b1N1pp/4PP2/2B2K1P/8/8 w - - 0 47,fxg5,587,622,35,1
8/8/4k3/2b1N1Pp/4P3/2B2K1P/8/8 b - - 0 47,Bd6,636,636,0,1
8/8/3bk3/4N1Pp/4P3/2B2K1P/8/8 w - - 1 48,Nd3,635,628,-7,1
8/8/3bk3/6Pp/4P3/2BN1K1P/8/8 b - - 2 48,Bf8,631,682,51,1
5b2/8/4k3/6Pp/4P3/2BN1K1P/8/8 w - - 3 49,Nc5+,648,364,-284,0
5b2/8/4k3/2N3Pp/4P3/2B2K1P/8/8 b - - 4 49,Kf7,584,629,45,1
5b2/5k2/8/2N3Pp/4P3/2B2K1P/8/8 w - - 5 50,Bd4,637,599,-38,1
5b2/5k2/8/2N3Pp/3BP3/5K1P/8/8 b - - 6 50,h4,605,619,14,1
5b2/5k2/8/2N3P1/3BP2p/5K1P/8/8 w - - 0 51,Kg4,659,657,-2,1
5b2/5k2/8/2N3P1/3BP1Kp/7P/8/8 b - - 1 51,Kg6,655,641,-14,1
5b2/8/6k1/2N3P1/3BP1Kp/7P/8/8 w - - 2 52,Kxh4,670,646,-24,1
5b2/8/6k1/2N3P1/3BP2K/7P/8/8 b - - 0 52,Be7,673,653,-20,1
8/4b3/6k1/2N3P1/3BP2K/7P/8/8 w - - 1 53,Be3,670,666,-4,1
8/4b3/6k1/2N3P1/4P2K/4B2P/8/8 b - - 2 53,Bd8,630,689,59,1
3b4/8/6k1/2N3P1/4P2K/4B2P/8/8 w - - 3 54,Kg4,685,687,2,1
3b4/8/6k1/2N3P1/4P1K1/4B2P/8/8 b - - 4 54,Be7,688,691,3,1
8/4b3/6k1/2N3P1/4P1K1/4B2P/8/8 w - - 5 55,h4,686,699,13,1
8/4b3/6k1/2N3P1/4P1KP/4B3/8/8 b - - 0 55,Bf8,669,696,27,1
5b2/8/6k1/2N3P1/4P1KP/4B3/8/8 w - - 1 56,h5+,715,706,-9,1
5b2/8/6k1/2N3PP/4P1K1/4B3/8/8 b - - 0 56,Kg7,708,731,23,1
5b2/6k1/8/2N3PP/4P1K1/4B3/8/8 w - - 1 57,Ne6+,709,793,84,1
5b2/6k1/4N3/6PP/4P1K1/4B3/8/8 b - - 2 57,Kf7,887,950,63,1
5b2/5k2/4N3/6PP/4P1K1/4B3/8/8 w - - 3 58,Nxf8,969,988,19,1
5N2/5k2/8/6PP/4P1K1/4B3/8/8 b - - 0 58,Kxf8,979,987,8,1
5k2/8/8/6PP/4P1K1/4B3/8/8 w - - 0 59,Kf5,1086,1089,3,1
5k2/8/8/5KPP/4P3/4B3/8/8 b - - 1 59,Kf7,1242,1259,17,1
8/5k2/8/5KPP/4P3/4B3/8/8 w - - 2 60,Bc5,1278,1011,-267,0
8/5k2/8/2B2KPP/4P3/8/8/8 b - - 3 60,Ke8,1225,1386,161,1
4k3/8/8/2B2KPP/4P3/8/8/8 w - - 4 61,h6,1390,1392,2,1
4k3/8/7P/2B2KP1/4P3/8/8/8 b - - 0 61,Kd7,9984,9986,2,1
8/3k4/7P/2B2KP1/4P3/8/8/8 w - - 1 62,h7,9986,9987,1,1
8/3k3P/8/2B2KP1/4P3/8/8/8 b - - 0 62,Kc6,9987,9987,0,1
8/7P/2k5/2B2KP1/4P3/8/8/8 w - - 1 63,h8=Q,9987,1094,-8893,0
7Q/8/2k5/2B2KP1/4P3/8/8/8 b - - 0 63,Kxc5,9986,9991,5,1
7Q/8/8/2k2KP1/4P3/8/8/8 w - - 0 64,Qb2,9991,9990,-1,1
8/8/8/2k2KP1/4P3/8/1Q6/8 b - - 1 64,Kc4,9990,9990,0,1
8/8/8/5KP1/2k1P3/8/1Q6/8 w - - 2 65,g6,9990,9991,1,1
8/8/6P1/5K2/2k1P3/8/1Q6/8 b - - 0 65,Kc5,9993,9993,0,1
8/8/6P1/2k2K2/4P3/8/1Q6/8 w - - 1 66,g7,9993,9993,0,1
8/6P1/8/2k2K2/4P3/8/1Q6/8 b - - 0 66,Kd6,9993,9997,4,1
8/6P1/3k4/5K2/4P3/8/1Q6/8 w - - 1 67,g8=Q,9997,9998,1,1
6Q1/8/3k4/5K2/4P3/8/1Q6/8 b - - 0 67,Kc5,9998,9999,1,1
6Q1/8/8/2k2K2/4P3/8/1Q6/8 w - - 1 68,Qc8+,9999,9999,0,1
2Q5/8/8/2k2K2/4P3/8/1Q6/8 b - - 2 68,Kd6,9999,9999,0,1
2Q5/8/3k4/5K2/4P3/8/1Q6/8 w - - 3 69,Qf6#,9999,10000,1,1
rnbqkbnr/pppppppp/8/8/8/8/PPPPPPPP/RNBQKBNR w KQkq - 0 1,e4,33,30,-3,1
rnbqkbnr/pppppppp/8/8/4P3/8/PPPP1PPP/RNBQKBNR b KQkq - 0 1,c5,38,23,-15,1
rnbqkbnr/pp1ppppp/8/2p5/4P3/8/PPPP1PPP/RNBQKBNR w KQkq - 0 2,Bc4,36,-13,-49,1
rnbqkbnr/pp1ppppp/8/2p5/2B1P3/8/PPPP1PPP/RNBQK1NR b KQkq - 1 2,Nc6,-2,12,14,1
r1bqkbnr/pp1ppppp/2n5/2p5/2B1P3/8/PPPP1PPP/RNBQK1NR w KQkq - 2 3,Nf3,11,10,-1,1
r1bqkbnr/pp1ppppp/2n5/2p5/2B1P3/5N2/PPPP1PPP/RNBQK2R b KQkq - 3 3,Nf6,16,12,-4,1
r1bqkb1r/pp1ppppp/2n2n2/2p5/2B1P3/5N2/PPPP1PPP/RNBQK2R w KQkq - 4 4,Nc3,51,7,-44,1
r1bqkb1r/pp1ppppp/2n2n2/2p5/2B1P3/2N2N2/PPPP1PPP/R1BQK2R b KQkq - 5 4,Nxe4,6,23,17,1
r1bqkb1r/pp1ppppp/2n5/2p5/2B1n3/2N2N2/PPPP1PPP/R1BQK2R w KQkq - 0 5,Bxf7+,39,30,-9,1
r1bqkb1r/pp1ppBpp/2n5/2p5/4n3/2N2N2/PPPP1PPP/R1BQK2R b KQkq - 0 5,Kxf7,28,42,14,1
r1bq1b1r/pp1ppkpp/2n5/2p5/4n3/2N2N2/PPPP1PPP/R1BQK2R w KQ - 0 6,Nxe4,44,36,-8,1
r1bq1b1r/pp1ppkpp/2n5/2p5/4N3/5N2/PPPP1PPP/R1BQK2R b KQ - 0 6,e6,29,65,36,1
r1bq1b1r/pp1p1kpp/2n1p3/2p5/4N3/5N2/PPPP1PPP/R1BQK2R w KQ - 0 7,d4,66,42,-24,1
r1bq1b1r/pp1p1kpp/2n1p3/2p5/3PN3/5N2/PPP2PPP/R1BQK2R b KQ - 0 7,cxd4,36,61,25,1
r1bq1b1r/pp1p1kpp/2n1p3/8/3pN3/5N2/PPP2PPP/R1BQK2R w KQ - 0 8,Nxd4,78,90,12,1
r1bq1b1r/pp1p1kpp/2n1p3/8/3NN3/8/PPP2PPP/R1BQK2R b KQ - 0 8,d5,42,66,24,1
r1bq1b1r/pp3kpp/2n1p3/3p4/3NN3/8/PPP2PPP/R1BQK2R w KQ - 0 9,Ng5+,52,50,-2,1
r1bq1b1r/pp3kpp/2n1p3/3p2N1/3N4/8/PPP2PPP/R1BQK2R b KQ - 1 9,Kg8,58,57,-1,1
r1bq1bkr/pp4pp/2n1p3/3p2N1/3N4/8/PPP2PPP/R1BQK2R w KQ - 2 10,f4,55,41,-14,1
r1bq1bkr/pp4pp/2n1p3/3p2N1/3N1P2/8/PPP3PP/R1BQK2R b KQ - 0 10,Qf6,58,60,2,1
r1b2bkr/pp4pp/2n1pq2/3p2N1/3N1P2/8/PPP3PP/R1BQK2R w KQ - 1 11,c3,63,14,-49,1
r1b2bkr/pp4pp/2n1pq2/3p2N1/3N1P2/2P5/PP4PP/R1BQK2R b KQ - 0 11,Bc5,19,66,47,1
r1b3kr/pp4pp/2n1pq2/2bp2N1/3N1P2/2P5/PP4PP/R1BQK2R w KQ - 1 12,Ngf3,65,53,-12,1
r1b3kr/pp4pp/2n1pq2/2bp4/3N1P2/2P2N2/PP4PP/R1BQK2R b KQ - 2 12,Bd7,40,88,48,1
r5kr/pp1b2pp/2n1pq2/2bp4/3N1P2/2P2N2/PP4PP/R1BQK2R w KQ - 3 13,O-O,77,38,-39,1
r5kr/pp1b2pp/2n1pq2/2bp4/3N1P2/2P2N2/PP4PP/R1BQ1RK1 b - - 4 13,Re8,61,88,27,1
4r1kr/pp1b2pp/2n1pq2/2bp4/3N1P2/2P2N2/PP4PP/R1BQ1RK1 w - - 5 14,Kh1,102,66,-36,1
4r1kr/pp1b2pp/2n1pq2/2bp4/3N1P2/2P2N2/PP4PP/R1BQ1R1K b - - 6 14,h6,60,111,51,1
4r1kr/pp1b2p1/2n1pq1p/2bp4/3N1P2/2P2N2/PP4PP/R1BQ1R1K w - - 0 15,Nxc6,94,49,-45,1
4r1kr/pp1b2p1/2N1pq1p/2bp4/5P2/2P2N2/PP4PP/R1BQ1R1K b - - 0 15,Bxc6,57,38,-19,1
4r1kr/pp4p1/2b1pq1p/2bp4/5P2/2P2N2/PP4PP/R1BQ1R1K w - - 0 16,Ne5,43,49,6,1
4r1kr/pp4p1/2b1pq1p/2bpN3/5P2/2P5/PP4PP/R1BQ1R1K b - - 1 16,Bd6,47,89,42,1
4r1kr/pp4p1/2bbpq1p/3pN3/5P2/2P5/PP4PP/R1BQ1R1K w - - 2 17,Nxc6,120,111,-9,1
4r1kr/pp4p1/2Nbpq1p/3p4/5P2/2P5/PP4PP/R1BQ1R1K b - - 0 17,bxc6,126,130,4,1
4r1kr/p5p1/2pbpq1p/3p4/5P2/2P5/PP4PP/R1BQ1R1K w - - 0 18,Be3,132,56,-76,1
4r1kr/p5p1/2pbpq1p/3p4/5P2/2P1B3/PP4PP/R2Q1R1K b - - 1 18,Kh7,74,146,72,1
4r2r/p5pk/2pbpq1p/3p4/5P2/2P1B3/PP4PP/R2Q1R1K w - - 2 19,Bxa7,144,122,-22,1
4r2r/B5pk/2pbpq1p/3p4/5P2/2P5/PP4PP/R2Q1R1K b - - 0 19,e5,132,172,40,1
4r2r/B5pk/2pb1q1p/3pp3/5P2/2P5/PP4PP/R2Q1R1K w - - 0 20,fxe5,189,185,-4,1
4r2r/B5pk/2pb1q1p/3pP3/8/2P5/PP4PP/R2Q1R1K b - - 0 20,Qxe5,205,198,-7,1
4r2r/B5pk/2pb3p/3pq3/8/2P5/PP4PP/R2Q1R1K w - - 0 21,g3,201,22,-179,0
4r2r/B5pk/2pb3p/3pq3/8/2P3P1/PP5P/R2Q1R1K b - - 0 21,Qe4+,26,27,1,1
4r2r/B5pk/2pb3p/3p4/4q3/2P3P1/PP5P/R2Q1R1K w - - 1 22,Qf3,42,46,4,1
4r2r/B5pk/2pb3p/3p4/4q3/2P2QP1/PP5P/R4R1K b - - 2 22,Qxf3+,41,48,7,1
4r2r/B5pk/2pb3p/3p4/8/2P2qP1/PP5P/R4R1K w - - 0 23,Rxf3,47,45,-2,1
4r2r/B5pk/2pb3p/3p4/8/2P2RP1/PP5P/R6K b - - 0 23,Re2,43,20,-23,1
7r/B5pk/2pb3p/3p4/8/2P2RP1/PP2r2P/R6K w - - 1 24,Rf2,27,19,-8,1
7r/B5pk/2pb3p/3p4/8/2P3P1/PP2rR1P/R6K b - - 2 24,Rhe8,-386,193,579,1
4r3/B5pk/2pb3p/3p4/8/2P3P1/PP2rR1P/R6K w - - 3 25,Raf1,127,-11,-138,0
4r3/B5pk/2pb3p/3p4/8/2P3P1/PP2rR1P/5R1K b - - 4 25,Rxf2,-22,59,81,1
4r3/B5pk/2pb3p/3p4/8/2P3P1/PP3r1P/5R1K w - - 0 26,Rxf2,94,68,-26,1
4r3/B5pk/2pb3p/3p4/8/2P3P1/PP3R1P/7K b - - 0 26,Ra8,95,112,17,1
r7/B5pk/2pb3p/3p4/8/2P3P1/PP3R1P/7K w - - 1 27,Bd4,137,10,-127,0
r7/6pk/2pb3p/3p4/3B4/2P3P1/PP3R1P/7K b - - 2 27,c5,10,0,-10,1
r7/6pk/3b3p/2pp4/3B4/2P3P1/PP3R1P/7K w - - 0 28,Be3,-1,2,3,1
r7/6pk/3b3p/2pp4/8/2P1B1P1/PP3R1P/7K b - - 1 28,Rxa2,1,-1,-2,1
8/6pk/3b3p/2pp4/8/2P1B1P1/rP3R1P/7K w - - 0 29,Rf5,0,-11,-11,1
8/6pk/3b3p/2pp1R2/8/2P1B1P1/rP5P/7K b - - 1 29,Rxb2,-8,-1,7,1
8/6pk/3b3p/2pp1R2/8/2P1B1P1/1r5P/7K w - - 0 30,Rxd5,0,0,0,1
8/6pk/3b3p/2pR4/8/2P1B1P1/1r5P/7K b - - 0 30,Bf8,0,0,0,1
5b2/6pk/7p/2pR4/8/2P1B1P1/1r5P/7K w - - 1 31,Bxc5,0,-204,-204,0
5b2/6pk/7p/2BR4/8/2P3P1/1r5P/7K b - - 0 31,Bxc5,-231,7,238,1
8/6pk/7p/2bR4/8/2P3P1/1r5P/7K w - - 0 32,Rxc5,2,0,-2,1
8/6pk/7p/2R5/8/2P3P1/1r5P/7K b - - 0 32,Rc2,-8,13,21,1
8/6pk/7p/2R5/8/2P3P1/2r4P/7K w - - 1 33,Rc6,7,0,-7,1
8/6pk/2R4p/8/8/2P3P1/2r4P/7K b - - 2 33,h5,18,20,2,1
8/6pk/2R5/7p/8/2P3P1/2r4P/7K w - - 0 34,Kg1,37,0,-37,1
8/6pk/2R5/7p/8/2P3P1/2r4P/6K1 b - - 1 34,g6,5,19,14,1
8/7k/2R3p1/7p/8/2P3P1/2r4P/6K1 w - - 0 35,h4,18,11,-7,1
8/7k/2R3p1/7p/7P/2P3P1/2r5/6K1 b - - 0 35,Kg7,10,7,-3,1
8/6k1/2R3p1/7p/7P/2P3P1/2r5/6K1 w - - 1 36,c4,8,1,-7,1
8/6k1/2R3p1/7p/2P4P/6P1/2r5/6K1 b - - 0 36,Kf7,0,8,8,1
8/5k2/2R3p1/7p/2P4P/6P1/2r5/6K1 w - - 1 37,c5,7,3,-4,1
8/5k2/2R3p1/2P4p/7P/6P1/2r5/6K1 b - - 0 37,Ke7,5,6,1,1
8/4k3/2R3p1/2P4p/7P/6P1/2r5/6K1 w - - 1 38,Rxg6,2,0,-2,1
8/4k3/6R1/2P4p/7P/6P1/2r5/6K1 b - - 0 38,Rxc5,0,0,0,1
8/4k3/6R1/2r4p/7P/6P1/8/6K1 w - - 0 39,Rg5,0,0,0,1
8/4k3/8/2r3Rp/7P/6P1/8/6K1 b - - 1 39,Rxg5,0,0,0,1
8/4k3/8/6rp/7P/6P1/8/6K1 w - - 0 40,hxg5,0,0,0,1
8/4k3/8/6Pp/8/6P1/8/6K1 b - - 0 40,Kf7,0,0,0,1
8/5k2/8/6Pp/8/6P1/8/6K1 w - - 1 41,Kf2,0,0,0,1
8/5k2/8/6Pp/8/6P1/5K2/8 b - - 2 41,Kg6,0,0,0,1
rnbqkbnr/pppppppp/8/8/8/8/PPPPPPPP/RNBQKBNR w KQkq - 0 1,e4,32,43,11,1
rnbqkbnr/pppppppp/8/8/4P3/8/PPPP1PPP/RNBQKBNR b KQkq - 0 1,e5,38,35,-3,1
rnbqkbnr/pppp1ppp/8/4p3/4P3/8/PPPP1PPP/RNBQKBNR w KQkq - 0 2,Bc4,35,3,-32,1
rnbqkbnr/pppp1ppp/8/4p3/2B1P3/8/PPPP1PPP/RNBQK1NR b KQkq - 1 2,Nf6,1,0,-1,1
rnbqkb1r/pppp1ppp/5n2/4p3/2B1P3/8/PPPP1PPP/RNBQK1NR w KQkq - 2 3,d4,13,-36,-49,1
rnbqkb1r/pppp1ppp/5n2/4p3/2BPP3/8/PPP2PPP/RNBQK1NR b KQkq - 0 3,Nxe4,-38,88,126,1
rnbqkb1r/pppp1ppp/8/4p3/2BPn3/8/PPP2PPP/RNBQK1NR w KQkq - 0 4,dxe5,95,64,-31,1
rnbqkb1r/pppp1ppp/8/4P3/2B1n3/8/PPP2PPP/RNBQK1NR b KQkq - 0 4,Bc5,62,206,144,1
rnbqk2r/pppp1ppp/8/2b1P3/2B1n3/8/PPP2PPP/RNBQK1NR w KQkq - 1 5,Qd5,240,208,-32,1
rnbqk2r/pppp1ppp/8/2bQP3/2B1n3/8/PPP2PPP/RNB1K1NR b KQkq - 2 5,Bxf2+,180,344,164,1
rnbqk2r/pppp1ppp/8/3QP3/2B1n3/8/PPP2bPP/RNB1K1NR w KQkq - 0 6,Kf1,314,334,20,1
rnbqk2r/pppp1ppp/8/3QP3/2B1n3/8/PPP2bPP/RNB2KNR b kq - 1 6,Qh4,353,422,69,1
rnb1k2r/pppp1ppp/8/3QP3/2B1n2q/8/PPP2bPP/RNB2KNR w kq - 2 7,Qxf7+,429,409,-20,1
rnb1k2r/pppp1Qpp/8/4P3/2B1n2q/8/PPP2bPP/RNB2KNR b kq - 0 7,Kd8,454,452,-2,1
rnbk3r/pppp1Qpp/8/4P3/2B1n2q/8/PPP2bPP/RNB2KNR w - - 1 8,Nf3,432,418,-14,1
rnbk3r/pppp1Qpp/8/4P3/2B1n2q/5N2/PPP2bPP/RNB2K1R b - - 2 8,Ng3+,399,406,7,1
rnbk3r/pppp1Qpp/8/4P3/2B4q/5Nn1/PPP2bPP/RNB2K1R w - - 3 9,hxg3,507,391,-116,0
rnbk3r/pppp1Qpp/8/4P3/2B4q/5NP1/PPP2bP1/RNB2K1R b - - 0 9,Qxh1+,354,432,78,1
rnbk3r/pppp1Qpp/8/4P3/2B5/5NP1/PPP2bP1/RNB2K1q w - - 0 10,Kxf2,413,457,44,1
rnbk3r/pppp1Qpp/8/4P3/2B5/5NP1/PPP2KP1/RNB4q b - - 0 10,Nc6,450,9998,9548,1
r1bk3r/pppp1Qpp/2n5/4P3/2B5/5NP1/PPP2KP1/RNB4q w - - 1 11,Bg5+,9998,9999,1,1
r1bk3r/pppp1Qpp/2n5/4P1B1/2B5/5NP1/PPP2KP1/RN5q b - - 2 11,Ne7,9999,9999,0,1
r1bk3r/ppppnQpp/8/4P1B1/2B5/5NP1/PPP2KP1/RN5q w - - 3 12,Qxe7#,9999,10000,1,1
rnbqkbnr/pppppppp/8/8/8/8/PPPPPPPP/RNBQKBNR w KQkq - 0 1,e4,38,30,-8,1
rnbqkbnr/pppppppp/8/8/4P3/8/PPPP1PPP/RNBQKBNR b KQkq - 0 1,e5,29,26,-3,1
rnbqkbnr/pppp1ppp/8/4p3/4P3/8/PPPP1PPP/RNBQKBNR w KQkq - 0 2,Nf3,32,21,-11,1
rnbqkbnr/pppp1ppp/8/4p3/4P3/5N2/PPPP1PPP/RNBQKB1R b KQkq - 1 2,d5,43,80,37,1
rnbqkbnr/ppp2ppp/8/3pp3/4P3/5N2/PPPP1PPP/RNBQKB1R w KQkq - 0 3,exd5,102,84,-18,1
rnbqkbnr/ppp2ppp/8/3Pp3/8/5N2/PPPP1PPP/RNBQKB1R b KQkq - 0 3,e4,83,83,0,1
rnbqkbnr/ppp2ppp/8/3P4/4p3/5N2/PPPP1PPP/RNBQKB1R w KQkq - 0 4,Nd4,101,-13,-114,0
rnbqkbnr/ppp2ppp/8/3P4/3Np3/8/PPPP1PPP/RNBQKB1R b KQkq - 1 4,f5,-24,213,237,1
rnbqkbnr/ppp3pp/8/3P1p2/3Np3/8/PPPP1PPP/RNBQKB1R w KQkq - 0 5,Nb3,197,47,-150,0
rnbqkbnr/ppp3pp/8/3P1p2/4p3/1N6/PPPP1PPP/RNBQKB1R b KQkq - 1 5,Nf6,39,60,21,1
rnbqkb1r/ppp3pp/5n2/3P1p2/4p3/1N6/PPPP1PPP/RNBQKB1R w KQkq - 2 6,d3,40,41,1,1
rnbqkb1r/ppp3pp/5n2/3P1p2/4p3/1N1P4/PPP2PPP/RNBQKB1R b KQkq - 0 6,Bd6,42,84,42,1
rnbqk2r/ppp3pp/3b1n2/3P1p2/4p3/1N1P4/PPP2PPP/RNBQKB1R w KQkq - 1 7,dxe4,78,84,6,1
rnbqk2r/ppp3pp/3b1n2/3P1p2/4P3/1N6/PPP2PPP/RNBQKB1R b KQkq - 0 7,Nxe4,92,93,1,1
rnbqk2r/ppp3pp/3b4/3P1p2/4n3/1N6/PPP2PPP/RNBQKB1R w KQkq - 0 8,Bd3,98,61,-37,1
rnbqk2r/ppp3pp/3b4/3P1p2/4n3/1N1B4/PPP2PPP/RNBQK2R b KQkq - 1 8,O-O,89,78,-11,1
rnbq1rk1/ppp3pp/3b4/3P1p2/4n3/1N1B4/PPP2PPP/RNBQK2R w KQ - 2 9,Bxe4,68,34,-34,1
rnbq1rk1/ppp3pp/3b4/3P1p2/4B3/1N6/PPP2PPP/RNBQK2R b KQ - 0 9,fxe4,30,33,3,1
rnbq1rk1/ppp3pp/3b4/3P4/4p3/1N6/PPP2PPP/RNBQK2R w KQ - 0 10,O-O,26,-208,-234,0
rnbq1rk1/ppp3pp/3b4/3P4/4p3/1N6/PPP2PPP/RNBQ1RK1 b - - 1 10,Qh4,-217,-237,-20,1
rnb2rk1/ppp3pp/3b4/3P4/4p2q/1N6/PPP2PPP/RNBQ1RK1 w - - 2 11,g3,-252,-241,11,1
rnb2rk1/ppp3pp/3b4/3P4/4p2q/1N4P1/PPP2P1P/RNBQ1RK1 b - - 0 11,Qh3,-243,-221,22,1
rnb2rk1/ppp3pp/3b4/3P4/4p3/1N4Pq/PPP2P1P/RNBQ1RK1 w - - 1 12,Qe2,-254,-255,-1,1
rnb2rk1/ppp3pp/3b4/3P4/4p3/1N4Pq/PPP1QP1P/RNB2RK1 b - - 2 12,Bg4,-283,-243,40,1
rn3rk1/ppp3pp/3b4/3P4/4p1b1/1N4Pq/PPP1QP1P/RNB2RK1 w - - 3 13,Qxe4,-249,-245,4,1
rn3rk1/ppp3pp/3b4/3P4/4Q1b1/1N4Pq/PPP2P1P/RNB2RK1 b - - 0 13,Bf3,-290,40,330,1
rn3rk1/ppp3pp/3b4/3P4/4Q3/1N3bPq/PPP2P1P/RNB2RK1 w - - 1 14,Qe6+,44,47,3,1
rn3rk1/ppp3pp/3bQ3/3P4/8/1N3bPq/PPP2P1P/RNB2RK1 b - - 2 14,Qxe6,54,62,8,1
rn3rk1/ppp3pp/3bq3/3P4/8/1N3bP1/PPP2P1P/RNB2RK1 w - - 0 15,dxe6,64,48,-16,1
rn3rk1/ppp3pp/3bP3/8/8/1N3bP1/PPP2P1P/RNB2RK1 b - - 0 15,Nc6,41,45,4,1
r4rk1/ppp3pp/2nbP3/8/8/1N3bP1/PPP2P1P/RNB2RK1 w - - 1 16,Nc3,41,50,9,1
r4rk1/ppp3pp/2nbP3/8/8/1NN2bP1/PPP2P1P/R1B2RK1 b - - 2 16,Rae8,31,38,7,1
4rrk1/ppp3pp/2nbP3/8/8/1NN2bP1/PPP2P1P/R1B2RK1 w - - 3 17,Be3,42,4,-38,1
4rrk1/ppp3pp/2nbP3/8/8/1NN1BbP1/PPP2P1P/R4RK1 b - - 4 17,Rxe6,11,20,9,1
5rk1/ppp3pp/2nbr3/8/8/1NN1BbP1/PPP2P1P/R4RK1 w - - 0 18,Rfe1,20,12,-8,1
5rk1/ppp3pp/2nbr3/8/8/1NN1BbP1/PPP2P1P/R3R1K1 b - - 1 18,Ref6,9,70,61,1
5rk1/ppp3pp/2nb1r2/8/8/1NN1BbP1/PPP2P1P/R3R1K1 w - - 2 19,Nd4,66,27,-39,1
5rk1/ppp3pp/2nb1r2/8/3N4/2N1BbP1/PPP2P1P/R3R1K1 b - - 3 19,Ne5,47,80,33,1
5rk1/ppp3pp/3b1r2/4n3/3N4/2N1BbP1/PPP2P1P/R3R1K1 w - - 4 20,Bf4,73,-116,-189,0
5rk1/ppp3pp/3b1r2/4n3/3N1B2/2N2bP1/PPP2P1P/R3R1K1 b - - 5 20,c5,-69,105,174,1
5rk1/pp4pp/3b1r2/2p1n3/3N1B2/2N2bP1/PPP2P1P/R3R1K1 w - - 0 21,Bxe5,98,23,-75,1
5rk1/pp4pp/3b1r2/2p1B3/3N4/2N2bP1/PPP2P1P/R3R1K1 b - - 0 21,Bxe5,27,56,29,1
5rk1/pp4pp/5r2/2p1b3/3N4/2N2bP1/PPP2P1P/R3R1K1 w - - 0 22,Nxf3,18,5,-13,1
5rk1/pp4pp/5r2/2p1b3/8/2N2NP1/PPP2P1P/R3R1K1 b - - 0 22,Bxc3,0,14,14,1
5rk1/pp4pp/5r2/2p5/8/2b2NP1/PPP2P1P/R3R1K1 w - - 0 23,bxc3,10,6,-4,1
5rk1/pp4pp/5r2/2p5/8/2P2NP1/P1P2P1P/R3R1K1 b - - 0 23,Rxf3,0,0,0,1
5rk1/pp4pp/8/2p5/8/2P2rP1/P1P2P1P/R3R1K1 w - - 0 24,Re7,0,0,0,1
5rk1/pp2R1pp/8/2p5/8/2P2rP1/P1P2P1P/R5K1 b - - 1 24,Rxf2,0,0,0,1
5rk1/pp2R1pp/8/2p5/8/2P3P1/P1P2r1P/R5K1 w - - 0 25,Rxb7,0,-5,-5,1
5rk1/pR4pp/8/2p5/8/2P3P1/P1P2r1P/R5K1 b - - 0 25,Rxc2,-16,-11,5,1
5rk1/pR4pp/8/2p5/8/2P3P1/P1r4P/R5K1 w - - 0 26,Re1,-14,-55,-41,1
5rk1/pR4pp/8/2p5/8/2P3P1/P1r4P/4R1K1 b - - 1 26,Rcf2,-44,147,191,1
5rk1/pR4pp/8/2p5/8/2P3P1/P4r1P/4R1K1 w - - 2 27,Ree7,90,40,-50,1
5rk1/pR2R1pp/8/2p5/8/2P3P1/P4r1P/6K1 b - - 3 27,R2f7,25,17,-8,1
5rk1/pR2Rrpp/8/2p5/8/2P3P1/P6P/6K1 w - - 4 28,Rxa7,16,-18,-34,1
5rk1/R3Rrpp/8/2p5/8/2P3P1/P6P/6K1 b - - 0 28,Rxe7,-6,-7,-1,1
5rk1/R3r1pp/8/2p5/8/2P3P1/P6P/6K1 w - - 0 29,Rxe7,-8,-10,-2,1
5rk1/4R1pp/8/2p5/8/2P3P1/P6P/6K1 b - - 0 29,Ra8,-11,11,22,1
r5k1/4R1pp/8/2p5/8/2P3P1/P6P/6K1 w - - 1 30,Re5,22,20,-2,1
r5k1/6pp/8/2p1R3/8/2P3P1/P6P/6K1 b - - 2 30,Ra5,10,15,5,1
6k1/6pp/8/r1p1R3/8/2P3P1/P6P/6K1 w - - 3 31,Rxc5,10,-660,-670,0
6k1/6pp/8/r1R5/8/2P3P1/P6P/6K1 b - - 0 31,Rxc5,-695,-651,44,1
6k1/6pp/8/2r5/8/2P3P1/P6P/6K1 w - - 0 32,Kf2,-650,-643,7,1
6k1/6pp/8/2r5/8/2P3P1/P4K1P/8 b - - 1 32,Rxc3,-672,-552,120,1
6k1/6pp/8/8/8/2r3P1/P4K1P/8 w - - 0 33,Ke2,-556,-589,-33,1
6k1/6pp/8/8/8/2r3P1/P3K2P/8 b - - 1 33,Ra3,-585,-577,8,1
6k1/6pp/8/8/8/r5P1/P3K2P/8 w - - 2 34,Kd2,-596,-608,-12,1
6k1/6pp/8/8/8/r5P1/P2K3P/8 b - - 3 34,Rxa2+,-644,-612,32,1
6k1/6pp/8/8/8/6P1/r2K3P/8 w - - 0 35,Kd3,-616,-612,4,1
6k1/6pp/8/8/8/3K2P1/r6P/8 b - - 1 35,Rxh2,-615,-620,-5,1
6k1/6pp/8/8/8/3K2P1/7r/8 w - - 0 36,Ke4,-603,-614,-11,1
6k1/6pp/8/8/4K3/6P1/7r/8 b - - 1 36,Rh3,-628,-582,46,1
6k1/6pp/8/8/4K3/6Pr/8/8 w - - 2 37,Kf4,-582,-614,-32,1
6k1/6pp/8/8/5K2/6Pr/8/8 b - - 3 37,g5+,-619,-567,52,1
6k1/7p/8/6p1/5K2/6Pr/8/8 w - - 0 38,Kg4,-532,-571,-39,1
6k1/7p/8/6p1/6K1/6Pr/8/8 b - - 1 38,Rh1,-659,-518,141,1
6k1/7p/8/6p1/6K1/6P1/8/7r w - - 2 39,Kxg5,-520,-523,-3,1
6k1/7p/8/6K1/8/6P1/8/7r b - - 0 39,Ra1,-512,-533,-21,1
6k1/7p/8/6K1/8/6P1/8/r7 w - - 1 40,Kg4,-477,-500,-23,1
6k1/7p/8/8/6K1/6P1/8/r7 b - - 2 40,Ra5,-513,-515,-2,1
6k1/7p/8/r7/6K1/6P1/8/8 w - - 3 41,Kh3,-489,-512,-23,1
6k1/7p/8/r7/8/6PK/8/8 b - - 4 41,Kg7,-538,-572,-34,1
8/6kp/8/r7/8/6PK/8/8 w - - 5 42,Kg2,-566,-629,-63,1
8/6kp/8/r7/8/6P1/6K1/8 b - - 6 42,Kg6,-630,-641,-11,1
8/7p/6k1/r7/8/6P1/6K1/8 w - - 7 43,Kf3,-656,-672,-16,1
8/7p/6k1/r7/8/5KP1/8/8 b - - 8 43,Kg5,-662,-679,-17,1
8/7p/8/r5k1/8/5KP1/8/8 w - - 9 44,Ke4,-684,-744,-60,1
8/7p/8/r5k1/4K3/6P1/8/8 b - - 10 44,h5,-731,-870,-139,0
8/8/8/r5kp/4K3/6P1/8/8 w - - 0 45,Kd3,-902,-958,-56,1
8/8/8/r5kp/8/3K2P1/8/8 b - - 1 45,h4,-969,-540,429,1
rnbqkbnr/pppppppp/8/8/8/8/PPPPPPPP/RNBQKBNR w KQkq - 0 1,e4,33,30,-3,1
rnbqkbnr/pppppppp/8/8/4P3/8/PPPP1PPP/RNBQKBNR b KQkq - 0 1,e5,28,36,8,1
rnbqkbnr/pppp1ppp/8/4p3/4P3/8/PPPP1PPP/RNBQKBNR w KQkq - 0 2,d3,38,5,-33,1
rnbqkbnr/pppp1ppp/8/4p3/4P3/3P4/PPP2PPP/RNBQKBNR b KQkq - 0 2,Nc6,-7,1,8,1
r1bqkbnr/pppp1ppp/2n5/4p3/4P3/3P4/PPP2PPP/RNBQKBNR w KQkq - 1 3,Nf3,-7,-20,-13,1
r1bqkbnr/pppp1ppp/2n5/4p3/4P3/3P1N2/PPP2PPP/RNBQKB1R b KQkq - 2 3,Nf6,-12,-14,-2,1
r1bqkb1r/pppp1ppp/2n2n2/4p3/4P3/3P1N2/PPP2PPP/RNBQKB1R w KQkq - 3 4,Nc3,-13,-34,-21,1
r1bqkb1r/pppp1ppp/2n2n2/4p3/4P3/2NP1N2/PPP2PPP/R1BQKB1R b KQkq - 4 4,Bb4,-29,-22,7,1
r1bqk2r/pppp1ppp/2n2n2/4p3/1b2P3/2NP1N2/PPP2PPP/R1BQKB1R w KQkq - 5 5,Bg5,-25,-41,-16,1
r1bqk2r/pppp1ppp/2n2n2/4p1B1/1b2P3/2NP1N2/PPP2PPP/R2QKB1R b KQkq - 6 5,d6,-34,-16,18,1
r1bqk2r/ppp2ppp/2np1n2/4p1B1/1b2P3/2NP1N2/PPP2PPP/R2QKB1R w KQkq - 0 6,Bxf6,-23,-54,-31,1
r1bqk2r/ppp2ppp/2np1B2/4p3/1b2P3/2NP1N2/PPP2PPP/R2QKB1R b KQkq - 0 6,Qxf6,-60,-55,5,1
r1b1k2r/ppp2ppp/2np1q2/4p3/1b2P3/2NP1N2/PPP2PPP/R2QKB1R w KQkq - 0 7,Be2,-64,-68,-4,1
r1b1k2r/ppp2ppp/2np1q2/4p3/1b2P3/2NP1N2/PPP1BPPP/R2QK2R b KQkq - 1 7,h6,-82,-21,61,1
r1b1k2r/ppp2pp1/2np1q1p/4p3/1b2P3/2NP1N2/PPP1BPPP/R2QK2R w KQkq - 0 8,Qd2,-27,-71,-44,1
r1b1k2r/ppp2pp1/2np1q1p/4p3/1b2P3/2NP1N2/PPPQBPPP/R3K2R b KQkq - 1 8,Be6,-76,-81,-5,1
r3k2r/ppp2pp1/2npbq1p/4p3/1b2P3/2NP1N2/PPPQBPPP/R3K2R w KQkq - 2 9,a3,-71,-76,-5,1
r3k2r/ppp2pp1/2npbq1p/4p3/1b2P3/P1NP1N2/1PPQBPPP/R3K2R b KQkq - 0 9,Ba5,-79,-31,48,1
r3k2r/ppp2pp1/2npbq1p/b3p3/4P3/P1NP1N2/1PPQBPPP/R3K2R w KQkq - 1 10,b4,-40,-41,-1,1
r3k2r/ppp2pp1/2npbq1p/b3p3/1P2P3/P1NP1N2/2PQBPPP/R3K2R b KQkq - 0 10,Bb6,-41,-36,5,1
r3k2r/ppp2pp1/1bnpbq1p/4p3/1P2P3/P1NP1N2/2PQBPPP/R3K2R w KQkq - 1 11,b5,-31,-167,-136,0
r3k2r/ppp2pp1/1bnpbq1p/1P2p3/4P3/P1NP1N2/2PQBPPP/R3K2R b KQkq - 0 11,Ne7,-150,-69,81,1
r3k2r/ppp1npp1/1b1pbq1p/1P2p3/4P3/P1NP1N2/2PQBPPP/R3K2R w KQkq - 1 12,Na4,-88,-93,-5,1
r3k2r/ppp1npp1/1b1pbq1p/1P2p3/N3P3/P2P1N2/2PQBPPP/R3K2R b KQkq - 2 12,a6,-92,-5,87,1
r3k2r/1pp1npp1/pb1pbq1p/1P2p3/N3P3/P2P1N2/2PQBPPP/R3K2R w KQkq - 0 13,Nxb6,-7,-7,0,1
r3k2r/1pp1npp1/pN1pbq1p/1P2p3/4P3/P2P1N2/2PQBPPP/R3K2R b KQkq - 0 13,cxb6,-15,-12,3,1
r3k2r/1p2npp1/pp1pbq1p/1P2p3/4P3/P2P1N2/2PQBPPP/R3K2R w KQkq - 0 14,bxa6,-2,-25,-23,1
r3k2r/1p2npp1/Pp1pbq1p/4p3/4P3/P2P1N2/2PQBPPP/R3K2R b KQkq - 0 14,bxa6,-15,-11,4,1
r3k2r/4npp1/pp1pbq1p/4p3/4P3/P2P1N2/2PQBPPP/R3K2R w KQkq - 0 15,O-O,-5,-12,-7,1
r3k2r/4npp1/pp1pbq1p/4p3/4P3/P2P1N2/2PQBPPP/R4RK1 b kq - 1 15,b5,2,8,6,1
r3k2r/4npp1/p2pbq1p/1p2p3/4P3/P2P1N2/2PQBPPP/R4RK1 w kq - 0 16,d4,11,-1,-12,1
r3k2r/4npp1/p2pbq1p/1p2p3/3PP3/P4N2/2PQBPPP/R4RK1 b kq - 0 16,exd4,-3,54,57,1
r3k2r/4npp1/p2pbq1p/1p6/3pP3/P4N2/2PQBPPP/R4RK1 w kq - 0 17,Qxd4,52,25,-27,1
r3k2r/4npp1/p2pbq1p/1p6/3QP3/P4N2/2P1BPPP/R4RK1 b kq - 0 17,Nc6,17,29,12,1
r3k2r/5pp1/p1npbq1p/1p6/3QP3/P4N2/2P1BPPP/R4RK1 w kq - 1 18,Qxf6,55,22,-33,1
r3k2r/5pp1/p1npbQ1p/1p6/4P3/P4N2/2P1BPPP/R4RK1 b kq - 0 18,gxf6,20,23,3,1
r3k2r/5p2/p1npbp1p/1p6/4P3/P4N2/2P1BPPP/R4RK1 w kq - 0 19,Rfe1,29,2,-27,1
r3k2r/5p2/p1npbp1p/1p6/4P3/P4N2/2P1BPPP/R3R1K1 b kq - 1 19,O-O,0,32,32,1
r4rk1/5p2/p1npbp1p/1p6/4P3/P4N2/2P1BPPP/R3R1K1 w - - 2 20,c3,36,-2,-38,1
r4rk1/5p2/p1npbp1p/1p6/4P3/P1P2N2/4BPPP/R3R1K1 b - - 0 20,Kh7,5,23,18,1
r4r2/5p1k/p1npbp1p/1p6/4P3/P1P2N2/4BPPP/R3R1K1 w - - 1 21,Nd4,18,-5,-23,1
r4r2/5p1k/p1npbp1p/1p6/3NP3/P1P5/4BPPP/R3R1K1 b - - 2 21,Nxd4,-10,-6,4,1
r4r2/5p1k/p2pbp1p/1p6/3nP3/P1P5/4BPPP/R3R1K1 w - - 0 22,cxd4,-4,-17,-13,1
r4r2/5p1k/p2pbp1p/1p6/3PP3/P7/4BPPP/R3R1K1 b - - 0 22,f5,-11,0,11,1
r4r2/5p1k/p2pb2p/1p3p2/3PP3/P7/4BPPP/R3R1K1 w - - 0 23,d5,0,-23,-23,1
r4r2/5p1k/p2pb2p/1p1P1p2/4P3/P7/4BPPP/R3R1K1 b - - 0 23,Bd7,-4,-10,-6,1
r4r2/3b1p1k/p2p3p/1p1P1p2/4P3/P7/4BPPP/R3R1K1 w - - 1 24,Bd3,-8,-49,-41,1
r4r2/3b1p1k/p2p3p/1p1P1p2/4P3/P2B4/5PPP/R3R1K1 b - - 2 24,fxe4,-61,-58,3,1
r4r2/3b1p1k/p2p3p/1p1P4/4p3/P2B4/5PPP/R3R1K1 w - - 0 25,Bxe4+,-83,-79,4,1
r4r2/3b1p1k/p2p3p/1p1P4/4B3/P7/5PPP/R3R1K1 b - - 0 25,Kg7,-79,-83,-4,1
r4r2/3b1pk1/p2p3p/1p1P4/4B3/P7/5PPP/R3R1K1 w - - 1 26,Re2,-60,-136,-76,1
r4r2/3b1pk1/p2p3p/1p1P4/4B3/P7/4RPPP/R5K1 b - - 2 26,Rae8,-126,-46,80,1
4rr2/3b1pk1/p2p3p/1p1P4/4B3/P7/4RPPP/R5K1 w - - 3 27,Re3,-59,-104,-45,1
4rr2/3b1pk1/p2p3p/1p1P4/4B3/P3R3/5PPP/R5K1 b - - 4 27,Re5,-96,-52,44,1
5r2/3b1pk1/p2p3p/1p1Pr3/4B3/P3R3/5PPP/R5K1 w - - 5 28,Rae1,-47,-148,-101,0
5r2/3b1pk1/p2p3p/1p1Pr3/4B3/P3R3/5PPP/4R1K1 b - - 6 28,Rfe8,-99,-47,52,1
4r3/3b1pk1/p2p3p/1p1Pr3/4B3/P3R3/5PPP/4R1K1 w - - 7 29,Rg3+,-23,-128,-105,0
4r3/3b1pk1/p2p3p/1p1Pr3/4B3/P5R1/5PPP/4R1K1 b - - 8 29,Kf8,-140,-99,41,1
4rk2/3b1p2/p2p3p/1p1Pr3/4B3/P5R1/5PPP/4R1K1 w - - 9 30,Ree3,-99,-583,-484,0
4rk2/3b1p2/p2p3p/1p1Pr3/4B3/P3R1R1/5PPP/6K1 b - - 10 30,Ke7,-568,416,984,1
4r3/3bkp2/p2p3p/1p1Pr3/4B3/P3R1R1/5PPP/6K1 w - - 11 31,f3,417,-357,-774,0
4r3/3bkp2/p2p3p/1p1Pr3/4B3/P3RPR1/6PP/6K1 b - - 0 31,Kd8,-322,-181,141,1
3kr3/3b1p2/p2p3p/1p1Pr3/4B3/P3RPR1/6PP/6K1 w - - 1 32,Kf2,-219,-323,-104,0
3kr3/3b1p2/p2p3p/1p1Pr3/4B3/P3RPR1/5KPP/8 b - - 2 32,Kc7,-308,-2,306,1
4r3/2kb1p2/p2p3p/1p1Pr3/4B3/P3RPR1/5KPP/8 w - - 3 33,h4,25,-91,-116,0
4r3/2kb1p2/p2p3p/1p1Pr3/4B2P/P3RPR1/5KP1/8 b - - 0 33,Kb6,-99,17,116,1
4r3/3b1p2/pk1p3p/1p1Pr3/4B2P/P3RPR1/5KP1/8 w - - 1 34,f4,25,-516,-541,0
4r3/3b1p2/pk1p3p/1p1Pr3/4BP1P/P3R1R1/5KP1/8 b - - 0 34,R5e7,-450,-91,359,1
4r3/3brp2/pk1p3p/1p1P4/4BP1P/P3R1R1/5KP1/8 w - - 1 35,Kf3,-90,-448,-358,0
4r3/3brp2/pk1p3p/1p1P4/4BP1P/P3RKR1/6P1/8 b - - 2 35,f5,-460,-351,109,1
4r3/3br3/pk1p3p/1p1P1p2/4BP1P/P3RKR1/6P1/8 w - - 0 36,a4,-396,-520,-124,0
4r3/3br3/pk1p3p/1p1P1p2/P3BP1P/4RKR1/6P1/8 b - - 0 36,Rxe4,-553,-502,51,1
4r3/3b4/pk1p3p/1p1P1p2/P3rP1P/4RKR1/6P1/8 w - - 0 37,Rxe4,-553,-581,-28,1
4r3/3b4/pk1p3p/1p1P1p2/P3RP1P/5KR1/6P1/8 b - - 0 37,fxe4+,-596,-575,21,1
4r3/3b4/pk1p3p/1p1P4/P3pP1P/5KR1/6P1/8 w - - 0 38,Ke3,-616,-641,-25,1
4r3/3b4/pk1p3p/1p1P4/P3pP1P/4K1R1/6P1/8 b - - 1 38,Bf5,-614,-412,202,1
4r3/8/pk1p3p/1p1P1b2/P3pP1P/4K1R1/6P1/8 w - - 2 39,Rg7,-467,-425,42,1
4r3/6R1/pk1p3p/1p1P1b2/P3pP1P/4K3/6P1/8 b - - 3 39,Bh7,-462,-142,320,1
4r3/6Rb/pk1p3p/1p1P4/P3pP1P/4K3/6P1/8 w - - 4 40,Rxh7,-138,-179,-41,1
4r3/7R/pk1p3p/1p1P4/P3pP1P/4K3/6P1/8 b - - 0 40,Re5,-191,591,782,1
8/7R/pk1p3p/1p1Pr3/P3pP1P/4K3/6P1/8 w - - 1 41,Rxh6,663,138,-525,0
8/8/pk1p3R/1p1Pr3/P3pP1P/4K3/6P1/8 b - - 0 41,Re8,132,348,216,1
4r3/8/pk1p3R/1p1P4/P3pP1P/4K3/6P1/8 w - - 1 42,Rxd6+,359,360,1,1
4r3/8/pk1R4/1p1P4/P3pP1P/4K3/6P1/8 b - - 0 42,Kc5,393,390,-3,1
4r3/8/p2R4/1pkP4/P3pP1P/4K3/6P1/8 w - - 1 43,Rf6,383,315,-68,1
4r3/8/p4R2/1pkP4/P3pP1P/4K3/6P1/8 b - - 2 43,Kb4,337,512,175,1
4r3/8/p4R2/1p1P4/Pk2pP1P/4K3/6P1/8 w - - 3 44,Ke2,473,322,-151,0
4r3/8/p4R2/1p1P4/Pk2pP1P/8/4K1P1/8 b - - 4 44,Kc4,323,353,30,1
4r3/8/p4R2/1p1P4/P1k1pP1P/8/4K1P1/8 w - - 5 45,Rc6+,369,289,-80,1
4r3/8/p1R5/1p1P4/P1k1pP1P/8/4K1P1/8 b - - 6 45,Kxd5,285,198,-87,1
4r3/8/p1R5/1p1k4/P3pP1P/8/4K1P1/8 w - - 0 46,Rd6+,230,-574,-804,0
4r3/8/p2R4/1p1k4/P3pP1P/8/4K1P1/8 b - - 1 46,Kxd6,-556,-576,-20,1
4r3/8/p2k4/1p6/P3pP1P/8/4K1P1/8 w - - 0 47,Ke3,-609,-628,-19,1
4r3/8/p2k4/1p6/P3pP1P/4K3/6P1/8 b - - 1 47,Kd5,-666,-567,99,1
4r3/8/p7/1p1k4/P3pP1P/4K3/6P1/8 w - - 2 48,g4,-610,-734,-124,0
4r3/8/p7/1p1k4/P3pPPP/4K3/8/8 b - - 0 48,Kc5,-781,-571,210,1
4r3/8/p7/1pk5/P3pPPP/4K3/8/8 w - - 1 49,h5,-554,-605,-51,1
4r3/8/p7/1pk4P/P3pPP1/4K3/8/8 b - - 0 49,Kc4,-631,-522,109,1
4r3/8/p7/1p5P/P1k1pPP1/4K3/8/8 w - - 1 50,g5,-506,-605,-99,1
4r3/8/p7/1p4PP/P1k1pP2/4K3/8/8 b - - 0 50,Kd5,-613,-458,155,1
4r3/8/p7/1p1k2PP/P3pP2/4K3/8/8 w - - 1 51,h6,-519,-473,46,1
4r3/8/p6P/1p1k2P1/P3pP2/4K3/8/8 b - - 0 51,Ke6,-538,-362,176,1
4r3/8/p3k2P/1p4P1/P3pP2/4K3/8/8 w - - 1 52,g6,-422,-565,-143,0
rnbqkbnr/pppppppp/8/8/8/8/PPPPPPPP/RNBQKBNR w KQkq - 0 1,e4,39,38,-1,1
rnbqkbnr/pppppppp/8/8/4P3/8/PPPP1PPP/RNBQKBNR b KQkq - 0 1,d6,39,48,9,1
rnbqkbnr/ppp1pppp/3p4/8/4P3/8/PPPP1PPP/RNBQKBNR w KQkq - 0 2,d4,52,50,-2,1
rnbqkbnr/ppp1pppp/3p4/8/3PP3/8/PPP2PPP/RNBQKBNR b KQkq - 0 2,e6,49,91,42,1
rnbqkbnr/ppp2ppp/3pp3/8/3PP3/8/PPP2PPP/RNBQKBNR w KQkq - 0 3,d5,97,31,-66,1
rnbqkbnr/ppp2ppp/3pp3/3P4/4P3/8/PPP2PPP/RNBQKBNR b KQkq - 0 3,exd5,29,35,6,1
rnbqkbnr/ppp2ppp/3p4/3p4/4P3/8/PPP2PPP/RNBQKBNR w KQkq - 0 4,exd5,43,18,-25,1
rnbqkbnr/ppp2ppp/3p4/3P4/8/8/PPP2PPP/RNBQKBNR b KQkq - 0 4,Nf6,9,35,26,1
rnbqkb1r/ppp2ppp/3p1n2/3P4/8/8/PPP2PPP/RNBQKBNR w KQkq - 1 5,c4,40,0,-40,1
rnbqkb1r/ppp2ppp/3p1n2/3P4/2P5/8/PP3PPP/RNBQKBNR b KQkq - 0 5,c6,-10,40,50,1
rnbqkb1r/pp3ppp/2pp1n2/3P4/2P5/8/PP3PPP/RNBQKBNR w KQkq - 0 6,Nf3,55,53,-2,1
rnbqkb1r/pp3ppp/2pp1n2/3P4/2P5/5N2/PP3PPP/RNBQKB1R b KQkq - 1 6,cxd5,45,57,12,1
rnbqkb1r/pp3ppp/3p1n2/3p4/2P5/5N2/PP3PPP/RNBQKB1R w KQkq - 0 7,cxd5,56,24,-32,1
rnbqkb1r/pp3ppp/3p1n2/3P4/8/5N2/PP3PPP/RNBQKB1R b KQkq - 0 7,Be7,37,40,3,1
rnbqk2r/pp2bppp/3p1n2/3P4/8/5N2/PP3PPP/RNBQKB1R w KQkq - 1 8,Nc3,40,58,18,1
rnbqk2r/pp2bppp/3p1n2/3P4/8/2N2N2/PP3PPP/R1BQKB1R b KQkq - 2 8,O-O,57,49,-8,1
rnbq1rk1/pp2bppp/3p1n2/3P4/8/2N2N2/PP3PPP/R1BQKB1R w KQ - 3 9,Qd4,48,11,-37,1
rnbq1rk1/pp2bppp/3p1n2/3P4/3Q4/2N2N2/PP3PPP/R1B1KB1R b KQ - 4 9,Nfd7,3,50,47,1
rnbq1rk1/pp1nbppp/3p4/3P4/3Q4/2N2N2/PP3PPP/R1B1KB1R w KQ - 5 10,b3,31,-76,-107,0
rnbq1rk1/pp1nbppp/3p4/3P4/3Q4/1PN2N2/P4PPP/R1B1KB1R b KQ - 0 10,Nb6,-45,9,54,1
rnbq1rk1/pp2bppp/1n1p4/3P4/3Q4/1PN2N2/P4PPP/R1B1KB1R w KQ - 1 11,Bb2,12,9,-3,1
rnbq1rk1/pp2bppp/1n1p4/3P4/3Q4/1PN2N2/PB3PPP/R3KB1R b KQ - 2 11,f6,-13,115,128,1
rnbq1rk1/pp2b1pp/1n1p1p2/3P4/3Q4/1PN2N2/PB3PPP/R3KB1R w KQ - 0 12,Qg4,119,-603,-722,0
rnbq1rk1/pp2b1pp/1n1p1p2/3P4/6Q1/1PN2N2/PB3PPP/R3KB1R b KQ - 1 12,Bxg4,-660,-644,16,1
rnbqkbnr/pppppppp/8/8/8/8/PPPPPPPP/RNBQKBNR w KQkq - 0 1,e4,40,28,-12,1
rnbqkbnr/pppppppp/8/8/4P3/8/PPPP1PPP/RNBQKBNR b KQkq - 0 1,d5,23,50,27,1
rnbqkbnr/ppp1pppp/8/3p4/4P3/8/PPPP1PPP/RNBQKBNR w KQkq - 0 2,e5,48,-3,-51,1
rnbqkbnr/ppp1pppp/8/3pP3/8/8/PPPP1PPP/RNBQKBNR b KQkq - 0 2,Nc6,-5,50,55,1
r1bqkbnr/ppp1pppp/2n5/3pP3/8/8/PPPP1PPP/RNBQKBNR w KQkq - 1 3,d4,39,38,-1,1
r1bqkbnr/ppp1pppp/2n5/3pP3/3P4/8/PPP2PPP/RNBQKBNR b KQkq - 0 3,f6,35,54,19,1
r1bqkbnr/ppp1p1pp/2n2p2/3pP3/3P4/8/PPP2PPP/RNBQKBNR w KQkq - 0 4,exf6,50,-12,-62,1
r1bqkbnr/ppp1p1pp/2n2P2/3p4/3P4/8/PPP2PPP/RNBQKBNR b KQkq - 0 4,Nxf6,-23,-13,10,1
r1bqkb1r/ppp1p1pp/2n2n2/3p4/3P4/8/PPP2PPP/RNBQKBNR w KQkq - 0 5,Bg5,-1,-63,-62,1
r1bqkb1r/ppp1p1pp/2n2n2/3p2B1/3P4/8/PPP2PPP/RN1QKBNR b KQkq - 1 5,Ne4,-57,-58,-1,1
r1bqkb1r/ppp1p1pp/2n5/3p2B1/3Pn3/8/PPP2PPP/RN1QKBNR w KQkq - 2 6,Be3,-51,-63,-12,1
r1bqkb1r/ppp1p1pp/2n5/3p4/3Pn3/4B3/PPP2PPP/RN1QKBNR b KQkq - 3 6,h5,-67,48,115,1
r1bqkb1r/ppp1p1p1/2n5/3p3p/3Pn3/4B3/PPP2PPP/RN1QKBNR w KQkq - 0 7,Nc3,60,-45,-105,0
r1bqkb1r/ppp1p1p1/2n5/3p3p/3Pn3/2N1B3/PPP2PPP/R2QKBNR b KQkq - 1 7,Qd6,-30,69,99,1
r1b1kb1r/ppp1p1p1/2nq4/3p3p/3Pn3/2N1B3/PPP2PPP/R2QKBNR w KQkq - 2 8,Nxe4,58,67,9,1
r1b1kb1r/ppp1p1p1/2nq4/3p3p/3PN3/4B3/PPP2PPP/R2QKBNR b KQkq - 0 8,dxe4,63,73,10,1
r1b1kb1r/ppp1p1p1/2nq4/7p/3Pp3/4B3/PPP2PPP/R2QKBNR w KQkq - 0 9,Qd2,67,55,-12,1
r1b1kb1r/ppp1p1p1/2nq4/7p/3Pp3/4B3/PPPQ1PPP/R3KBNR b KQkq - 1 9,Bg4,53,81,28,1
r3kb1r/ppp1p1p1/2nq4/7p/3Pp1b1/4B3/PPPQ1PPP/R3KBNR w KQkq - 2 10,f3,58,-30,-88,1
r3kb1r/ppp1p1p1/2nq4/7p/3Pp1b1/4BP2/PPPQ2PP/R3KBNR b KQkq - 0 10,exf3,-28,56,84,1
r3kb1r/ppp1p1p1/2nq4/7p/3P2b1/4Bp2/PPPQ2PP/R3KBNR w KQkq - 0 11,Nxf3,46,8,-38,1
r3kb1r/ppp1p1p1/2nq4/7p/3P2b1/4BN2/PPPQ2PP/R3KB1R b KQkq - 0 11,Bxf3,-14,56,70,1
r3kb1r/ppp1p1p1/2nq4/7p/3P4/4Bb2/PPPQ2PP/R3KB1R w KQkq - 0 12,gxf3,81,80,-1,1
r3kb1r/ppp1p1p1/2nq4/7p/3P4/4BP2/PPPQ3P/R3KB1R b KQkq - 0 12,e5,66,124,58,1
r3kb1r/ppp3p1/2nq4/4p2p/3P4/4BP2/PPPQ3P/R3KB1R w KQkq - 0 13,O-O-O,139,55,-84,1
r3kb1r/ppp3p1/2nq4/4p2p/3P4/4BP2/PPPQ3P/2KR1B1R b kq - 1 13,exd4,48,84,36,1
r3kb1r/ppp3p1/2nq4/7p/3p4/4BP2/PPPQ3P/2KR1B1R w kq - 0 14,Bxd4,73,-19,-92,1
r3kb1r/ppp3p1/2nq4/7p/3B4/5P2/PPPQ3P/2KR1B1R b kq - 0 14,Nxd4,-12,184,196,1
r3kb1r/ppp3p1/3q4/7p/3n4/5P2/PPPQ3P/2KR1B1R w kq - 0 15,Qxd4,148,-5,-153,0
r3kb1r/ppp3p1/3q4/7p/3Q4/5P2/PPP4P/2KR1B1R b kq - 0 15,Qxd4,-14,-4,10,1
r3kb1r/ppp3p1/8/7p/3q4/5P2/PPP4P/2KR1B1R w kq - 0 16,Rxd4,1,-1,-2,1
r3kb1r/ppp3p1/8/7p/3R4/5P2/PPP4P/2K2B1R b kq - 0 16,a5,-5,98,103,1
r3kb1r/1pp3p1/8/p6p/3R4/5P2/PPP4P/2K2B1R w kq - 0 17,Bc4,117,-3,-120,0
r3kb1r/1pp3p1/8/p6p/2BR4/5P2/PPP4P/2K4R b kq - 1 17,Bc5,-6,513,519,1
r3k2r/1pp3p1/8/p1b4p/2BR4/5P2/PPP4P/2K4R w kq - 2 18,Re1+,490,490,0,1
r3k2r/1pp3p1/8/p1b4p/2BR4/5P2/PPP4P/2K1R3 b kq - 3 18,Kf8,514,9999,9485,1
r4k1r/1pp3p1/8/p1b4p/2BR4/5P2/PPP4P/2K1R3 w - - 4 19,Rf4#,9999,10000,1,1
rnbqkbnr/pppppppp/8/8/8/8/PPPPPPPP/RNBQKBNR w KQkq - 0 1,Nf3,26,8,-18,1
rnbqkbnr/pppppppp/8/8/8/5N2/PPPPPPPP/RNBQKB1R b KQkq - 1 1,d5,12,15,3,1
rnbqkbnr/ppp1pppp/8/3p4/8/5N2/PPPPPPPP/RNBQKB1R w KQkq - 0 2,g3,15,7,-8,1
rnbqkbnr/ppp1pppp/8/3p4/8/5NP1/PPPPPP1P/RNBQKB1R b KQkq - 0 2,Bg4,10,41,31,1
rn1qkbnr/ppp1pppp/8/3p4/6b1/5NP1/PPPPPP1P/RNBQKB1R w KQkq - 1 3,Bg2,43,27,-16,1
rn1qkbnr/ppp1pppp/8/3p4/6b1/5NP1/PPPPPPBP/RNBQK2R b KQkq - 2 3,Nd7,23,39,16,1
r2qkbnr/pppnpppp/8/3p4/6b1/5NP1/PPPPPPBP/RNBQK2R w KQkq - 3 4,c4,38,22,-16,1
r2qkbnr/pppnpppp/8/3p4/2P3b1/5NP1/PP1PPPBP/RNBQK2R b KQkq - 0 4,c6,20,53,33,1
r2qkbnr/pp1npppp/2p5/3p4/2P3b1/5NP1/PP1PPPBP/RNBQK2R w KQkq - 0 5,b3,52,3,-49,1
r2qkbnr/pp1npppp/2p5/3p4/2P3b1/1P3NP1/P2PPPBP/RNBQK2R b KQkq - 0 5,Ngf6,-7,-18,-11,1
r2qkb1r/pp1npppp/2p2n2/3p4/2P3b1/1P3NP1/P2PPPBP/RNBQK2R w KQkq - 1 6,Bb2,-27,-22,5,1
r2qkb1r/pp1npppp/2p2n2/3p4/2P3b1/1P3NP1/PB1PPPBP/RN1QK2R b KQkq - 2 6,e6,-28,-26,2,1
r2qkb1r/pp1n1ppp/2p1pn2/3p4/2P3b1/1P3NP1/PB1PPPBP/RN1QK2R w KQkq - 0 7,O-O,-24,-22,2,1
r2qkb1r/pp1n1ppp/2p1pn2/3p4/2P3b1/1P3NP1/PB1PPPBP/RN1Q1RK1 b kq - 1 7,Bd6,-21,-20,1,1
r2qk2r/pp1n1ppp/2pbpn2/3p4/2P3b1/1P3NP1/PB1PPPBP/RN1Q1RK1 w kq - 2 8,d3,-14,-20,-6,1
r2qk2r/pp1n1ppp/2pbpn2/3p4/2P3b1/1P1P1NP1/PB2PPBP/RN1Q1RK1 b kq - 0 8,O-O,-21,-24,-3,1
r2q1rk1/pp1n1ppp/2pbpn2/3p4/2P3b1/1P1P1NP1/PB2PPBP/RN1Q1RK1 w - - 1 9,Nbd2,-16,6,22,1
r2q1rk1/pp1n1ppp/2pbpn2/3p4/2P3b1/1P1P1NP1/PB1NPPBP/R2Q1RK1 b - - 2 9,Qe7,7,26,19,1
r4rk1/pp1nqppp/2pbpn2/3p4/2P3b1/1P1P1NP1/PB1NPPBP/R2Q1RK1 w - - 3 10,Re1,27,12,-15,1
r4rk1/pp1nqppp/2pbpn2/3p4/2P3b1/1P1P1NP1/PB1NPPBP/R2QR1K1 b - - 4 10,e5,7,0,-7,1
r4rk1/pp1nqppp/2pb1n2/3pp3/2P3b1/1P1P1NP1/PB1NPPBP/R2QR1K1 w - - 0 11,cxd5,30,-19,-49,1
r4rk1/pp1nqppp/2pb1n2/3Pp3/6b1/1P1P1NP1/PB1NPPBP/R2QR1K1 b - - 0 11,cxd5,-7,1,8,1
r4rk1/pp1nqppp/3b1n2/3pp3/6b1/1P1P1NP1/PB1NPPBP/R2QR1K1 w - - 0 12,Rc1,-10,-42,-32,1
r4rk1/pp1nqppp/3b1n2/3pp3/6b1/1P1P1NP1/PB1NPPBP/2RQR1K1 b - - 1 12,Rfc8,-32,-5,27,1
r1r3k1/pp1nqppp/3b1n2/3pp3/6b1/1P1P1NP1/PB1NPPBP/2RQR1K1 w - - 2 13,Rxc8+,-1,-22,-21,1
r1R3k1/pp1nqppp/3b1n2/3pp3/6b1/1P1P1NP1/PB1NPPBP/3QR1K1 b - - 0 13,Rxc8,-6,-15,-9,1
2r3k1/pp1nqppp/3b1n2/3pp3/6b1/1P1P1NP1/PB1NPPBP/3QR1K1 w - - 0 14,Qa1,-21,-112,-91,1
2r3k1/pp1nqppp/3b1n2/3pp3/6b1/1P1P1NP1/PB1NPPBP/Q3R1K1 b - - 1 14,b5,-99,9,108,1
2r3k1/p2nqppp/3b1n2/1p1pp3/6b1/1P1P1NP1/PB1NPPBP/Q3R1K1 w - - 0 15,a4,15,-95,-110,0
2r3k1/p2nqppp/3b1n2/1p1pp3/P5b1/1P1P1NP1/1B1NPPBP/Q3R1K1 b - - 0 15,a6,-107,14,121,1
2r3k1/3nqppp/p2b1n2/1p1pp3/P5b1/1P1P1NP1/1B1NPPBP/Q3R1K1 w - - 0 16,axb5,11,7,-4,1
2r3k1/3nqppp/p2b1n2/1P1pp3/6b1/1P1P1NP1/1B1NPPBP/Q3R1K1 b - - 0 16,axb5,-1,2,3,1
2r3k1/3nqppp/3b1n2/1p1pp3/6b1/1P1P1NP1/1B1NPPBP/Q3R1K1 w - - 0 17,Qa5,6,-256,-262,0
2r3k1/3nqppp/3b1n2/Qp1pp3/6b1/1P1P1NP1/1B1NPPBP/4R1K1 b - - 1 17,e4,-232,-279,-47,1
2r3k1/3nqppp/3b1n2/Qp1p4/4p1b1/1P1P1NP1/1B1NPPBP/4R1K1 w - - 0 18,dxe4,-280,-250,30,1
2r3k1/3nqppp/3b1n2/Qp1p4/4P1b1/1P3NP1/1B1NPPBP/4R1K1 b - - 0 18,dxe4,-259,-262,-3,1
2r3k1/3nqppp/3b1n2/Qp6/4p1b1/1P3NP1/1B1NPPBP/4R1K1 w - - 0 19,Nd4,-263,-288,-25,1
2r3k1/3nqppp/3b1n2/Qp6/3Np1b1/1P4P1/1B1NPPBP/4R1K1 b - - 1 19,e3,-281,-252,29,1
2r3k1/3nqppp/3b1n2/Qp6/3N2b1/1P2p1P1/1B1NPPBP/4R1K1 w - - 0 20,N2f3,-258,-317,-59,1
2r3k1/3nqppp/3b1n2/Qp6/3N2b1/1P2pNP1/1B2PPBP/4R1K1 b - - 1 20,exf2+,-277,-228,49,1
2r3k1/3nqppp/3b1n2/Qp6/3N2b1/1P3NP1/1B2PpBP/4R1K1 w - - 0 21,Kxf2,-252,-237,15,1
2r3k1/3nqppp/3b1n2/Qp6/3N2b1/1P3NP1/1B2PKBP/4R3 b - - 0 21,Bc5,-298,-55,243,1
2r3k1/3nqppp/5n2/Qpb5/3N2b1/1P3NP1/1B2PKBP/4R3 w - - 1 22,Qxb5,-68,-68,0,1
2r3k1/3nqppp/5n2/1Qb5/3N2b1/1P3NP1/1B2PKBP/4R3 b - - 0 22,Bxf3,-73,-33,40,1
2r3k1/3nqppp/5n2/1Qb5/3N4/1P3bP1/1B2PKBP/4R3 w - - 0 23,Bxf3,-27,-26,1,1
2r3k1/3nqppp/5n2/1Qb5/3N4/1P3BP1/1B2PK1P/4R3 b - - 0 23,Ne4+,-17,289,306,1
2r3k1/3nqppp/8/1Qb5/3Nn3/1P3BP1/1B2PK1P/4R3 w - - 1 24,Kg2,281,116,-165,0
2r3k1/3nqppp/8/1Qb5/3Nn3/1P3BP1/1B2P1KP/4R3 b - - 2 24,Rb8,112,109,-3,1
1r4k1/3nqppp/8/1Qb5/3Nn3/1P3BP1/1B2P1KP/4R3 w - - 3 25,Qc4,121,64,-57,1
1r4k1/3nqppp/8/2b5/2QNn3/1P3BP1/1B2P1KP/4R3 b - - 4 25,Ne5,65,137,72,1
1r4k1/4qppp/8/2b1n3/2QNn3/1P3BP1/1B2P1KP/4R3 w - - 5 26,Nc6,143,24,-119,0
1r4k1/4qppp/2N5/2b1n3/2Q1n3/1P3BP1/1B2P1KP/4R3 b - - 6 26,Nxc6,30,63,33,1
1r4k1/4qppp/2n5/2b5/2Q1n3/1P3BP1/1B2P1KP/4R3 w - - 0 27,Qxe4,25,18,-7,1
1r4k1/4qppp/2n5/2b5/4Q3/1P3BP1/1B2P1KP/4R3 b - - 0 27,Qxe4,16,16,0,1
1r4k1/5ppp/2n5/2b5/4q3/1P3BP1/1B2P1KP/4R3 w - - 0 28,Bxe4,20,15,-5,1
1r4k1/5ppp/2n5/2b5/4B3/1P4P1/1B2P1KP/4R3 b - - 0 28,Nd4,18,87,69,1
1r4k1/5ppp/8/2b5/3nB3/1P4P1/1B2P1KP/4R3 w - - 1 29,e3,132,18,-114,0
1r4k1/5ppp/8/2b5/3nB3/1P2P1P1/1B4KP/4R3 b - - 0 29,Nxb3,24,29,5,1
1r4k1/5ppp/8/2b5/4B3/1n2P1P1/1B4KP/4R3 w - - 0 30,Be5,36,-8,-44,1
1r4k1/5ppp/8/2b1B3/4B3/1n2P1P1/6KP/4R3 b - - 1 30,Re8,-3,-4,-1,1
4r1k1/5ppp/8/2b1B3/4B3/1n2P1P1/6KP/4R3 w - - 2 31,Bd5,-12,-6,6,1
4r1k1/5ppp/8/2bBB3/8/1n2P1P1/6KP/4R3 b - - 3 31,Rxe5,-4,-3,1,1
6k1/5ppp/8/2bBr3/8/1n2P1P1/6KP/4R3 w - - 0 32,Bxb3,-5,-6,-1,1
6k1/5ppp/8/2b1r3/8/1B2P1P1/6KP/4R3 b - - 0 32,Rxe3,-4,0,4,1
6k1/5ppp/8/2b5/8/1B2r1P1/6KP/4R3 w - - 0 33,Rd1,4,-456,-460,0
6k1/5ppp/8/2b5/8/1B2r1P1/6KP/3R4 b - - 1 33,Bf8,-495,-20,475,1
5bk1/5ppp/8/8/8/1B2r1P1/6KP/3R4 w - - 2 34,Bd5,-17,-16,1,1
5bk1/5ppp/8/3B4/8/4r1P1/6KP/3R4 b - - 3 34,Re2+,-13,-16,-3,1
5bk1/5ppp/8/3B4/8/6P1/4r1KP/3R4 w - - 4 35,Kh3,-9,-9,0,1
rnbqkbnr/pppppppp/8/8/8/8/PPPPPPPP/RNBQKBNR w KQkq - 0 1,e4,35,23,-12,1
rnbqkbnr/pppppppp/8/8/4P3/8/PPPP1PPP/RNBQKBNR b KQkq - 0 1,e5,36,24,-12,1
rnbqkbnr/pppp1ppp/8/4p3/4P3/8/PPPP1PPP/RNBQKBNR w KQkq - 0 2,Nf3,37,40,3,1
rnbqkbnr/pppp1ppp/8/4p3/4P3/5N2/PPPP1PPP/RNBQKB1R b KQkq - 1 2,Nc6,32,30,-2,1
r1bqkbnr/pppp1ppp/2n5/4p3/4P3/5N2/PPPP1PPP/RNBQKB1R w KQkq - 2 3,d4,34,26,-8,1
r1bqkbnr/pppp1ppp/2n5/4p3/3PP3/5N2/PPP2PPP/RNBQKB1R b KQkq - 0 3,exd4,23,41,18,1
r1bqkbnr/pppp1ppp/2n5/8/3pP3/5N2/PPP2PPP/RNBQKB1R w KQkq - 0 4,Nxd4,27,27,0,1
r1bqkbnr/pppp1ppp/2n5/8/3NP3/8/PPP2PPP/RNBQKB1R b KQkq - 0 4,Nxd4,19,103,84,1
r1bqkbnr/pppp1ppp/8/8/3nP3/8/PPP2PPP/RNBQKB1R w KQkq - 0 5,Qxd4,127,84,-43,1
r1bqkbnr/pppp1ppp/8/8/3QP3/8/PPP2PPP/RNB1KB1R b KQkq - 0 5,Nf6,89,137,48,1
r1bqkb1r/pppp1ppp/5n2/8/3QP3/8/PPP2PPP/RNB1KB1R w KQkq - 1 6,Be3,138,48,-90,1
r1bqkb1r/pppp1ppp/5n2/8/3QP3/4B3/PPP2PPP/RN2KB1R b KQkq - 2 6,Be7,26,170,144,1
r1bqk2r/ppppbppp/5n2/8/3QP3/4B3/PPP2PPP/RN2KB1R w KQkq - 3 7,Nc3,171,117,-54,1
r1bqk2r/ppppbppp/5n2/8/3QP3/2N1B3/PPP2PPP/R3KB1R b KQkq - 4 7,O-O,105,129,24,1
r1bq1rk1/ppppbppp/5n2/8/3QP3/2N1B3/PPP2PPP/R3KB1R w KQ - 5 8,O-O-O,107,95,-12,1
r1bq1rk1/ppppbppp/5n2/8/3QP3/2N1B3/PPP2PPP/2KR1B1R b - - 6 8,a5,88,159,71,1
r1bq1rk1/1pppbppp/5n2/p7/3QP3/2N1B3/PPP2PPP/2KR1B1R w - - 0 9,f3,156,163,7,1
r1bq1rk1/1pppbppp/5n2/p7/3QP3/2N1BP2/PPP3PP/2KR1B1R b - - 0 9,c6,173,191,18,1
r1bq1rk1/1p1pbppp/2p2n2/p7/3QP3/2N1BP2/PPP3PP/2KR1B1R w - - 0 10,g4,178,137,-41,1
r1bq1rk1/1p1pbppp/2p2n2/p7/3QP1P1/2N1BP2/PPP4P/2KR1B1R b - - 0 10,b5,106,210,104,1
r1bq1rk1/3pbppp/2p2n2/pp6/3QP1P1/2N1BP2/PPP4P/2KR1B1R w - - 0 11,g5,182,127,-55,1
r1bq1rk1/3pbppp/2p2n2/pp4P1/3QP3/2N1BP2/PPP4P/2KR1B1R b - - 0 11,Ne8,112,117,5,1
r1bqnrk1/3pbppp/2p5/pp4P1/3QP3/2N1BP2/PPP4P/2KR1B1R w - - 1 12,h4,100,110,10,1
r1bqnrk1/3pbppp/2p5/pp4P1/3QP2P/2N1BP2/PPP5/2KR1B1R b - - 0 12,b4,107,204,97,1
r1bqnrk1/3pbppp/2p5/p5P1/1p1QP2P/2N1BP2/PPP5/2KR1B1R w - - 0 13,Na4,209,195,-14,1
r1bqnrk1/3pbppp/2p5/p5P1/Np1QP2P/4BP2/PPP5/2KR1B1R b - - 1 13,c5,194,269,75,1
r1bqnrk1/3pbppp/8/p1p3P1/Np1QP2P/4BP2/PPP5/2KR1B1R w - - 0 14,Nxc5,286,284,-2,1
r1bqnrk1/3pbppp/8/p1N3P1/1p1QP2P/4BP2/PPP5/2KR1B1R b - - 0 14,Bxc5,270,347,77,1
r1bqnrk1/3p1ppp/8/p1b3P1/1p1QP2P/4BP2/PPP5/2KR1B1R w - - 0 15,Qxc5,365,370,5,1
r1bqnrk1/3p1ppp/8/p1Q3P1/1p2P2P/4BP2/PPP5/2KR1B1R b - - 0 15,d6,370,354,-16,1
r1bqnrk1/5ppp/3p4/p1Q3P1/1p2P2P/4BP2/PPP5/2KR1B1R w - - 0 16,Bf4,339,259,-80,1
r1bqnrk1/5ppp/3p4/p1Q3P1/1p2PB1P/5P2/PPP5/2KR1B1R b - - 1 16,Qe7,226,360,134,1
r1b1nrk1/4qppp/3p4/p1Q3P1/1p2PB1P/5P2/PPP5/2KR1B1R w - - 2 17,Bxd6,339,271,-68,1
r1b1nrk1/4qppp/3B4/p1Q3P1/1p2P2P/5P2/PPP5/2KR1B1R b - - 0 17,Nxd6,298,322,24,1
r1b2rk1/4qppp/3n4/p1Q3P1/1p2P2P/5P2/PPP5/2KR1B1R w - - 0 18,Qxd6,315,335,20,1
r1b2rk1/4qppp/3Q4/p5P1/1p2P2P/5P2/PPP5/2KR1B1R b - - 0 18,Qxd6,314,360,46,1
r1b2rk1/5ppp/3q4/p5P1/1p2P2P/5P2/PPP5/2KR1B1R w - - 0 19,Rxd6,364,344,-20,1
r1b2rk1/5ppp/3R4/p5P1/1p2P2P/5P2/PPP5/2K2B1R b - - 0 19,Be6,306,364,58,1
r4rk1/5ppp/3Rb3/p5P1/1p2P2P/5P2/PPP5/2K2B1R w - - 1 20,Kb1,347,311,-36,1
r4rk1/5ppp/3Rb3/p5P1/1p2P2P/5P2/PPP5/1K3B1R b - - 2 20,a4,323,315,-8,1
r4rk1/5ppp/3Rb3/6P1/pp2P2P/5P2/PPP5/1K3B1R w - - 0 21,Be2,320,315,-5,1
r4rk1/5ppp/3Rb3/6P1/pp2P2P/5P2/PPP1B3/1K5R b - - 1 21,b3,282,297,15,1
r4rk1/5ppp/3Rb3/6P1/p3P2P/1p3P2/PPP1B3/1K5R w - - 0 22,cxb3,317,332,15,1
r4rk1/5ppp/3Rb3/6P1/p3P2P/1P3P2/PP2B3/1K5R b - - 0 22,axb3,305,318,13,1
r4rk1/5ppp/3Rb3/6P1/4P2P/1p3P2/PP2B3/1K5R w - - 0 23,a3,299,331,32,1
r4rk1/5ppp/3Rb3/6P1/4P2P/Pp3P2/1P2B3/1K5R b - - 0 23,g6,318,313,-5,1
r4rk1/5p1p/3Rb1p1/6P1/4P2P/Pp3P2/1P2B3/1K5R w - - 0 24,Rc1,308,317,9,1
r4rk1/5p1p/3Rb1p1/6P1/4P2P/Pp3P2/1P2B3/1KR5 b - - 1 24,Rfd8,335,358,23,1
r2r2k1/5p1p/3Rb1p1/6P1/4P2P/Pp3P2/1P2B3/1KR5 w - - 2 25,Rxd8+,377,359,-18,1
r2R2k1/5p1p/4b1p1/6P1/4P2P/Pp3P2/1P2B3/1KR5 b - - 0 25,Rxd8,389,346,-43,1
3r2k1/5p1p/4b1p1/6P1/4P2P/Pp3P2/1P2B3/1KR5 w - - 0 26,Rd1,334,347,13,1
3r2k1/5p1p/4b1p1/6P1/4P2P/Pp3P2/1P2B3/1K1R4 b - - 1 26,Rc8,367,393,26,1
2r3k1/5p1p/4b1p1/6P1/4P2P/Pp3P2/1P2B3/1K1R4 w - - 2 27,Bd3,410,279,-131,0
2r3k1/5p1p/4b1p1/6P1/4P2P/Pp1B1P2/1P6/1K1R4 b - - 3 27,Kf8,317,376,59,1
2r2k2/5p1p/4b1p1/6P1/4P2P/Pp1B1P2/1P6/1K1R4 w - - 4 28,f4,348,287,-61,1
2r2k2/5p1p/4b1p1/6P1/4PP1P/Pp1B4/1P6/1K1R4 b - - 0 28,Rd8,316,303,-13,1
3r1k2/5p1p/4b1p1/6P1/4PP1P/Pp1B4/1P6/1K1R4 w - - 1 29,Be2,349,370,21,1
3r1k2/5p1p/4b1p1/6P1/4PP1P/Pp6/1P2B3/1K1R4 b - - 2 29,Rxd1+,338,516,178,1
5k2/5p1p/4b1p1/6P1/4PP1P/Pp6/1P2B3/1K1r4 w - - 0 30,Bxd1,510,492,-18,1
5k2/5p1p/4b1p1/6P1/4PP1P/Pp6/1P6/1K1B4 b - - 0 30,Bc4,516,558,42,1
5k2/5p1p/6p1/6P1/2b1PP1P/Pp6/1P6/1K1B4 w - - 1 31,Bf3,577,458,-119,0
5k2/5p1p/6p1/6P1/2b1PP1P/Pp3B2/1P6/1K6 b - - 2 31,Ke7,501,518,17,1
8/4kp1p/6p1/6P1/2b1PP1P/Pp3B2/1P6/1K6 w - - 3 32,Kc1,508,520,12,1
8/4kp1p/6p1/6P1/2b1PP1P/Pp3B2/1P6/2K5 b - - 4 32,Kd6,497,521,24,1
8/5p1p/3k2p1/6P1/2b1PP1P/Pp3B2/1P6/2K5 w - - 5 33,Kd2,542,520,-22,1
8/5p1p/3k2p1/6P1/2b1PP1P/Pp3B2/1P1K4/8 b - - 6 33,Kc5,577,584,7,1
8/5p1p/6p1/2k3P1/2b1PP1P/Pp3B2/1P1K4/8 w - - 7 34,Kc3,590,612,22,1
8/5p1p/6p1/2k3P1/2b1PP1P/PpK2B2/1P6/8 b - - 8 34,Be6,610,612,2,1
8/5p1p/4b1p1/2k3P1/4PP1P/PpK2B2/1P6/8 w - - 9 35,Bd1,602,594,-8,1
8/5p1p/4b1p1/2k3P1/4PP1P/PpK5/1P6/3B4 b - - 10 35,Bc4,608,598,-10,1
8/5p1p/6p1/2k3P1/2b1PP1P/PpK5/1P6/3B4 w - - 11 36,Bxb3,621,597,-24,1
8/5p1p/6p1/2k3P1/2b1PP1P/PBK5/1P6/8 b - - 0 36,Bxb3,603,599,-4,1
8/5p1p/6p1/2k3P1/4PP1P/PbK5/1P6/8 w - - 0 37,Kxb3,591,597,6,1
8/5p1p/6p1/2k3P1/4PP1P/PK6/1P6/8 b - - 0 37,Kd4,602,615,13,1
8/5p1p/6p1/6P1/3kPP1P/PK6/1P6/8 w - - 1 38,a4,636,585,-51,1
8/5p1p/6p1/6P1/P2kPP1P/1K6/1P6/8 b - - 0 38,Kc5,611,632,21,1
8/5p1p/6p1/2k3P1/P3PP1P/1K6/1P6/8 w - - 1 39,Kc3,634,625,-9,1
rnbqkbnr/pppppppp/8/8/8/8/PPPPPPPP/RNBQKBNR w KQkq - 0 1,e4,35,31,-4,1
rnbqkbnr/pppppppp/8/8/4P3/8/PPPP1PPP/RNBQKBNR b KQkq - 0 1,c6,21,75,54,1
rnbqkbnr/pp1ppppp/2p5/8/4P3/8/PPPP1PPP/RNBQKBNR w KQkq - 0 2,Nf3,71,32,-39,1
rnbqkbnr/pp1ppppp/2p5/8/4P3/5N2/PPPP1PPP/RNBQKB1R b KQkq - 1 2,d5,38,39,1,1
rnbqkbnr/pp2pppp/2p5/3p4/4P3/5N2/PPPP1PPP/RNBQKB1R w KQkq - 0 3,Nc3,38,23,-15,1
rnbqkbnr/pp2pppp/2p5/3p4/4P3/2N2N2/PPPP1PPP/R1BQKB1R b KQkq - 1 3,dxe4,34,26,-8,1
rnbqkbnr/pp2pppp/2p5/8/4p3/2N2N2/PPPP1PPP/R1BQKB1R w KQkq - 0 4,Nxe4,24,34,10,1
rnbqkbnr/pp2pppp/2p5/8/4N3/5N2/PPPP1PPP/R1BQKB1R b KQkq - 0 4,Bg4,35,37,2,1
rn1qkbnr/pp2pppp/2p5/8/4N1b1/5N2/PPPP1PPP/R1BQKB1R w KQkq - 1 5,Nc3,38,20,-18,1
rn1qkbnr/pp2pppp/2p5/8/6b1/2N2N2/PPPP1PPP/R1BQKB1R b KQkq - 2 5,e6,20,20,0,1
rn1qkbnr/pp3ppp/2p1p3/8/6b1/2N2N2/PPPP1PPP/R1BQKB1R w KQkq - 0 6,Be2,10,10,0,1
rn1qkbnr/pp3ppp/2p1p3/8/6b1/2N2N2/PPPPBPPP/R1BQK2R b KQkq - 1 6,Bd6,9,19,10,1
rn1qk1nr/pp3ppp/2pbp3/8/6b1/2N2N2/PPPPBPPP/R1BQK2R w KQkq - 2 7,d4,21,7,-14,1
rn1qk1nr/pp3ppp/2pbp3/8/3P2b1/2N2N2/PPP1BPPP/R1BQK2R b KQkq - 0 7,Nf6,16,15,-1,1
rn1qk2r/pp3ppp/2pbpn2/8/3P2b1/2N2N2/PPP1BPPP/R1BQK2R w KQkq - 1 8,O-O,24,-2,-26,1
rn1qk2r/pp3ppp/2pbpn2/8/3P2b1/2N2N2/PPP1BPPP/R1BQ1RK1 b kq - 2 8,O-O,-3,13,16,1
rn1q1rk1/pp3ppp/2pbpn2/8/3P2b1/2N2N2/PPP1BPPP/R1BQ1RK1 w - - 3 9,h3,7,7,0,1
rn1q1rk1/pp3ppp/2pbpn2/8/3P2b1/2N2N1P/PPP1BPP1/R1BQ1RK1 b - - 0 9,Bh5,3,16,13,1
rn1q1rk1/pp3ppp/2pbpn2/7b/3P4/2N2N1P/PPP1BPP1/R1BQ1RK1 w - - 1 10,Re1,19,7,-12,1
rn1q1rk1/pp3ppp/2pbpn2/7b/3P4/2N2N1P/PPP1BPP1/R1BQR1K1 b - - 2 10,Nbd7,-8,8,16,1
r2q1rk1/pp1n1ppp/2pbpn2/7b/3P4/2N2N1P/PPP1BPP1/R1BQR1K1 w - - 3 11,Qd3,8,-22,-30,1
r2q1rk1/pp1n1ppp/2pbpn2/7b/3P4/2NQ1N1P/PPP1BPP1/R1B1R1K1 b - - 4 11,Qc7,-18,-21,-3,1
r4rk1/ppqn1ppp/2pbpn2/7b/3P4/2NQ1N1P/PPP1BPP1/R1B1R1K1 w - - 5 12,g3,-10,-249,-239,0
r4rk1/ppqn1ppp/2pbpn2/7b/3P4/2NQ1NPP/PPP1BP2/R1B1R1K1 b - - 0 12,Bxg3,-227,-228,-1,1
r4rk1/ppqn1ppp/2p1pn2/7b/3P4/2NQ1NbP/PPP1BP2/R1B1R1K1 w - - 0 13,Ng5,-230,-291,-61,1
r4rk1/ppqn1ppp/2p1pn2/6Nb/3P4/2NQ2bP/PPP1BP2/R1B1R1K1 b - - 1 13,Bxe2,-284,-178,106,1
r4rk1/ppqn1ppp/2p1pn2/6N1/3P4/2NQ2bP/PPP1bP2/R1B1R1K1 w - - 0 14,Qxg3,-183,-176,7,1
r4rk1/ppqn1ppp/2p1pn2/6N1/3P4/2N3QP/PPP1bP2/R1B1R1K1 b - - 0 14,Qxg3+,-183,-203,-20,1
r4rk1/pp1n1ppp/2p1pn2/6N1/3P4/2N3qP/PPP1bP2/R1B1R1K1 w - - 0 15,fxg3,-181,-193,-12,1
r4rk1/pp1n1ppp/2p1pn2/6N1/3P4/2N3PP/PPP1b3/R1B1R1K1 b - - 0 15,Bh5,-194,-186,8,1
r4rk1/pp1n1ppp/2p1pn2/6Nb/3P4/2N3PP/PPP5/R1B1R1K1 w - - 1 16,g4,-182,-177,5,1
r4rk1/pp1n1ppp/2p1pn2/6Nb/3P2P1/2N4P/PPP5/R1B1R1K1 b - - 0 16,Bg6,-201,-196,5,1
r4rk1/pp1n1ppp/2p1pnb1/6N1/3P2P1/2N4P/PPP5/R1B1R1K1 w - - 1 17,Re2,-230,-253,-23,1
r4rk1/pp1n1ppp/2p1pnb1/6N1/3P2P1/2N4P/PPP1R3/R1B3K1 b - - 2 17,h6,-252,-179,73,1
r4rk1/pp1n1pp1/2p1pnbp/6N1/3P2P1/2N4P/PPP1R3/R1B3K1 w - - 0 18,Nge4,-209,-212,-3,1
r4rk1/pp1n1pp1/2p1pnbp/8/3PN1P1/2N4P/PPP1R3/R1B3K1 b - - 1 18,Nxe4,-206,-188,18,1
r4rk1/pp1n1pp1/2p1p1bp/8/3Pn1P1/2N4P/PPP1R3/R1B3K1 w - - 0 19,Nxe4,-203,-211,-8,1
r4rk1/pp1n1pp1/2p1p1bp/8/3PN1P1/7P/PPP1R3/R1B3K1 b - - 0 19,Bxe4,-197,-206,-9,1
r4rk1/pp1n1pp1/2p1p2p/8/3Pb1P1/7P/PPP1R3/R1B3K1 w - - 0 20,Rxe4,-195,-186,9,1
r4rk1/pp1n1pp1/2p1p2p/8/3PR1P1/7P/PPP5/R1B3K1 b - - 0 20,Nf6,-195,-191,4,1
r4rk1/pp3pp1/2p1pn1p/8/3PR1P1/7P/PPP5/R1B3K1 w - - 1 21,Re1,-182,-209,-27,1
r4rk1/pp3pp1/2p1pn1p/8/3P2P1/7P/PPP5/R1B1R1K1 b - - 2 21,Rfd8,-206,-206,0,1
r2r2k1/pp3pp1/2p1pn1p/8/3P2P1/7P/PPP5/R1B1R1K1 w - - 3 22,c3,-195,-208,-13,1
r2r2k1/pp3pp1/2p1pn1p/8/3P2P1/2P4P/PP6/R1B1R1K1 b - - 0 22,Rd5,-195,-188,7,1
r5k1/pp3pp1/2p1pn1p/3r4/3P2P1/2P4P/PP6/R1B1R1K1 w - - 1 23,Bf4,-196,-203,-7,1
r5k1/pp3pp1/2p1pn1p/3r4/3P1BP1/2P4P/PP6/R3R1K1 b - - 2 23,Rad8,-202,-191,11,1
3r2k1/pp3pp1/2p1pn1p/3r4/3P1BP1/2P4P/PP6/R3R1K1 w - - 3 24,Rad1,-184,-199,-15,1
3r2k1/pp3pp1/2p1pn1p/3r4/3P1BP1/2P4P/PP6/3RR1K1 b - - 4 24,b6,-216,-180,36,1
3r2k1/p4pp1/1pp1pn1p/3r4/3P1BP1/2P4P/PP6/3RR1K1 w - - 0 25,a3,-192,-204,-12,1
3r2k1/p4pp1/1pp1pn1p/3r4/3P1BP1/P1P4P/1P6/3RR1K1 b - - 0 25,c5,-213,-212,1,1
3r2k1/p4pp1/1p2pn1p/2pr4/3P1BP1/P1P4P/1P6/3RR1K1 w - - 0 26,Be3,-208,-263,-55,1
3r2k1/p4pp1/1p2pn1p/2pr4/3P2P1/P1P1B2P/1P6/3RR1K1 b - - 1 26,cxd4,-285,-196,89,1
3r2k1/p4pp1/1p2pn1p/3r4/3p2P1/P1P1B2P/1P6/3RR1K1 w - - 0 27,cxd4,-211,-311,-100,1
3r2k1/p4pp1/1p2pn1p/3r4/3P2P1/P3B2P/1P6/3RR1K1 b - - 0 27,Ne4,-306,-190,116,1
3r2k1/p4pp1/1p2p2p/3r4/3Pn1P1/P3B2P/1P6/3RR1K1 w - - 1 28,Kg2,-179,-250,-71,1
3r2k1/p4pp1/1p2p2p/3r4/3Pn1P1/P3B2P/1P4K1/3RR3 b - - 2 28,Nc5,-258,-261,-3,1
3r2k1/p4pp1/1p2p2p/2nr4/3P2P1/P3B2P/1P4K1/3RR3 w - - 3 29,Re2,-317,-328,-11,1
3r2k1/p4pp1/1p2p2p/2nr4/3P2P1/P3B2P/1P2R1K1/3R4 b - - 4 29,Nb7,-330,-148,182,1
3r2k1/pn3pp1/1p2p2p/3r4/3P2P1/P3B2P/1P2R1K1/3R4 w - - 5 30,Rc2,-171,-174,-3,1
3r2k1/pn3pp1/1p2p2p/3r4/3P2P1/P3B2P/1PR3K1/3R4 b - - 6 30,R8d7,-185,-150,35,1
6k1/pn1r1pp1/1p2p2p/3r4/3P2P1/P3B2P/1PR3K1/3R4 w - - 7 31,Kf3,-154,-216,-62,1
6k1/pn1r1pp1/1p2p2p/3r4/3P2P1/P3BK1P/1PR5/3R4 b - - 8 31,e5,-226,-26,200,1
6k1/pn1r1pp1/1p5p/3rp3/3P2P1/P3BK1P/1PR5/3R4 w - - 0 32,Rcd2,-29,-43,-14,1
6k1/pn1r1pp1/1p5p/3rp3/3P2P1/P3BK1P/1P1R4/3R4 b - - 1 32,exd4,-35,0,35,1
6k1/pn1r1pp1/1p5p/3r4/3p2P1/P3BK1P/1P1R4/3R4 w - - 0 33,Rxd4,0,0,0,1
6k1/pn1r1pp1/1p5p/3r4/3R2P1/P3BK1P/1P6/3R4 b - - 0 33,Rxd4,0,0,0,1
6k1/pn1r1pp1/1p5p/8/3r2P1/P3BK1P/1P6/3R4 w - - 0 34,Rxd4,0,0,0,1
6k1/pn1r1pp1/1p5p/8/3R2P1/P3BK1P/1P6/8 b - - 0 34,Rxd4,0,0,0,1
6k1/pn3pp1/1p5p/8/3r2P1/P3BK1P/1P6/8 w - - 0 35,Bxd4,0,0,0,1
6k1/pn3pp1/1p5p/8/3B2P1/P4K1P/1P6/8 b - - 0 35,f6,0,-12,-12,1
6k1/pn4p1/1p3p1p/8/3B2P1/P4K1P/1P6/8 w - - 0 36,Ke4,12,-5,-17,1
rnbqkbnr/pppppppp/8/8/8/8/PPPPPPPP/RNBQKBNR w KQkq - 0 1,e4,33,43,10,1
rnbqkbnr/pppppppp/8/8/4P3/8/PPPP1PPP/RNBQKBNR b KQkq - 0 1,c5,43,29,-14,1
rnbqkbnr/pp1ppppp/8/2p5/4P3/8/PPPP1PPP/RNBQKBNR w KQkq - 0 2,c4,30,-7,-37,1
rnbqkbnr/pp1ppppp/8/2p5/2P1P3/8/PP1P1PPP/RNBQKBNR b KQkq - 0 2,e6,-10,13,23,1
rnbqkbnr/pp1p1ppp/4p3/2p5/2P1P3/8/PP1P1PPP/RNBQKBNR w KQkq - 0 3,Nc3,23,-20,-43,1
rnbqkbnr/pp1p1ppp/4p3/2p5/2P1P3/2N5/PP1P1PPP/R1BQKBNR b KQkq - 1 3,a6,-22,67,89,1
rnbqkbnr/1p1p1ppp/p3p3/2p5/2P1P3/2N5/PP1P1PPP/R1BQKBNR w KQkq - 0 4,d3,57,15,-42,1
rnbqkbnr/1p1p1ppp/p3p3/2p5/2P1P3/2NP4/PP3PPP/R1BQKBNR b KQkq - 0 4,b6,23,54,31,1
rnbqkbnr/3p1ppp/pp2p3/2p5/2P1P3/2NP4/PP3PPP/R1BQKBNR w KQkq - 0 5,f4,38,23,-15,1
rnbqkbnr/3p1ppp/pp2p3/2p5/2P1PP2/2NP4/PP4PP/R1BQKBNR b KQkq - 0 5,g6,32,60,28,1
rnbqkbnr/3p1p1p/pp2p1p1/2p5/2P1PP2/2NP4/PP4PP/R1BQKBNR w KQkq - 0 6,Nf3,55,49,-6,1
rnbqkbnr/3p1p1p/pp2p1p1/2p5/2P1PP2/2NP1N2/PP4PP/R1BQKB1R b KQkq - 1 6,Bg7,48,71,23,1
rnbqk1nr/3p1pbp/pp2p1p1/2p5/2P1PP2/2NP1N2/PP4PP/R1BQKB1R w KQkq - 2 7,Be2,73,29,-44,1
rnbqk1nr/3p1pbp/pp2p1p1/2p5/2P1PP2/2NP1N2/PP2B1PP/R1BQK2R b KQkq - 3 7,Ne7,19,37,18,1
rnbqk2r/3pnpbp/pp2p1p1/2p5/2P1PP2/2NP1N2/PP2B1PP/R1BQK2R w KQkq - 4 8,O-O,37,-29,-66,1
rnbqk2r/3pnpbp/pp2p1p1/2p5/2P1PP2/2NP1N2/PP2B1PP/R1BQ1RK1 b kq - 5 8,Bb7,-17,60,77,1
rn1qk2r/1b1pnpbp/pp2p1p1/2p5/2P1PP2/2NP1N2/PP2B1PP/R1BQ1RK1 w kq - 6 9,Be3,53,20,-33,1
rn1qk2r/1b1pnpbp/pp2p1p1/2p5/2P1PP2/2NPBN2/PP2B1PP/R2Q1RK1 b kq - 7 9,d5,14,17,3,1
rn1qk2r/1b2npbp/pp2p1p1/2pp4/2P1PP2/2NPBN2/PP2B1PP/R2Q1RK1 w kq - 0 10,cxd5,11,-55,-66,1
rn1qk2r/1b2npbp/pp2p1p1/2pP4/4PP2/2NPBN2/PP2B1PP/R2Q1RK1 b kq - 0 10,exd5,-7,-4,3,1
rn1qk2r/1b2npbp/pp4p1/2pp4/4PP2/2NPBN2/PP2B1PP/R2Q1RK1 w kq - 0 11,exd5,-2,-2,0,1
rn1qk2r/1b2npbp/pp4p1/2pP4/5P2/2NPBN2/PP2B1PP/R2Q1RK1 b kq - 0 11,Nxd5,2,15,13,1
rn1qk2r/1b3pbp/pp4p1/2pn4/5P2/2NPBN2/PP2B1PP/R2Q1RK1 w kq - 0 12,Nxd5,7,5,-2,1
rn1qk2r/1b3pbp/pp4p1/2pN4/5P2/3PBN2/PP2B1PP/R2Q1RK1 b kq - 0 12,Bxd5,11,40,29,1
rn1qk2r/5pbp/pp4p1/2pb4/5P2/3PBN2/PP2B1PP/R2Q1RK1 w kq - 0 13,d4,39,55,16,1
rn1qk2r/5pbp/pp4p1/2pb4/3P1P2/4BN2/PP2B1PP/R2Q1RK1 b kq - 0 13,O-O,61,51,-10,1
rn1q1rk1/5pbp/pp4p1/2pb4/3P1P2/4BN2/PP2B1PP/R2Q1RK1 w - - 1 14,dxc5,52,79,27,1
rn1q1rk1/5pbp/pp4p1/2Pb4/5P2/4BN2/PP2B1PP/R2Q1RK1 b - - 0 14,bxc5,73,77,4,1
rn1q1rk1/5pbp/p5p1/2pb4/5P2/4BN2/PP2B1PP/R2Q1RK1 w - - 0 15,Bxc5,67,39,-28,1
rn1q1rk1/5pbp/p5p1/2Bb4/5P2/5N2/PP2B1PP/R2Q1RK1 b - - 0 15,Re8,37,74,37,1
rn1qr1k1/5pbp/p5p1/2Bb4/5P2/5N2/PP2B1PP/R2Q1RK1 w - - 1 16,Bd3,69,-52,-121,0
rn1qr1k1/5pbp/p5p1/2Bb4/5P2/3B1N2/PP4PP/R2Q1RK1 b - - 2 16,Nd7,-48,-40,8,1
r2qr1k1/3n1pbp/p5p1/2Bb4/5P2/3B1N2/PP4PP/R2Q1RK1 w - - 3 17,Bd4,-57,-395,-338,0
r2qr1k1/3n1pbp/p5p1/3b4/3B1P2/3B1N2/PP4PP/R2Q1RK1 b - - 4 17,Nf6,-451,-34,417,1
r2qr1k1/5pbp/p4np1/3b4/3B1P2/3B1N2/PP4PP/R2Q1RK1 w - - 5 18,Be5,-29,-94,-65,1
r2qr1k1/5pbp/p4np1/3bB3/5P2/3B1N2/PP4PP/R2Q1RK1 b - - 6 18,Ng4,-133,-87,46,1
r2qr1k1/5pbp/p5p1/3bB3/5Pn1/3B1N2/PP4PP/R2Q1RK1 w - - 7 19,Bxg7,-148,-146,2,1
r2qr1k1/5pBp/p5p1/3b4/5Pn1/3B1N2/PP4PP/R2Q1RK1 b - - 0 19,Ne3,-123,-142,-19,1
r2qr1k1/5pBp/p5p1/3b4/5P2/3BnN2/PP4PP/R2Q1RK1 w - - 1 20,Qd2,-128,-209,-81,1
r2qr1k1/5pBp/p5p1/3b4/5P2/3BnN2/PP1Q2PP/R4RK1 b - - 2 20,Nxf1,-209,-224,-15,1
r2qr1k1/5pBp/p5p1/3b4/5P2/3B1N2/PP1Q2PP/R4nK1 w - - 0 21,Rxf1,-207,-337,-130,0
r2qr1k1/5pBp/p5p1/3b4/5P2/3B1N2/PP1Q2PP/5RK1 b - - 0 21,Kxg7,-352,-332,20,1
r2qr3/5pkp/p5p1/3b4/5P2/3B1N2/PP1Q2PP/5RK1 w - - 0 22,Qc3+,-362,-379,-17,1
r2qr3/5pkp/p5p1/3b4/5P2/2QB1N2/PP4PP/5RK1 b - - 1 22,Kg8,-345,-332,13,1
r2qr1k1/5p1p/p5p1/3b4/5P2/2QB1N2/PP4PP/5RK1 w - - 2 23,Ne5,-312,-346,-34,1
r2qr1k1/5p1p/p5p1/3bN3/5P2/2QB4/PP4PP/5RK1 b - - 3 23,Be6,-331,-85,246,1
r2qr1k1/5p1p/p3b1p1/4N3/5P2/2QB4/PP4PP/5RK1 w - - 4 24,f5,-73,-93,-20,1
r2qr1k1/5p1p/p3b1p1/4NP2/8/2QB4/PP4PP/5RK1 b - - 0 24,gxf5,-68,-81,-13,1
r2qr1k1/5p1p/p3b3/4Np2/8/2QB4/PP4PP/5RK1 w - - 0 25,Bxf5,-55,-68,-13,1
r2qr1k1/5p1p/p3b3/4NB2/8/2Q5/PP4PP/5RK1 b - - 0 25,Bxf5,-70,0,70,1
r2qr1k1/5p1p/p7/4Nb2/8/2Q5/PP4PP/5RK1 w - - 0 26,Rxf5,0,0,0,1
r2qr1k1/5p1p/p7/4NR2/8/2Q5/PP4PP/6K1 b - - 0 26,Qd1+,0,216,216,1
r3r1k1/5p1p/p7/4NR2/8/2Q5/PP4PP/3q2K1 w - - 1 27,Kf2,231,-61,-292,0
r3r1k1/5p1p/p7/4NR2/8/2Q5/PP3KPP/3q4 b - - 2 27,Qd6,-25,431,456,1
r3r1k1/5p1p/p2q4/4NR2/8/2Q5/PP3KPP/8 w - - 3 28,Qg3+,466,471,5,1
r3r1k1/5p1p/p2q4/4NR2/8/6Q1/PP3KPP/8 b - - 4 28,Qg6,458,465,7,1
r3r1k1/5p1p/p5q1/4NR2/8/6Q1/PP3KPP/8 w - - 5 29,Nxg6,480,466,-14,1
r3r1k1/5p1p/p5N1/5R2/8/6Q1/PP3KPP/8 b - - 0 29,hxg6,479,465,-14,1
r3r1k1/5p2/p5p1/5R2/8/6Q1/PP3KPP/8 w - - 0 30,Re5,466,481,15,1
r3r1k1/5p2/p5p1/4R3/8/6Q1/PP3KPP/8 b - - 1 30,Red8,469,481,12,1
r2r2k1/5p2/p5p1/4R3/8/6Q1/PP3KPP/8 w - - 2 31,Qe3,508,454,-54,1
r2r2k1/5p2/p5p1/4R3/8/4Q3/PP3KPP/8 b - - 3 31,Rac8,457,493,36,1
2rr2k1/5p2/p5p1/4R3/8/4Q3/PP3KPP/8 w - - 4 32,Kf3,465,439,-26,1
2rr2k1/5p2/p5p1/4R3/8/4QK2/PP4PP/8 b - - 5 32,Kf8,466,476,10,1
2rr1k2/5p2/p5p1/4R3/8/4QK2/PP4PP/8 w - - 6 33,Qa3+,471,461,-10,1
2rr1k2/5p2/p5p1/4R3/8/Q4K2/PP4PP/8 b - - 7 33,Kg8,460,441,-19,1
2rr2k1/5p2/p5p1/4R3/8/Q4K2/PP4PP/8 w - - 8 34,Qxa6,445,504,59,1
2rr2k1/5p2/Q5p1/4R3/8/5K2/PP4PP/8 b - - 0 34,Rd3+,476,712,236,1
2r3k1/5p2/Q5p1/4R3/8/3r1K2/PP4PP/8 w - - 1 35,Ke4,674,499,-175,0
2r3k1/5p2/Q5p1/4R3/4K3/3r4/PP4PP/8 b - - 2 35,Rcd8,440,719,279,1
3r2k1/5p2/Q5p1/4R3/4K3/3r4/PP4PP/8 w - - 3 36,Re8+,753,526,-227,0
3rR1k1/5p2/Q5p1/8/4K3/3r4/PP4PP/8 b - - 4 36,Kg7,590,580,-10,1
3rR3/5pk1/Q5p1/8/4K3/3r4/PP4PP/8 w - - 5 37,Rxd8,618,583,-35,1
3R4/5pk1/Q5p1/8/4K3/3r4/PP4PP/8 b - - 0 37,Rxd8,578,621,43,1
rnbqkbnr/pppppppp/8/8/8/8/PPPPPPPP/RNBQKBNR w KQkq - 0 1,e4,23,17,-6,1
rnbqkbnr/pppppppp/8/8/4P3/8/PPPP1PPP/RNBQKBNR b KQkq - 0 1,b6,27,96,69,1
rnbqkbnr/p1pppppp/1p6/8/4P3/8/PPPP1PPP/RNBQKBNR w KQkq - 0 2,d4,96,94,-2,1
rnbqkbnr/p1pppppp/1p6/8/3PP3/8/PPP2PPP/RNBQKBNR b KQkq - 0 2,Bb7,102,101,-1,1
rn1qkbnr/pbpppppp/1p6/8/3PP3/8/PPP2PPP/RNBQKBNR w KQkq - 1 3,Nc3,90,92,2,1
rn1qkbnr/pbpppppp/1p6/8/3PP3/2N5/PPP2PPP/R1BQKBNR b KQkq - 2 3,g6,97,145,48,1
rn1qkbnr/pbpppp1p/1p4p1/8/3PP3/2N5/PPP2PPP/R1BQKBNR w KQkq - 0 4,Qf3,142,92,-50,1
rn1qkbnr/pbpppp1p/1p4p1/8/3PP3/2N2Q2/PPP2PPP/R1B1KBNR b KQkq - 1 4,Bg7,69,86,17,1
rn1qk1nr/pbppppbp/1p4p1/8/3PP3/2N2Q2/PPP2PPP/R1B1KBNR w KQkq - 2 5,Be3,74,66,-8,1
rn1qk1nr/pbppppbp/1p4p1/8/3PP3/2N1BQ2/PPP2PPP/R3KBNR b KQkq - 3 5,Nf6,63,65,2,1
rn1qk2r/pbppppbp/1p3np1/8/3PP3/2N1BQ2/PPP2PPP/R3KBNR w KQkq - 4 6,Be2,59,41,-18,1
rn1qk2r/pbppppbp/1p3np1/8/3PP3/2N1BQ2/PPP1BPPP/R3K1NR b KQkq - 5 6,O-O,49,64,15,1
rn1q1rk1/pbppppbp/1p3np1/8/3PP3/2N1BQ2/PPP1BPPP/R3K1NR w KQ - 6 7,O-O-O,77,25,-52,1
rn1q1rk1/pbppppbp/1p3np1/8/3PP3/2N1BQ2/PPP1BPPP/2KR2NR b - - 7 7,d6,16,21,5,1
rn1q1rk1/pbp1ppbp/1p1p1np1/8/3PP3/2N1BQ2/PPP1BPPP/2KR2NR w - - 0 8,h4,31,22,-9,1
rn1q1rk1/pbp1ppbp/1p1p1np1/8/3PP2P/2N1BQ2/PPP1BPP1/2KR2NR b - - 0 8,c5,31,118,87,1
rn1q1rk1/pb2ppbp/1p1p1np1/2p5/3PP2P/2N1BQ2/PPP1BPP1/2KR2NR w - - 0 9,d5,179,-5,-184,0
rn1q1rk1/pb2ppbp/1p1p1np1/2pP4/4P2P/2N1BQ2/PPP1BPP1/2KR2NR b - - 0 9,Nbd7,10,99,89,1
r2q1rk1/pb1nppbp/1p1p1np1/2pP4/4P2P/2N1BQ2/PPP1BPP1/2KR2NR w - - 1 10,h5,119,130,11,1
r2q1rk1/pb1nppbp/1p1p1np1/2pP3P/4P3/2N1BQ2/PPP1BPP1/2KR2NR b - - 0 10,Ne5,109,173,64,1
r2q1rk1/pb2ppbp/1p1p1np1/2pPn2P/4P3/2N1BQ2/PPP1BPP1/2KR2NR w - - 1 11,Qg3,164,173,9,1
r2q1rk1/pb2ppbp/1p1p1np1/2pPn2P/4P3/2N1B1Q1/PPP1BPP1/2KR2NR b - - 2 11,e6,150,282,132,1
r2q1rk1/pb3pbp/1p1ppnp1/2pPn2P/4P3/2N1B1Q1/PPP1BPP1/2KR2NR w - - 0 12,hxg6,298,275,-23,1
r2q1rk1/pb3pbp/1p1ppnP1/2pPn3/4P3/2N1B1Q1/PPP1BPP1/2KR2NR b - - 0 12,fxg6,298,361,63,1
r2q1rk1/pb4bp/1p1ppnp1/2pPn3/4P3/2N1B1Q1/PPP1BPP1/2KR2NR w - - 0 13,dxe6,349,236,-113,0
r2q1rk1/pb4bp/1p1pPnp1/2p1n3/4P3/2N1B1Q1/PPP1BPP1/2KR2NR b - - 0 13,Bxe4,245,335,90,1
r2q1rk1/p5bp/1p1pPnp1/2p1n3/4b3/2N1B1Q1/PPP1BPP1/2KR2NR w - - 0 14,Bf4,307,311,4,1
r2q1rk1/p5bp/1p1pPnp1/2p1n3/4bB2/2N3Q1/PPP1BPP1/2KR2NR b - - 1 14,Bf5,299,488,189,1
r2q1rk1/p5bp/1p1pPnp1/2p1nb2/5B2/2N3Q1/PPP1BPP1/2KR2NR w - - 2 15,Bxe5,410,416,6,1
r2q1rk1/p5bp/1p1pPnp1/2p1Bb2/8/2N3Q1/PPP1BPP1/2KR2NR b - - 0 15,Ne4,416,530,114,1
r2q1rk1/p5bp/1p1pP1p1/2p1Bb2/4n3/2N3Q1/PPP1BPP1/2KR2NR w - - 1 16,Nxe4,577,429,-148,0
r2q1rk1/p5bp/1p1pP1p1/2p1Bb2/4N3/6Q1/PPP1BPP1/2KR2NR b - - 0 16,Bxe5,454,424,-30,1
r2q1rk1/p6p/1p1pP1p1/2p1bb2/4N3/6Q1/PPP1BPP1/2KR2NR w - - 0 17,f4,423,414,-9,1
r2q1rk1/p6p/1p1pP1p1/2p1bb2/4NP2/6Q1/PPP1B1P1/2KR2NR b - - 0 17,Bg7,423,423,0,1
r2q1rk1/p5bp/1p1pP1p1/2p2b2/4NP2/6Q1/PPP1B1P1/2KR2NR w - - 1 18,Ng5,425,394,-31,1
r2q1rk1/p5bp/1p1pP1p1/2p2bN1/5P2/6Q1/PPP1B1P1/2KR2NR b - - 2 18,Qf6,437,450,13,1
r4rk1/p5bp/1p1pPqp1/2p2bN1/5P2/6Q1/PPP1B1P1/2KR2NR w - - 3 19,c3,465,358,-107,0
r4rk1/p5bp/1p1pPqp1/2p2bN1/5P2/2P3Q1/PP2B1P1/2KR2NR b - - 0 19,Bxe6,388,537,149,1
r4rk1/p5bp/1p1pbqp1/2p3N1/5P2/2P3Q1/PP2B1P1/2KR2NR w - - 0 20,Rxd6,554,522,-32,1
r4rk1/p5bp/1p1Rbqp1/2p3N1/5P2/2P3Q1/PP2B1P1/2K3NR b - - 0 20,Rae8,512,589,77,1
4rrk1/p5bp/1p1Rbqp1/2p3N1/5P2/2P3Q1/PP2B1P1/2K3NR w - - 1 21,Nxh7,650,384,-266,0
4rrk1/p5bN/1p1Rbqp1/2p5/5P2/2P3Q1/PP2B1P1/2K3NR b - - 0 21,Qf5,429,450,21,1
4rrk1/p5bN/1p1Rb1p1/2p2q2/5P2/2P3Q1/PP2B1P1/2K3NR w - - 1 22,Nxf8,484,482,-2,1
4rNk1/p5b1/1p1Rb1p1/2p2q2/5P2/2P3Q1/PP2B1P1/2K3NR b - - 0 22,Bxf8,479,493,14,1
4rbk1/p7/1p1Rb1p1/2p2q2/5P2/2P3Q1/PP2B1P1/2K3NR w - - 0 23,Rd1,536,486,-50,1
4rbk1/p7/1p2b1p1/2p2q2/5P2/2P3Q1/PP2B1P1/2KR2NR b - - 1 23,Bxa2,489,540,51,1
4rbk1/p7/1p4p1/2p2q2/5P2/2P3Q1/bP2B1P1/2KR2NR w - - 0 24,Bd3,575,472,-103,0
4rbk1/p7/1p4p1/2p2q2/5P2/2PB2Q1/bP4P1/2KR2NR b - - 1 24,Qf6,437,613,176,1
4rbk1/p7/1p3qp1/2p5/5P2/2PB2Q1/bP4P1/2KR2NR w - - 2 25,Qxg6+,637,599,-38,1
4rbk1/p7/1p3qQ1/2p5/5P2/2PB4/bP4P1/2KR2NR b - - 0 25,Qxg6,581,599,18,1
4rbk1/p7/1p4q1/2p5/5P2/2PB4/bP4P1/2KR2NR w - - 0 26,Bxg6,585,604,19,1
4rbk1/p7/1p4B1/2p5/5P2/2P5/bP4P1/2KR2NR b - - 0 26,Re6,623,597,-26,1
5bk1/p7/1p2r1B1/2p5/5P2/2P5/bP4P1/2KR2NR w - - 1 27,f5,556,477,-79,1
5bk1/p7/1p2r1B1/2p2P2/8/2P5/bP4P1/2KR2NR b - - 0 27,Rf6,558,555,-3,1
5bk1/p7/1p3rB1/2p2P2/8/2P5/bP4P1/2KR2NR w - - 1 28,Nf3,544,523,-21,1
5bk1/p7/1p3rB1/2p2P2/8/2P2N2/bP4P1/2KR3R b - - 2 28,Bc4,562,638,76,1
5bk1/p7/1p3rB1/2p2P2/2b5/2P2N2/1P4P1/2KR3R w - - 3 29,Rd8,651,575,-76,1
rnbqkbnr/pppppppp/8/8/8/8/PPPPPPPP/RNBQKBNR w KQkq - 0 1,e3,36,2,-34,1
rnbqkbnr/pppppppp/8/8/8/4P3/PPPP1PPP/RNBQKBNR b KQkq - 0 1,c5,1,22,21,1
rnbqkbnr/pp1ppppp/8/2p5/8/4P3/PPPP1PPP/RNBQKBNR w KQkq - 0 2,d4,13,23,10,1
rnbqkbnr/pp1ppppp/8/2p5/3P4/4P3/PPP2PPP/RNBQKBNR b KQkq - 0 2,cxd4,25,42,17,1
rnbqkbnr/pp1ppppp/8/8/3p4/4P3/PPP2PPP/RNBQKBNR w KQkq - 0 3,exd4,29,37,8,1
rnbqkbnr/pp1ppppp/8/8/3P4/8/PPP2PPP/RNBQKBNR b KQkq - 0 3,d5,32,33,1,1
rnbqkbnr/pp2pppp/8/3p4/3P4/8/PPP2PPP/RNBQKBNR w KQkq - 0 4,Bd3,30,28,-2,1
rnbqkbnr/pp2pppp/8/3p4/3P4/3B4/PPP2PPP/RNBQK1NR b KQkq - 1 4,Nc6,27,27,0,1
r1bqkbnr/pp2pppp/2n5/3p4/3P4/3B4/PPP2PPP/RNBQK1NR w KQkq - 2 5,c3,26,18,-8,1
r1bqkbnr/pp2pppp/2n5/3p4/3P4/2PB4/PP3PPP/RNBQK1NR b KQkq - 0 5,e6,22,36,14,1
r1bqkbnr/pp3ppp/2n1p3/3p4/3P4/2PB4/PP3PPP/RNBQK1NR w KQkq - 0 6,Ne2,45,4,-41,1
r1bqkbnr/pp3ppp/2n1p3/3p4/3P4/2PB4/PP2NPPP/RNBQK2R b KQkq - 1 6,Nf6,-1,24,25,1
r1bqkb1r/pp3ppp/2n1pn2/3p4/3P4/2PB4/PP2NPPP/RNBQK2R w KQkq - 2 7,O-O,22,16,-6,1
r1bqkb1r/pp3ppp/2n1pn2/3p4/3P4/2PB4/PP2NPPP/RNBQ1RK1 b kq - 3 7,Nd7,18,61,43,1
r1bqkb1r/pp1n1ppp/2n1p3/3p4/3P4/2PB4/PP2NPPP/RNBQ1RK1 w kq - 4 8,Nd2,66,58,-8,1
r1bqkb1r/pp1n1ppp/2n1p3/3p4/3P4/2PB4/PP1NNPPP/R1BQ1RK1 b kq - 5 8,Be7,54,97,43,1
r1bqk2r/pp1nbppp/2n1p3/3p4/3P4/2PB4/PP1NNPPP/R1BQ1RK1 w kq - 6 9,Ng3,99,39,-60,1
r1bqk2r/pp1nbppp/2n1p3/3p4/3P4/2PB2N1/PP1N1PPP/R1BQ1RK1 b kq - 7 9,O-O,38,69,31,1
r1bq1rk1/pp1nbppp/2n1p3/3p4/3P4/2PB2N1/PP1N1PPP/R1BQ1RK1 w - - 8 10,Nf3,72,72,0,1
r1bq1rk1/pp1nbppp/2n1p3/3p4/3P4/2PB1NN1/PP3PPP/R1BQ1RK1 b - - 9 10,f6,80,158,78,1
r1bq1rk1/pp1nb1pp/2n1pp2/3p4/3P4/2PB1NN1/PP3PPP/R1BQ1RK1 w - - 0 11,Ne5,124,-438,-562,0
r1bq1rk1/pp1nb1pp/2n1pp2/3pN3/3P4/2PB2N1/PP3PPP/R1BQ1RK1 b - - 1 11,fxe5,-388,-431,-43,1
r1bq1rk1/pp1nb1pp/2n1p3/3pp3/3P4/2PB2N1/PP3PPP/R1BQ1RK1 w - - 0 12,dxe5,-471,-472,-1,1
r1bq1rk1/pp1nb1pp/2n1p3/3pP3/8/2PB2N1/PP3PPP/R1BQ1RK1 b - - 0 12,Ncxe5,-474,-452,22,1
r1bq1rk1/pp1nb1pp/4p3/3pn3/8/2PB2N1/PP3PPP/R1BQ1RK1 w - - 0 13,f4,-457,-573,-116,0
r1bq1rk1/pp1nb1pp/4p3/3pn3/5P2/2PB2N1/PP4PP/R1BQ1RK1 b - - 0 13,Nxd3,-545,-581,-36,1
r1bq1rk1/pp1nb1pp/4p3/3p4/5P2/2Pn2N1/PP4PP/R1BQ1RK1 w - - 0 14,Qxd3,-566,-544,22,1
r1bq1rk1/pp1nb1pp/4p3/3p4/5P2/2PQ2N1/PP4PP/R1B2RK1 b - - 0 14,Nf6,-541,-527,14,1
r1bq1rk1/pp2b1pp/4pn2/3p4/5P2/2PQ2N1/PP4PP/R1B2RK1 w - - 1 15,f5,-526,-545,-19,1
r1bq1rk1/pp2b1pp/4pn2/3p1P2/8/2PQ2N1/PP4PP/R1B2RK1 b - - 0 15,e5,-557,-549,8,1
r1bq1rk1/pp2b1pp/5n2/3ppP2/8/2PQ2N1/PP4PP/R1B2RK1 w - - 0 16,Bg5,-559,-546,13,1
r1bq1rk1/pp2b1pp/5n2/3ppPB1/8/2PQ2N1/PP4PP/R4RK1 b - - 1 16,e4,-540,-516,24,1
r1bq1rk1/pp2b1pp/5n2/3p1PB1/4p3/2PQ2N1/PP4PP/R4RK1 w - - 0 17,Qc2,-534,-556,-22,1
r1bq1rk1/pp2b1pp/5n2/3p1PB1/4p3/2P3N1/PPQ3PP/R4RK1 b - - 1 17,Qd7,-539,-451,88,1
r1b2rk1/pp1qb1pp/5n2/3p1PB1/4p3/2P3N1/PPQ3PP/R4RK1 w - - 2 18,Bxf6,-479,-475,4,1
r1b2rk1/pp1qb1pp/5B2/3p1P2/4p3/2P3N1/PPQ3PP/R4RK1 b - - 0 18,Bxf6,-465,-478,-13,1
r1b2rk1/pp1q2pp/5b2/3p1P2/4p3/2P3N1/PPQ3PP/R4RK1 w - - 0 19,Nh5,-484,-466,18,1
r1b2rk1/pp1q2pp/5b2/3p1P1N/4p3/2P5/PPQ3PP/R4RK1 b - - 1 19,Qe7,-466,-464,2,1
r1b2rk1/pp2q1pp/5b2/3p1P1N/4p3/2P5/PPQ3PP/R4RK1 w - - 2 20,Qf2,-457,-526,-69,1
r1b2rk1/pp2q1pp/5b2/3p1P1N/4p3/2P5/PP3QPP/R4RK1 b - - 3 20,Bd7,-517,-445,72,1
r4rk1/pp1bq1pp/5b2/3p1P1N/4p3/2P5/PP3QPP/R4RK1 w - - 4 21,Qg3,-463,-505,-42,1
r4rk1/pp1bq1pp/5b2/3p1P1N/4p3/2P3Q1/PP4PP/R4RK1 b - - 5 21,Bc6,-506,-453,53,1
r4rk1/pp2q1pp/2b2b2/3p1P1N/4p3/2P3Q1/PP4PP/R4RK1 w - - 6 22,Rad1,-463,-498,-35,1
r4rk1/pp2q1pp/2b2b2/3p1P1N/4p3/2P3Q1/PP4PP/3R1RK1 b - - 7 22,Rad8,-487,-455,32,1
3r1rk1/pp2q1pp/2b2b2/3p1P1N/4p3/2P3Q1/PP4PP/3R1RK1 w - - 8 23,Rde1,-500,-523,-23,1
3r1rk1/pp2q1pp/2b2b2/3p1P1N/4p3/2P3Q1/PP4PP/4RRK1 b - - 9 23,Qf7,-532,-505,27,1
3r1rk1/pp3qpp/2b2b2/3p1P1N/4p3/2P3Q1/PP4PP/4RRK1 w - - 10 24,Qg4,-514,-513,1,1
3r1rk1/pp3qpp/2b2b2/3p1P1N/4p1Q1/2P5/PP4PP/4RRK1 b - - 11 24,Bd7,-522,-466,56,1
3r1rk1/pp1b1qpp/5b2/3p1P1N/4p1Q1/2P5/PP4PP/4RRK1 w - - 12 25,Nf4,-477,-505,-28,1
3r1rk1/pp1b1qpp/5b2/3p1P2/4pNQ1/2P5/PP4PP/4RRK1 b - - 13 25,Be5,-497,-456,41,1
3r1rk1/pp1b1qpp/8/3pbP2/4pNQ1/2P5/PP4PP/4RRK1 w - - 14 26,Ne6,-501,-514,-13,1
3r1rk1/pp1b1qpp/4N3/3pbP2/4p1Q1/2P5/PP4PP/4RRK1 b - - 15 26,Bxe6,-513,-417,96,1
3r1rk1/pp3qpp/4b3/3pbP2/4p1Q1/2P5/PP4PP/4RRK1 w - - 0 27,fxe6,-435,-474,-39,1
3r1rk1/pp3qpp/4P3/3pb3/4p1Q1/2P5/PP4PP/4RRK1 b - - 0 27,Qe7,-482,-483,-1,1
3r1rk1/pp2q1pp/4P3/3pb3/4p1Q1/2P5/PP4PP/4RRK1 w - - 1 28,Qh5,-506,-541,-35,1
3r1rk1/pp2q1pp/4P3/3pb2Q/4p3/2P5/PP4PP/4RRK1 b - - 2 28,Rxf1+,-547,-556,-9,1
3r2k1/pp2q1pp/4P3/3pb2Q/4p3/2P5/PP4PP/4RrK1 w - - 0 29,Rxf1,-583,-560,23,1
3r2k1/pp2q1pp/4P3/3pb2Q/4p3/2P5/PP4PP/5RK1 b - - 0 29,Bf6,-552,-518,34,1
3r2k1/pp2q1pp/4Pb2/3p3Q/4p3/2P5/PP4PP/5RK1 w - - 1 30,Qg4,-538,-553,-15,1
3r2k1/pp2q1pp/4Pb2/3p4/4p1Q1/2P5/PP4PP/5RK1 b - - 2 30,Re8,-550,-522,28,1
4r1k1/pp2q1pp/4Pb2/3p4/4p1Q1/2P5/PP4PP/5RK1 w - - 3 31,Qf5,-513,-542,-29,1
4r1k1/pp2q1pp/4Pb2/3p1Q2/4p3/2P5/PP4PP/5RK1 b - - 4 31,Qxe6,-577,-577,0,1
4r1k1/pp4pp/4qb2/3p1Q2/4p3/2P5/PP4PP/5RK1 w - - 0 32,Qg4,-604,-893,-289,0
4r1k1/pp4pp/4qb2/3p4/4p1Q1/2P5/PP4PP/5RK1 b - - 1 32,Qe5,-895,-529,366,1
4r1k1/pp4pp/5b2/3pq3/4p1Q1/2P5/PP4PP/5RK1 w - - 2 33,Qe2,-514,-571,-57,1
4r1k1/pp4pp/5b2/3pq3/4p3/2P5/PP2Q1PP/5RK1 b - - 3 33,d4,-572,-607,-35,1
4r1k1/pp4pp/5b2/4q3/3pp3/2P5/PP2Q1PP/5RK1 w - - 0 34,cxd4,-602,-603,-1,1
4r1k1/pp4pp/5b2/4q3/3Pp3/8/PP2Q1PP/5RK1 b - - 0 34,Qxd4+,-603,-553,50,1
4r1k1/pp4pp/5b2/8/3qp3/8/PP2Q1PP/5RK1 w - - 0 35,Kh1,-566,-595,-29,1
4r1k1/pp4pp/5b2/8/3qp3/8/PP2Q1PP/5R1K b - - 1 35,Qe5,-581,-558,23,1
4r1k1/pp4pp/5b2/4q3/4p3/8/PP2Q1PP/5R1K w - - 2 36,Re1,-538,-597,-59,1
4r1k1/pp4pp/5b2/4q3/4p3/8/PP2Q1PP/4R2K b - - 3 36,e3,-574,-586,-12,1
4r1k1/pp4pp/5b2/4q3/8/4p3/PP2Q1PP/4R2K w - - 0 37,a3,-592,-589,3,1
4r1k1/pp4pp/5b2/4q3/8/P3p3/1P2Q1PP/4R2K b - - 0 37,Qe4,-585,-578,7,1
4r1k1/pp4pp/5b2/8/4q3/P3p3/1P2Q1PP/4R2K w - - 1 38,b3,-546,-614,-68,1
4r1k1/pp4pp/5b2/8/4q3/PP2p3/4Q1PP/4R2K b - - 0 38,Qe5,-603,-556,47,1
4r1k1/pp4pp/5b2/4q3/8/PP2p3/4Q1PP/4R2K w - - 1 39,b4,-585,-597,-12,1
4r1k1/pp4pp/5b2/4q3/1P6/P3p3/4Q1PP/4R2K b - - 0 39,Qe4,-578,-548,30,1
4r1k1/pp4pp/5b2/8/1P2q3/P3p3/4Q1PP/4R2K w - - 1 40,b5,-534,-555,-21,1
4r1k1/pp4pp/5b2/1P6/4q3/P3p3/4Q1PP/4R2K b - - 0 40,Bd4,-574,-556,18,1
4r1k1/pp4pp/8/1P6/3bq3/P3p3/4Q1PP/4R2K w - - 1 41,a4,-578,-569,9,1
4r1k1/pp4pp/8/1P6/P2bq3/4p3/4Q1PP/4R2K b - - 0 41,Bb6,-573,-501,72,1
4r1k1/pp4pp/1b6/1P6/P3q3/4p3/4Q1PP/4R2K w - - 1 42,a5,-511,-532,-21,1
4r1k1/pp4pp/1b6/PP6/4q3/4p3/4Q1PP/4R2K b - - 0 42,Bc5,-468,-476,-8,1
4r1k1/pp4pp/8/PPb5/4q3/4p3/4Q1PP/4R2K w - - 1 43,a6,-542,-564,-22,1
4r1k1/pp4pp/P7/1Pb5/4q3/4p3/4Q1PP/4R2K b - - 0 43,b6,-558,-535,23,1
4r1k1/p5pp/Pp6/1Pb5/4q3/4p3/4Q1PP/4R2K w - - 0 44,Rf1,-537,-524,13,1
4r1k1/p5pp/Pp6/1Pb5/4q3/4p3/4Q1PP/5R1K b - - 1 44,Kh8,-507,-505,2,1
4r2k/p5pp/Pp6/1Pb5/4q3/4p3/4Q1PP/5R1K w - - 2 45,h3,-484,-539,-55,1
4r2k/p5pp/Pp6/1Pb5/4q3/4p2P/4Q1P1/5R1K b - - 0 45,Qe7,-565,-551,14,1
4r2k/p3q1pp/Pp6/1Pb5/8/4p2P/4Q1P1/5R1K w - - 1 46,Kg1,-539,-589,-50,1
4r2k/p3q1pp/Pp6/1Pb5/8/4p2P/4Q1P1/5RK1 b - - 2 46,Qe4,-585,-453,132,1
4r2k/p5pp/Pp6/1Pb5/4q3/4p2P/4Q1P1/5RK1 w - - 3 47,Kh1,-553,-582,-29,1
4r2k/p5pp/Pp6/1Pb5/4q3/4p2P/4Q1P1/5R1K b - - 4 47,Qd4,-567,-548,19,1
4r2k/p5pp/Pp6/1Pb5/3q4/4p2P/4Q1P1/5R1K w - - 5 48,Kg1,-517,-597,-80,1
4r2k/p5pp/Pp6/1Pb5/3q4/4p2P/4Q1P1/5RK1 b - - 6 48,Qd2,-600,-602,-2,1
4r2k/p5pp/Pp6/1Pb5/8/4p2P/3qQ1P1/5RK1 w - - 7 49,Re1,-584,-602,-18,1
4r2k/p5pp/Pp6/1Pb5/8/4p2P/3qQ1P1/4R1K1 b - - 8 49,Qxe2,-584,-587,-3,1
4r2k/p5pp/Pp6/1Pb5/8/4p2P/4q1P1/4R1K1 w - - 0 50,Rxe2,-574,-557,17,1
4r2k/p5pp/Pp6/1Pb5/8/4p2P/4R1P1/6K1 b - - 0 50,Re4,-597,-535,62,1
7k/p5pp/Pp6/1Pb5/4r3/4p2P/4R1P1/6K1 w - - 1 51,Kf1,-568,-568,0,1
7k/p5pp/Pp6/1Pb5/4r3/4p2P/4R1P1/5K2 b - - 2 51,Rb4,-552,-564,-12,1
7k/p5pp/Pp6/1Pb5/1r6/4p2P/4R1P1/5K2 w - - 3 52,Kg1,-597,-662,-65,1
7k/p5pp/Pp6/1Pb5/1r6/4p2P/4R1P1/6K1 b - - 4 52,Rxb5,-644,-651,-7,1
7k/p5pp/Pp6/1rb5/8/4p2P/4R1P1/6K1 w - - 0 53,Kf1,-596,-661,-65,1
7k/p5pp/Pp6/1rb5/8/4p2P/4R1P1/5K2 b - - 1 53,Rb1+,-672,-717,-45,1
7k/p5pp/Pp6/2b5/8/4p2P/4R1P1/1r3K2 w - - 2 54,Re1,-661,-708,-47,1
7k/p5pp/Pp6/2b5/8/4p2P/6P1/1r2RK2 b - - 3 54,Rb5,-705,-584,121,1
7k/p5pp/Pp6/1rb5/8/4p2P/6P1/4RK2 w - - 4 55,Re2,-618,-682,-64,1
7k/p5pp/Pp6/1rb5/8/4p2P/4R1P1/5K2 b - - 5 55,Rb4,-727,-658,69,1
7k/p5pp/Pp6/2b5/1r6/4p2P/4R1P1/5K2 w - - 6 56,Re1,-650,-690,-40,1
7k/p5pp/Pp6/2b5/1r6/4p2P/6P1/4RK2 b - - 7 56,Rd4,-687,-576,111,1
7k/p5pp/Pp6/2b5/3r4/4p2P/6P1/4RK2 w - - 8 57,Kg1,-638,-702,-64,1
7k/p5pp/Pp6/2b5/3r4/4p2P/6P1/4R1K1 b - - 9 57,Rd2,-704,-676,28,1
7k/p5pp/Pp6/2b5/8/4p2P/3r2P1/4R1K1 w - - 10 58,Kh2,-692,-691,1,1
7k/p5pp/Pp6/2b5/8/4p2P/3r2PK/4R3 b - - 11 58,Rf2,-671,-637,34,1
7k/p5pp/Pp6/2b5/8/4p2P/5rPK/4R3 w - - 12 59,Kg3,-673,-701,-28,1
7k/p5pp/Pp6/2b5/8/4p1KP/5rP1/4R3 b - - 13 59,Rd2,-702,-643,59,1
7k/p5pp/Pp6/2b5/8/4p1KP/3r2P1/4R3 w - - 14 60,h4,-653,-634,19,1
7k/p5pp/Pp6/2b5/7P/4p1K1/3r2P1/4R3 b - - 0 60,Rd4,-672,-507,165,1
7k/p5pp/Pp6/2b5/3r3P/4p1K1/6P1/4R3 w - - 1 61,h5,-531,-581,-50,1
7k/p5pp/Pp6/2b4P/3r4/4p1K1/6P1/4R3 b - - 0 61,Rd5,-626,-566,60,1
7k/p5pp/Pp6/2br3P/8/4p1K1/6P1/4R3 w - - 1 62,h6,-598,-673,-75,1
7k/p5pp/Pp5P/2br4/8/4p1K1/6P1/4R3 b - - 0 62,Bd6+,-684,-521,163,1
7k/p5pp/Pp1b3P/3r4/8/4p1K1/6P1/4R3 w - - 1 63,Kf3,-542,-593,-51,1
7k/p5pp/Pp1b3P/3r4/8/4pK2/6P1/4R3 b - - 2 63,Bc5,-604,-593,11,1
7k/p5pp/Pp5P/2br4/8/4pK2/6P1/4R3 w - - 3 64,Ke2,-596,-667,-71,1
7k/p5pp/Pp5P/2br4/8/4p3/4K1P1/4R3 b - - 4 64,g6,-661,-559,102,1
7k/p6p/Pp4pP/2br4/8/4p3/4K1P1/4R3 w - - 0 65,Rf1,-541,-679,-138,0
7k/p6p/Pp4pP/2br4/8/4p3/4K1P1/5R2 b - - 1 65,g5,-659,-592,67,1
7k/p6p/Pp5P/2br2p1/8/4p3/4K1P1/5R2 w - - 0 66,Rf8+,-578,-842,-264,0
rnbqkbnr/pppppppp/8/8/8/8/PPPPPPPP/RNBQKBNR w KQkq - 0 1,e4,28,32,4,1
rnbqkbnr/pppppppp/8/8/4P3/8/PPPP1PPP/RNBQKBNR b KQkq - 0 1,e5,26,42,16,1
rnbqkbnr/pppp1ppp/8/4p3/4P3/8/PPPP1PPP/RNBQKBNR w KQkq - 0 2,Bc4,45,-5,-50,1
rnbqkbnr/pppp1ppp/8/4p3/2B1P3/8/PPPP1PPP/RNBQK1NR b KQkq - 1 2,Nc6,-7,29,36,1
r1bqkbnr/pppp1ppp/2n5/4p3/2B1P3/8/PPPP1PPP/RNBQK1NR w KQkq - 2 3,a3,17,-27,-44,1
r1bqkbnr/pppp1ppp/2n5/4p3/2B1P3/P7/1PPP1PPP/RNBQK1NR b KQkq - 0 3,Nf6,-24,-7,17,1
r1bqkb1r/pppp1ppp/2n2n2/4p3/2B1P3/P7/1PPP1PPP/RNBQK1NR w KQkq - 1 4,d3,-36,-36,0,1
r1bqkb1r/pppp1ppp/2n2n2/4p3/2B1P3/P2P4/1PP2PPP/RNBQK1NR b KQkq - 0 4,d6,-51,28,79,1
r1bqkb1r/ppp2ppp/2np1n2/4p3/2B1P3/P2P4/1PP2PPP/RNBQK1NR w KQkq - 0 5,h3,25,-26,-51,1
r1bqkb1r/ppp2ppp/2np1n2/4p3/2B1P3/P2P3P/1PP2PP1/RNBQK1NR b KQkq - 0 5,a6,-18,40,58,1
r1bqkb1r/1pp2ppp/p1np1n2/4p3/2B1P3/P2P3P/1PP2PP1/RNBQK1NR w KQkq - 0 6,Nf3,30,24,-6,1
r1bqkb1r/1pp2ppp/p1np1n2/4p3/2B1P3/P2P1N1P/1PP2PP1/RNBQK2R b KQkq - 1 6,b5,25,57,32,1
r1bqkb1r/2p2ppp/p1np1n2/1p2p3/2B1P3/P2P1N1P/1PP2PP1/RNBQK2R w KQkq - 0 7,Ba2,42,34,-8,1
r1bqkb1r/2p2ppp/p1np1n2/1p2p3/4P3/P2P1N1P/BPP2PP1/RNBQK2R b KQkq - 1 7,Nd4,30,55,25,1
r1bqkb1r/2p2ppp/p2p1n2/1p2p3/3nP3/P2P1N1P/BPP2PP1/RNBQK2R w KQkq - 2 8,Ng5,64,26,-38,1
r1bqkb1r/2p2ppp/p2p1n2/1p2p1N1/3nP3/P2P3P/BPP2PP1/RNBQK2R b KQkq - 3 8,Be6,24,87,63,1
r2qkb1r/2p2ppp/p2pbn2/1p2p1N1/3nP3/P2P3P/BPP2PP1/RNBQK2R w KQkq - 4 9,c3,106,16,-90,1
r2qkb1r/2p2ppp/p2pbn2/1p2p1N1/3nP3/P1PP3P/BP3PP1/RNBQK2R b KQkq - 0 9,Nc6,10,273,263,1
r2qkb1r/2p2ppp/p1npbn2/1p2p1N1/4P3/P1PP3P/BP3PP1/RNBQK2R w KQkq - 1 10,Nxe6,278,293,15,1
r2qkb1r/2p2ppp/p1npNn2/1p2p3/4P3/P1PP3P/BP3PP1/RNBQK2R b KQkq - 0 10,fxe6,303,329,26,1
r2qkb1r/2p3pp/p1nppn2/1p2p3/4P3/P1PP3P/BP3PP1/RNBQK2R w KQkq - 0 11,Bxe6,318,306,-12,1
r2qkb1r/2p3pp/p1npBn2/1p2p3/4P3/P1PP3P/1P3PP1/RNBQK2R b KQkq - 0 11,Qe7,322,350,28,1
r3kb1r/2p1q1pp/p1npBn2/1p2p3/4P3/P1PP3P/1P3PP1/RNBQK2R w KQkq - 1 12,Ba2,344,317,-27,1
r3kb1r/2p1q1pp/p1np1n2/1p2p3/4P3/P1PP3P/BP3PP1/RNBQK2R b KQkq - 2 12,g6,326,354,28,1
r3kb1r/2p1q2p/p1np1np1/1p2p3/4P3/P1PP3P/BP3PP1/RNBQK2R w KQkq - 0 13,Qf3,343,303,-40,1
r3kb1r/2p1q2p/p1np1np1/1p2p3/4P3/P1PP1Q1P/BP3PP1/RNB1K2R b KQkq - 1 13,Bg7,266,273,7,1
r3k2r/2p1q1bp/p1np1np1/1p2p3/4P3/P1PP1Q1P/BP3PP1/RNB1K2R w KQkq - 2 14,O-O,256,257,1,1
r3k2r/2p1q1bp/p1np1np1/1p2p3/4P3/P1PP1Q1P/BP3PP1/RNB2RK1 b kq - 3 14,Na5,253,319,66,1
r3k2r/2p1q1bp/p2p1np1/np2p3/4P3/P1PP1Q1P/BP3PP1/RNB2RK1 w kq - 4 15,Be3,301,353,52,1
r3k2r/2p1q1bp/p2p1np1/np2p3/4P3/P1PPBQ1P/BP3PP1/RN3RK1 b kq - 5 15,c6,324,328,4,1
r3k2r/4q1bp/p1pp1np1/np2p3/4P3/P1PPBQ1P/BP3PP1/RN3RK1 w kq - 0 16,Nd2,356,328,-28,1
r3k2r/4q1bp/p1pp1np1/np2p3/4P3/P1PPBQ1P/BP1N1PP1/R4RK1 b kq - 1 16,d5,359,441,82,1
r3k2r/4q1bp/p1p2np1/np1pp3/4P3/P1PPBQ1P/BP1N1PP1/R4RK1 w kq - 0 17,b4,413,438,25,1
r3k2r/4q1bp/p1p2np1/np1pp3/1P2P3/P1PPBQ1P/B2N1PP1/R4RK1 b kq - 0 17,Nb7,410,424,14,1
r3k2r/1n2q1bp/p1p2np1/1p1pp3/1P2P3/P1PPBQ1P/B2N1PP1/R4RK1 w kq - 1 18,exd5,435,440,5,1
r3k2r/1n2q1bp/p1p2np1/1p1Pp3/1P6/P1PPBQ1P/B2N1PP1/R4RK1 b kq - 0 18,cxd5,425,435,10,1
r3k2r/1n2q1bp/p4np1/1p1pp3/1P6/P1PPBQ1P/B2N1PP1/R4RK1 w kq - 0 19,Bg5,424,412,-12,1
r3k2r/1n2q1bp/p4np1/1p1pp1B1/1P6/P1PP1Q1P/B2N1PP1/R4RK1 b kq - 1 19,O-O,377,403,26,1
r4rk1/1n2q1bp/p4np1/1p1pp1B1/1P6/P1PP1Q1P/B2N1PP1/R4RK1 w - - 2 20,Bxd5+,400,371,-29,1
r4rk1/1n2q1bp/p4np1/1p1Bp1B1/1P6/P1PP1Q1P/3N1PP1/R4RK1 b - - 0 20,Kh8,374,479,105,1
r4r1k/1n2q1bp/p4np1/1p1Bp1B1/1P6/P1PP1Q1P/3N1PP1/R4RK1 w - - 1 21,Bxb7,481,514,33,1
r4r1k/1B2q1bp/p4np1/1p2p1B1/1P6/P1PP1Q1P/3N1PP1/R4RK1 b - - 0 21,Rab8,502,553,51,1
1r3r1k/1B2q1bp/p4np1/1p2p1B1/1P6/P1PP1Q1P/3N1PP1/R4RK1 w - - 1 22,Bxa6,544,490,-54,1
1r3r1k/4q1bp/B4np1/1p2p1B1/1P6/P1PP1Q1P/3N1PP1/R4RK1 b - - 0 22,Qd6,503,503,0,1
1r3r1k/6bp/B2q1np1/1p2p1B1/1P6/P1PP1Q1P/3N1PP1/R4RK1 w - - 1 23,Bxb5,514,538,24,1
1r3r1k/6bp/3q1np1/1B2p1B1/1P6/P1PP1Q1P/3N1PP1/R4RK1 b - - 0 23,Rxb5,550,625,75,1
5r1k/6bp/3q1np1/1r2p1B1/1P6/P1PP1Q1P/3N1PP1/R4RK1 w - - 0 24,Nc4,626,469,-157,0
5r1k/6bp/3q1np1/1r2p1B1/1PN5/P1PP1Q1P/5PP1/R4RK1 b - - 1 24,Qd7,447,487,40,1
5r1k/3q2bp/5np1/1r2p1B1/1PN5/P1PP1Q1P/5PP1/R4RK1 w - - 2 25,Qg3,529,409,-120,0
5r1k/3q2bp/5np1/1r2p1B1/1PN5/P1PP2QP/5PP1/R4RK1 b - - 3 25,Rd5,407,444,37,1
5r1k/3q2bp/5np1/3rp1B1/1PN5/P1PP2QP/5PP1/R4RK1 w - - 4 26,Rad1,452,357,-95,1
5r1k/3q2bp/5np1/3rp1B1/1PN5/P1PP2QP/5PP1/3R1RK1 b - - 5 26,Nh5,381,490,109,1
5r1k/3q2bp/6p1/3rp1Bn/1PN5/P1PP2QP/5PP1/3R1RK1 w - - 6 27,Qh4,461,398,-63,1
5r1k/3q2bp/6p1/3rp1Bn/1PN4Q/P1PP3P/5PP1/3R1RK1 b - - 7 27,e4,374,507,133,1
5r1k/3q2bp/6p1/3r2Bn/1PN1p2Q/P1PP3P/5PP1/3R1RK1 w - - 0 28,Nb6,545,544,-1,1
5r1k/3q2bp/1N4p1/3r2Bn/1P2p2Q/P1PP3P/5PP1/3R1RK1 b - - 1 28,Qf5,494,554,60,1
5r1k/6bp/1N4p1/3r1qBn/1P2p2Q/P1PP3P/5PP1/3R1RK1 w - - 2 29,Nxd5,537,551,14,1
5r1k/6bp/6p1/3N1qBn/1P2p2Q/P1PP3P/5PP1/3R1RK1 b - - 0 29,Qxd5,541,506,-35,1
5r1k/6bp/6p1/3q2Bn/1P2p2Q/P1PP3P/5PP1/3R1RK1 w - - 0 30,dxe4,532,522,-10,1
5r1k/6bp/6p1/3q2Bn/1P2P2Q/P1P4P/5PP1/3R1RK1 b - - 0 30,Qb3,499,532,33,1
5r1k/6bp/6p1/6Bn/1P2P2Q/PqP4P/5PP1/3R1RK1 w - - 1 31,g4,567,448,-119,0
5r1k/6bp/6p1/6Bn/1P2P1PQ/PqP4P/5P2/3R1RK1 b - - 0 31,Nf6,456,465,9,1
5r1k/6bp/5np1/6B1/1P2P1PQ/PqP4P/5P2/3R1RK1 w - - 1 32,Bxf6,474,486,12,1
5r1k/6bp/5Bp1/8/1P2P1PQ/PqP4P/5P2/3R1RK1 b - - 0 32,Bxf6,487,471,-16,1
5r1k/7p/5bp1/8/1P2P1PQ/PqP4P/5P2/3R1RK1 w - - 0 33,Qg3,476,477,1,1
5r1k/7p/5bp1/8/1P2P1P1/PqP3QP/5P2/3R1RK1 b - - 1 33,Qxa3,481,540,59,1
5r1k/7p/5bp1/8/1P2P1P1/q1P3QP/5P2/3R1RK1 w - - 0 34,e5,535,554,19,1
5r1k/7p/5bp1/4P3/1P4P1/q1P3QP/5P2/3R1RK1 b - - 0 34,Be7,562,566,4,1
5r1k/4b2p/6p1/4P3/1P4P1/q1P3QP/5P2/3R1RK1 w - - 1 35,Qe3,592,547,-45,1
5r1k/4b2p/6p1/4P3/1P4P1/q1P1Q2P/5P2/3R1RK1 b - - 2 35,Re8,487,643,156,1
4r2k/4b2p/6p1/4P3/1P4P1/q1P1Q2P/5P2/3R1RK1 w - - 3 36,e6,614,599,-15,1
4r2k/4b2p/4P1p1/8/1P4P1/q1P1Q2P/5P2/3R1RK1 b - - 0 36,Kg7,596,587,-9,1
4r3/4b1kp/4P1p1/8/1P4P1/q1P1Q2P/5P2/3R1RK1 w - - 1 37,Qe5+,603,576,-27,1
4r3/4b1kp/4P1p1/4Q3/1P4P1/q1P4P/5P2/3R1RK1 b - - 2 37,Kh6,592,603,11,1
4r3/4b2p/4P1pk/4Q3/1P4P1/q1P4P/5P2/3R1RK1 w - - 3 38,Qf4+,584,512,-72,1
4r3/4b2p/4P1pk/8/1P3QP1/q1P4P/5P2/3R1RK1 b - - 4 38,g5,519,520,1,1
4r3/4b2p/4P2k/6p1/1P3QP1/q1P4P/5P2/3R1RK1 w - - 0 39,Qf7,592,659,67,1
4r3/4bQ1p/4P2k/6p1/1P4P1/q1P4P/5P2/3R1RK1 b - - 1 39,Qa8,668,876,208,1
q3r3/4bQ1p/4P2k/6p1/1P4P1/2P4P/5P2/3R1RK1 w - - 2 40,Rd7,905,847,-58,1
q3r3/3RbQ1p/4P2k/6p1/1P4P1/2P4P/5P2/5RK1 b - - 3 40,Bc5,924,9999,9075,1
q3r3/3R1Q1p/4P2k/2b3p1/1P4P1/2P4P/5P2/5RK1 w - - 4 41,Qxh7#,9999,10000,1,1
rnbqkbnr/pppppppp/8/8/8/8/PPPPPPPP/RNBQKBNR w KQkq - 0 1,e4,21,27,6,1
rnbqkbnr/pppppppp/8/8/4P3/8/PPPP1PPP/RNBQKBNR b KQkq - 0 1,Nf6,33,91,58,1
rnbqkb1r/pppppppp/5n2/8/4P3/8/PPPP1PPP/RNBQKBNR w KQkq - 1 2,d4,69,-85,-154,0
rnbqkb1r/pppppppp/5n2/8/3PP3/8/PPP2PPP/RNBQKBNR b KQkq - 0 2,Nxe4,-80,-69,11,1
rnbqkb1r/pppppppp/8/8/3Pn3/8/PPP2PPP/RNBQKBNR w KQkq - 0 3,Nc3,-71,-116,-45,1
rnbqkb1r/pppppppp/8/8/3Pn3/2N5/PPP2PPP/R1BQKBNR b KQkq - 1 3,d5,-96,-64,32,1
rnbqkb1r/ppp1pppp/8/3p4/3Pn3/2N5/PPP2PPP/R1BQKBNR w KQkq - 0 4,Nxd5,-62,-397,-335,0
rnbqkb1r/ppp1pppp/8/3N4/3Pn3/8/PPP2PPP/R1BQKBNR b KQkq - 0 4,Qd7,-421,71,492,1
rnb1kb1r/pppqpppp/8/3N4/3Pn3/8/PPP2PPP/R1BQKBNR w KQkq - 1 5,Ne3,63,53,-10,1
rnb1kb1r/pppqpppp/8/8/3Pn3/4N3/PPP2PPP/R1BQKBNR b KQkq - 2 5,Qd6,50,134,84,1
rnb1kb1r/ppp1pppp/3q4/8/3Pn3/4N3/PPP2PPP/R1BQKBNR w KQkq - 3 6,Bb5+,154,92,-62,1
rnb1kb1r/ppp1pppp/3q4/1B6/3Pn3/4N3/PPP2PPP/R1BQK1NR b KQkq - 4 6,c6,78,83,5,1
rnb1kb1r/pp2pppp/2pq4/1B6/3Pn3/4N3/PPP2PPP/R1BQK1NR w KQkq - 0 7,Nc4,95,-455,-550,0
rnb1kb1r/pp2pppp/2pq4/1B6/2NPn3/8/PPP2PPP/R1BQK1NR b KQkq - 1 7,Qf6,-391,-312,79,1
rnb1kb1r/pp2pppp/2p2q2/1B6/2NPn3/8/PPP2PPP/R1BQK1NR w KQkq - 2 8,Ba4,-360,-9999,-9639,0
rnb1kb1r/pp2pppp/2p2q2/8/B1NPn3/8/PPP2PPP/R1BQK1NR b KQkq - 3 8,Qxf2#,-9999,-10000,-1,1
rnbqkbnr/pppppppp/8/8/8/8/PPPPPPPP/RNBQKBNR w KQkq - 0 1,e4,40,35,-5,1
rnbqkbnr/pppppppp/8/8/4P3/8/PPPP1PPP/RNBQKBNR b KQkq - 0 1,c5,31,20,-11,1
rnbqkbnr/pp1ppppp/8/2p5/4P3/8/PPPP1PPP/RNBQKBNR w KQkq - 0 2,Nf3,20,12,-8,1
rnbqkbnr/pp1ppppp/8/2p5/4P3/5N2/PPPP1PPP/RNBQKB1R b KQkq - 1 2,Nc6,24,37,13,1
r1bqkbnr/pp1ppppp/2n5/2p5/4P3/5N2/PPPP1PPP/RNBQKB1R w KQkq - 2 3,Bb5,42,39,-3,1
r1bqkbnr/pp1ppppp/2n5/1Bp5/4P3/5N2/PPPP1PPP/RNBQK2R b KQkq - 3 3,e6,37,35,-2,1
r1bqkbnr/pp1p1ppp/2n1p3/1Bp5/4P3/5N2/PPPP1PPP/RNBQK2R w KQkq - 0 4,O-O,35,26,-9,1
r1bqkbnr/pp1p1ppp/2n1p3/1Bp5/4P3/5N2/PPPP1PPP/RNBQ1RK1 b kq - 1 4,Be7,24,65,41,1
r1bqk1nr/pp1pbppp/2n1p3/1Bp5/4P3/5N2/PPPP1PPP/RNBQ1RK1 w kq - 2 5,c3,66,41,-25,1
r1bqk1nr/pp1pbppp/2n1p3/1Bp5/4P3/2P2N2/PP1P1PPP/RNBQ1RK1 b kq - 0 5,Nf6,45,51,6,1
r1bqk2r/pp1pbppp/2n1pn2/1Bp5/4P3/2P2N2/PP1P1PPP/RNBQ1RK1 w kq - 1 6,Re1,43,36,-7,1
r1bqk2r/pp1pbppp/2n1pn2/1Bp5/4P3/2P2N2/PP1P1PPP/RNBQR1K1 b kq - 2 6,d6,39,79,40,1
r1bqk2r/pp2bppp/2nppn2/1Bp5/4P3/2P2N2/PP1P1PPP/RNBQR1K1 w kq - 0 7,e5,85,45,-40,1
r1bqk2r/pp2bppp/2nppn2/1Bp1P3/8/2P2N2/PP1P1PPP/RNBQR1K1 b kq - 0 7,dxe5,45,48,3,1
r1bqk2r/pp2bppp/2n1pn2/1Bp1p3/8/2P2N2/PP1P1PPP/RNBQR1K1 w kq - 0 8,Nxe5,50,31,-19,1
r1bqk2r/pp2bppp/2n1pn2/1Bp1N3/8/2P5/PP1P1PPP/RNBQR1K1 b kq - 0 8,Qc7,29,72,43,1
r1b1k2r/ppq1bppp/2n1pn2/1Bp1N3/8/2P5/PP1P1PPP/RNBQR1K1 w kq - 1 9,d3,71,31,-40,1
r1b1k2r/ppq1bppp/2n1pn2/1Bp1N3/8/2PP4/PP3PPP/RNBQR1K1 b kq - 0 9,h6,14,144,130,1
r1b1k2r/ppq1bpp1/2n1pn1p/1Bp1N3/8/2PP4/PP3PPP/RNBQR1K1 w kq - 0 10,Bf4,161,120,-41,1
r1b1k2r/ppq1bpp1/2n1pn1p/1Bp1N3/5B2/2PP4/PP3PPP/RN1QR1K1 b kq - 1 10,Bd6,114,130,16,1
r1b1k2r/ppq2pp1/2nbpn1p/1Bp1N3/5B2/2PP4/PP3PPP/RN1QR1K1 w kq - 2 11,d4,117,60,-57,1
r1b1k2r/ppq2pp1/2nbpn1p/1Bp1N3/3P1B2/2P5/PP3PPP/RN1QR1K1 b kq - 0 11,cxd4,58,57,-1,1
r1b1k2r/ppq2pp1/2nbpn1p/1B2N3/3p1B2/2P5/PP3PPP/RN1QR1K1 w kq - 0 12,cxd4,62,33,-29,1
r1b1k2r/ppq2pp1/2nbpn1p/1B2N3/3P1B2/8/PP3PPP/RN1QR1K1 b kq - 0 12,O-O,31,45,14,1
r1b2rk1/ppq2pp1/2nbpn1p/1B2N3/3P1B2/8/PP3PPP/RN1QR1K1 w - - 1 13,Bxc6,66,45,-21,1
r1b2rk1/ppq2pp1/2Bbpn1p/4N3/3P1B2/8/PP3PPP/RN1QR1K1 b - - 0 13,bxc6,52,53,1,1
r1b2rk1/p1q2pp1/2pbpn1p/4N3/3P1B2/8/PP3PPP/RN1QR1K1 w - - 0 14,Nd2,62,60,-2,1
r1b2rk1/p1q2pp1/2pbpn1p/4N3/3P1B2/8/PP1N1PPP/R2QR1K1 b - - 1 14,Bb7,53,97,44,1
r4rk1/pbq2pp1/2pbpn1p/4N3/3P1B2/8/PP1N1PPP/R2QR1K1 w - - 2 15,Rc1,93,67,-26,1
r4rk1/pbq2pp1/2pbpn1p/4N3/3P1B2/8/PP1N1PPP/2RQR1K1 b - - 3 15,Rac8,49,91,42,1
2r2rk1/pbq2pp1/2pbpn1p/4N3/3P1B2/8/PP1N1PPP/2RQR1K1 w - - 4 16,Ndc4,111,99,-12,1
2r2rk1/pbq2pp1/2pbpn1p/4N3/2NP1B2/8/PP3PPP/2RQR1K1 b - - 5 16,Nd5,95,166,71,1
2r2rk1/pbq2pp1/2pbp2p/3nN3/2NP1B2/8/PP3PPP/2RQR1K1 w - - 6 17,Bg3,189,131,-58,1
2r2rk1/pbq2pp1/2pbp2p/3nN3/2NP4/6B1/PP3PPP/2RQR1K1 b - - 7 17,Nb4,152,373,221,1
2r2rk1/pbq2pp1/2pbp2p/4N3/1nNP4/6B1/PP3PPP/2RQR1K1 w - - 8 18,a3,344,354,10,1
2r2rk1/pbq2pp1/2pbp2p/4N3/1nNP4/P5B1/1P3PPP/2RQR1K1 b - - 0 18,Nd5,362,394,32,1
2r2rk1/pbq2pp1/2pbp2p/3nN3/2NP4/P5B1/1P3PPP/2RQR1K1 w - - 1 19,Qd2,397,142,-255,0
2r2rk1/pbq2pp1/2pbp2p/3nN3/2NP4/P5B1/1P1Q1PPP/2R1R1K1 b - - 2 19,f6,168,375,207,1
2r2rk1/pbq3p1/2pbpp1p/3nN3/2NP4/P5B1/1P1Q1PPP/2R1R1K1 w - - 0 20,Nxd6,340,335,-5,1
2r2rk1/pbq3p1/2pNpp1p/3nN3/3P4/P5B1/1P1Q1PPP/2R1R1K1 b - - 0 20,Qxd6,346,331,-15,1
2r2rk1/pb4p1/2pqpp1p/3nN3/3P4/P5B1/1P1Q1PPP/2R1R1K1 w - - 0 21,Ng6,339,333,-6,1
2r2rk1/pb4p1/2pqppNp/3n4/3P4/P5B1/1P1Q1PPP/2R1R1K1 b - - 1 21,Qd8,319,433,114,1
2rq1rk1/pb4p1/2p1ppNp/3n4/3P4/P5B1/1P1Q1PPP/2R1R1K1 w - - 2 22,Nxf8,430,420,-10,1
2rq1Nk1/pb4p1/2p1pp1p/3n4/3P4/P5B1/1P1Q1PPP/2R1R1K1 b - - 0 22,Qxf8,443,452,9,1
2r2qk1/pb4p1/2p1pp1p/3n4/3P4/P5B1/1P1Q1PPP/2R1R1K1 w - - 0 23,Rxe6,425,439,14,1
2r2qk1/pb4p1/2p1Rp1p/3n4/3P4/P5B1/1P1Q1PPP/2R3K1 b - - 0 23,Rd8,452,466,14,1
3r1qk1/pb4p1/2p1Rp1p/3n4/3P4/P5B1/1P1Q1PPP/2R3K1 w - - 1 24,Rce1,457,448,-9,1
3r1qk1/pb4p1/2p1Rp1p/3n4/3P4/P5B1/1P1Q1PPP/4R1K1 b - - 2 24,c5,441,467,26,1
3r1qk1/pb4p1/4Rp1p/2pn4/3P4/P5B1/1P1Q1PPP/4R1K1 w - - 0 25,dxc5,485,514,29,1
3r1qk1/pb4p1/4Rp1p/2Pn4/8/P5B1/1P1Q1PPP/4R1K1 b - - 0 25,Nc7,504,555,51,1
3r1qk1/pbn3p1/4Rp1p/2P5/8/P5B1/1P1Q1PPP/4R1K1 w - - 1 26,Rd6,592,557,-35,1
3r1qk1/pbn3p1/3R1p1p/2P5/8/P5B1/1P1Q1PPP/4R1K1 b - - 2 26,Nd5,561,590,29,1
3r1qk1/pb4p1/3R1p1p/2Pn4/8/P5B1/1P1Q1PPP/4R1K1 w - - 3 27,Rxd8,607,556,-51,1
3R1qk1/pb4p1/5p1p/2Pn4/8/P5B1/1P1Q1PPP/4R1K1 b - - 0 27,Qxd8,561,563,2,1
3q2k1/pb4p1/5p1p/2Pn4/8/P5B1/1P1Q1PPP/4R1K1 w - - 0 28,Bd6,554,529,-25,1
3q2k1/pb4p1/3B1p1p/2Pn4/8/P7/1P1Q1PPP/4R1K1 b - - 1 28,Qd7,537,535,-2,1
6k1/pb1q2p1/3B1p1p/2Pn4/8/P7/1P1Q1PPP/4R1K1 w - - 2 29,b4,532,453,-79,1
6k1/pb1q2p1/3B1p1p/2Pn4/1P6/P7/3Q1PPP/4R1K1 b - - 0 29,Qg4,507,533,26,1
6k1/pb4p1/3B1p1p/2Pn4/1P4q1/P7/3Q1PPP/4R1K1 w - - 1 30,h3,528,517,-11,1
6k1/pb4p1/3B1p1p/2Pn4/1P4q1/P6P/3Q1PP1/4R1K1 b - - 0 30,Qg6,494,527,33,1
6k1/pb4p1/3B1pqp/2Pn4/1P6/P6P/3Q1PP1/4R1K1 w - - 1 31,f4,564,456,-108,0
6k1/pb4p1/3B1pqp/2Pn4/1P3P2/P6P/3Q2P1/4R1K1 b - - 0 31,Qg3,479,429,-50,1
6k1/pb4p1/3B1p1p/2Pn4/1P3P2/P5qP/3Q2P1/4R1K1 w - - 1 32,Qf2,524,469,-55,1
6k1/pb4p1/3B1p1p/2Pn4/1P3P2/P5qP/5QP1/4R1K1 b - - 2 32,Qxa3,450,518,68,1
6k1/pb4p1/3B1p1p/2Pn4/1P3P2/q6P/5QP1/4R1K1 w - - 0 33,b5,461,447,-14,1
6k1/pb4p1/3B1p1p/1PPn4/5P2/q6P/5QP1/4R1K1 b - - 0 33,Qd3,466,495,29,1
6k1/pb4p1/3B1p1p/1PPn4/5P2/3q3P/5QP1/4R1K1 w - - 1 34,c6,504,504,0,1
6k1/pb4p1/2PB1p1p/1P1n4/5P2/3q3P/5QP1/4R1K1 b - - 0 34,Bc8,518,490,-28,1
2b3k1/p5p1/2PB1p1p/1P1n4/5P2/3q3P/5QP1/4R1K1 w - - 1 35,Re3,491,-300,-791,0
2b3k1/p5p1/2PB1p1p/1P1n4/5P2/3qR2P/5QP1/6K1 b - - 2 35,Qg6,-298,482,780,1
2b3k1/p5p1/2PB1pqp/1P1n4/5P2/4R2P/5QP1/6K1 w - - 3 36,Re8+,526,-142,-668,0
2b1R1k1/p5p1/2PB1pqp/1P1n4/5P2/7P/5QP1/6K1 b - - 4 36,Qxe8,-189,-177,12,1
2b1q1k1/p5p1/2PB1p1p/1P1n4/5P2/7P/5QP1/6K1 w - - 0 37,Kh2,-171,-214,-43,1
2b1q1k1/p5p1/2PB1p1p/1P1n4/5P2/7P/5QPK/8 b - - 1 37,Qe4,-219,-249,-30,1
2b3k1/p5p1/2PB1p1p/1P1n4/4qP2/7P/5QPK/8 w - - 2 38,Qd2,-244,-329,-85,1
2b3k1/p5p1/2PB1p1p/1P1n4/4qP2/7P/3Q2PK/8 b - - 3 38,Nb4,-356,221,577,1
2b3k1/p5p1/2PB1p1p/1P6/1n2qP2/7P/3Q2PK/8 w - - 4 39,Bxb4,185,11,-174,0
rnbqkbnr/pppppppp/8/8/8/8/PPPPPPPP/RNBQKBNR w KQkq - 0 1,e4,35,25,-10,1
rnbqkbnr/pppppppp/8/8/4P3/8/PPPP1PPP/RNBQKBNR b KQkq - 0 1,e5,30,19,-11,1
rnbqkbnr/pppp1ppp/8/4p3/4P3/8/PPPP1PPP/RNBQKBNR w KQkq - 0 2,d3,32,-18,-50,1
rnbqkbnr/pppp1ppp/8/4p3/4P3/3P4/PPP2PPP/RNBQKBNR b KQkq - 0 2,c5,-21,23,44,1
rnbqkbnr/pp1p1ppp/8/2p1p3/4P3/3P4/PPP2PPP/RNBQKBNR w KQkq - 0 3,Nc3,20,2,-18,1
rnbqkbnr/pp1p1ppp/8/2p1p3/4P3/2NP4/PPP2PPP/R1BQKBNR b KQkq - 1 3,Nf6,0,27,27,1
rnbqkb1r/pp1p1ppp/5n2/2p1p3/4P3/2NP4/PPP2PPP/R1BQKBNR w KQkq - 2 4,Nf3,29,-8,-37,1
rnbqkb1r/pp1p1ppp/5n2/2p1p3/4P3/2NP1N2/PPP2PPP/R1BQKB1R b KQkq - 3 4,h6,3,157,154,1
rnbqkb1r/pp1p1pp1/5n1p/2p1p3/4P3/2NP1N2/PPP2PPP/R1BQKB1R w KQkq - 0 5,Nxe5,171,133,-38,1
rnbqkb1r/pp1p1pp1/5n1p/2p1N3/4P3/2NP4/PPP2PPP/R1BQKB1R b KQkq - 0 5,Bd6,140,301,161,1
rnbqk2r/pp1p1pp1/3b1n1p/2p1N3/4P3/2NP4/PPP2PPP/R1BQKB1R w KQkq - 1 6,Nf3,296,157,-139,0
rnbqk2r/pp1p1pp1/3b1n1p/2p5/4P3/2NP1N2/PPP2PPP/R1BQKB1R b KQkq - 2 6,O-O,147,159,12,1
rnbq1rk1/pp1p1pp1/3b1n1p/2p5/4P3/2NP1N2/PPP2PPP/R1BQKB1R w KQ - 3 7,Be2,140,132,-8,1
rnbq1rk1/pp1p1pp1/3b1n1p/2p5/4P3/2NP1N2/PPP1BPPP/R1BQK2R b KQ - 4 7,Re8,135,140,5,1
rnbqr1k1/pp1p1pp1/3b1n1p/2p5/4P3/2NP1N2/PPP1BPPP/R1BQK2R w KQ - 5 8,O-O,140,138,-2,1
rnbqr1k1/pp1p1pp1/3b1n1p/2p5/4P3/2NP1N2/PPP1BPPP/R1BQ1RK1 b - - 6 8,c4,134,314,180,1
rnbqr1k1/pp1p1pp1/3b1n1p/8/2p1P3/2NP1N2/PPP1BPPP/R1BQ1RK1 w - - 0 9,Be3,304,217,-87,1
rnbqr1k1/pp1p1pp1/3b1n1p/8/2p1P3/2NPBN2/PPP1BPPP/R2Q1RK1 b - - 1 9,a6,207,320,113,1
rnbqr1k1/1p1p1pp1/p2b1n1p/8/2p1P3/2NPBN2/PPP1BPPP/R2Q1RK1 w - - 0 10,Bd4,317,182,-135,0
rnbqr1k1/1p1p1pp1/p2b1n1p/8/2pBP3/2NP1N2/PPP1BPPP/R2Q1RK1 b - - 1 10,Qc7,174,444,270,1
rnb1r1k1/1pqp1pp1/p2b1n1p/8/2pBP3/2NP1N2/PPP1BPPP/R2Q1RK1 w - - 2 11,dxc4,419,459,40,1
rnb1r1k1/1pqp1pp1/p2b1n1p/8/2PBP3/2N2N2/PPP1BPPP/R2Q1RK1 b - - 0 11,Nc6,466,455,-11,1
r1b1r1k1/1pqp1pp1/p1nb1n1p/8/2PBP3/2N2N2/PPP1BPPP/R2Q1RK1 w - - 1 12,Bxf6,490,486,-4,1
r1b1r1k1/1pqp1pp1/p1nb1B1p/8/2P1P3/2N2N2/PPP1BPPP/R2Q1RK1 b - - 0 12,gxf6,477,465,-12,1
r1b1r1k1/1pqp1p2/p1nb1p1p/8/2P1P3/2N2N2/PPP1BPPP/R2Q1RK1 w - - 0 13,a3,453,462,9,1
r1b1r1k1/1pqp1p2/p1nb1p1p/8/2P1P3/P1N2N2/1PP1BPPP/R2Q1RK1 b - - 0 13,Kh7,437,517,80,1
r1b1r3/1pqp1p1k/p1nb1p1p/8/2P1P3/P1N2N2/1PP1BPPP/R2Q1RK1 w - - 1 14,Bd3,524,516,-8,1
r1b1r3/1pqp1p1k/p1nb1p1p/8/2P1P3/P1NB1N2/1PP2PPP/R2Q1RK1 b - - 2 14,Ne5,508,500,-8,1
r1b1r3/1pqp1p1k/p2b1p1p/4n3/2P1P3/P1NB1N2/1PP2PPP/R2Q1RK1 w - - 3 15,Nxe5,498,491,-7,1
r1b1r3/1pqp1p1k/p2b1p1p/4N3/2P1P3/P1NB4/1PP2PPP/R2Q1RK1 b - - 0 15,Bxe5,478,542,64,1
r1b1r3/1pqp1p1k/p4p1p/4b3/2P1P3/P1NB4/1PP2PPP/R2Q1RK1 w - - 0 16,Qd2,525,383,-142,0
r1b1r3/1pqp1p1k/p4p1p/4b3/2P1P3/P1NB4/1PPQ1PPP/R4RK1 b - - 1 16,Rg8,420,424,4,1
r1b3r1/1pqp1p1k/p4p1p/4b3/2P1P3/P1NB4/1PPQ1PPP/R4RK1 w - - 2 17,g3,431,381,-50,1
r1b3r1/1pqp1p1k/p4p1p/4b3/2P1P3/P1NB2P1/1PPQ1P1P/R4RK1 b - - 0 17,Bxc3,379,408,29,1
r1b3r1/1pqp1p1k/p4p1p/8/2P1P3/P1bB2P1/1PPQ1P1P/R4RK1 w - - 0 18,Qxc3,387,371,-16,1
r1b3r1/1pqp1p1k/p4p1p/8/2P1P3/P1QB2P1/1PP2P1P/R4RK1 b - - 0 18,d6,384,507,123,1
r1b3r1/1pq2p1k/p2p1p1p/8/2P1P3/P1QB2P1/1PP2P1P/R4RK1 w - - 0 19,e5+,553,419,-134,0
r1b3r1/1pq2p1k/p2p1p1p/4P3/2P5/P1QB2P1/1PP2P1P/R4RK1 b - - 0 19,f5,466,457,-9,1
r1b3r1/1pq2p1k/p2p3p/4Pp2/2P5/P1QB2P1/1PP2P1P/R4RK1 w - - 0 20,exd6,464,412,-52,1
r1b3r1/1pq2p1k/p2P3p/5p2/2P5/P1QB2P1/1PP2P1P/R4RK1 b - - 0 20,Qxd6,443,431,-12,1
r1b3r1/1p3p1k/p2q3p/5p2/2P5/P1QB2P1/1PP2P1P/R4RK1 w - - 0 21,c5,445,404,-41,1
r1b3r1/1p3p1k/p2q3p/2P2p2/8/P1QB2P1/1PP2P1P/R4RK1 b - - 0 21,Qc6,372,432,60,1
r1b3r1/1p3p1k/p1q4p/2P2p2/8/P1QB2P1/1PP2P1P/R4RK1 w - - 1 22,Qc4,433,367,-66,1
r1b3r1/1p3p1k/p1q4p/2P2p2/2Q5/P2B2P1/1PP2P1P/R4RK1 b - - 2 22,Be6,341,408,67,1
r5r1/1p3p1k/p1q1b2p/2P2p2/2Q5/P2B2P1/1PP2P1P/R4RK1 w - - 3 23,Qf4,489,387,-102,0
r5r1/1p3p1k/p1q1b2p/2P2p2/5Q2/P2B2P1/1PP2P1P/R4RK1 b - - 4 23,Rg5,383,407,24,1
r7/1p3p1k/p1q1b2p/2P2pr1/5Q2/P2B2P1/1PP2P1P/R4RK1 w - - 5 24,b4,402,381,-21,1
r7/1p3p1k/p1q1b2p/2P2pr1/1P3Q2/P2B2P1/2P2P1P/R4RK1 b - - 0 24,Rag8,382,431,49,1
6r1/1p3p1k/p1q1b2p/2P2pr1/1P3Q2/P2B2P1/2P2P1P/R4RK1 w - - 1 25,h4,443,138,-305,0
6r1/1p3p1k/p1q1b2p/2P2pr1/1P3Q1P/P2B2P1/2P2P2/R4RK1 b - - 0 25,Rh5,50,417,367,1
6r1/1p3p1k/p1q1b2p/2P2p1r/1P3Q1P/P2B2P1/2P2P2/R4RK1 w - - 1 26,Be2,402,409,7,1
6r1/1p3p1k/p1q1b2p/2P2p1r/1P3Q1P/P5P1/2P1BP2/R4RK1 b - - 2 26,Rg4,442,490,48,1
8/1p3p1k/p1q1b2p/2P2p1r/1P3QrP/P5P1/2P1BP2/R4RK1 w - - 3 27,Bxg4,511,510,-1,1
8/1p3p1k/p1q1b2p/2P2p1r/1P3QBP/P5P1/2P2P2/R4RK1 b - - 0 27,fxg4,473,475,2,1
8/1p3p1k/p1q1b2p/2P4r/1P3QpP/P5P1/2P2P2/R4RK1 w - - 0 28,Rfe1,466,486,20,1
8/1p3p1k/p1q1b2p/2P4r/1P3QpP/P5P1/2P2P2/R3R1K1 b - - 1 28,Rf5,480,480,0,1
8/1p3p1k/p1q1b2p/2P2r2/1P3QpP/P5P1/2P2P2/R3R1K1 w - - 2 29,Qxg4,506,400,-106,0
8/1p3p1k/p1q1b2p/2P2r2/1P4QP/P5P1/2P2P2/R3R1K1 b - - 0 29,Rxf2,362,384,22,1
8/1p3p1k/p1q1b2p/2P5/1P4QP/P5P1/2P2r2/R3R1K1 w - - 0 30,Qe4+,352,356,4,1
8/1p3p1k/p1q1b2p/2P5/1P2Q2P/P5P1/2P2r2/R3R1K1 b - - 1 30,Qxe4,362,373,11,1
8/1p3p1k/p3b2p/2P5/1P2q2P/P5P1/2P2r2/R3R1K1 w - - 0 31,Rxe4,377,379,2,1
8/1p3p1k/p3b2p/2P5/1P2R2P/P5P1/2P2r2/R5K1 b - - 0 31,Rxc2,400,360,-40,1
8/1p3p1k/p3b2p/2P5/1P2R2P/P5P1/2r5/R5K1 w - - 0 32,Rd4,367,365,-2,1
8/1p3p1k/p3b2p/2P5/1P1R3P/P5P1/2r5/R5K1 b - - 1 32,Bh3,352,366,14,1
8/1p3p1k/p6p/2P5/1P1R3P/P5Pb/2r5/R5K1 w - - 2 33,Kh1,358,340,-18,1
8/1p3p1k/p6p/2P5/1P1R3P/P5Pb/2r5/R6K b - - 3 33,Bg2+,332,365,33,1
8/1p3p1k/p6p/2P5/1P1R3P/P5P1/2r3b1/R6K w - - 4 34,Kh2,387,268,-119,0
8/1p3p1k/p6p/2P5/1P1R3P/P5P1/2r3bK/R7 b - - 5 34,Bf3+,290,368,78,1
8/1p3p1k/p6p/2P5/1P1R3P/P4bP1/2r4K/R7 w - - 6 35,Kh3,343,225,-118,0
8/1p3p1k/p6p/2P5/1P1R3P/P4bPK/2r5/R7 b - - 7 35,h5,195,225,30,1
8/1p3p1k/p7/2P4p/1P1R3P/P4bPK/2r5/R7 w - - 0 36,Rf1,242,-482,-724,0
8/1p3p1k/p7/2P4p/1P1R3P/P4bPK/2r5/5R2 b - - 1 36,Bg2+,-459,-477,-18,1
8/1p3p1k/p7/2P4p/1P1R3P/P5PK/2r3b1/5R2 w - - 2 37,Kh2,-485,-476,9,1
8/1p3p1k/p7/2P4p/1P1R3P/P5P1/2r3bK/5R2 b - - 3 37,Bxf1+,-461,-462,-1,1
8/1p3p1k/p7/2P4p/1P1R3P/P5P1/2r4K/5b2 w - - 0 38,Kg1,-464,-466,-2,1
8/1p3p1k/p7/2P4p/1P1R3P/P5P1/2r5/5bK1 b - - 1 38,Bh3,-445,-433,12,1
8/1p3p1k/p7/2P4p/1P1R3P/P5Pb/2r5/6K1 w - - 2 39,Rf4,-479,-496,-17,1
8/1p3p1k/p7/2P4p/1P3R1P/P5Pb/2r5/6K1 b - - 3 39,Rg2+,-499,-460,39,1
8/1p3p1k/p7/2P4p/1P3R1P/P5Pb/6r1/6K1 w - - 4 40,Kh1,-504,-497,7,1
8/1p3p1k/p7/2P4p/1P3R1P/P5Pb/6r1/7K b - - 5 40,Kg6,-507,-510,-3,1
8/1p3p2/p5k1/2P4p/1P3R1P/P5Pb/6r1/7K w - - 6 41,Rd4,-485,-466,19,1
8/1p3p2/p5k1/2P4p/1P1R3P/P5Pb/6r1/7K b - - 7 41,Rxg3,-501,-484,17,1
8/1p3p2/p5k1/2P4p/1P1R3P/P5rb/8/7K w - - 0 42,Kh2,-507,-549,-42,1
8/1p3p2/p5k1/2P4p/1P1R3P/P5rb/7K/8 b - - 1 42,Rxa3,-541,-479,62,1
8/1p3p2/p5k1/2P4p/1P1R3P/r6b/7K/8 w - - 0 43,Re4,-511,-535,-24,1
rnbqkbnr/pppppppp/8/8/8/8/PPPPPPPP/RNBQKBNR w KQkq - 0 1,e4,35,20,-15,1
rnbqkbnr/pppppppp/8/8/4P3/8/PPPP1PPP/RNBQKBNR b KQkq - 0 1,e6,27,65,38,1
rnbqkbnr/pppp1ppp/4p3/8/4P3/8/PPPP1PPP/RNBQKBNR w KQkq - 0 2,Nf3,55,0,-55,1
rnbqkbnr/pppp1ppp/4p3/8/4P3/5N2/PPPP1PPP/RNBQKB1R b KQkq - 1 2,c6,5,83,78,1
rnbqkbnr/pp1p1ppp/2p1p3/8/4P3/5N2/PPPP1PPP/RNBQKB1R w KQkq - 0 3,Nc3,90,98,8,1
rnbqkbnr/pp1p1ppp/2p1p3/8/4P3/2N2N2/PPPP1PPP/R1BQKB1R b KQkq - 1 3,d5,108,107,-1,1
rnbqkbnr/pp3ppp/2p1p3/3p4/4P3/2N2N2/PPPP1PPP/R1BQKB1R w KQkq - 0 4,d4,101,98,-3,1
rnbqkbnr/pp3ppp/2p1p3/3p4/3PP3/2N2N2/PPP2PPP/R1BQKB1R b KQkq - 0 4,dxe4,89,104,15,1
rnbqkbnr/pp3ppp/2p1p3/8/3Pp3/2N2N2/PPP2PPP/R1BQKB1R w KQkq - 0 5,Nxe4,121,127,6,1
rnbqkbnr/pp3ppp/2p1p3/8/3PN3/5N2/PPP2PPP/R1BQKB1R b KQkq - 0 5,Nf6,125,157,32,1
rnbqkb1r/pp3ppp/2p1pn2/8/3PN3/5N2/PPP2PPP/R1BQKB1R w KQkq - 1 6,Bg5,158,95,-63,1
rnbqkb1r/pp3ppp/2p1pn2/6B1/3PN3/5N2/PPP2PPP/R2QKB1R b KQkq - 2 6,Be7,92,93,1,1
rnbqk2r/pp2bppp/2p1pn2/6B1/3PN3/5N2/PPP2PPP/R2QKB1R w KQkq - 3 7,Nxf6+,99,104,5,1
rnbqk2r/pp2bppp/2p1pN2/6B1/3P4/5N2/PPP2PPP/R2QKB1R b KQkq - 0 7,Bxf6,106,89,-17,1
rnbqk2r/pp3ppp/2p1pb2/6B1/3P4/5N2/PPP2PPP/R2QKB1R w KQkq - 0 8,Bf4,102,57,-45,1
rnbqk2r/pp3ppp/2p1pb2/8/3P1B2/5N2/PPP2PPP/R2QKB1R b KQkq - 1 8,Qb6,71,87,16,1
rnb1k2r/pp3ppp/1qp1pb2/8/3P1B2/5N2/PPP2PPP/R2QKB1R w KQkq - 2 9,b3,96,-30,-126,0
rnb1k2r/pp3ppp/1qp1pb2/8/3P1B2/1P3N2/P1P2PPP/R2QKB1R b KQkq - 0 9,Qb4+,-28,120,148,1
rnb1k2r/pp3ppp/2p1pb2/8/1q1P1B2/1P3N2/P1P2PPP/R2QKB1R w KQkq - 1 10,Qd2,53,22,-31,1
rnb1k2r/pp3ppp/2p1pb2/8/1q1P1B2/1P3N2/P1PQ1PPP/R3KB1R b KQkq - 2 10,Qxd2+,21,33,12,1
rnb1k2r/pp3ppp/2p1pb2/8/3P1B2/1P3N2/P1Pq1PPP/R3KB1R w KQkq - 0 11,Bxd2,19,17,-2,1
rnb1k2r/pp3ppp/2p1pb2/8/3P4/1P3N2/P1PB1PPP/R3KB1R b KQkq - 0 11,O-O,11,40,29,1
rnb2rk1/pp3ppp/2p1pb2/8/3P4/1P3N2/P1PB1PPP/R3KB1R w KQ - 1 12,Bd3,40,-6,-46,1
rnb2rk1/pp3ppp/2p1pb2/8/3P4/1P1B1N2/P1PB1PPP/R3K2R b KQ - 2 12,Rd8,-10,51,61,1
rnbr2k1/pp3ppp/2p1pb2/8/3P4/1P1B1N2/P1PB1PPP/R3K2R w KQ - 3 13,c3,46,-4,-50,1
rnbr2k1/pp3ppp/2p1pb2/8/3P4/1PPB1N2/P2B1PPP/R3K2R b KQ - 0 13,c5,-9,-17,-8,1
rnbr2k1/pp3ppp/4pb2/2p5/3P4/1PPB1N2/P2B1PPP/R3K2R w KQ - 0 14,O-O,-8,-93,-85,1
rnbr2k1/pp3ppp/4pb2/2p5/3P4/1PPB1N2/P2B1PPP/R4RK1 b - - 1 14,cxd4,-89,-84,5,1
rnbr2k1/pp3ppp/4pb2/8/3p4/1PPB1N2/P2B1PPP/R4RK1 w - - 0 15,c4,-84,-142,-58,1
rnbr2k1/pp3ppp/4pb2/8/2Pp4/1P1B1N2/P2B1PPP/R4RK1 b - - 0 15,Nc6,-172,-68,104,1
r1br2k1/pp3ppp/2n1pb2/8/2Pp4/1P1B1N2/P2B1PPP/R4RK1 w - - 1 16,a3,-65,-139,-74,1
r1br2k1/pp3ppp/2n1pb2/8/2Pp4/PP1B1N2/3B1PPP/R4RK1 b - - 0 16,b6,-149,-134,15,1
r1br2k1/p4ppp/1pn1pb2/8/2Pp4/PP1B1N2/3B1PPP/R4RK1 w - - 0 17,Bc1,-131,-214,-83,1
r1br2k1/p4ppp/1pn1pb2/8/2Pp4/PP1B1N2/5PPP/R1B2RK1 b - - 1 17,Bb7,-200,-187,13,1
r2r2k1/pb3ppp/1pn1pb2/8/2Pp4/PP1B1N2/5PPP/R1B2RK1 w - - 2 18,Bb2,-195,-222,-27,1
r2r2k1/pb3ppp/1pn1pb2/8/2Pp4/PP1B1N2/1B3PPP/R4RK1 b - - 3 18,Rd7,-237,-178,59,1
r5k1/pb1r1ppp/1pn1pb2/8/2Pp4/PP1B1N2/1B3PPP/R4RK1 w - - 4 19,Rad1,-198,-200,-2,1
r5k1/pb1r1ppp/1pn1pb2/8/2Pp4/PP1B1N2/1B3PPP/3R1RK1 b - - 5 19,Rad8,-190,-187,3,1
3r2k1/pb1r1ppp/1pn1pb2/8/2Pp4/PP1B1N2/1B3PPP/3R1RK1 w - - 6 20,Rfe1,-175,-163,12,1
3r2k1/pb1r1ppp/1pn1pb2/8/2Pp4/PP1B1N2/1B3PPP/3RR1K1 b - - 7 20,Na5,-170,-114,56,1
3r2k1/pb1r1ppp/1p2pb2/n7/2Pp4/PP1B1N2/1B3PPP/3RR1K1 w - - 8 21,Bc2,-156,-537,-381,0
3r2k1/pb1r1ppp/1p2pb2/n7/2Pp4/PP3N2/1BB2PPP/3RR1K1 b - - 9 21,d3,-499,-544,-45,1
3r2k1/pb1r1ppp/1p2pb2/n7/2P5/PP1p1N2/1BB2PPP/3RR1K1 w - - 0 22,Bb1,-459,-560,-101,0
3r2k1/pb1r1ppp/1p2pb2/n7/2P5/PP1p1N2/1B3PPP/1B1RR1K1 b - - 1 22,Bxb2,-617,-572,45,1
3r2k1/pb1r1ppp/1p2p3/n7/2P5/PP1p1N2/1b3PPP/1B1RR1K1 w - - 0 23,b4,-614,-699,-85,1
3r2k1/pb1r1ppp/1p2p3/n7/1PP5/P2p1N2/1b3PPP/1B1RR1K1 b - - 0 23,Nxc4,-708,-741,-33,1
3r2k1/pb1r1ppp/1p2p3/8/1Pn5/P2p1N2/1b3PPP/1B1RR1K1 w - - 0 24,Re3,-722,-748,-26,1
3r2k1/pb1r1ppp/1p2p3/8/1Pn5/P2pRN2/1b3PPP/1B1R2K1 b - - 1 24,Nxe3,-796,-858,-62,1
3r2k1/pb1r1ppp/1p2p3/8/1P6/P2pnN2/1b3PPP/1B1R2K1 w - - 0 25,fxe3,-812,-792,20,1
rnbqkbnr/pppppppp/8/8/8/8/PPPPPPPP/RNBQKBNR w KQkq - 0 1,e4,35,29,-6,1
rnbqkbnr/pppppppp/8/8/4P3/8/PPPP1PPP/RNBQKBNR b KQkq - 0 1,e5,26,34,8,1
rnbqkbnr/pppp1ppp/8/4p3/4P3/8/PPPP1PPP/RNBQKBNR w KQkq - 0 2,Bc4,26,-10,-36,1
rnbqkbnr/pppp1ppp/8/4p3/2B1P3/8/PPPP1PPP/RNBQK1NR b KQkq - 1 2,Nc6,-15,32,47,1
r1bqkbnr/pppp1ppp/2n5/4p3/2B1P3/8/PPPP1PPP/RNBQK1NR w KQkq - 2 3,Qf3,28,-43,-71,1
r1bqkbnr/pppp1ppp/2n5/4p3/2B1P3/5Q2/PPPP1PPP/RNB1K1NR b KQkq - 3 3,Nf6,-34,-28,6,1
r1bqkb1r/pppp1ppp/2n2n2/4p3/2B1P3/5Q2/PPPP1PPP/RNB1K1NR w KQkq - 4 4,d4,-35,-310,-275,0
r1bqkb1r/pppp1ppp/2n2n2/4p3/2BPP3/5Q2/PPP2PPP/RNB1K1NR b KQkq - 0 4,h6,-341,-47,294,1
r1bqkb1r/pppp1pp1/2n2n1p/4p3/2BPP3/5Q2/PPP2PPP/RNB1K1NR w KQkq - 0 5,dxe5,-43,-138,-95,1
r1bqkb1r/pppp1pp1/2n2n1p/4P3/2B1P3/5Q2/PPP2PPP/RNB1K1NR b KQkq - 0 5,d5,-122,62,184,1
r1bqkb1r/ppp2pp1/2n2n1p/3pP3/2B1P3/5Q2/PPP2PPP/RNB1K1NR w KQkq d6 0 6,Bxd5,98,-52,-150,0
r1bqkb1r/ppp2pp1/2n2n1p/3BP3/4P3/5Q2/PPP2PPP/RNB1K1NR b KQkq - 0 6,Nd4,-47,168,215,1
r1bqkb1r/ppp2pp1/5n1p/3BP3/3nP3/5Q2/PPP2PPP/RNB1K1NR w KQkq - 1 7,Qd3,185,168,-17,1
r1bqkb1r/ppp2pp1/5n1p/3BP3/3nP3/3Q4/PPP2PPP/RNB1K1NR b KQkq - 2 7,c5,173,466,293,1
r1bqkb1r/pp3pp1/5n1p/2pBP3/3nP3/3Q4/PPP2PPP/RNB1K1NR w KQkq - 0 8,exf6,466,422,-44,1
r1bqkb1r/pp3pp1/5P1p/2pB4/3nP3/3Q4/PPP2PPP/RNB1K1NR b KQkq - 0 8,Qxf6,463,459,-4,1
r1b1kb1r/pp3pp1/5q1p/2pB4/3nP3/3Q4/PPP2PPP/RNB1K1NR w KQkq - 0 9,Qb5+,494,-507,-1001,0
r1b1kb1r/pp3pp1/5q1p/1QpB4/3nP3/8/PPP2PPP/RNB1K1NR b KQkq - 1 9,Bd7,-482,231,713,1
r3kb1r/pp1b1pp1/5q1p/1QpB4/3nP3/8/PPP2PPP/RNB1K1NR w KQkq - 2 10,Qxc5,304,-666,-970,0
r3kb1r/pp1b1pp1/5q1p/2QB4/3nP3/8/PPP2PPP/RNB1K1NR b KQkq - 0 10,b6,-718,293,1011,1
r3kb1r/p2b1pp1/1p3q1p/2QB4/3nP3/8/PPP2PPP/RNB1K1NR w KQkq - 0 11,Qc7,303,-105,-408,0
r3kb1r/p1Qb1pp1/1p3q1p/3B4/3nP3/8/PPP2PPP/RNB1K1NR b KQkq - 1 11,g5,-137,319,456,1
r3kb1r/p1Qb1p2/1p3q1p/3B2p1/3nP3/8/PPP2PPP/RNB1K1NR w KQkq - 0 12,e5,336,242,-94,1
r3kb1r/p1Qb1p2/1p3q1p/3BP1p1/3n4/8/PPP2PPP/RNB1K1NR b KQkq - 0 12,Qg6,214,323,109,1
r3kb1r/p1Qb1p2/1p4qp/3BP1p1/3n4/8/PPP2PPP/RNB1K1NR w KQkq - 1 13,e6,310,263,-47,1
r3kb1r/p1Qb1p2/1p2P1qp/3B2p1/3n4/8/PPP2PPP/RNB1K1NR b KQkq - 0 13,fxe6,256,334,78,1
r3kb1r/p1Qb4/1p2p1qp/3B2p1/3n4/8/PPP2PPP/RNB1K1NR w KQkq - 0 14,Bxe6,350,-467,-817,0
r3kb1r/p1Qb4/1p2B1qp/6p1/3n4/8/PPP2PPP/RNB1K1NR b KQkq - 0 14,Bxe6,-492,-479,13,1
r3kb1r/p1Q5/1p2b1qp/6p1/3n4/8/PPP2PPP/RNB1K1NR w KQkq - 0 15,Qc4,-471,-1007,-536,0
r3kb1r/p7/1p2b1qp/6p1/2Qn4/8/PPP2PPP/RNB1K1NR b KQkq - 1 15,Qf7,-922,333,1255,1
r3kb1r/p4q2/1p2b2p/6p1/2Qn4/8/PPP2PPP/RNB1K1NR w KQkq - 2 16,Qxd4,351,319,-32,1
r3kb1r/p4q2/1p2b2p/6p1/3Q4/8/PPP2PPP/RNB1K1NR b KQkq - 0 16,Rd8,323,511,188,1
3rkb1r/p4q2/1p2b2p/6p1/3Q4/8/PPP2PPP/RNB1K1NR w KQk - 1 17,Qxh8,522,500,-22,1
3rkb1Q/p4q2/1p2b2p/6p1/8/8/PPP2PPP/RNB1K1NR b KQ - 0 17,Bf5,515,584,69,1
3rkb1Q/p4q2/1p5p/5bp1/8/8/PPP2PPP/RNB1K1NR w KQ - 1 18,Nf3,590,544,-46,1
3rkb1Q/p4q2/1p5p/5bp1/8/5N2/PPP2PPP/RNB1K2R b KQ - 2 18,Bxc2,543,628,85,1
3rkb1Q/p4q2/1p5p/6p1/8/5N2/PPb2PPP/RNB1K2R w KQ - 0 19,O-O,652,621,-31,1
3rkb1Q/p4q2/1p5p/6p1/8/5N2/PPb2PPP/RNB2RK1 b - - 1 19,Bxb1,643,779,136,1
3rkb1Q/p4q2/1p5p/6p1/8/5N2/PP3PPP/RbB2RK1 w - - 0 20,Rxb1,750,711,-39,1
3rkb1Q/p4q2/1p5p/6p1/8/5N2/PP3PPP/1RB2RK1 b - - 0 20,Kd7,804,851,47,1
3r1b1Q/p2k1q2/1p5p/6p1/8/5N2/PP3PPP/1RB2RK1 w - - 1 21,Ne5+,836,847,11,1
3r1b1Q/p2k1q2/1p5p/4N1p1/8/8/PP3PPP/1RB2RK1 b - - 2 21,Ke6,878,909,31,1
3r1b1Q/p4q2/1p2k2p/4N1p1/8/8/PP3PPP/1RB2RK1 w - - 3 22,Nxf7,911,926,15,1
3r1b1Q/p4N2/1p2k2p/6p1/8/8/PP3PPP/1RB2RK1 b - - 0 22,Kxf7,926,936,10,1
3r1b1Q/p4k2/1p5p/6p1/8/8/PP3PPP/1RB2RK1 w - - 0 23,Qc3,938,877,-61,1
3r1b2/p4k2/1p5p/6p1/8/2Q5/PP3PPP/1RB2RK1 b - - 1 23,Re8,871,855,-16,1
4rb2/p4k2/1p5p/6p1/8/2Q5/PP3PPP/1RB2RK1 w - - 2 24,f4,882,761,-121,0
4rb2/p4k2/1p5p/6p1/5P2/2Q5/PP4PP/1RB2RK1 b - - 0 24,gxf4,764,945,181,1
4rb2/p4k2/1p5p/8/5p2/2Q5/PP4PP/1RB2RK1 w - - 0 25,Rxf4+,912,860,-52,1
4rb2/p4k2/1p5p/8/5R2/2Q5/PP4PP/1RB3K1 b - - 0 25,Kg8,905,941,36,1
4rbk1/p7/1p5p/8/5R2/2Q5/PP4PP/1RB3K1 w - - 1 26,Rg4+,928,1018,90,1
4rbk1/p7/1p5p/8/6R1/2Q5/PP4PP/1RB3K1 b - - 2 26,Kh7,1043,9993,8950,1
4rb2/p6k/1p5p/8/6R1/2Q5/PP4PP/1RB3K1 w - - 3 27,Qc7+,9993,790,-9203,0
4rb2/p1Q4k/1p5p/8/6R1/8/PP4PP/1RB3K1 b - - 4 27,Kh8,783,1040,257,1
4rb1k/p1Q5/1p5p/8/6R1/8/PP4PP/1RB3K1 w - - 5 28,Be3,9993,738,-9255,0
4rb1k/p1Q5/1p5p/8/6R1/4B3/PP4PP/1R4K1 b - - 6 28,h5,794,9997,9203,1
4rb1k/p1Q5/1p6/7p/6R1/4B3/PP4PP/1R4K1 w - - 0 29,Rg5,9997,9993,-4,1
4rb1k/p1Q5/1p6/6Rp/8/4B3/PP4PP/1R4K1 b - - 1 29,h4,9993,9997,4,1
4rb1k/p1Q5/1p6/6R1/7p/4B3/PP4PP/1R4K1 w - - 0 30,Rf1,9997,9997,0,1
4rb1k/p1Q5/1p6/6R1/7p/4B3/PP4PP/5RK1 b - - 1 30,h3,9997,9998,1,1
4rb1k/p1Q5/1p6/6R1/8/4B2p/PP4PP/5RK1 w - - 0 31,Bd4+,9998,9999,1,1
4rb1k/p1Q5/1p6/6R1/3B4/7p/PP4PP/5RK1 b - - 1 31,Bg7,9999,9999,0,1
4r2k/p1Q3b1/1p6/6R1/3B4/7p/PP4PP/5RK1 w - - 2 32,Rxg7,9999,9998,-1,1
4r2k/p1Q3R1/1p6/8/3B4/7p/PP4PP/5RK1 b - - 0 32,Rg8,9998,9999,1,1
6rk/p1Q3R1/1p6/8/3B4/7p/PP4PP/5RK1 w - - 1 33,Rxg8+,9999,9999,0,1
6Rk/p1Q5/1p6/8/3B4/7p/PP4PP/5RK1 b - - 0 33,Kxg8,9999,9999,0,1
6k1/p1Q5/1p6/8/3B4/7p/PP4PP/5RK1 w - - 0 34,Qg7#,9999,10000,1,1
rnbqkbnr/pppppppp/8/8/8/8/PPPPPPPP/RNBQKBNR w KQkq - 0 1,e4,31,29,-2,1
rnbqkbnr/pppppppp/8/8/4P3/8/PPPP1PPP/RNBQKBNR b KQkq - 0 1,c6,38,45,7,1
rnbqkbnr/pp1ppppp/2p5/8/4P3/8/PPPP1PPP/RNBQKBNR w KQkq - 0 2,Bc4,48,-38,-86,1
rnbqkbnr/pp1ppppp/2p5/8/2B1P3/8/PPPP1PPP/RNBQK1NR b KQkq - 1 2,d5,-43,-40,3,1
rnbqkbnr/pp2pppp/2p5/3p4/2B1P3/8/PPPP1PPP/RNBQK1NR w KQkq - 0 3,exd5,-41,-43,-2,1
rnbqkbnr/pp2pppp/2p5/3P4/2B5/8/PPPP1PPP/RNBQK1NR b KQkq - 0 3,cxd5,-41,-34,7,1
rnbqkbnr/pp2pppp/8/3p4/2B5/8/PPPP1PPP/RNBQK1NR w KQkq - 0 4,Bb3,-37,-35,2,1
rnbqkbnr/pp2pppp/8/3p4/8/1B6/PPPP1PPP/RNBQK1NR b KQkq - 1 4,e5,-37,1,38,1
rnbqkbnr/pp3ppp/8/3pp3/8/1B6/PPPP1PPP/RNBQK1NR w KQkq - 0 5,d4,9,-6,-15,1
rnbqkbnr/pp3ppp/8/3pp3/3P4/1B6/PPP2PPP/RNBQK1NR b KQkq - 0 5,Nc6,4,134,130,1
r1bqkbnr/pp3ppp/2n5/3pp3/3P4/1B6/PPP2PPP/RNBQK1NR w KQkq - 1 6,Nf3,90,-22,-112,0
r1bqkbnr/pp3ppp/2n5/3pp3/3P4/1B3N2/PPP2PPP/RNBQK2R b KQkq - 2 6,e4,-23,-24,-1,1
r1bqkbnr/pp3ppp/2n5/3p4/3Pp3/1B3N2/PPP2PPP/RNBQK2R w KQkq - 0 7,Nfd2,-4,-165,-161,0
r1bqkbnr/pp3ppp/2n5/3p4/3Pp3/1B6/PPPN1PPP/RNBQK2R b KQkq - 1 7,Nf6,-156,-116,40,1
r1bqkb1r/pp3ppp/2n2n2/3p4/3Pp3/1B6/PPPN1PPP/RNBQK2R w KQkq - 2 8,O-O,-114,-192,-78,1
r1bqkb1r/pp3ppp/2n2n2/3p4/3Pp3/1B6/PPPN1PPP/RNBQ1RK1 b kq - 3 8,Bd6,-200,-146,54,1
r1bqk2r/pp3ppp/2nb1n2/3p4/3Pp3/1B6/PPPN1PPP/RNBQ1RK1 w kq - 4 9,f4,-135,-339,-204,0
r1bqk2r/pp3ppp/2nb1n2/3p4/3PpP2/1B6/PPPN2PP/RNBQ1RK1 b kq f3 0 9,O-O,-364,-263,101,1
r1bq1rk1/pp3ppp/2nb1n2/3p4/3PpP2/1B6/PPPN2PP/RNBQ1RK1 w - - 1 10,f5,-286,-394,-108,0
r1bq1rk1/pp3ppp/2nb1n2/3p1P2/3Pp3/1B6/PPPN2PP/RNBQ1RK1 b - - 0 10,Qc7,-409,-293,116,1
r1b2rk1/ppq2ppp/2nb1n2/3p1P2/3Pp3/1B6/PPPN2PP/RNBQ1RK1 w - - 1 11,Nc3,-314,-303,11,1
r1b2rk1/ppq2ppp/2nb1n2/3p1P2/3Pp3/1BN5/PPPN2PP/R1BQ1RK1 b - - 2 11,Bxh2+,-289,-327,-38,1
r1b2rk1/ppq2ppp/2n2n2/3p1P2/3Pp3/1BN5/PPPN2Pb/R1BQ1RK1 w - - 0 12,Kh1,-318,-337,-19,1
r1b2rk1/ppq2ppp/2n2n2/3p1P2/3Pp3/1BN5/PPPN2Pb/R1BQ1R1K b - - 1 12,Nxd4,-319,-214,105,1
r1b2rk1/ppq2ppp/5n2/3p1P2/3np3/1BN5/PPPN2Pb/R1BQ1R1K w - - 0 13,Bxd5,-202,-228,-26,1
r1b2rk1/ppq2ppp/5n2/3B1P2/3np3/2N5/PPPN2Pb/R1BQ1R1K b - - 0 13,e3,-220,-216,4,1
r1b2rk1/ppq2ppp/5n2/3B1P2/3n4/2N1p3/PPPN2Pb/R1BQ1R1K w - - 0 14,Nde4,-220,-242,-22,1
r1b2rk1/ppq2ppp/5n2/3B1P2/3nN3/2N1p3/PPP3Pb/R1BQ1R1K b - - 1 14,Nxd5,-260,-249,11,1
r1b2rk1/ppq2ppp/8/3n1P2/3nN3/2N1p3/PPP3Pb/R1BQ1R1K w - - 0 15,Nxd5,-219,-332,-113,0
r1b2rk1/ppq2ppp/8/3N1P2/3nN3/4p3/PPP3Pb/R1BQ1R1K b - - 0 15,Qe5,-363,-163,200,1
r1b2rk1/pp3ppp/8/3NqP2/3nN3/4p3/PPP3Pb/R1BQ1R1K w - - 1 16,Nec3,-138,-375,-237,0
r1b2rk1/pp3ppp/8/3NqP2/3n4/2N1p3/PPP3Pb/R1BQ1R1K b - - 2 16,Bxf5,-347,306,653,1
r4rk1/pp3ppp/8/3Nqb2/3n4/2N1p3/PPP3Pb/R1BQ1R1K w - - 0 17,Nxe3,272,-344,-616,0
r4rk1/pp3ppp/8/4qb2/3n4/2N1N3/PPP3Pb/R1BQ1R1K b - - 0 17,Bg6,-281,0,281,1
r4rk1/pp3ppp/6b1/4q3/3n4/2N1N3/PPP3Pb/R1BQ1R1K w - - 1 18,Ng4,0,0,0,1
r4rk1/pp3ppp/6b1/4q3/3n2N1/2N5/PPP3Pb/R1BQ1R1K b - - 2 18,Qh5,0,0,0,1
r4rk1/pp3ppp/6b1/7q/3n2N1/2N5/PPP3Pb/R1BQ1R1K w - - 3 19,Qxd4,0,-727,-727,0
r4rk1/pp3ppp/6b1/7q/3Q2N1/2N5/PPP3Pb/R1B2R1K b - - 0 19,Be5+,-753,-724,29,1
r4rk1/pp3ppp/6b1/4b2q/3Q2N1/2N5/PPP3P1/R1B2R1K w - - 1 20,Kg1,-724,-724,0,1
r4rk1/pp3ppp/6b1/4b2q/3Q2N1/2N5/PPP3P1/R1B2RK1 b - - 2 20,Bxd4+,-741,-718,23,1
r4rk1/pp3ppp/6b1/7q/3b2N1/2N5/PPP3P1/R1B2RK1 w - - 0 21,Be3,-699,-745,-46,1
r4rk1/pp3ppp/6b1/7q/3b2N1/2N1B3/PPP3P1/R4RK1 b - - 1 21,Bxe3+,-788,-647,141,1
r4rk1/pp3ppp/6b1/7q/6N1/2N1b3/PPP3P1/R4RK1 w - - 0 22,Nxe3,-630,-642,-12,1
r4rk1/pp3ppp/6b1/7q/8/2N1N3/PPP3P1/R4RK1 b - - 0 22,Rfe8,-632,-606,26,1
r3r1k1/pp3ppp/6b1/7q/8/2N1N3/PPP3P1/R4RK1 w - - 1 23,Ned5,-618,-666,-48,1
r3r1k1/pp3ppp/6b1/3N3q/8/2N5/PPP3P1/R4RK1 b - - 2 23,Rac8,-619,-601,18,1
2r1r1k1/pp3ppp/6b1/3N3q/8/2N5/PPP3P1/R4RK1 w - - 3 24,Nb4,-586,-698,-112,0
2r1r1k1/pp3ppp/6b1/7q/1N6/2N5/PPP3P1/R4RK1 b - - 4 24,Qc5+,-642,-640,2,1
2r1r1k1/pp3ppp/6b1/2q5/1N6/2N5/PPP3P1/R4RK1 w - - 5 25,Kh1,-653,-753,-100,1
2r1r1k1/pp3ppp/6b1/2q5/1N6/2N5/PPP3P1/R4R1K b - - 6 25,Qxb4,-783,-760,23,1
2r1r1k1/pp3ppp/6b1/8/1q6/2N5/PPP3P1/R4R1K w - - 0 26,Nd5,-742,-851,-109,0
2r1r1k1/pp3ppp/6b1/3N4/1q6/8/PPP3P1/R4R1K b - - 1 26,Qh4+,-864,-829,35,1
2r1r1k1/pp3ppp/6b1/3N4/7q/8/PPP3P1/R4R1K w - - 2 27,Kg1,-863,-866,-3,1
2r1r1k1/pp3ppp/6b1/3N4/7q/8/PPP3P1/R4RK1 b - - 3 27,Qd4+,-870,-856,14,1
2r1r1k1/pp3ppp/6b1/3N4/3q4/8/PPP3P1/R4RK1 w - - 4 28,Ne3,-872,-920,-48,1
2r1r1k1/pp3ppp/6b1/8/3q4/4N3/PPP3P1/R4RK1 b - - 5 28,Qxe3+,-920,-934,-14,1
2r1r1k1/pp3ppp/6b1/8/8/4q3/PPP3P1/R4RK1 w - - 0 29,Kh1,-881,-920,-39,1
2r1r1k1/pp3ppp/6b1/8/8/4q3/PPP3P1/R4R1K b - - 1 29,Bxc2,-935,-942,-7,1
2r1r1k1/pp3ppp/8/8/8/4q3/PPb3P1/R4R1K w - - 0 30,Rac1,-964,-1109,-145,0
2r1r1k1/pp3ppp/8/8/8/4q3/PPb3P1/2R2R1K b - - 1 30,Be4,-1112,-1135,-23,1
2r1r1k1/pp3ppp/8/8/4b3/4q3/PP4P1/2R2R1K w - - 2 31,Rfe1,-1449,-9998,-8549,0
2r1r1k1/pp3ppp/8/8/4b3/4q3/PP4P1/2R1R2K b - - 3 31,Qh6+,-9998,-1146,8852,1
2r1r1k1/pp3ppp/7q/8/4b3/8/PP4P1/2R1R2K w - - 4 32,Kg1,-9991,-9991,0,1
2r1r1k1/pp3ppp/7q/8/4b3/8/PP4P1/2R1R1K1 b - - 5 32,Rxc1,-9991,-9992,-1,1
4r1k1/pp3ppp/7q/8/4b3/8/PP4P1/2r1R1K1 w - - 0 33,Rxc1,-9992,-9992,0,1
4r1k1/pp3ppp/7q/8/4b3/8/PP4P1/2R3K1 b - - 0 33,Qxc1+,-9994,-9995,-1,1
4r1k1/pp3ppp/8/8/4b3/8/PP4P1/2q3K1 w - - 0 34,Kf2,-9995,-9995,0,1
4r1k1/pp3ppp/8/8/4b3/8/PP3KP1/2q5 b - - 1 34,Qxb2+,-9996,-9994,2,1
4r1k1/pp3ppp/8/8/4b3/8/Pq3KP1/8 w - - 0 35,Ke3,-9994,-9995,-1,1
4r1k1/pp3ppp/8/8/4b3/4K3/Pq4P1/8 b - - 1 35,Qxa2,-9995,-1089,8906,1
4r1k1/pp3ppp/8/8/4b3/4K3/q5P1/8 w - - 0 36,Kf4,-9994,-9993,1,1
4r1k1/pp3ppp/8/8/4bK2/8/q5P1/8 b - - 1 36,Qxg2,-9994,-9995,-1,1
4r1k1/pp3ppp/8/8/4bK2/8/6q1/8 w - - 0 37,Ke3,-9993,-9995,-2,1
4r1k1/pp3ppp/8/8/4b3/4K3/6q1/8 b - - 1 37,Bc6+,-9995,-9995,0,1
4r1k1/pp3ppp/2b5/8/8/4K3/6q1/8 w - - 2 38,Kd4,-9996,-9996,0,1
4r1k1/pp3ppp/2b5/8/3K4/8/6q1/8 b - - 3 38,Re4+,-9996,-9996,0,1
6k1/pp3ppp/2b5/8/3Kr3/8/6q1/8 w - - 4 39,Kc5,-9996,-9998,-2,1
6k1/pp3ppp/2b5/2K5/4r3/8/6q1/8 b - - 5 39,Qg5+,-9998,-9999,-1,1
6k1/pp3ppp/2b5/2K3q1/4r3/8/8/8 w - - 6 40,Kd6,-9999,-9999,0,1
6k1/pp3ppp/2bK4/6q1/4r3/8/8/8 b - - 7 40,Re6+,-9999,-9998,1,1
6k1/pp3ppp/2bKr3/6q1/8/8/8/8 w - - 8 41,Kc7,-9998,-9998,0,1
6k1/ppK2ppp/2b1r3/6q1/8/8/8/8 b - - 9 41,Qe5+,-9998,-9999,-1,1
6k1/ppK2ppp/2b1r3/4q3/8/8/8/8 w - - 10 42,Kc8,-9999,-9999,0,1
2K3k1/pp3ppp/2b1r3/4q3/8/8/8/8 b - - 11 42,Re8#,-9999,-10000,-1,1
rnbqkbnr/pppppppp/8/8/8/8/PPPPPPPP/RNBQKBNR w KQkq - 0 1,e4,38,31,-7,1
rnbqkbnr/pppppppp/8/8/4P3/8/PPPP1PPP/RNBQKBNR b KQkq - 0 1,e5,43,45,2,1
rnbqkbnr/pppp1ppp/8/4p3/4P3/8/PPPP1PPP/RNBQKBNR w KQkq - 0 2,d3,47,-18,-65,1
rnbqkbnr/pppp1ppp/8/4p3/4P3/3P4/PPP2PPP/RNBQKBNR b KQkq - 0 2,d6,-15,7,22,1
rnbqkbnr/ppp2ppp/3p4/4p3/4P3/3P4/PPP2PPP/RNBQKBNR w KQkq - 0 3,Nf3,20,2,-18,1
rnbqkbnr/ppp2ppp/3p4/4p3/4P3/3P1N2/PPP2PPP/RNBQKB1R b KQkq - 1 3,Nf6,7,7,0,1
rnbqkb1r/ppp2ppp/3p1n2/4p3/4P3/3P1N2/PPP2PPP/RNBQKB1R w KQkq - 2 4,Nc3,11,9,-2,1
rnbqkb1r/ppp2ppp/3p1n2/4p3/4P3/2NP1N2/PPP2PPP/R1BQKB1R b KQkq - 3 4,Be7,12,8,-4,1
rnbqk2r/ppp1bppp/3p1n2/4p3/4P3/2NP1N2/PPP2PPP/R1BQKB1R w KQkq - 4 5,Bg5,26,-29,-55,1
rnbqk2r/ppp1bppp/3p1n2/4p1B1/4P3/2NP1N2/PPP2PPP/R2QKB1R b KQkq - 5 5,O-O,-42,-40,2,1
rnbq1rk1/ppp1bppp/3p1n2/4p1B1/4P3/2NP1N2/PPP2PPP/R2QKB1R w KQ - 6 6,h3,-31,-38,-7,1
rnbq1rk1/ppp1bppp/3p1n2/4p1B1/4P3/2NP1N1P/PPP2PP1/R2QKB1R b KQ - 0 6,h6,-34,-43,-9,1
rnbq1rk1/ppp1bpp1/3p1n1p/4p1B1/4P3/2NP1N1P/PPP2PP1/R2QKB1R w KQ - 0 7,Bxf6,-40,-48,-8,1
rnbq1rk1/ppp1bpp1/3p1B1p/4p3/4P3/2NP1N1P/PPP2PP1/R2QKB1R b KQ - 0 7,Bxf6,-56,-53,3,1
rnbq1rk1/ppp2pp1/3p1b1p/4p3/4P3/2NP1N1P/PPP2PP1/R2QKB1R w KQ - 0 8,h4,-46,-105,-59,1
rnbq1rk1/ppp2pp1/3p1b1p/4p3/4P2P/2NP1N2/PPP2PP1/R2QKB1R b KQ - 0 8,Nc6,-83,-41,42,1
r1bq1rk1/ppp2pp1/2np1b1p/4p3/4P2P/2NP1N2/PPP2PP1/R2QKB1R w KQ - 1 9,h5,-40,-135,-95,1
r1bq1rk1/ppp2pp1/2np1b1p/4p2P/4P3/2NP1N2/PPP2PP1/R2QKB1R b KQ - 0 9,Be6,-142,-124,18,1
r2q1rk1/ppp2pp1/2npbb1p/4p2P/4P3/2NP1N2/PPP2PP1/R2QKB1R w KQ - 1 10,Nd2,-130,-144,-14,1
r2q1rk1/ppp2pp1/2npbb1p/4p2P/4P3/2NP4/PPPN1PP1/R2QKB1R b KQ - 2 10,d5,-147,-32,115,1
r2q1rk1/ppp2pp1/2n1bb1p/3pp2P/4P3/2NP4/PPPN1PP1/R2QKB1R w KQ - 0 11,exd5,-36,-37,-1,1
r2q1rk1/ppp2pp1/2n1bb1p/3Pp2P/8/2NP4/PPPN1PP1/R2QKB1R b KQ - 0 11,Bxd5,-41,-26,15,1
r2q1rk1/ppp2pp1/2n2b1p/3bp2P/8/2NP4/PPPN1PP1/R2QKB1R w KQ - 0 12,Nxd5,-12,-25,-13,1
r2q1rk1/ppp2pp1/2n2b1p/3Np2P/8/3P4/PPPN1PP1/R2QKB1R b KQ - 0 12,Qxd5,-26,-23,3,1
r4rk1/ppp2pp1/2n2b1p/3qp2P/8/3P4/PPPN1PP1/R2QKB1R w KQ - 0 13,g4,-22,-533,-511,0
r4rk1/ppp2pp1/2n2b1p/3qp2P/6P1/3P4/PPPN1P2/R2QKB1R b KQ - 0 13,e4,-475,-137,338,1
r4rk1/ppp2pp1/2n2b1p/3q3P/4p1P1/3P4/PPPN1P2/R2QKB1R w KQ - 0 14,dxe4,-126,-177,-51,1
r4rk1/ppp2pp1/2n2b1p/3q3P/4P1P1/8/PPPN1P2/R2QKB1R b KQ - 0 14,Rfe8,-173,-119,54,1
r3r1k1/ppp2pp1/2n2b1p/3q3P/4P1P1/8/PPPN1P2/R2QKB1R w KQ - 1 15,Be2,-163,-207,-44,1
r3r1k1/ppp2pp1/2n2b1p/3q3P/4P1P1/8/PPPNBP2/R2QK2R b KQ - 2 15,Qc5,-223,-160,63,1
r3r1k1/ppp2pp1/2n2b1p/2q4P/4P1P1/8/PPPNBP2/R2QK2R w KQ - 3 16,c3,-156,-212,-56,1
r3r1k1/ppp2pp1/2n2b1p/2q4P/4P1P1/2P5/PP1NBP2/R2QK2R b KQ - 0 16,Rad8,-228,-235,-7,1
3rr1k1/ppp2pp1/2n2b1p/2q4P/4P1P1/2P5/PP1NBP2/R2QK2R w KQ - 1 17,Qc2,-242,-267,-25,1
3rr1k1/ppp2pp1/2n2b1p/2q4P/4P1P1/2P5/PPQNBP2/R3K2R b KQ - 2 17,Bg5,-290,-101,189,1
3rr1k1/ppp2pp1/2n4p/2q3bP/4P1P1/2P5/PPQNBP2/R3K2R w KQ - 3 18,O-O-O,-70,-460,-390,0
3rr1k1/ppp2pp1/2n4p/2q3bP/4P1P1/2P5/PPQNBP2/2KR3R b - - 4 18,Bxd2+,-459,-138,321,1
3rr1k1/ppp2pp1/2n4p/2q4P/4P1P1/2P5/PPQbBP2/2KR3R w - - 0 19,Rxd2,-145,-92,53,1
3rr1k1/ppp2pp1/2n4p/2q4P/4P1P1/2P5/PPQRBP2/2K4R b - - 0 19,Rxd2,-102,-38,64,1
4r1k1/ppp2pp1/2n4p/2q4P/4P1P1/2P5/PPQrBP2/2K4R w - - 0 20,Qxd2,-41,-48,-7,1
4r1k1/ppp2pp1/2n4p/2q4P/4P1P1/2P5/PP1QBP2/2K4R b - - 0 20,Rxe4,-41,0,41,1
6k1/ppp2pp1/2n4p/2q4P/4r1P1/2P5/PP1QBP2/2K4R w - - 0 21,Bf3,3,3,0,1
6k1/ppp2pp1/2n4p/2q4P/4r1P1/2P2B2/PP1Q1P2/2K4R b - - 1 21,Re8,0,2,2,1
4r1k1/ppp2pp1/2n4p/2q4P/6P1/2P2B2/PP1Q1P2/2K4R w - - 2 22,Bxc6,0,-20,-20,1
4r1k1/ppp2pp1/2B4p/2q4P/6P1/2P5/PP1Q1P2/2K4R b - - 0 22,Qxc6,-7,-11,-4,1
4r1k1/ppp2pp1/2q4p/7P/6P1/2P5/PP1Q1P2/2K4R w - - 0 23,Kb1,-8,-745,-737,0
4r1k1/ppp2pp1/2q4p/7P/6P1/2P5/PP1Q1P2/1K5R b - - 1 23,Qxh1+,-722,-705,17,1
4r1k1/ppp2pp1/7p/7P/6P1/2P5/PP1Q1P2/1K5q w - - 0 24,Kc2,-716,-697,19,1
4r1k1/ppp2pp1/7p/7P/6P1/2P5/PPKQ1P2/7q b - - 1 24,Qe4+,-694,-675,19,1
4r1k1/ppp2pp1/7p/7P/4q1P1/2P5/PPKQ1P2/8 w - - 2 25,Kc1,-693,-724,-31,1
4r1k1/ppp2pp1/7p/7P/4q1P1/2P5/PP1Q1P2/2K5 b - - 3 25,Qe1+,-724,-574,150,1
4r1k1/ppp2pp1/7p/7P/6P1/2P5/PP1Q1P2/2K1q3 w - - 4 26,Kc2,-583,-701,-118,0
4r1k1/ppp2pp1/7p/7P/6P1/2P5/PPKQ1P2/4q3 b - - 5 26,Qxd2+,-690,-602,88,1
4r1k1/ppp2pp1/7p/7P/6P1/2P5/PPKq1P2/8 w - - 0 27,Kb3,-617,-987,-370,0
rnbqkbnr/pppppppp/8/8/8/8/PPPPPPPP/RNBQKBNR w KQkq - 0 1,e4,48,37,-11,1
rnbqkbnr/pppppppp/8/8/4P3/8/PPPP1PPP/RNBQKBNR b KQkq - 0 1,e5,35,26,-9,1
rnbqkbnr/pppp1ppp/8/4p3/4P3/8/PPPP1PPP/RNBQKBNR w KQkq - 0 2,Nf3,37,30,-7,1
rnbqkbnr/pppp1ppp/8/4p3/4P3/5N2/PPPP1PPP/RNBQKB1R b KQkq - 1 2,d6,28,57,29,1
rnbqkbnr/ppp2ppp/3p4/4p3/4P3/5N2/PPPP1PPP/RNBQKB1R w KQkq - 0 3,d4,77,65,-12,1
rnbqkbnr/ppp2ppp/3p4/4p3/3PP3/5N2/PPP2PPP/RNBQKB1R b KQkq - 0 3,exd4,62,83,21,1
rnbqkbnr/ppp2ppp/3p4/8/3pP3/5N2/PPP2PPP/RNBQKB1R w KQkq - 0 4,Nxd4,77,72,-5,1
rnbqkbnr/ppp2ppp/3p4/8/3NP3/8/PPP2PPP/RNBQKB1R b KQkq - 0 4,h6,55,107,52,1
rnbqkbnr/ppp2pp1/3p3p/8/3NP3/8/PPP2PPP/RNBQKB1R w KQkq - 0 5,Nc3,112,110,-2,1
rnbqkbnr/ppp2pp1/3p3p/8/3NP3/2N5/PPP2PPP/R1BQKB1R b KQkq - 1 5,a6,97,121,24,1
rnbqkbnr/1pp2pp1/p2p3p/8/3NP3/2N5/PPP2PPP/R1BQKB1R w KQkq - 0 6,Qf3,123,85,-38,1
rnbqkbnr/1pp2pp1/p2p3p/8/3NP3/2N2Q2/PPP2PPP/R1B1KB1R b KQkq - 1 6,Nf6,99,104,5,1
rnbqkb1r/1pp2pp1/p2p1n1p/8/3NP3/2N2Q2/PPP2PPP/R1B1KB1R w KQkq - 2 7,Bc4,109,67,-42,1
rnbqkb1r/1pp2pp1/p2p1n1p/8/2BNP3/2N2Q2/PPP2PPP/R1B1K2R b KQkq - 3 7,Bg4,56,137,81,1
rn1qkb1r/1pp2pp1/p2p1n1p/8/2BNP1b1/2N2Q2/PPP2PPP/R1B1K2R w KQkq - 4 8,Qf4,166,78,-88,1
rn1qkb1r/1pp2pp1/p2p1n1p/8/2BNPQb1/2N5/PPP2PPP/R1B1K2R b KQkq - 5 8,g5,69,99,30,1
rn1qkb1r/1pp2p2/p2p1n1p/6p1/2BNPQb1/2N5/PPP2PPP/R1B1K2R w KQkq - 0 9,Qg3,110,78,-32,1
rn1qkb1r/1pp2p2/p2p1n1p/6p1/2BNP1b1/2N3Q1/PPP2PPP/R1B1K2R b KQkq - 1 9,c6,108,191,83,1
rn1qkb1r/1p3p2/p1pp1n1p/6p1/2BNP1b1/2N3Q1/PPP2PPP/R1B1K2R w KQkq - 0 10,h3,163,151,-12,1
rn1qkb1r/1p3p2/p1pp1n1p/6p1/2BNP1b1/2N3QP/PPP2PP1/R1B1K2R b KQkq - 0 10,Bh5,153,160,7,1
rn1qkb1r/1p3p2/p1pp1n1p/6pb/2BNP3/2N3QP/PPP2PP1/R1B1K2R w KQkq - 1 11,e5,172,75,-97,1
rn1qkb1r/1p3p2/p1pp1n1p/4P1pb/2BN4/2N3QP/PPP2PP1/R1B1K2R b KQkq - 0 11,Nd5,27,293,266,1
rn1qkb1r/1p3p2/p1pp3p/3nP1pb/2BN4/2N3QP/PPP2PP1/R1B1K2R w KQkq - 1 12,Nxd5,285,163,-122,0
rn1qkb1r/1p3p2/p1pp3p/3NP1pb/2BN4/6QP/PPP2PP1/R1B1K2R b KQkq - 0 12,cxd5,143,126,-17,1
rn1qkb1r/1p3p2/p2p3p/3pP1pb/2BN4/6QP/PPP2PP1/R1B1K2R w KQkq - 0 13,Bxd5,113,50,-63,1
rn1qkb1r/1p3p2/p2p3p/3BP1pb/3N4/6QP/PPP2PP1/R1B1K2R b KQkq - 0 13,dxe5,48,393,345,1
rn1qkb1r/1p3p2/p6p/3Bp1pb/3N4/6QP/PPP2PP1/R1B1K2R w KQkq - 0 14,Qxe5+,372,352,-20,1
rn1qkb1r/1p3p2/p6p/3BQ1pb/3N4/7P/PPP2PP1/R1B1K2R b KQkq - 0 14,Qe7,347,337,-10,1
rn2kb1r/1p2qp2/p6p/3BQ1pb/3N4/7P/PPP2PP1/R1B1K2R w KQkq - 1 15,Qxe7+,359,352,-7,1
rn2kb1r/1p2Qp2/p6p/3B2pb/3N4/7P/PPP2PP1/R1B1K2R b KQkq - 0 15,Bxe7,356,359,3,1
rn2k2r/1p2bp2/p6p/3B2pb/3N4/7P/PPP2PP1/R1B1K2R w KQkq - 0 16,Bxb7,361,290,-71,1
rn2k2r/1B2bp2/p6p/6pb/3N4/7P/PPP2PP1/R1B1K2R b KQkq - 0 16,Ra7,287,310,23,1
1n2k2r/rB2bp2/p6p/6pb/3N4/7P/PPP2PP1/R1B1K2R w KQk - 1 17,Bd5,304,305,1,1
1n2k2r/r3bp2/p6p/3B2pb/3N4/7P/PPP2PP1/R1B1K2R b KQk - 2 17,Rd7,263,327,64,1
1n2k2r/3rbp2/p6p/3B2pb/3N4/7P/PPP2PP1/R1B1K2R w KQk - 3 18,Bc6,341,-459,-800,0
1n2k2r/3rbp2/p1B4p/6pb/3N4/7P/PPP2PP1/R1B1K2R b KQk - 4 18,Nxc6,-441,-464,-23,1
4k2r/3rbp2/p1n4p/6pb/3N4/7P/PPP2PP1/R1B1K2R w KQk - 0 19,O-O,-430,-599,-169,0
4k2r/3rbp2/p1n4p/6pb/3N4/7P/PPP2PP1/R1B2RK1 b k - 1 19,Rxd4,-575,-567,8,1
4k2r/4bp2/p1n4p/6pb/3r4/7P/PPP2PP1/R1B2RK1 w k - 0 20,g4,-546,-520,26,1
4k2r/4bp2/p1n4p/6pb/3r2P1/7P/PPP2P2/R1B2RK1 b k - 0 20,Bg6,-564,-567,-3,1
4k2r/4bp2/p1n3bp/6p1/3r2P1/7P/PPP2P2/R1B2RK1 w k - 1 21,f4,-568,-622,-54,1
4k2r/4bp2/p1n3bp/6p1/3r1PP1/7P/PPP5/R1B2RK1 b k - 0 21,Bxc2,-543,-549,-6,1
4k2r/4bp2/p1n4p/6p1/3r1PP1/7P/PPb5/R1B2RK1 w k - 0 22,f5,-521,-694,-173,0
4k2r/4bp2/p1n4p/5Pp1/3r2P1/7P/PPb5/R1B2RK1 b k - 0 22,Be4,-599,-619,-20,1
4k2r/4bp2/p1n4p/5Pp1/3rb1P1/7P/PP6/R1B2RK1 w k - 1 23,b3,-606,-616,-10,1
4k2r/4bp2/p1n4p/5Pp1/3rb1P1/1P5P/P7/R1B2RK1 b k - 0 23,Bc5,-592,-545,47,1
4k2r/5p2/p1n4p/2b2Pp1/3rb1P1/1P5P/P7/R1B2RK1 w k - 1 24,Kh2,-521,-636,-115,0
4k2r/5p2/p1n4p/2b2Pp1/3rb1P1/1P5P/P6K/R1B2R2 b k - 2 24,Bd3,-602,-511,91,1
4k2r/5p2/p1n4p/2b2Pp1/3r2P1/1P1b3P/P6K/R1B2R2 w k - 3 25,Re1+,-500,-536,-36,1
4k2r/5p2/p1n4p/2b2Pp1/3r2P1/1P1b3P/P6K/R1B1R3 b k - 4 25,Kd8,-542,-471,71,1
3k3r/5p2/p1n4p/2b2Pp1/3r2P1/1P1b3P/P6K/R1B1R3 w - - 5 26,Bb2,-486,-461,25,1
3k3r/5p2/p1n4p/2b2Pp1/3r2P1/1P1b3P/PB5K/R3R3 b - - 6 26,Rf4,-550,-193,357,1
3k3r/5p2/p1n4p/2b2Pp1/5rP1/1P1b3P/PB5K/R3R3 w - - 7 27,Bxh8,-274,-277,-3,1
3k3B/5p2/p1n4p/2b2Pp1/5rP1/1P1b3P/P6K/R3R3 b - - 0 27,Rf2+,-239,-224,15,1
3k3B/5p2/p1n4p/2b2Pp1/6P1/1P1b3P/P4r1K/R3R3 w - - 1 28,Kg3,-218,-206,12,1
3k3B/5p2/p1n4p/2b2Pp1/6P1/1P1b2KP/P4r2/R3R3 b - - 2 28,Rc2,-241,-88,153,1
3k3B/5p2/p1n4p/2b2Pp1/6P1/1P1b2KP/P1r5/R3R3 w - - 3 29,Rad1,-61,-229,-168,0
3k3B/5p2/p1n4p/2b2Pp1/6P1/1P1b2KP/P1r5/3RR3 b - - 4 29,Bd6+,-225,220,445,1
3k3B/5p2/p1nb3p/5Pp1/6P1/1P1b2KP/P1r5/3RR3 w - - 5 30,Kf3,210,206,-4,1
3k3B/5p2/p1nb3p/5Pp1/6P1/1P1b1K1P/P1r5/3RR3 b - - 6 30,Be2+,200,539,339,1
3k3B/5p2/p1nb3p/5Pp1/6P1/1P3K1P/P1r1b3/3RR3 w - - 7 31,Rxe2,555,567,12,1
3k3B/5p2/p1nb3p/5Pp1/6P1/1P3K1P/P1r1R3/3R4 b - - 0 31,Rxe2,585,562,-23,1
3k3B/5p2/p1nb3p/5Pp1/6P1/1P3K1P/P3r3/3R4 w - - 0 32,Kxe2,577,489,-88,1
3k3B/5p2/p1nb3p/5Pp1/6P1/1P5P/P3K3/3R4 b - - 0 32,Kc7,479,521,42,1
7B/2k2p2/p1nb3p/5Pp1/6P1/1P5P/P3K3/3R4 w - - 1 33,Rxd6,512,372,-140,0
7B/2k2p2/p1nR3p/5Pp1/6P1/1P5P/P3K3/8 b - - 0 33,Nd4+,373,841,468,1
rnbqkbnr/pppppppp/8/8/8/8/PPPPPPPP/RNBQKBNR w KQkq - 0 1,g3,29,-24,-53,1
rnbqkbnr/pppppppp/8/8/8/6P1/PPPPPP1P/RNBQKBNR b KQkq - 0 1,d5,-11,19,30,1
rnbqkbnr/ppp1pppp/8/3p4/8/6P1/PPPPPP1P/RNBQKBNR w KQkq - 0 2,Bg2,24,-21,-45,1
rnbqkbnr/ppp1pppp/8/3p4/8/6P1/PPPPPPBP/RNBQK1NR b KQkq - 1 2,Nf6,-30,21,51,1
rnbqkb1r/ppp1pppp/5n2/3p4/8/6P1/PPPPPPBP/RNBQK1NR w KQkq - 2 3,b3,28,-60,-88,1
rnbqkb1r/ppp1pppp/5n2/3p4/8/1P4P1/P1PPPPBP/RNBQK1NR b KQkq - 0 3,Bf5,-75,-7,68,1
rn1qkb1r/ppp1pppp/5n2/3p1b2/8/1P4P1/P1PPPPBP/RNBQK1NR w KQkq - 1 4,Bb2,-10,-31,-21,1
rn1qkb1r/ppp1pppp/5n2/3p1b2/8/1P4P1/PBPPPPBP/RN1QK1NR b KQkq - 2 4,e6,-10,30,40,1
rn1qkb1r/ppp2ppp/4pn2/3p1b2/8/1P4P1/PBPPPPBP/RN1QK1NR w KQkq - 0 5,d3,18,17,-1,1
rn1qkb1r/ppp2ppp/4pn2/3p1b2/8/1P1P2P1/PBP1PPBP/RN1QK1NR b KQkq - 0 5,c5,7,17,10,1
rn1qkb1r/pp3ppp/4pn2/2pp1b2/8/1P1P2P1/PBP1PPBP/RN1QK1NR w KQkq - 0 6,Nd2,23,10,-13,1
rn1qkb1r/pp3ppp/4pn2/2pp1b2/8/1P1P2P1/PBPNPPBP/R2QK1NR b KQkq - 1 6,Nc6,15,25,10,1
r2qkb1r/pp3ppp/2n1pn2/2pp1b2/8/1P1P2P1/PBPNPPBP/R2QK1NR w KQkq - 2 7,e3,25,-37,-62,1
r2qkb1r/pp3ppp/2n1pn2/2pp1b2/8/1P1PP1P1/PBPN1PBP/R2QK1NR b KQkq - 0 7,Bd6,-38,-25,13,1
r2qk2r/pp3ppp/2nbpn2/2pp1b2/8/1P1PP1P1/PBPN1PBP/R2QK1NR w KQkq - 1 8,Qe2,-29,-47,-18,1
r2qk2r/pp3ppp/2nbpn2/2pp1b2/8/1P1PP1P1/PBPNQPBP/R3K1NR b KQkq - 2 8,Qc7,-60,-7,53,1
r3k2r/ppq2ppp/2nbpn2/2pp1b2/8/1P1PP1P1/PBPNQPBP/R3K1NR w KQkq - 3 9,h4,-10,-115,-105,0
r3k2r/ppq2ppp/2nbpn2/2pp1b2/7P/1P1PP1P1/PBPNQPB1/R3K1NR b KQkq - 0 9,a6,-119,23,142,1
r3k2r/1pq2ppp/p1nbpn2/2pp1b2/7P/1P1PP1P1/PBPNQPB1/R3K1NR w KQkq - 0 10,e4,61,-92,-153,0
r3k2r/1pq2ppp/p1nbpn2/2pp1b2/4P2P/1P1P2P1/PBPNQPB1/R3K1NR b KQkq - 0 10,dxe4,-144,-51,93,1
r3k2r/1pq2ppp/p1nbpn2/2p2b2/4p2P/1P1P2P1/PBPNQPB1/R3K1NR w KQkq - 0 11,Bxe4,-41,-78,-37,1
r3k2r/1pq2ppp/p1nbpn2/2p2b2/4B2P/1P1P2P1/PBPNQP2/R3K1NR b KQkq - 0 11,Bg6,-84,35,119,1
r3k2r/1pq2ppp/p1nbpnb1/2p5/4B2P/1P1P2P1/PBPNQP2/R3K1NR w KQkq - 1 12,Bxg6,40,26,-14,1
r3k2r/1pq2ppp/p1nbpnB1/2p5/7P/1P1P2P1/PBPNQP2/R3K1NR b KQkq - 0 12,hxg6,10,9,-1,1
r3k2r/1pq2pp1/p1nbpnp1/2p5/7P/1P1P2P1/PBPNQP2/R3K1NR w KQkq - 0 13,Ne4,13,-71,-84,1
r3k2r/1pq2pp1/p1nbpnp1/2p5/4N2P/1P1P2P1/PBP1QP2/R3K1NR b KQkq - 1 13,Nxe4,-50,12,62,1
r3k2r/1pq2pp1/p1nbp1p1/2p5/4n2P/1P1P2P1/PBP1QP2/R3K1NR w KQkq - 0 14,Qxe4,14,-33,-47,1
r3k2r/1pq2pp1/p1nbp1p1/2p5/4Q2P/1P1P2P1/PBP2P2/R3K1NR b KQkq - 0 14,O-O,-31,121,152,1
r4rk1/1pq2pp1/p1nbp1p1/2p5/4Q2P/1P1P2P1/PBP2P2/R3K1NR w KQ - 1 15,h5,130,106,-24,1
r4rk1/1pq2pp1/p1nbp1p1/2p4P/4Q3/1P1P2P1/PBP2P2/R3K1NR b KQ - 0 15,gxh5,110,184,74,1
r4rk1/1pq2pp1/p1nbp3/2p4p/4Q3/1P1P2P1/PBP2P2/R3K1NR w KQ - 0 16,Rxh5,191,176,-15,1
r4rk1/1pq2pp1/p1nbp3/2p4R/4Q3/1P1P2P1/PBP2P2/R3K1N1 b Q - 0 16,f6,174,222,48,1
r4rk1/1pq3p1/p1nbpp2/2p4R/4Q3/1P1P2P1/PBP2P2/R3K1N1 w Q - 0 17,Qh7+,276,7,-269,0
r4rk1/1pq3pQ/p1nbpp2/2p4R/8/1P1P2P1/PBP2P2/R3K1N1 b Q - 1 17,Kf7,0,0,0,1
r4r2/1pq2kpQ/p1nbpp2/2p4R/8/1P1P2P1/PBP2P2/R3K1N1 w Q - 2 18,Bxf6,0,-359,-359,0
r4r2/1pq2kpQ/p1nbpB2/2p4R/8/1P1P2P1/P1P2P2/R3K1N1 b Q - 0 18,Kxf6,-373,-392,-19,1
r4r2/1pq3pQ/p1nbpk2/2p4R/8/1P1P2P1/P1P2P2/R3K1N1 w Q - 0 19,g4,-348,-426,-78,1
r4r2/1pq3pQ/p1nbpk2/2p4R/6P1/1P1P4/P1P2P2/R3K1N1 b Q - 0 19,Rf7,-369,-303,66,1
r7/1pq2rpQ/p1nbpk2/2p4R/6P1/1P1P4/P1P2P2/R3K1N1 w Q - 1 20,g5+,-318,-389,-71,1
r7/1pq2rpQ/p1nbpk2/2p3PR/8/1P1P4/P1P2P2/R3K1N1 b Q - 0 20,Ke7,-435,-464,-29,1
r7/1pq1krpQ/p1nbp3/2p3PR/8/1P1P4/P1P2P2/R3K1N1 w Q - 1 21,Qg6,-395,-540,-145,0
r7/1pq1krp1/p1nbp1Q1/2p3PR/8/1P1P4/P1P2P2/R3K1N1 b Q - 2 21,Raf8,-531,-490,41,1
5r2/1pq1krp1/p1nbp1Q1/2p3PR/8/1P1P4/P1P2P2/R3K1N1 w Q - 3 22,O-O-O,-477,-499,-22,1
5r2/1pq1krp1/p1nbp1Q1/2p3PR/8/1P1P4/P1P2P2/2KR2N1 b - - 4 22,Ke8,-508,-438,70,1
4kr2/1pq2rp1/p1nbp1Q1/2p3PR/8/1P1P4/P1P2P2/2KR2N1 w - - 5 23,Re1,-430,-449,-19,1
4kr2/1pq2rp1/p1nbp1Q1/2p3PR/8/1P1P4/P1P2P2/2K1R1N1 b - - 6 23,Kd8,-456,-386,70,1
3k1r2/1pq2rp1/p1nbp1Q1/2p3PR/8/1P1P4/P1P2P2/2K1R1N1 w - - 7 24,Qxe6,-385,-587,-202,0
3k1r2/1pq2rp1/p1nbQ3/2p3PR/8/1P1P4/P1P2P2/2K1R1N1 b - - 0 24,Re7,-612,-609,3,1
3k1r2/1pq1r1p1/p1nbQ3/2p3PR/8/1P1P4/P1P2P2/2K1R1N1 w - - 1 25,Rh6,-572,-740,-168,0
3k1r2/1pq1r1p1/p1nbQ2R/2p3P1/8/1P1P4/P1P2P2/2K1R1N1 b - - 2 25,Rxe6,-748,-639,109,1
3k1r2/1pq3p1/p1nbr2R/2p3P1/8/1P1P4/P1P2P2/2K1R1N1 w - - 0 26,Rhxe6,-610,-648,-38,1
3k1r2/1pq3p1/p1nbR3/2p3P1/8/1P1P4/P1P2P2/2K1R1N1 b - - 0 26,Kc8,-593,-506,87,1
2k2r2/1pq3p1/p1nbR3/2p3P1/8/1P1P4/P1P2P2/2K1R1N1 w - - 1 27,Nh3,-560,-609,-49,1
2k2r2/1pq3p1/p1nbR3/2p3P1/8/1P1P3N/P1P2P2/2K1R3 b - - 2 27,Rd8,-599,-598,1,1
2kr4/1pq3p1/p1nbR3/2p3P1/8/1P1P3N/P1P2P2/2K1R3 w - - 3 28,g6,-568,-599,-31,1
2kr4/1pq3p1/p1nbR1P1/2p5/8/1P1P3N/P1P2P2/2K1R3 b - - 0 28,Kb8,-619,-555,64,1
1k1r4/1pq3p1/p1nbR1P1/2p5/8/1P1P3N/P1P2P2/2K1R3 w - - 1 29,Ng5,-546,-634,-88,1
1k1r4/1pq3p1/p1nbR1P1/2p3N1/8/1P1P4/P1P2P2/2K1R3 b - - 2 29,Ka7,-658,-469,189,1
3r4/kpq3p1/p1nbR1P1/2p3N1/8/1P1P4/P1P2P2/2K1R3 w - - 3 30,Nf7,-485,-505,-20,1
3r4/kpq2Np1/p1nbR1P1/2p5/8/1P1P4/P1P2P2/2K1R3 b - - 4 30,Rd7,-548,-482,66,1
8/kpqr1Np1/p1nbR1P1/2p5/8/1P1P4/P1P2P2/2K1R3 w - - 5 31,Nxd6,-497,-563,-66,1
8/kpqr2p1/p1nNR1P1/2p5/8/1P1P4/P1P2P2/2K1R3 b - - 0 31,Rxd6,-590,-543,47,1
8/kpq3p1/p1nrR1P1/2p5/8/1P1P4/P1P2P2/2K1R3 w - - 0 32,Re7,-565,-741,-176,0
8/kpq1R1p1/p1nr2P1/2p5/8/1P1P4/P1P2P2/2K1R3 b - - 1 32,Rd7,-735,-581,154,1
8/kpqrR1p1/p1n3P1/2p5/8/1P1P4/P1P2P2/2K1R3 w - - 2 33,Re8,-579,-567,12,1
4R3/kpqr2p1/p1n3P1/2p5/8/1P1P4/P1P2P2/2K1R3 b - - 3 33,Kb6,-613,-543,70,1
4R3/1pqr2p1/pkn3P1/2p5/8/1P1P4/P1P2P2/2K1R3 w - - 4 34,Rg8,-528,-603,-75,1
6R1/1pqr2p1/pkn3P1/2p5/8/1P1P4/P1P2P2/2K1R3 b - - 5 34,Nd8,-599,-527,72,1
3n2R1/1pqr2p1/pk4P1/2p5/8/1P1P4/P1P2P2/2K1R3 w - - 6 35,Rh1,-512,-573,-61,1
3n2R1/1pqr2p1/pk4P1/2p5/8/1P1P4/P1P2P2/2K4R b - - 7 35,Rd6,-601,-460,141,1
3n2R1/1pq3p1/pk1r2P1/2p5/8/1P1P4/P1P2P2/2K4R w - - 8 36,Rh7,-429,-516,-87,1
3n2R1/1pq3pR/pk1r2P1/2p5/8/1P1P4/P1P2P2/2K5 b - - 9 36,Rxg6,-507,-492,15,1
3n2R1/1pq3pR/pk4r1/2p5/8/1P1P4/P1P2P2/2K5 w - - 0 37,f4,-555,-641,-86,1
3n2R1/1pq3pR/pk4r1/2p5/5P2/1P1P4/P1P5/2K5 b - - 0 37,Ne6,-686,-554,132,1
6R1/1pq3pR/pk2n1r1/2p5/5P2/1P1P4/P1P5/2K5 w - - 1 38,Kb2,-584,-678,-94,1
6R1/1pq3pR/pk2n1r1/2p5/5P2/1P1P4/PKP5/8 b - - 2 38,Nxf4,-634,-620,14,1
6R1/1pq3pR/pk4r1/2p5/5n2/1P1P4/PKP5/8 w - - 0 39,Rhxg7,-611,-726,-115,0
6R1/1pq3R1/pk4r1/2p5/5n2/1P1P4/PKP5/8 b - - 0 39,Ne2,-702,-248,454,1
6R1/1pq3R1/pk4r1/2p5/8/1P1P4/PKP1n3/8 w - - 1 40,Rxg6+,-185,-209,-24,1
6R1/1pq5/pk4R1/2p5/8/1P1P4/PKP1n3/8 b - - 0 40,Kb5,-220,-185,35,1
6R1/1pq5/p5R1/1kp5/8/1P1P4/PKP1n3/8 w - - 1 41,R8g7,-160,-315,-155,0
8/1pq3R1/p5R1/1kp5/8/1P1P4/PKP1n3/8 b - - 2 41,Qe5+,-295,-328,-33,1
8/1p4R1/p5R1/1kp1q3/8/1P1P4/PKP1n3/8 w - - 3 42,c3,-360,-9998,-9638,0
8/1p4R1/p5R1/1kp1q3/8/1PPP4/PK2n3/8 b - - 0 42,Nxc3,-9998,-399,9599,1
8/1p4R1/p5R1/1kp1q3/8/1PnP4/PK6/8 w - - 0 43,Re6,-389,-644,-255,0
8/1p4R1/p3R3/1kp1q3/8/1PnP4/PK6/8 b - - 1 43,Nd1+,-678,-565,113,1
8/1p4R1/p3R3/1kp1q3/8/1P1P4/PK6/3n4 w - - 2 44,Kc2,-622,-568,54,1
8/1p4R1/p3R3/1kp1q3/8/1P1P4/P1K5/3n4 b - - 3 44,Qc3+,-584,-461,123,1
8/1p4R1/p3R3/1kp5/8/1PqP4/P1K5/3n4 w - - 4 45,Kxd1,-435,-488,-53,1
8/1p4R1/p3R3/1kp5/8/1PqP4/P7/3K4 b - - 0 45,Qb2,-497,40,537,1
8/1p4R1/p3R3/1kp5/8/1P1P4/Pq6/3K4 w - - 1 46,Ke1,0,-569,-569,0
8/1p4R1/p3R3/1kp5/8/1P1P4/Pq6/4K3 b - - 2 46,Qa1+,-552,-534,18,1
rnbqkbnr/pppppppp/8/8/8/8/PPPPPPPP/RNBQKBNR w KQkq - 0 1,e4,25,35,10,1
rnbqkbnr/pppppppp/8/8/4P3/8/PPPP1PPP/RNBQKBNR b KQkq - 0 1,e5,34,41,7,1
rnbqkbnr/pppp1ppp/8/4p3/4P3/8/PPPP1PPP/RNBQKBNR w KQkq - 0 2,Nf3,33,37,4,1
rnbqkbnr/pppp1ppp/8/4p3/4P3/5N2/PPPP1PPP/RNBQKB1R b KQkq - 1 2,d6,36,62,26,1
rnbqkbnr/ppp2ppp/3p4/4p3/4P3/5N2/PPPP1PPP/RNBQKB1R w KQkq - 0 3,Bc4,58,34,-24,1
rnbqkbnr/ppp2ppp/3p4/4p3/2B1P3/5N2/PPPP1PPP/RNBQK2R b KQkq - 1 3,Nc6,36,41,5,1
r1bqkbnr/ppp2ppp/2np4/4p3/2B1P3/5N2/PPPP1PPP/RNBQK2R w KQkq - 2 4,d3,53,-10,-63,1
r1bqkbnr/ppp2ppp/2np4/4p3/2B1P3/3P1N2/PPP2PPP/RNBQK2R b KQkq - 0 4,Bg4,16,51,35,1
r2qkbnr/ppp2ppp/2np4/4p3/2B1P1b1/3P1N2/PPP2PPP/RNBQK2R w KQkq - 1 5,O-O,55,44,-11,1
r2qkbnr/ppp2ppp/2np4/4p3/2B1P1b1/3P1N2/PPP2PPP/RNBQ1RK1 b kq - 2 5,Nd4,51,67,16,1
r2qkbnr/ppp2ppp/3p4/4p3/2BnP1b1/3P1N2/PPP2PPP/RNBQ1RK1 w kq - 3 6,Nc3,83,-104,-187,0
r2qkbnr/ppp2ppp/3p4/4p3/2BnP1b1/2NP1N2/PPP2PPP/R1BQ1RK1 b kq - 4 6,Nxf3+,-108,-42,66,1
r2qkbnr/ppp2ppp/3p4/4p3/2B1P1b1/2NP1n2/PPP2PPP/R1BQ1RK1 w kq - 0 7,gxf3,-41,-49,-8,1
r2qkbnr/ppp2ppp/3p4/4p3/2B1P1b1/2NP1P2/PPP2P1P/R1BQ1RK1 b kq - 0 7,Bh3,-46,-45,1,1
r2qkbnr/ppp2ppp/3p4/4p3/2B1P3/2NP1P1b/PPP2P1P/R1BQ1RK1 w kq - 1 8,Re1,-47,-48,-1,1
r2qkbnr/ppp2ppp/3p4/4p3/2B1P3/2NP1P1b/PPP2P1P/R1BQR1K1 b kq - 2 8,Nf6,-49,18,67,1
r2qkb1r/ppp2ppp/3p1n2/4p3/2B1P3/2NP1P1b/PPP2P1P/R1BQR1K1 w kq - 3 9,Bg5,15,-35,-50,1
r2qkb1r/ppp2ppp/3p1n2/4p1B1/2B1P3/2NP1P1b/PPP2P1P/R2QR1K1 b kq - 4 9,c6,-75,-38,37,1
r2qkb1r/pp3ppp/2pp1n2/4p1B1/2B1P3/2NP1P1b/PPP2P1P/R2QR1K1 w kq - 0 10,f4,-27,-119,-92,1
r2qkb1r/pp3ppp/2pp1n2/4p1B1/2B1PP2/2NP3b/PPP2P1P/R2QR1K1 b kq - 0 10,exf4,-121,158,279,1
r2qkb1r/pp3ppp/2pp1n2/6B1/2B1Pp2/2NP3b/PPP2P1P/R2QR1K1 w kq - 0 11,Bxf4,129,17,-112,0
r2qkb1r/pp3ppp/2pp1n2/8/2B1PB2/2NP3b/PPP2P1P/R2QR1K1 b kq - 0 11,Be7,8,17,9,1
r2qk2r/pp2bppp/2pp1n2/8/2B1PB2/2NP3b/PPP2P1P/R2QR1K1 w kq - 1 12,Qf3,27,-48,-75,1
r2qk2r/pp2bppp/2pp1n2/8/2B1PB2/2NP1Q1b/PPP2P1P/R3R1K1 b kq - 2 12,Be6,-11,59,70,1
r2qk2r/pp2bppp/2ppbn2/8/2B1PB2/2NP1Q2/PPP2P1P/R3R1K1 w kq - 3 13,Bxe6,57,60,3,1
r2qk2r/pp2bppp/2ppBn2/8/4PB2/2NP1Q2/PPP2P1P/R3R1K1 b kq - 0 13,fxe6,74,75,1,1
r2qk2r/pp2b1pp/2pppn2/8/4PB2/2NP1Q2/PPP2P1P/R3R1K1 w kq - 0 14,Qg3,75,-97,-172,0
r2qk2r/pp2b1pp/2pppn2/8/4PB2/2NP2Q1/PPP2P1P/R3R1K1 b kq - 1 14,O-O,-89,-31,58,1
r2q1rk1/pp2b1pp/2pppn2/8/4PB2/2NP2Q1/PPP2P1P/R3R1K1 w - - 2 15,Bh6,-31,-196,-165,0
r2q1rk1/pp2b1pp/2pppn1B/8/4P3/2NP2Q1/PPP2P1P/R3R1K1 b - - 3 15,Rf7,-139,-86,53,1
r2q2k1/pp2brpp/2pppn1B/8/4P3/2NP2Q1/PPP2P1P/R3R1K1 w - - 4 16,Ne2,-93,-166,-73,1
r2q2k1/pp2brpp/2pppn1B/8/4P3/3P2Q1/PPP1NP1P/R3R1K1 b - - 5 16,Kh8,-161,-25,136,1
r2q3k/pp2brpp/2pppn1B/8/4P3/3P2Q1/PPP1NP1P/R3R1K1 w - - 6 17,Nf4,-36,-416,-380,0
r2q3k/pp2brpp/2pppn1B/8/4PN2/3P2Q1/PPP2P1P/R3R1K1 b - - 7 17,gxh6,-464,-482,-18,1
r2q3k/pp2br1p/2pppn1p/8/4PN2/3P2Q1/PPP2P1P/R3R1K1 w - - 0 18,Nxe6,-456,-552,-96,1
r2q3k/pp2br1p/2ppNn1p/8/4P3/3P2Q1/PPP2P1P/R3R1K1 b - - 0 18,Qd7,-534,-548,-14,1
r6k/pp1qbr1p/2ppNn1p/8/4P3/3P2Q1/PPP2P1P/R3R1K1 w - - 1 19,Qg7+,-573,-734,-161,0
r6k/pp1qbrQp/2ppNn1p/8/4P3/3P4/PPP2P1P/R3R1K1 b - - 2 19,Rxg7+,-734,-772,-38,1
rnbqkbnr/pppppppp/8/8/8/8/PPPPPPPP/RNBQKBNR w KQkq - 0 1,e3,24,15,-9,1
rnbqkbnr/pppppppp/8/8/8/4P3/PPPP1PPP/RNBQKBNR b KQkq - 0 1,e5,12,18,6,1
rnbqkbnr/pppp1ppp/8/4p3/8/4P3/PPPP1PPP/RNBQKBNR w KQkq - 0 2,d3,23,-49,-72,1
rnbqkbnr/pppp1ppp/8/4p3/8/3PP3/PPP2PPP/RNBQKBNR b KQkq - 0 2,Nc6,-39,-14,25,1
r1bqkbnr/pppp1ppp/2n5/4p3/8/3PP3/PPP2PPP/RNBQKBNR w KQkq - 1 3,Be2,-20,-51,-31,1
r1bqkbnr/pppp1ppp/2n5/4p3/8/3PP3/PPP1BPPP/RNBQK1NR b KQkq - 2 3,b6,-37,22,59,1
r1bqkbnr/p1pp1ppp/1pn5/4p3/8/3PP3/PPP1BPPP/RNBQK1NR w KQkq - 0 4,c3,32,-20,-52,1
r1bqkbnr/p1pp1ppp/1pn5/4p3/8/2PPP3/PP2BPPP/RNBQK1NR b KQkq - 0 4,Bb7,-16,-22,-6,1
r2qkbnr/pbpp1ppp/1pn5/4p3/8/2PPP3/PP2BPPP/RNBQK1NR w KQkq - 1 5,d4,-27,-65,-38,1
r2qkbnr/pbpp1ppp/1pn5/4p3/3P4/2P1P3/PP2BPPP/RNBQK1NR b KQkq - 0 5,e4,-62,-20,42,1
r2qkbnr/pbpp1ppp/1pn5/8/3Pp3/2P1P3/PP2BPPP/RNBQK1NR w KQkq - 0 6,Nd2,-27,-23,4,1
r2qkbnr/pbpp1ppp/1pn5/8/3Pp3/2P1P3/PP1NBPPP/R1BQK1NR b KQkq - 1 6,d5,-21,-20,1,1
r2qkbnr/pbp2ppp/1pn5/3p4/3Pp3/2P1P3/PP1NBPPP/R1BQK1NR w KQkq - 0 7,Bb5,-14,-113,-99,1
r2qkbnr/pbp2ppp/1pn5/1B1p4/3Pp3/2P1P3/PP1N1PPP/R1BQK1NR b KQkq - 1 7,Bd6,-141,-115,26,1
r2qk1nr/pbp2ppp/1pnb4/1B1p4/3Pp3/2P1P3/PP1N1PPP/R1BQK1NR w KQkq - 2 8,Nh3,-97,-93,4,1
r2qk1nr/pbp2ppp/1pnb4/1B1p4/3Pp3/2P1P2N/PP1N1PPP/R1BQK2R b KQkq - 3 8,h6,-82,-38,44,1
r2qk1nr/pbp2pp1/1pnb3p/1B1p4/3Pp3/2P1P2N/PP1N1PPP/R1BQK2R w KQkq - 0 9,Nb3,-22,-137,-115,0
r2qk1nr/pbp2pp1/1pnb3p/1B1p4/3Pp3/1NP1P2N/PP3PPP/R1BQK2R b KQkq - 1 9,Rh7,-147,-18,129,1
r2qk1n1/pbp2ppr/1pnb3p/1B1p4/3Pp3/1NP1P2N/PP3PPP/R1BQK2R w KQq - 2 10,a4,-30,-73,-43,1
r2qk1n1/pbp2ppr/1pnb3p/1B1p4/P2Pp3/1NP1P2N/1P3PPP/R1BQK2R b KQq - 0 10,Nf6,-82,-67,15,1
r2qk3/pbp2ppr/1pnb1n1p/1B1p4/P2Pp3/1NP1P2N/1P3PPP/R1BQK2R w KQq - 1 11,Bd2,-58,-90,-32,1
r2qk3/pbp2ppr/1pnb1n1p/1B1p4/P2Pp3/1NP1P2N/1P1B1PPP/R2QK2R b KQq - 2 11,Qc8,-97,-63,34,1
r1q1k3/pbp2ppr/1pnb1n1p/1B1p4/P2Pp3/1NP1P2N/1P1B1PPP/R2QK2R w KQq - 3 12,c4,-47,-72,-25,1
r1q1k3/pbp2ppr/1pnb1n1p/1B1p4/P1PPp3/1N2P2N/1P1B1PPP/R2QK2R b KQq - 0 12,a6,-90,-28,62,1
r1q1k3/1bp2ppr/ppnb1n1p/1B1p4/P1PPp3/1N2P2N/1P1B1PPP/R2QK2R w KQq - 0 13,Bxc6+,-30,-35,-5,1
r1q1k3/1bp2ppr/ppBb1n1p/3p4/P1PPp3/1N2P2N/1P1B1PPP/R2QK2R b KQq - 0 13,Bxc6,-36,-27,9,1
r1q1k3/2p2ppr/ppbb1n1p/3p4/P1PPp3/1N2P2N/1P1B1PPP/R2QK2R w KQq - 0 14,c5,-17,-31,-14,1
r1q1k3/2p2ppr/ppbb1n1p/2Pp4/P2Pp3/1N2P2N/1P1B1PPP/R2QK2R b KQq - 0 14,Ng4,-38,504,542,1
rnbqkbnr/pppppppp/8/8/8/8/PPPPPPPP/RNBQKBNR w KQkq - 0 1,e4,34,38,4,1
rnbqkbnr/pppppppp/8/8/4P3/8/PPPP1PPP/RNBQKBNR b KQkq - 0 1,e5,44,34,-10,1
rnbqkbnr/pppp1ppp/8/4p3/4P3/8/PPPP1PPP/RNBQKBNR w KQkq - 0 2,Nf3,39,33,-6,1
rnbqkbnr/pppp1ppp/8/4p3/4P3/5N2/PPPP1PPP/RNBQKB1R b KQkq - 1 2,Nc6,33,33,0,1
r1bqkbnr/pppp1ppp/2n5/4p3/4P3/5N2/PPPP1PPP/RNBQKB1R w KQkq - 2 3,Nc3,34,15,-19,1
r1bqkbnr/pppp1ppp/2n5/4p3/4P3/2N2N2/PPPP1PPP/R1BQKB1R b KQkq - 3 3,Bc5,25,66,41,1
r1bqk1nr/pppp1ppp/2n5/2b1p3/4P3/2N2N2/PPPP1PPP/R1BQKB1R w KQkq - 4 4,Bb5,73,12,-61,1
r1bqk1nr/pppp1ppp/2n5/1Bb1p3/4P3/2N2N2/PPPP1PPP/R1BQK2R b KQkq - 5 4,d6,6,39,33,1
r1bqk1nr/ppp2ppp/2np4/1Bb1p3/4P3/2N2N2/PPPP1PPP/R1BQK2R w KQkq - 0 5,Bxc6+,48,-1,-49,1
r1bqk1nr/ppp2ppp/2Bp4/2b1p3/4P3/2N2N2/PPPP1PPP/R1BQK2R b KQkq - 0 5,bxc6,-3,44,47,1
r1bqk1nr/p1p2ppp/2pp4/2b1p3/4P3/2N2N2/PPPP1PPP/R1BQK2R w KQkq - 0 6,h3,11,-31,-42,1
r1bqk1nr/p1p2ppp/2pp4/2b1p3/4P3/2N2N1P/PPPP1PP1/R1BQK2R b KQkq - 0 6,Nf6,-31,25,56,1
r1bqk2r/p1p2ppp/2pp1n2/2b1p3/4P3/2N2N1P/PPPP1PP1/R1BQK2R w KQkq - 1 7,d4,24,16,-8,1
r1bqk2r/p1p2ppp/2pp1n2/2b1p3/3PP3/2N2N1P/PPP2PP1/R1BQK2R b KQkq - 0 7,exd4,8,18,10,1
r1bqk2r/p1p2ppp/2pp1n2/2b5/3pP3/2N2N1P/PPP2PP1/R1BQK2R w KQkq - 0 8,Nxd4,20,26,6,1
r1bqk2r/p1p2ppp/2pp1n2/2b5/3NP3/2N4P/PPP2PP1/R1BQK2R b KQkq - 0 8,Bxd4,23,113,90,1
r1bqk2r/p1p2ppp/2pp1n2/8/3bP3/2N4P/PPP2PP1/R1BQK2R w KQkq - 0 9,Qxd4,89,90,1,1
r1bqk2r/p1p2ppp/2pp1n2/8/3QP3/2N4P/PPP2PP1/R1B1K2R b KQkq - 0 9,Ba6,77,193,116,1
r2qk2r/p1p2ppp/b1pp1n2/8/3QP3/2N4P/PPP2PP1/R1B1K2R w KQkq - 1 10,Bg5,195,189,-6,1
r2qk2r/p1p2ppp/b1pp1n2/6B1/3QP3/2N4P/PPP2PP1/R3K2R b KQkq - 2 10,c5,210,526,316,1
r2qk2r/p1p2ppp/b2p1n2/2p3B1/3QP3/2N4P/PPP2PP1/R3K2R w KQkq - 0 11,Qe3,575,130,-445,0
r2qk2r/p1p2ppp/b2p1n2/2p3B1/4P3/2N1Q2P/PPP2PP1/R3K2R b KQkq - 1 11,Qe7,129,128,-1,1
r3k2r/p1p1qppp/b2p1n2/2p3B1/4P3/2N1Q2P/PPP2PP1/R3K2R w KQkq - 2 12,O-O-O,126,140,14,1
r3k2r/p1p1qppp/b2p1n2/2p3B1/4P3/2N1Q2P/PPP2PP1/2KR3R b kq - 3 12,h6,122,206,84,1
r3k2r/p1p1qpp1/b2p1n1p/2p3B1/4P3/2N1Q2P/PPP2PP1/2KR3R w kq - 0 13,Bh4,215,123,-92,1
r3k2r/p1p1qpp1/b2p1n1p/2p5/4P2B/2N1Q2P/PPP2PP1/2KR3R b kq - 1 13,Qe5,118,288,170,1
r3k2r/p1p2pp1/b2p1n1p/2p1q3/4P2B/2N1Q2P/PPP2PP1/2KR3R w kq - 2 14,f4,295,261,-34,1
r3k2r/p1p2pp1/b2p1n1p/2p1q3/4PP1B/2N1Q2P/PPP3P1/2KR3R b kq - 0 14,Qe6,224,270,46,1
r3k2r/p1p2pp1/b2pqn1p/2p5/4PP1B/2N1Q2P/PPP3P1/2KR3R w kq - 1 15,g4,281,156,-125,0
r3k2r/p1p2pp1/b2pqn1p/2p5/4PPPB/2N1Q2P/PPP5/2KR3R b kq - 0 15,Nd7,133,378,245,1
r3k2r/p1pn1pp1/b2pq2p/2p5/4PPPB/2N1Q2P/PPP5/2KR3R w kq - 1 16,Nd5,376,387,11,1
r3k2r/p1pn1pp1/b2pq2p/2pN4/4PPPB/4Q2P/PPP5/2KR3R b kq - 2 16,Rc8,405,600,195,1
2r1k2r/p1pn1pp1/b2pq2p/2pN4/4PPPB/4Q2P/PPP5/2KR3R w k - 3 17,Rhe1,597,283,-314,0
2r1k2r/p1pn1pp1/b2pq2p/2pN4/4PPPB/4Q2P/PPP5/2KRR3 b k - 4 17,Nb6,327,417,90,1
2r1k2r/p1p2pp1/bn1pq2p/2pN4/4PPPB/4Q2P/PPP5/2KRR3 w k - 5 18,f5,383,329,-54,1
2r1k2r/p1p2pp1/bn1pq2p/2pN1P2/4P1PB/4Q2P/PPP5/2KRR3 b k - 0 18,Qe5,315,327,12,1
2r1k2r/p1p2pp1/bn1p3p/2pNqP2/4P1PB/4Q2P/PPP5/2KRR3 w k - 1 19,f6,296,226,-70,1
2r1k2r/p1p2pp1/bn1p1P1p/2pNq3/4P1PB/4Q2P/PPP5/2KRR3 b k - 0 19,g5,223,216,-7,1
2r1k2r/p1p2p2/bn1p1P1p/2pNq1p1/4P1PB/4Q2P/PPP5/2KRR3 w k - 0 20,Bg3,202,260,58,1
2r1k2r/p1p2p2/bn1p1P1p/2pNq1p1/4P1P1/4Q1BP/PPP5/2KRR3 b k - 1 20,Qe6,251,405,154,1
2r1k2r/p1p2p2/bn1pqP1p/2pN2p1/4P1P1/4Q1BP/PPP5/2KRR3 w k - 2 21,Qb3,396,338,-58,1
2r1k2r/p1p2p2/bn1pqP1p/2pN2p1/4P1P1/1Q4BP/PPP5/2KRR3 b k - 3 21,O-O,352,353,1,1
2r2rk1/p1p2p2/bn1pqP1p/2pN2p1/4P1P1/1Q4BP/PPP5/2KRR3 w - - 4 22,Ne7+,338,376,38,1
2r2rk1/p1p1Np2/bn1pqP1p/2p3p1/4P1P1/1Q4BP/PPP5/2KRR3 b - - 5 22,Kh8,351,432,81,1
2r2r1k/p1p1Np2/bn1pqP1p/2p3p1/4P1P1/1Q4BP/PPP5/2KRR3 w - - 6 23,Qxe6,471,466,-5,1
2r2r1k/p1p1Np2/bn1pQP1p/2p3p1/4P1P1/6BP/PPP5/2KRR3 b - - 0 23,fxe6,492,481,-11,1
2r2r1k/p1p1N3/bn1ppP1p/2p3p1/4P1P1/6BP/PPP5/2KRR3 w - - 0 24,Nxc8,440,403,-37,1
2N2r1k/p1p5/bn1ppP1p/2p3p1/4P1P1/6BP/PPP5/2KRR3 b - - 0 24,Nxc8,444,456,12,1
2n2r1k/p1p5/b2ppP1p/2p3p1/4P1P1/6BP/PPP5/2KRR3 w - - 0 25,e5,481,456,-25,1
2n2r1k/p1p5/b2ppP1p/2p1P1p1/6P1/6BP/PPP5/2KRR3 b - - 0 25,d5,441,465,24,1
2n2r1k/p1p5/b3pP1p/2ppP1p1/6P1/6BP/PPP5/2KRR3 w - - 0 26,Rh1,487,460,-27,1
2n2r1k/p1p5/b3pP1p/2ppP1p1/6P1/6BP/PPP5/2KR3R b - - 1 26,Nb6,469,523,54,1
5r1k/p1p5/bn2pP1p/2ppP1p1/6P1/6BP/PPP5/2KR3R w - - 2 27,h4,528,501,-27,1
5r1k/p1p5/bn2pP1p/2ppP1p1/6PP/6B1/PPP5/2KR3R b - - 0 27,Be2,534,552,18,1
5r1k/p1p5/1n2pP1p/2ppP1p1/6PP/6B1/PPP1b3/2KR3R w - - 1 28,Rde1,536,509,-27,1
5r1k/p1p5/1n2pP1p/2ppP1p1/6PP/6B1/PPP1b3/2K1R2R b - - 2 28,Bf3,556,586,30,1
5r1k/p1p5/1n2pP1p/2ppP1p1/6PP/5bB1/PPP5/2K1R2R w - - 3 29,hxg5,601,599,-2,1
5r1k/p1p5/1n2pP1p/2ppP1P1/6P1/5bB1/PPP5/2K1R2R b - - 0 29,Bxh1,627,628,1,1
5r1k/p1p5/1n2pP1p/2ppP1P1/6P1/6B1/PPP5/2K1R2b w - - 0 30,Rxh1,628,631,3,1
5r1k/p1p5/1n2pP1p/2ppP1P1/6P1/6B1/PPP5/2K4R b - - 0 30,Kh7,606,668,62,1
5r2/p1p4k/1n2pP1p/2ppP1P1/6P1/6B1/PPP5/2K4R w - - 1 31,Rxh6+,680,662,-18,1
5r2/p1p4k/1n2pP1R/2ppP1P1/6P1/6B1/PPP5/2K5 b - - 0 31,Kg8,683,704,21,1
5rk1/p1p5/1n2pP1R/2ppP1P1/6P1/6B1/PPP5/2K5 w - - 1 32,g6,712,710,-2,1
5rk1/p1p5/1n2pPPR/2ppP3/6P1/6B1/PPP5/2K5 b - - 0 32,Nc4,710,753,43,1
5rk1/p1p5/4pPPR/2ppP3/2n3P1/6B1/PPP5/2K5 w - - 1 33,f7+,840,385,-455,0
5rk1/p1p2P2/4p1PR/2ppP3/2n3P1/6B1/PPP5/2K5 b - - 0 33,Kg7,305,328,23,1
5r2/p1p2Pk1/4p1PR/2ppP3/2n3P1/6B1/PPP5/2K5 w - - 1 34,g5,359,265,-94,1
5r2/p1p2Pk1/4p1PR/2ppP1P1/2n5/6B1/PPP5/2K5 b - - 0 34,Ne3,268,470,202,1
5r2/p1p2Pk1/4p1PR/2ppP1P1/8/4n1B1/PPP5/2K5 w - - 1 35,Bf2,479,525,46,1
5r2/p1p2Pk1/4p1PR/2ppP1P1/8/4n3/PPP2B2/2K5 b - - 2 35,Nf5,530,533,3,1
5r2/p1p2Pk1/4p1PR/2ppPnP1/8/8/PPP2B2/2K5 w - - 3 36,Bxc5,535,561,26,1
5r2/p1p2Pk1/4p1PR/2BpPnP1/8/8/PPP5/2K5 b - - 0 36,Nxh6,548,627,79,1
5r2/p1p2Pk1/4p1Pn/2BpP1P1/8/8/PPP5/2K5 w - - 0 37,gxh6+,685,569,-116,0
5r2/p1p2Pk1/4p1PP/2BpP3/8/8/PPP5/2K5 b - - 0 37,Kxh6,583,566,-17,1
5r2/p1p2P2/4p1Pk/2BpP3/8/8/PPP5/2K5 w - - 0 38,Bxf8+,567,571,4,1
5B2/p1p2P2/4p1Pk/3pP3/8/8/PPP5/2K5 b - - 0 38,Kxg6,605,598,-7,1
5B2/p1p2P2/4p1k1/3pP3/8/8/PPP5/2K5 w - - 0 39,Bc5,604,593,-11,1
8/p1p2P2/4p1k1/2BpP3/8/8/PPP5/2K5 b - - 1 39,Kxf7,599,632,33,1
8/p1p2k2/4p3/2BpP3/8/8/PPP5/2K5 w - - 0 40,Bxa7,647,654,7,1
8/B1p2k2/4p3/3pP3/8/8/PPP5/2K5 b - - 0 40,Kg6,631,627,-4,1
8/B1p5/4p1k1/3pP3/8/8/PPP5/2K5 w - - 1 41,Bd4,617,617,0,1
8/2p5/4p1k1/3pP3/3B4/8/PPP5/2K5 b - - 2 41,Kf5,601,656,55,1
8/2p5/4p3/3pPk2/3B4/8/PPP5/2K5 w - - 3 42,a4,647,655,8,1
8/2p5/4p3/3pPk2/P2B4/8/1PP5/2K5 b - - 0 42,Ke4,630,673,43,1
8/2p5/4p3/3pP3/P2Bk3/8/1PP5/2K5 w - - 1 43,c3,649,685,36,1
rnbqkbnr/pppppppp/8/8/8/8/PPPPPPPP/RNBQKBNR w KQkq - 0 1,g3,44,20,-24,1
rnbqkbnr/pppppppp/8/8/8/6P1/PPPPPP1P/RNBQKBNR b KQkq - 0 1,e5,16,24,8,1
rnbqkbnr/pppp1ppp/8/4p3/8/6P1/PPPPPP1P/RNBQKBNR w KQkq - 0 2,Bg2,26,-20,-46,1
rnbqkbnr/pppp1ppp/8/4p3/8/6P1/PPPPPPBP/RNBQK1NR b KQkq - 1 2,d5,-28,-27,1,1
rnbqkbnr/ppp2ppp/8/3pp3/8/6P1/PPPPPPBP/RNBQK1NR w KQkq - 0 3,b3,-32,-63,-31,1
rnbqkbnr/ppp2ppp/8/3pp3/8/1P4P1/P1PPPPBP/RNBQK1NR b KQkq - 0 3,f5,-65,-53,12,1
rnbqkbnr/ppp3pp/8/3ppp2/8/1P4P1/P1PPPPBP/RNBQK1NR w KQkq - 0 4,Bb2,-57,-63,-6,1
rnbqkbnr/ppp3pp/8/3ppp2/8/1P4P1/PBPPPPBP/RN1QK1NR b KQkq - 1 4,Nc6,-61,-65,-4,1
r1bqkbnr/ppp3pp/2n5/3ppp2/8/1P4P1/PBPPPPBP/RN1QK1NR w KQkq - 2 5,Nf3,-62,-92,-30,1
r1bqkbnr/ppp3pp/2n5/3ppp2/8/1P3NP1/PBPPPPBP/RN1QK2R b KQkq - 3 5,Bd6,-72,7,79,1
r1bqk1nr/ppp3pp/2nb4/3ppp2/8/1P3NP1/PBPPPPBP/RN1QK2R w KQkq - 4 6,O-O,3,-64,-67,1
r1bqk1nr/ppp3pp/2nb4/3ppp2/8/1P3NP1/PBPPPPBP/RN1Q1RK1 b kq - 5 6,Nf6,-68,-72,-4,1
r1bqk2r/ppp3pp/2nb1n2/3ppp2/8/1P3NP1/PBPPPPBP/RN1Q1RK1 w kq - 6 7,d3,-67,-86,-19,1
r1bqk2r/ppp3pp/2nb1n2/3ppp2/8/1P1P1NP1/PBP1PPBP/RN1Q1RK1 b kq - 0 7,O-O,-81,-73,8,1
r1bq1rk1/ppp3pp/2nb1n2/3ppp2/8/1P1P1NP1/PBP1PPBP/RN1Q1RK1 w - - 1 8,Nc3,-68,-77,-9,1
r1bq1rk1/ppp3pp/2nb1n2/3ppp2/8/1PNP1NP1/PBP1PPBP/R2Q1RK1 b - - 2 8,f4,-70,-41,29,1
r1bq1rk1/ppp3pp/2nb1n2/3pp3/5p2/1PNP1NP1/PBP1PPBP/R2Q1RK1 w - - 0 9,Ng5,-67,-160,-93,1
r1bq1rk1/ppp3pp/2nb1n2/3pp1N1/5p2/1PNP2P1/PBP1PPBP/R2Q1RK1 b - - 1 9,d4,-147,-46,101,1
r1bq1rk1/ppp3pp/2nb1n2/4p1N1/3p1p2/1PNP2P1/PBP1PPBP/R2Q1RK1 w - - 0 10,Nce4,-36,-57,-21,1
r1bq1rk1/ppp3pp/2nb1n2/4p1N1/3pNp2/1P1P2P1/PBP1PPBP/R2Q1RK1 b - - 1 10,Bf5,-59,-29,30,1
r2q1rk1/ppp3pp/2nb1n2/4pbN1/3pNp2/1P1P2P1/PBP1PPBP/R2Q1RK1 w - - 2 11,Nxf6+,-26,-49,-23,1
r2q1rk1/ppp3pp/2nb1N2/4pbN1/3p1p2/1P1P2P1/PBP1PPBP/R2Q1RK1 b - - 0 11,Qxf6,-48,-58,-10,1
r4rk1/ppp3pp/2nb1q2/4pbN1/3p1p2/1P1P2P1/PBP1PPBP/R2Q1RK1 w - - 0 12,Ne4,-64,-63,1,1
r4rk1/ppp3pp/2nb1q2/4pb2/3pNp2/1P1P2P1/PBP1PPBP/R2Q1RK1 b - - 1 12,Bxe4,-61,-10,51,1
r4rk1/ppp3pp/2nb1q2/4p3/3pbp2/1P1P2P1/PBP1PPBP/R2Q1RK1 w - - 0 13,Bxe4,-11,-19,-8,1
r4rk1/ppp3pp/2nb1q2/4p3/3pBp2/1P1P2P1/PBP1PP1P/R2Q1RK1 b - - 0 13,Rf7,-22,111,133,1
r5k1/ppp2rpp/2nb1q2/4p3/3pBp2/1P1P2P1/PBP1PP1P/R2Q1RK1 w - - 1 14,e3,114,69,-45,1
r5k1/ppp2rpp/2nb1q2/4p3/3pBp2/1P1PP1P1/PBP2P1P/R2Q1RK1 b - - 0 14,f3,13,143,130,1
r5k1/ppp2rpp/2nb1q2/4p3/3pB3/1P1PPpP1/PBP2P1P/R2Q1RK1 w - - 0 15,exd4,123,97,-26,1
r5k1/ppp2rpp/2nb1q2/4p3/3PB3/1P1P1pP1/PBP2P1P/R2Q1RK1 b - - 0 15,exd4,72,157,85,1
r5k1/ppp2rpp/2nb1q2/8/3pB3/1P1P1pP1/PBP2P1P/R2Q1RK1 w - - 0 16,c3,98,-297,-395,0
r5k1/ppp2rpp/2nb1q2/8/3pB3/1PPP1pP1/PB3P1P/R2Q1RK1 b - - 0 16,dxc3,-322,-285,37,1
r5k1/ppp2rpp/2nb1q2/8/4B3/1PpP1pP1/PB3P1P/R2Q1RK1 w - - 0 17,Bc1,-287,-308,-21,1
r5k1/ppp2rpp/2nb1q2/8/4B3/1PpP1pP1/P4P1P/R1BQ1RK1 b - - 1 17,Nd4,-273,-286,-13,1
r5k1/ppp2rpp/3b1q2/8/3nB3/1PpP1pP1/P4P1P/R1BQ1RK1 w - - 2 18,Be3,-296,-290,6,1
r5k1/ppp2rpp/3b1q2/8/3nB3/1PpPBpP1/P4P1P/R2Q1RK1 b - - 3 18,Ne2+,-285,-296,-11,1
r5k1/ppp2rpp/3b1q2/8/4B3/1PpPBpP1/P3nP1P/R2Q1RK1 w - - 4 19,Kh1,-292,-293,-1,1
r5k1/ppp2rpp/3b1q2/8/4B3/1PpPBpP1/P3nP1P/R2Q1R1K b - - 5 19,c6,-292,-281,11,1
r5k1/pp3rpp/2pb1q2/8/4B3/1PpPBpP1/P3nP1P/R2Q1R1K w - - 0 20,Qc2,-284,-296,-12,1
r5k1/pp3rpp/2pb1q2/8/4B3/1PpPBpP1/P1Q1nP1P/R4R1K b - - 1 20,Re8,-305,-317,-12,1
4r1k1/pp3rpp/2pb1q2/8/4B3/1PpPBpP1/P1Q1nP1P/R4R1K w - - 2 21,Rfe1,-271,-313,-42,1
4r1k1/pp3rpp/2pb1q2/8/4B3/1PpPBpP1/P1Q1nP1P/R3R2K b - - 3 21,Re5,-320,-221,99,1
6k1/pp3rpp/2pb1q2/4r3/4B3/1PpPBpP1/P1Q1nP1P/R3R2K w - - 4 22,Rxe2,-218,-215,3,1
6k1/pp3rpp/2pb1q2/4r3/4B3/1PpPBpP1/P1Q1RP1P/R6K b - - 0 22,fxe2,-234,-234,0,1
6k1/pp3rpp/2pb1q2/4r3/4B3/1PpPB1P1/P1Q1pP1P/R6K w - - 0 23,Qxe2,-210,-232,-22,1
6k1/pp3rpp/2pb1q2/4r3/4B3/1PpPB1P1/P3QP1P/R6K b - - 0 23,Rxe4,-249,-15,234,1
6k1/pp3rpp/2pb1q2/8/4r3/1PpPB1P1/P3QP1P/R6K w - - 0 24,dxe4,-27,-58,-31,1
6k1/pp3rpp/2pb1q2/8/4P3/1Pp1B1P1/P3QP1P/R6K b - - 0 24,c2,-42,182,224,1
6k1/pp3rpp/2pb1q2/8/4P3/1P2B1P1/P1p1QP1P/R6K w - - 0 25,Rc1,182,185,3,1
6k1/pp3rpp/2pb1q2/8/4P3/1P2B1P1/P1p1QP1P/2R4K b - - 1 25,b6,200,306,106,1
6k1/p4rpp/1ppb1q2/8/4P3/1P2B1P1/P1p1QP1P/2R4K w - - 0 26,Qxc2,294,265,-29,1
6k1/p4rpp/1ppb1q2/8/4P3/1P2B1P1/P1Q2P1P/2R4K b - - 0 26,Qf3+,288,301,13,1
6k1/p4rpp/1ppb4/8/4P3/1P2BqP1/P1Q2P1P/2R4K w - - 1 27,Kg1,271,267,-4,1
6k1/p4rpp/1ppb4/8/4P3/1P2BqP1/P1Q2P1P/2R3K1 b - - 2 27,Bc5,271,363,92,1
6k1/p4rpp/1pp5/2b5/4P3/1P2BqP1/P1Q2P1P/2R3K1 w - - 3 28,Bxc5,366,385,19,1
6k1/p4rpp/1pp5/2B5/4P3/1P3qP1/P1Q2P1P/2R3K1 b - - 0 28,bxc5,365,362,-3,1
6k1/p4rpp/2p5/2p5/4P3/1P3qP1/P1Q2P1P/2R3K1 w - - 0 29,Rf1,350,325,-25,1
6k1/p4rpp/2p5/2p5/4P3/1P3qP1/P1Q2P1P/5RK1 b - - 1 29,Re7,272,369,97,1
6k1/p3r1pp/2p5/2p5/4P3/1P3qP1/P1Q2P1P/5RK1 w - - 2 30,Re1,375,354,-21,1
6k1/p3r1pp/2p5/2p5/4P3/1P3qP1/P1Q2P1P/4R1K1 b - - 3 30,Re5,373,410,37,1
6k1/p5pp/2p5/2p1r3/4P3/1P3qP1/P1Q2P1P/4R1K1 w - - 4 31,Qc4+,389,361,-28,1
rnbqkbnr/pppppppp/8/8/8/8/PPPPPPPP/RNBQKBNR w KQkq - 0 1,e4,41,36,-5,1
rnbqkbnr/pppppppp/8/8/4P3/8/PPPP1PPP/RNBQKBNR b KQkq - 0 1,d5,33,70,37,1
rnbqkbnr/ppp1pppp/8/3p4/4P3/8/PPPP1PPP/RNBQKBNR w KQkq - 0 2,e5,65,2,-63,1
rnbqkbnr/ppp1pppp/8/3pP3/8/8/PPPP1PPP/RNBQKBNR b KQkq - 0 2,Nc6,4,48,44,1
r1bqkbnr/ppp1pppp/2n5/3pP3/8/8/PPPP1PPP/RNBQKBNR w KQkq - 1 3,Nf3,49,15,-34,1
r1bqkbnr/ppp1pppp/2n5/3pP3/8/5N2/PPPP1PPP/RNBQKB1R b KQkq - 2 3,d4,15,87,72,1
r1bqkbnr/ppp1pppp/2n5/4P3/3p4/5N2/PPPP1PPP/RNBQKB1R w KQkq - 0 4,c3,40,-65,-105,0
r1bqkbnr/ppp1pppp/2n5/4P3/3p4/2P2N2/PP1P1PPP/RNBQKB1R b KQkq - 0 4,Bg4,-50,-58,-8,1
r2qkbnr/ppp1pppp/2n5/4P3/3p2b1/2P2N2/PP1P1PPP/RNBQKB1R w KQkq - 1 5,Be2,-46,-163,-117,0
r2qkbnr/ppp1pppp/2n5/4P3/3p2b1/2P2N2/PP1PBPPP/RNBQK2R b KQkq - 2 5,Bxf3,-149,20,169,1
r2qkbnr/ppp1pppp/2n5/4P3/3p4/2P2b2/PP1PBPPP/RNBQK2R w KQkq - 0 6,Bxf3,25,21,-4,1
r2qkbnr/ppp1pppp/2n5/4P3/3p4/2P2B2/PP1P1PPP/RNBQK2R b KQkq - 0 6,Nxe5,0,128,128,1
r2qkbnr/ppp1pppp/8/4n3/3p4/2P2B2/PP1P1PPP/RNBQK2R w KQkq - 0 7,cxd4,120,-150,-270,0
r2qkbnr/ppp1pppp/8/4n3/3P4/5B2/PP1P1PPP/RNBQK2R b KQkq - 0 7,Ng6,-174,332,506,1
r2qkbnr/ppp1pppp/6n1/8/3P4/5B2/PP1P1PPP/RNBQK2R w KQkq - 1 8,Bxb7,313,336,23,1
r2qkbnr/pBp1pppp/6n1/8/3P4/8/PP1P1PPP/RNBQK2R b KQkq - 0 8,Rb8,315,686,371,1
1r1qkbnr/pBp1pppp/6n1/8/3P4/8/PP1P1PPP/RNBQK2R w KQk - 1 9,Qa4+,675,608,-67,1
1r1qkbnr/pBp1pppp/6n1/8/Q2P4/8/PP1P1PPP/RNB1K2R b KQk - 2 9,Qd7,595,590,-5,1
1r2kbnr/pBpqpppp/6n1/8/Q2P4/8/PP1P1PPP/RNB1K2R w KQk - 3 10,Bc6,575,608,33,1
1r2kbnr/p1pqpppp/2B3n1/8/Q2P4/8/PP1P1PPP/RNB1K2R b KQk - 4 10,Qxc6,587,584,-3,1
1r2kbnr/p1p1pppp/2q3n1/8/Q2P4/8/PP1P1PPP/RNB1K2R w KQk - 0 11,Qxc6+,595,605,10,1
1r2kbnr/p1p1pppp/2Q3n1/8/3P4/8/PP1P1PPP/RNB1K2R b KQk - 0 11,Kd8,602,576,-26,1
1r1k1bnr/p1p1pppp/2Q3n1/8/3P4/8/PP1P1PPP/RNB1K2R w KQ - 1 12,O-O,583,515,-68,1
1r1k1bnr/p1p1pppp/2Q3n1/8/3P4/8/PP1P1PPP/RNB2RK1 b - - 2 12,Nf4,514,528,14,1
1r1k1bnr/p1p1pppp/2Q5/8/3P1n2/8/PP1P1PPP/RNB2RK1 w - - 3 13,d3,619,616,-3,1
1r1k1bnr/p1p1pppp/2Q5/8/3P1n2/3P4/PP3PPP/RNB2RK1 b - - 0 13,Nxd3,614,650,36,1
1r1k1bnr/p1p1pppp/2Q5/8/3P4/3n4/PP3PPP/RNB2RK1 w - - 0 14,Nc3,654,627,-27,1
1r1k1bnr/p1p1pppp/2Q5/8/3P4/2Nn4/PP3PPP/R1B2RK1 b - - 1 14,e6,663,660,-3,1
1r1k1bnr/p1p2ppp/2Q1p3/8/3P4/2Nn4/PP3PPP/R1B2RK1 w - - 0 15,Bf4,658,487,-171,0
1r1k1bnr/p1p2ppp/2Q1p3/8/3P1B2/2Nn4/PP3PPP/R4RK1 b - - 1 15,Bd6,479,759,280,1
1r1k2nr/p1p2ppp/2Qbp3/8/3P1B2/2Nn4/PP3PPP/R4RK1 w - - 2 16,Bxd6,754,772,18,1
1r1k2nr/p1p2ppp/2QBp3/8/3P4/2Nn4/PP3PPP/R4RK1 b - - 0 16,cxd6,759,781,22,1
1r1k2nr/p4ppp/2Qpp3/8/3P4/2Nn4/PP3PPP/R4RK1 w - - 0 17,Qxd6+,810,817,7,1
1r1k2nr/p4ppp/3Qp3/8/3P4/2Nn4/PP3PPP/R4RK1 b - - 0 17,Kc8,788,848,60,1
1rk3nr/p4ppp/3Qp3/8/3P4/2Nn4/PP3PPP/R4RK1 w - - 1 18,Qf8+,806,831,25,1
1rk2Qnr/p4ppp/4p3/8/3P4/2Nn4/PP3PPP/R4RK1 b - - 2 18,Kb7,834,834,0,1
1r3Qnr/pk3ppp/4p3/8/3P4/2Nn4/PP3PPP/R4RK1 w - - 3 19,Nb5,822,-310,-1132,0
1r3Qnr/pk3ppp/4p3/1N6/3P4/3n4/PP3PPP/R4RK1 b - - 4 19,Nf6,-325,743,1068,1
1r3Q1r/pk3ppp/4pn2/1N6/3P4/3n4/PP3PPP/R4RK1 w - - 5 20,Qe7+,795,778,-17,1
1r5r/pk2Qppp/4pn2/1N6/3P4/3n4/PP3PPP/R4RK1 b - - 6 20,Kb6,765,835,70,1
1r5r/p3Qppp/1k2pn2/1N6/3P4/3n4/PP3PPP/R4RK1 w - - 7 21,Nd6,834,690,-144,0
1r5r/p3Qppp/1k1Npn2/8/3P4/3n4/PP3PPP/R4RK1 b - - 8 21,Nd5,729,662,-67,1
1r5r/p3Qppp/1k1Np3/3n4/3P4/3n4/PP3PPP/R4RK1 w - - 9 22,Qxf7,673,638,-35,1
1r5r/p4Qpp/1k1Np3/3n4/3P4/3n4/PP3PPP/R4RK1 b - - 0 22,Rb7,666,9998,9332,1
7r/pr3Qpp/1k1Np3/3n4/3P4/3n4/PP3PPP/R4RK1 w - - 1 23,Qxe6,9998,631,-9367,0
7r/pr4pp/1k1NQ3/3n4/3P4/3n4/PP3PPP/R4RK1 b - - 0 23,N5f4,628,771,143,1
7r/pr4pp/1k1NQ3/8/3P1n2/3n4/PP3PPP/R4RK1 w - - 1 24,Nc8+,795,619,-176,0
2N4r/pr4pp/1k2Q3/8/3P1n2/3n4/PP3PPP/R4RK1 b - - 2 24,Kc7,697,9996,9299,1
2N4r/prk3pp/4Q3/8/3P1n2/3n4/PP3PPP/R4RK1 w - - 3 25,Qd6+,9996,9997,1,1
2N4r/prk3pp/3Q4/8/3P1n2/3n4/PP3PPP/R4RK1 b - - 4 25,Kxc8,9997,9997,0,1
2k4r/pr4pp/3Q4/8/3P1n2/3n4/PP3PPP/R4RK1 w - - 0 26,Rac1+,9997,9998,1,1
2k4r/pr4pp/3Q4/8/3P1n2/3n4/PP3PPP/2R2RK1 b - - 1 26,Rc7,9998,9999,1,1
2k4r/p1r3pp/3Q4/8/3P1n2/3n4/PP3PPP/2R2RK1 w - - 2 27,Rxc7+,9999,9997,-2,1
2k4r/p1R3pp/3Q4/8/3P1n2/3n4/PP3PPP/5RK1 b - - 0 27,Kb8,9997,9997,0,1
1k5r/p1R3pp/3Q4/8/3P1n2/3n4/PP3PPP/5RK1 w - - 1 28,Qd7,9997,912,-9085,0
1k5r/p1RQ2pp/8/8/3P1n2/3n4/PP3PPP/5RK1 b - - 2 28,Nc5,936,976,40,1
1k5r/p1RQ2pp/8/2n5/3P1n2/8/PP3PPP/5RK1 w - - 3 29,Rb7+,1053,647,-406,0
1k5r/pR1Q2pp/8/2n5/3P1n2/8/PP3PPP/5RK1 b - - 4 29,Ka8,691,9998,9307,1
k6r/pR1Q2pp/8/2n5/3P1n2/8/PP3PPP/5RK1 w - - 5 30,Rxa7+,9998,9999,1,1
k6r/R2Q2pp/8/2n5/3P1n2/8/PP3PPP/5RK1 b - - 0 30,Kb8,9999,9999,0,1
1k5r/R2Q2pp/8/2n5/3P1n2/8/PP3PPP/5RK1 w - - 1 31,Qc7#,9999,10000,1,1
rnbqkbnr/pppppppp/8/8/8/8/PPPPPPPP/RNBQKBNR w KQkq - 0 1,e4,44,43,-1,1
rnbqkbnr/pppppppp/8/8/4P3/8/PPPP1PPP/RNBQKBNR b KQkq - 0 1,e5,42,37,-5,1
rnbqkbnr/pppp1ppp/8/4p3/4P3/8/PPPP1PPP/RNBQKBNR w KQkq - 0 2,Nf3,50,38,-12,1
rnbqkbnr/pppp1ppp/8/4p3/4P3/5N2/PPPP1PPP/RNBQKB1R b KQkq - 1 2,d5,33,90,57,1
rnbqkbnr/ppp2ppp/8/3pp3/4P3/5N2/PPPP1PPP/RNBQKB1R w KQkq - 0 3,d3,95,7,-88,1
rnbqkbnr/ppp2ppp/8/3pp3/4P3/3P1N2/PPP2PPP/RNBQKB1R b KQkq - 0 3,dxe4,-3,16,19,1
rnbqkbnr/ppp2ppp/8/4p3/4p3/3P1N2/PPP2PPP/RNBQKB1R w KQkq - 0 4,Nxe5,-1,-12,-11,1
rnbqkbnr/ppp2ppp/8/4N3/4p3/3P4/PPP2PPP/RNBQKB1R b KQkq - 0 4,Nd7,-12,95,107,1
r1bqkbnr/pppn1ppp/8/4N3/4p3/3P4/PPP2PPP/RNBQKB1R w KQkq - 1 5,Nxd7,119,113,-6,1
r1bqkbnr/pppN1ppp/8/8/4p3/3P4/PPP2PPP/RNBQKB1R b KQkq - 0 5,Qxd7,121,116,-5,1
r1b1kbnr/pppq1ppp/8/8/4p3/3P4/PPP2PPP/RNBQKB1R w KQkq - 0 6,Be2,120,11,-109,0
r1b1kbnr/pppq1ppp/8/8/4p3/3P4/PPP1BPPP/RNBQK2R b KQkq - 1 6,exd3,14,35,21,1
r1b1kbnr/pppq1ppp/8/8/8/3p4/PPP1BPPP/RNBQK2R w KQkq - 0 7,Qxd3,34,-3,-37,1
r1b1kbnr/pppq1ppp/8/8/8/3Q4/PPP1BPPP/RNB1K2R b KQkq - 0 7,Nf6,6,27,21,1
r1b1kb1r/pppq1ppp/5n2/8/8/3Q4/PPP1BPPP/RNB1K2R w KQkq - 1 8,O-O,27,-5,-32,1
r1b1kb1r/pppq1ppp/5n2/8/8/3Q4/PPP1BPPP/RNB2RK1 b kq - 2 8,Bd6,-5,29,34,1
r1b1k2r/pppq1ppp/3b1n2/8/8/3Q4/PPP1BPPP/RNB2RK1 w kq - 3 9,Nc3,58,34,-24,1
r1b1k2r/pppq1ppp/3b1n2/8/8/2NQ4/PPP1BPPP/R1B2RK1 b kq - 4 9,O-O,32,57,25,1
r1b2rk1/pppq1ppp/3b1n2/8/8/2NQ4/PPP1BPPP/R1B2RK1 w - - 5 10,Ne4,29,-33,-62,1
r1b2rk1/pppq1ppp/3b1n2/8/4N3/3Q4/PPP1BPPP/R1B2RK1 b - - 6 10,Nxe4,-43,-18,25,1
r1b2rk1/pppq1ppp/3b4/8/4n3/3Q4/PPP1BPPP/R1B2RK1 w - - 0 11,Qxe4,-25,-44,-19,1
r1b2rk1/pppq1ppp/3b4/8/4Q3/8/PPP1BPPP/R1B2RK1 b - - 0 11,Re8,-54,-47,7,1
r1b1r1k1/pppq1ppp/3b4/8/4Q3/8/PPP1BPPP/R1B2RK1 w - - 1 12,Qh4,-49,-499,-450,0
r1b1r1k1/pppq1ppp/3b4/8/7Q/8/PPP1BPPP/R1B2RK1 b - - 2 12,Qf5,-523,276,799,1
r1b1r1k1/ppp2ppp/3b4/5q2/7Q/8/PPP1BPPP/R1B2RK1 w - - 3 13,Bd3,258,269,11,1
r1b1r1k1/ppp2ppp/3b4/5q2/7Q/3B4/PPP2PPP/R1B2RK1 b - - 4 13,Be7,244,402,158,1
r1b1r1k1/ppp1bppp/8/5q2/7Q/3B4/PPP2PPP/R1B2RK1 w - - 5 14,Bxf5,406,11,-395,0
r1b1r1k1/ppp1bppp/8/5B2/7Q/8/PPP2PPP/R1B2RK1 b - - 0 14,Bxh4,-10,12,22,1
r1b1r1k1/ppp2ppp/8/5B2/7b/8/PPP2PPP/R1B2RK1 w - - 0 15,Bxc8,14,21,7,1
r1B1r1k1/ppp2ppp/8/8/7b/8/PPP2PPP/R1B2RK1 b - - 0 15,Raxc8,17,11,-6,1
2r1r1k1/ppp2ppp/8/8/7b/8/PPP2PPP/R1B2RK1 w - - 0 16,Be3,15,15,0,1
2r1r1k1/ppp2ppp/8/8/7b/4B3/PPP2PPP/R4RK1 b - - 1 16,a6,15,10,-5,1
2r1r1k1/1pp2ppp/p7/8/7b/4B3/PPP2PPP/R4RK1 w - - 0 17,Rfd1,1,0,-1,1
2r1r1k1/1pp2ppp/p7/8/7b/4B3/PPP2PPP/R2R2K1 b - - 1 17,Bf6,5,11,6,1
2r1r1k1/1pp2ppp/p4b2/8/8/4B3/PPP2PPP/R2R2K1 w - - 2 18,c3,11,11,0,1
2r1r1k1/1pp2ppp/p4b2/8/8/2P1B3/PP3PPP/R2R2K1 b - - 0 18,Rcd8,9,14,5,1
3rr1k1/1pp2ppp/p4b2/8/8/2P1B3/PP3PPP/R2R2K1 w - - 1 19,Kf1,15,14,-1,1
3rr1k1/1pp2ppp/p4b2/8/8/2P1B3/PP3PPP/R2R1K2 b - - 2 19,Kf8,11,5,-6,1
3rrk2/1pp2ppp/p4b2/8/8/2P1B3/PP3PPP/R2R1K2 w - - 3 20,Ke2,-1,-5,-4,1
3rrk2/1pp2ppp/p4b2/8/8/2P1B3/PP2KPPP/R2R4 b - - 4 20,b6,-6,-3,3,1
3rrk2/2p2ppp/pp3b2/8/8/2P1B3/PP2KPPP/R2R4 w - - 0 21,g3,0,3,3,1
3rrk2/2p2ppp/pp3b2/8/8/2P1B1P1/PP2KP1P/R2R4 b - - 0 21,Rd6,5,27,22,1
4rk2/2p2ppp/pp1r1b2/8/8/2P1B1P1/PP2KP1P/R2R4 w - - 1 22,Rxd6,115,59,-56,1
4rk2/2p2ppp/pp1R1b2/8/8/2P1B1P1/PP2KP1P/R7 b - - 0 22,cxd6,49,68,19,1
4rk2/5ppp/pp1p1b2/8/8/2P1B1P1/PP2KP1P/R7 w - - 0 23,Rd1,66,43,-23,1
4rk2/5ppp/pp1p1b2/8/8/2P1B1P1/PP2KP1P/3R4 b - - 1 23,Re6,48,97,49,1
5k2/5ppp/pp1prb2/8/8/2P1B1P1/PP2KP1P/3R4 w - - 2 24,Kf3,84,59,-25,1
5k2/5ppp/pp1prb2/8/8/2P1BKP1/PP3P1P/3R4 b - - 3 24,b5,62,49,-13,1
5k2/5ppp/p2prb2/1p6/8/2P1BKP1/PP3P1P/3R4 w - - 0 25,Rd5,65,21,-44,1
5k2/5ppp/p2prb2/1p1R4/8/2P1BKP1/PP3P1P/8 b - - 1 25,Bd8,18,39,21,1
3b1k2/5ppp/p2pr3/1p1R4/8/2P1BKP1/PP3P1P/8 w - - 2 26,Bc5,46,16,-30,1
3b1k2/5ppp/p2pr3/1pBR4/8/2P2KP1/PP3P1P/8 b - - 3 26,Ke7,21,26,5,1
3b4/4kppp/p2pr3/1pBR4/8/2P2KP1/PP3P1P/8 w - - 4 27,Bb4,25,-21,-46,1
3b4/4kppp/p2pr3/1p1R4/1B6/2P2KP1/PP3P1P/8 b - - 5 27,f6,-24,12,36,1
3b4/4k1pp/p2prp2/1p1R4/1B6/2P2KP1/PP3P1P/8 w - - 0 28,a4,28,-16,-44,1
3b4/4k1pp/p2prp2/1p1R4/PB6/2P2KP1/1P3P1P/8 b - - 0 28,Bc7,-35,215,250,1
8/2b1k1pp/p2prp2/1p1R4/PB6/2P2KP1/1P3P1P/8 w - - 1 29,axb5,216,236,20,1
8/2b1k1pp/p2prp2/1P1R4/1B6/2P2KP1/1P3P1P/8 b - - 0 29,a5,239,271,32,1
8/2b1k1pp/3prp2/pP1R4/1B6/2P2KP1/1P3P1P/8 w - - 0 30,Ba3,259,266,7,1
8/2b1k1pp/3prp2/pP1R4/8/B1P2KP1/1P3P1P/8 b - - 1 30,Bb6,243,300,57,1
8/4k1pp/1b1prp2/pP1R4/8/B1P2KP1/1P3P1P/8 w - - 2 31,c4,301,273,-28,1
8/4k1pp/1b1prp2/pP1R4/2P5/B4KP1/1P3P1P/8 b - - 0 31,Kd7,280,310,30,1
8/3k2pp/1b1prp2/pP1R4/2P5/B4KP1/1P3P1P/8 w - - 1 32,b4,314,294,-20,1
8/3k2pp/1b1prp2/pP1R4/1PP5/B4KP1/5P1P/8 b - - 0 32,axb4,288,339,51,1
8/3k2pp/1b1prp2/1P1R4/1pP5/B4KP1/5P1P/8 w - - 0 33,Bxb4,352,318,-34,1
8/3k2pp/1b1prp2/1P1R4/1BP5/5KP1/5P1P/8 b - - 0 33,Kc7,316,356,40,1
rnbqkbnr/pppppppp/8/8/8/8/PPPPPPPP/RNBQKBNR w KQkq - 0 1,e4,36,35,-1,1
rnbqkbnr/pppppppp/8/8/4P3/8/PPPP1PPP/RNBQKBNR b KQkq - 0 1,e5,35,34,-1,1
rnbqkbnr/pppp1ppp/8/4p3/4P3/8/PPPP1PPP/RNBQKBNR w KQkq - 0 2,Nf3,49,30,-19,1
rnbqkbnr/pppp1ppp/8/4p3/4P3/5N2/PPPP1PPP/RNBQKB1R b KQkq - 1 2,d6,27,49,22,1
rnbqkbnr/ppp2ppp/3p4/4p3/4P3/5N2/PPPP1PPP/RNBQKB1R w KQkq - 0 3,Nc3,61,19,-42,1
rnbqkbnr/ppp2ppp/3p4/4p3/4P3/2N2N2/PPPP1PPP/R1BQKB1R b KQkq - 1 3,Nf6,12,61,49,1
rnbqkb1r/ppp2ppp/3p1n2/4p3/4P3/2N2N2/PPPP1PPP/R1BQKB1R w KQkq - 2 4,Bc4,47,28,-19,1
rnbqkb1r/ppp2ppp/3p1n2/4p3/2B1P3/2N2N2/PPPP1PPP/R1BQK2R b KQkq - 3 4,h6,32,53,21,1
rnbqkb1r/ppp2pp1/3p1n1p/4p3/2B1P3/2N2N2/PPPP1PPP/R1BQK2R w KQkq - 0 5,d4,65,66,1,1
rnbqkb1r/ppp2pp1/3p1n1p/4p3/2BPP3/2N2N2/PPP2PPP/R1BQK2R b KQkq - 0 5,exd4,66,89,23,1
rnbqkb1r/ppp2pp1/3p1n1p/8/2BpP3/2N2N2/PPP2PPP/R1BQK2R w KQkq - 0 6,Nxd4,93,55,-38,1
rnbqkb1r/ppp2pp1/3p1n1p/8/2BNP3/2N5/PPP2PPP/R1BQK2R b KQkq - 0 6,a6,56,98,42,1
rnbqkb1r/1pp2pp1/p2p1n1p/8/2BNP3/2N5/PPP2PPP/R1BQK2R w KQkq - 0 7,Be3,119,61,-58,1
rnbqkb1r/1pp2pp1/p2p1n1p/8/2BNP3/2N1B3/PPP2PPP/R2QK2R b KQkq - 1 7,b5,66,126,60,1
rnbqkb1r/2p2pp1/p2p1n1p/1p6/2BNP3/2N1B3/PPP2PPP/R2QK2R w KQkq - 0 8,Bb3,94,-134,-228,0
rnbqkb1r/2p2pp1/p2p1n1p/1p6/3NP3/1BN1B3/PPP2PPP/R2QK2R b KQkq - 1 8,c5,-119,-116,3,1
rnbqkb1r/5pp1/p2p1n1p/1pp5/3NP3/1BN1B3/PPP2PPP/R2QK2R w KQkq - 0 9,Nf5,-117,-152,-35,1
rnbqkb1r/5pp1/p2p1n1p/1pp2N2/4P3/1BN1B3/PPP2PPP/R2QK2R b KQkq - 1 9,Bxf5,-159,-5,154,1
rn1qkb1r/5pp1/p2p1n1p/1pp2b2/4P3/1BN1B3/PPP2PPP/R2QK2R w KQkq - 0 10,Bxf7+,-2,-333,-331,0
rn1qkb1r/5Bp1/p2p1n1p/1pp2b2/4P3/2N1B3/PPP2PPP/R2QK2R b KQkq - 0 10,Kxf7,-352,-334,18,1
rn1q1b1r/5kp1/p2p1n1p/1pp2b2/4P3/2N1B3/PPP2PPP/R2QK2R w KQ - 0 11,exf5,-336,-304,32,1
rn1q1b1r/5kp1/p2p1n1p/1pp2P2/8/2N1B3/PPP2PPP/R2QK2R b KQ - 0 11,Nc6,-302,-251,51,1
r2q1b1r/5kp1/p1np1n1p/1pp2P2/8/2N1B3/PPP2PPP/R2QK2R w KQ - 1 12,Nd5,-238,-263,-25,1
r2q1b1r/5kp1/p1np1n1p/1ppN1P2/8/4B3/PPP2PPP/R2QK2R b KQ - 2 12,Rc8,-255,-233,22,1
2rq1b1r/5kp1/p1np1n1p/1ppN1P2/8/4B3/PPP2PPP/R2QK2R w KQ - 3 13,O-O,-243,-256,-13,1
2rq1b1r/5kp1/p1np1n1p/1ppN1P2/8/4B3/PPP2PPP/R2Q1RK1 b - - 4 13,Be7,-304,-160,144,1
2rq3r/4bkp1/p1np1n1p/1ppN1P2/8/4B3/PPP2PPP/R2Q1RK1 w - - 5 14,Re1,-195,-257,-62,1
2rq3r/4bkp1/p1np1n1p/1ppN1P2/8/4B3/PPP2PPP/R2QR1K1 b - - 6 14,Re8,-218,-217,1,1
2rqr3/4bkp1/p1np1n1p/1ppN1P2/8/4B3/PPP2PPP/R2QR1K1 w - - 7 15,Nxf6,-242,-352,-110,0
2rqr3/4bkp1/p1np1N1p/1pp2P2/8/4B3/PPP2PPP/R2QR1K1 b - - 0 15,Bxf6,-345,-373,-28,1
2rqr3/5kp1/p1np1b1p/1pp2P2/8/4B3/PPP2PPP/R2QR1K1 w - - 0 16,Qd5+,-367,-358,9,1
2rqr3/5kp1/p1np1b1p/1ppQ1P2/8/4B3/PPP2PPP/R3R1K1 b - - 1 16,Kf8,-350,-374,-24,1
2rqrk2/6p1/p1np1b1p/1ppQ1P2/8/4B3/PPP2PPP/R3R1K1 w - - 2 17,Bf4,-346,-415,-69,1
2rqrk2/6p1/p1np1b1p/1ppQ1P2/5B2/8/PPP2PPP/R3R1K1 b - - 3 17,Ne5,-388,-389,-1,1
2rqrk2/6p1/p2p1b1p/1ppQnP2/5B2/8/PPP2PPP/R3R1K1 w - - 4 18,Rad1,-396,-396,0,1
2rqrk2/6p1/p2p1b1p/1ppQnP2/5B2/8/PPP2PPP/3RR1K1 b - - 5 18,Qc7,-408,-391,17,1
2r1rk2/2q3p1/p2p1b1p/1ppQnP2/5B2/8/PPP2PPP/3RR1K1 w - - 6 19,Qd2,-411,-439,-28,1
2r1rk2/2q3p1/p2p1b1p/1pp1nP2/5B2/8/PPPQ1PPP/3RR1K1 b - - 7 19,Rcd8,-430,-418,12,1
3rrk2/2q3p1/p2p1b1p/1pp1nP2/5B2/8/PPPQ1PPP/3RR1K1 w - - 8 20,Re2,-423,-439,-16,1
3rrk2/2q3p1/p2p1b1p/1pp1nP2/5B2/8/PPPQRPPP/3R2K1 b - - 9 20,Kg8,-459,-418,41,1
3rr1k1/2q3p1/p2p1b1p/1pp1nP2/5B2/8/PPPQRPPP/3R2K1 w - - 10 21,h4,-424,-485,-61,1
3rr1k1/2q3p1/p2p1b1p/1pp1nP2/5B1P/8/PPPQRPP1/3R2K1 b - - 0 21,Bxh4,-487,-403,84,1
3rr1k1/2q3p1/p2p3p/1pp1nP2/5B1b/8/PPPQRPP1/3R2K1 w - - 0 22,Bxh6,-438,-375,63,1
3rr1k1/2q3p1/p2p3B/1pp1nP2/7b/8/PPPQRPP1/3R2K1 b - - 0 22,gxh6,-399,-507,-108,0
3rr1k1/2q5/p2p3p/1pp1nP2/7b/8/PPPQRPP1/3R2K1 w - - 0 23,Qxh6,-466,-513,-47,1
3rr1k1/2q5/p2p3Q/1pp1nP2/7b/8/PPP1RPP1/3R2K1 b - - 0 23,Qg7,-496,-496,0,1
3rr1k1/6q1/p2p3Q/1pp1nP2/7b/8/PPP1RPP1/3R2K1 w - - 1 24,Qxh4,-471,-828,-357,0
3rr1k1/6q1/p2p4/1pp1nP2/7Q/8/PPP1RPP1/3R2K1 b - - 0 24,Nf3+,-813,-847,-34,1
3rr1k1/6q1/p2p4/1pp2P2/7Q/5n2/PPP1RPP1/3R2K1 w - - 1 25,Kh1,-815,-837,-22,1
3rr1k1/6q1/p2p4/1pp2P2/7Q/5n2/PPP1RPP1/3R3K b - - 2 25,Nxh4,-844,-876,-32,1
3rr1k1/6q1/p2p4/1pp2P2/7n/8/PPP1RPP1/3R3K w - - 0 26,Rxe8+,-887,-1057,-170,0
rnbqkbnr/pppppppp/8/8/8/8/PPPPPPPP/RNBQKBNR w KQkq - 0 1,d4,48,11,-37,1
rnbqkbnr/pppppppp/8/8/3P4/8/PPP1PPPP/RNBQKBNR b KQkq - 0 1,d5,19,25,6,1
rnbqkbnr/ppp1pppp/8/3p4/3P4/8/PPP1PPPP/RNBQKBNR w KQkq - 0 2,c4,27,32,5,1
rnbqkbnr/ppp1pppp/8/3p4/2PP4/8/PP2PPPP/RNBQKBNR b KQkq - 0 2,c6,26,35,9,1
rnbqkbnr/pp2pppp/2p5/3p4/2PP4/8/PP2PPPP/RNBQKBNR w KQkq - 0 3,Nc3,34,32,-2,1
rnbqkbnr/pp2pppp/2p5/3p4/2PP4/2N5/PP2PPPP/R1BQKBNR b KQkq - 1 3,h6,14,56,42,1
rnbqkbnr/pp2ppp1/2p4p/3p4/2PP4/2N5/PP2PPPP/R1BQKBNR w KQkq - 0 4,Bf4,63,40,-23,1
rnbqkbnr/pp2ppp1/2p4p/3p4/2PP1B2/2N5/PP2PPPP/R2QKBNR b KQkq - 1 4,Nf6,64,65,1,1
rnbqkb1r/pp2ppp1/2p2n1p/3p4/2PP1B2/2N5/PP2PPPP/R2QKBNR w KQkq - 2 5,Nf3,74,36,-38,1
rnbqkb1r/pp2ppp1/2p2n1p/3p4/2PP1B2/2N2N2/PP2PPPP/R2QKB1R b KQkq - 3 5,e6,33,65,32,1
rnbqkb1r/pp3pp1/2p1pn1p/3p4/2PP1B2/2N2N2/PP2PPPP/R2QKB1R w KQkq - 0 6,e3,72,64,-8,1
rnbqkb1r/pp3pp1/2p1pn1p/3p4/2PP1B2/2N1PN2/PP3PPP/R2QKB1R b KQkq - 0 6,Bd6,74,75,1,1
rnbqk2r/pp3pp1/2pbpn1p/3p4/2PP1B2/2N1PN2/PP3PPP/R2QKB1R w KQkq - 1 7,Bg3,67,50,-17,1
rnbqk2r/pp3pp1/2pbpn1p/3p4/2PP4/2N1PNB1/PP3PPP/R2QKB1R b KQkq - 2 7,Bc7,39,88,49,1
rnbqk2r/ppb2pp1/2p1pn1p/3p4/2PP4/2N1PNB1/PP3PPP/R2QKB1R w KQkq - 3 8,Bd3,88,68,-20,1
rnbqk2r/ppb2pp1/2p1pn1p/3p4/2PP4/2NBPNB1/PP3PPP/R2QK2R b KQkq - 4 8,Nbd7,77,99,22,1
r1bqk2r/ppbn1pp1/2p1pn1p/3p4/2PP4/2NBPNB1/PP3PPP/R2QK2R w KQkq - 5 9,O-O,78,50,-28,1
r1bqk2r/ppbn1pp1/2p1pn1p/3p4/2PP4/2NBPNB1/PP3PPP/R2Q1RK1 b kq - 6 9,O-O,52,95,43,1
r1bq1rk1/ppbn1pp1/2p1pn1p/3p4/2PP4/2NBPNB1/PP3PPP/R2Q1RK1 w - - 7 10,Rc1,104,55,-49,1
r1bq1rk1/ppbn1pp1/2p1pn1p/3p4/2PP4/2NBPNB1/PP3PPP/2RQ1RK1 b - - 8 10,Re8,57,96,39,1
r1bqr1k1/ppbn1pp1/2p1pn1p/3p4/2PP4/2NBPNB1/PP3PPP/2RQ1RK1 w - - 9 11,a3,107,34,-73,1
r1bqr1k1/ppbn1pp1/2p1pn1p/3p4/2PP4/P1NBPNB1/1P3PPP/2RQ1RK1 b - - 0 11,a6,25,78,53,1
r1bqr1k1/1pbn1pp1/p1p1pn1p/3p4/2PP4/P1NBPNB1/1P3PPP/2RQ1RK1 w - - 0 12,Qc2,78,41,-37,1
r1bqr1k1/1pbn1pp1/p1p1pn1p/3p4/2PP4/P1NBPNB1/1PQ2PPP/2R2RK1 b - - 1 12,e5,48,109,61,1
r1bqr1k1/1pbn1pp1/p1p2n1p/3pp3/2PP4/P1NBPNB1/1PQ2PPP/2R2RK1 w - - 0 13,dxe5,151,22,-129,0
r1bqr1k1/1pbn1pp1/p1p2n1p/3pP3/2P5/P1NBPNB1/1PQ2PPP/2R2RK1 b - - 0 13,Nxe5,15,55,40,1
r1bqr1k1/1pb2pp1/p1p2n1p/3pn3/2P5/P1NBPNB1/1PQ2PPP/2R2RK1 w - - 0 14,Nxe5,31,27,-4,1
r1bqr1k1/1pb2pp1/p1p2n1p/3pN3/2P5/P1NBP1B1/1PQ2PPP/2R2RK1 b - - 0 14,Bxe5,26,35,9,1
r1bqr1k1/1p3pp1/p1p2n1p/3pb3/2P5/P1NBP1B1/1PQ2PPP/2R2RK1 w - - 0 15,Bxe5,34,42,8,1
r1bqr1k1/1p3pp1/p1p2n1p/3pB3/2P5/P1NBP3/1PQ2PPP/2R2RK1 b - - 0 15,Rxe5,36,43,7,1
r1bq2k1/1p3pp1/p1p2n1p/3pr3/2P5/P1NBP3/1PQ2PPP/2R2RK1 w - - 0 16,cxd5,31,25,-6,1
r1bq2k1/1p3pp1/p1p2n1p/3Pr3/8/P1NBP3/1PQ2PPP/2R2RK1 b - - 0 16,Nxd5,29,31,2,1
r1bq2k1/1p3pp1/p1p4p/3nr3/8/P1NBP3/1PQ2PPP/2R2RK1 w - - 0 17,Nxd5,42,-2,-44,1
r1bq2k1/1p3pp1/p1p4p/3Nr3/8/P2BP3/1PQ2PPP/2R2RK1 b - - 0 17,Rxd5,4,10,6,1
r1bq2k1/1p3pp1/p1p4p/3r4/8/P2BP3/1PQ2PPP/2R2RK1 w - - 0 18,Be4,16,10,-6,1
r1bq2k1/1p3pp1/p1p4p/3r4/4B3/P3P3/1PQ2PPP/2R2RK1 b - - 1 18,Rd2,12,24,12,1
r1bq2k1/1p3pp1/p1p4p/8/4B3/P3P3/1PQr1PPP/2R2RK1 w - - 2 19,Qc3,16,24,8,1
r1bq2k1/1p3pp1/p1p4p/8/4B3/P1Q1P3/1P1r1PPP/2R2RK1 b - - 3 19,Be6,20,18,-2,1
r2q2k1/1p3pp1/p1p1b2p/8/4B3/P1Q1P3/1P1r1PPP/2R2RK1 w - - 4 20,Bf3,24,-45,-69,1
r2q2k1/1p3pp1/p1p1b2p/8/8/P1Q1PB2/1P1r1PPP/2R2RK1 b - - 5 20,Rd3,-24,-16,8,1
r2q2k1/1p3pp1/p1p1b2p/8/8/P1QrPB2/1P3PPP/2R2RK1 w - - 6 21,Qc5,-20,-67,-47,1
r2q2k1/1p3pp1/p1p1b2p/2Q5/8/P2rPB2/1P3PPP/2R2RK1 b - - 7 21,Qf6,-75,-50,25,1
r5k1/1p3pp1/p1p1bq1p/2Q5/8/P2rPB2/1P3PPP/2R2RK1 w - - 8 22,Qb6,-58,-194,-136,0
r5k1/1p3pp1/pQp1bq1p/8/8/P2rPB2/1P3PPP/2R2RK1 b - - 9 22,Rd7,-187,-20,167,1
r5k1/1p1r1pp1/pQp1bq1p/8/8/P3PB2/1P3PPP/2R2RK1 w - - 10 23,Rcd1,2,-12,-14,1
r5k1/1p1r1pp1/pQp1bq1p/8/8/P3PB2/1P3PPP/3R1RK1 b - - 11 23,Rad8,-6,-1,5,1
3r2k1/1p1r1pp1/pQp1bq1p/8/8/P3PB2/1P3PPP/3R1RK1 w - - 12 24,Rxd7,10,-19,-29,1
3r2k1/1p1R1pp1/pQp1bq1p/8/8/P3PB2/1P3PPP/5RK1 b - - 0 24,Rxd7,-14,-8,6,1
6k1/1p1r1pp1/pQp1bq1p/8/8/P3PB2/1P3PPP/5RK1 w - - 0 25,Rd1,-6,-33,-27,1
6k1/1p1r1pp1/pQp1bq1p/8/8/P3PB2/1P3PPP/3R2K1 b - - 1 25,Rxd1+,-15,-17,-2,1
6k1/1p3pp1/pQp1bq1p/8/8/P3PB2/1P3PPP/3r2K1 w - - 0 26,Bxd1,-23,-29,-6,1
6k1/1p3pp1/pQp1bq1p/8/8/P3P3/1P3PPP/3B2K1 b - - 0 26,Qe7,-11,5,16,1
6k1/1p2qpp1/pQp1b2p/8/8/P3P3/1P3PPP/3B2K1 w - - 1 27,h3,0,0,0,1
6k1/1p2qpp1/pQp1b2p/8/8/P3P2P/1P3PP1/3B2K1 b - - 0 27,Bd5,-7,5,12,1
6k1/1p2qpp1/pQp4p/3b4/8/P3P2P/1P3PP1/3B2K1 w - - 1 28,Bc2,3,-32,-35,1
6k1/1p2qpp1/pQp4p/3b4/8/P3P2P/1PB2PP1/6K1 b - - 2 28,Qd7,-32,378,410,1
6k1/1p1q1pp1/pQp4p/3b4/8/P3P2P/1PB2PP1/6K1 w - - 3 29,Qd4,2,-5,-7,1
6k1/1p1q1pp1/p1p4p/3b4/3Q4/P3P2P/1PB2PP1/6K1 b - - 4 29,Qe6,-3,33,36,1
6k1/1p3pp1/p1p1q2p/3b4/3Q4/P3P2P/1PB2PP1/6K1 w - - 5 30,Qa7,30,5,-25,1
6k1/Qp3pp1/p1p1q2p/3b4/8/P3P2P/1PB2PP1/6K1 b - - 6 30,Qc8,6,7,1,1
2q3k1/Qp3pp1/p1p4p/3b4/8/P3P2P/1PB2PP1/6K1 w - - 7 31,Qc5,11,0,-11,1
2q3k1/1p3pp1/p1p4p/2Qb4/8/P3P2P/1PB2PP1/6K1 b - - 8 31,g6,0,20,20,1
2q3k1/1p3p2/p1p3pp/2Qb4/8/P3P2P/1PB2PP1/6K1 w - - 0 32,Qd4,13,-5,-18,1
2q3k1/1p3p2/p1p3pp/3b4/3Q4/P3P2P/1PB2PP1/6K1 b - - 1 32,Qe6,-6,0,6,1
6k1/1p3p2/p1p1q1pp/3b4/3Q4/P3P2P/1PB2PP1/6K1 w - - 2 33,e4,0,0,0,1
6k1/1p3p2/p1p1q1pp/3b4/3QP3/P6P/1PB2PP1/6K1 b - - 0 33,Bb3,0,0,0,1
6k1/1p3p2/p1p1q1pp/8/3QP3/Pb5P/1PB2PP1/6K1 w - - 1 34,Bd3,0,0,0,1
6k1/1p3p2/p1p1q1pp/8/3QP3/Pb1B3P/1P3PP1/6K1 b - - 2 34,b5,8,12,4,1
6k1/5p2/p1p1q1pp/1p6/3QP3/Pb1B3P/1P3PP1/6K1 w - - 0 35,e5,16,-16,-32,1
6k1/5p2/p1p1q1pp/1p2P3/3Q4/Pb1B3P/1P3PP1/6K1 b - - 0 35,Bc4,-14,-3,11,1
6k1/5p2/p1p1q1pp/1p2P3/2bQ4/P2B3P/1P3PP1/6K1 w - - 1 36,Bxc4,39,-5,-44,1
6k1/5p2/p1p1q1pp/1p2P3/2BQ4/P6P/1P3PP1/6K1 b - - 0 36,Qxc4,-15,262,277,1
6k1/5p2/p1p3pp/1p2P3/2qQ4/P6P/1P3PP1/6K1 w - - 0 37,Qxc4,281,324,43,1
6k1/5p2/p1p3pp/1p2P3/2Q5/P6P/1P3PP1/6K1 b - - 0 37,bxc4,319,312,-7,1
6k1/5p2/p1p3pp/4P3/2p5/P6P/1P3PP1/6K1 w - - 0 38,Kf1,332,271,-61,1
6k1/5p2/p1p3pp/4P3/2p5/P6P/1P3PP1/5K2 b - - 1 38,g5,334,355,21,1
6k1/5p2/p1p4p/4P1p1/2p5/P6P/1P3PP1/5K2 w - - 0 39,Ke2,362,374,12,1
6k1/5p2/p1p4p/4P1p1/2p5/P6P/1P2KPP1/8 b - - 1 39,Kf8,369,369,0,1
5k2/5p2/p1p4p/4P1p1/2p5/P6P/1P2KPP1/8 w - - 2 40,Ke3,377,384,7,1
5k2/5p2/p1p4p/4P1p1/2p5/P3K2P/1P3PP1/8 b - - 3 40,Ke7,397,396,-1,1
8/4kp2/p1p4p/4P1p1/2p5/P3K2P/1P3PP1/8 w - - 4 41,g3,407,359,-48,1
8/4kp2/p1p4p/4P1p1/2p5/P3K1PP/1P3P2/8 b - - 0 41,Ke6,384,384,0,1
8/5p2/p1p1k2p/4P1p1/2p5/P3K1PP/1P3P2/8 w - - 1 42,Kd4,403,222,-181,0
8/5p2/p1p1k2p/4P1p1/2pK4/P5PP/1P3P2/8 b - - 2 42,h5,239,235,-4,1
8/5p2/p1p1k3/4P1pp/2pK4/P5PP/1P3P2/8 w - - 0 43,a4,238,230,-8,1
8/5p2/p1p1k3/4P1pp/P1pK4/6PP/1P3P2/8 b - - 0 43,a5,184,409,225,1
8/5p2/2p1k3/p3P1pp/P1pK4/6PP/1P3P2/8 w - - 0 44,f3,411,313,-98,1
8/5p2/2p1k3/p3P1pp/P1pK4/5PPP/1P6/8 b - - 0 44,c5+,301,417,116,1
8/5p2/4k3/p1p1P1pp/P1pK4/5PPP/1P6/8 w - - 0 45,Ke4,445,438,-7,1
8/5p2/4k3/p1p1P1pp/P1p1K3/5PPP/1P6/8 b - - 1 45,h4,455,472,17,1
8/5p2/4k3/p1p1P1p1/P1p1K2p/5PPP/1P6/8 w - - 0 46,gxh4,445,543,98,1
8/5p2/4k3/p1p1P1p1/P1p1K2P/5P1P/1P6/8 b - - 0 46,gxh4,492,458,-34,1
8/5p2/4k3/p1p1P3/P1p1K2p/5P1P/1P6/8 w - - 0 47,f4,521,524,3,1
8/5p2/4k3/p1p1P3/P1p1KP1p/7P/1P6/8 b - - 0 47,f6,549,557,8,1
8/8/4kp2/p1p1P3/P1p1KP1p/7P/1P6/8 w - - 0 48,f5+,555,539,-16,1
8/8/4kp2/p1p1PP2/P1p1K2p/7P/1P6/8 b - - 0 48,Ke7,571,538,-33,1
8/4k3/5p2/p1p1PP2/P1p1K2p/7P/1P6/8 w - - 1 49,e6,581,571,-10,1
8/4k3/4Pp2/p1p2P2/P1p1K2p/7P/1P6/8 b - - 0 49,Kd6,624,607,-17,1
8/8/3kPp2/p1p2P2/P1p1K2p/7P/1P6/8 w - - 1 50,Kf4,632,631,-1,1
8/8/3kPp2/p1p2P2/P1p2K1p/7P/1P6/8 b - - 2 50,Ke7,631,700,69,1
8/4k3/4Pp2/p1p2P2/P1p2K1p/7P/1P6/8 w - - 3 51,Kg4,722,728,6,1
8/4k3/4Pp2/p1p2P2/P1p3Kp/7P/1P6/8 b - - 4 51,c3,697,734,37,1
8/4k3/4Pp2/p1p2P2/P5Kp/2p4P/1P6/8 w - - 0 52,bxc3,734,737,3,1
8/4k3/4Pp2/p1p2P2/P5Kp/2P4P/8/8 b - - 0 52,Kd6,728,733,5,1
8/8/3kPp2/p1p2P2/P5Kp/2P4P/8/8 w - - 1 53,Kxh4,757,684,-73,1
8/8/3kPp2/p1p2P2/P6K/2P4P/8/8 b - - 0 53,Ke7,727,783,56,1
8/4k3/4Pp2/p1p2P2/P6K/2P4P/8/8 w - - 1 54,Kg4,768,775,7,1
8/4k3/4Pp2/p1p2P2/P5K1/2P4P/8/8 b - - 2 54,c4,798,813,15,1
8/4k3/4Pp2/p4P2/P1p3K1/2P4P/8/8 w - - 0 55,Kf4,795,836,41,1
8/4k3/4Pp2/p4P2/P1p2K2/2P4P/8/8 b - - 1 55,Kd6,876,863,-13,1
8/8/3kPp2/p4P2/P1p2K2/2P4P/8/8 w - - 2 56,h4,1031,1235,204,1
8/8/3kPp2/p4P2/P1p2K1P/2P5/8/8 b - - 0 56,Ke7,1041,1241,200,1
8/4k3/4Pp2/p4P2/P1p2K1P/2P5/8/8 w - - 1 57,h5,927,917,-10,1
8/4k3/4Pp2/p4P1P/P1p2K2/2P5/8/8 b - - 0 57,Kf8,9985,939,-9046,0
5k2/8/4Pp2/p4P1P/P1p2K2/2P5/8/8 w - - 1 58,Ke4,1331,1328,-3,1
5k2/8/4Pp2/p4P1P/P1p1K3/2P5/8/8 b - - 2 58,Ke7,974,9987,9013,1
8/4k3/4Pp2/p4P1P/P1p1K3/2P5/8/8 w - - 3 59,Kd5,9986,9987,1,1
8/4k3/4Pp2/p2K1P1P/P1p5/2P5/8/8 b - - 4 59,Kf8,9988,9988,0,1
5k2/8/4Pp2/p2K1P1P/P1p5/2P5/8/8 w - - 5 60,h6,9988,9989,1,1
5k2/8/4Pp1P/p2K1P2/P1p5/2P5/8/8 b - - 0 60,Kg8,9989,9989,0,1
6k1/8/4Pp1P/p2K1P2/P1p5/2P5/8/8 w - - 1 61,Kd6,9989,1003,-8986,0
6k1/8/3KPp1P/p4P2/P1p5/2P5/8/8 b - - 2 61,Kh7,1313,9986,8673,1
8/7k/3KPp1P/p4P2/P1p5/2P5/8/8 w - - 3 62,e7,9986,9987,1,1
8/4P2k/3K1p1P/p4P2/P1p5/2P5/8/8 b - - 0 62,Kxh6,9987,9987,0,1
8/4P3/3K1p1k/p4P2/P1p5/2P5/8/8 w - - 0 63,e8=Q,9987,9988,1,1
4Q3/8/3K1p1k/p4P2/P1p5/2P5/8/8 b - - 0 63,Kh7,9988,9993,5,1
4Q3/7k/3K1p2/p4P2/P1p5/2P5/8/8 w - - 1 64,Qf7+,9993,9995,2,1
8/5Q1k/3K1p2/p4P2/P1p5/2P5/8/8 b - - 2 64,Kh8,9995,9995,0,1
7k/5Q2/3K1p2/p4P2/P1p5/2P5/8/8 w - - 3 65,Qxf6+,9995,9996,1,1
7k/8/3K1Q2/p4P2/P1p5/2P5/8/8 b - - 0 65,Kh7,9996,9996,0,1
8/7k/3K1Q2/p4P2/P1p5/2P5/8/8 w - - 1 66,Qg6+,9997,9996,-1,1
8/7k/3K2Q1/p4P2/P1p5/2P5/8/8 b - - 2 66,Kh8,9996,9996,0,1
7k/8/3K2Q1/p4P2/P1p5/2P5/8/8 w - - 3 67,Qg1,9997,9996,-1,1
7k/8/3K4/p4P2/P1p5/2P5/8/6Q1 b - - 4 67,Kh7,9989,9997,8,1
8/7k/3K4/p4P2/P1p5/2P5/8/6Q1 w - - 5 68,f6,9997,9990,-7,1
8/7k/3K1P2/p7/P1p5/2P5/8/6Q1 b - - 0 68,Kh6,9990,9990,0,1
8/8/3K1P1k/p7/P1p5/2P5/8/6Q1 w - - 1 69,f7,9990,9991,1,1
8/5P2/3K3k/p7/P1p5/2P5/8/6Q1 b - - 0 69,Kh7,9991,9998,7,1
8/5P1k/3K4/p7/P1p5/2P5/8/6Q1 w - - 1 70,f8=Q,9998,0,-9998,0
rnbqkbnr/pppppppp/8/8/8/8/PPPPPPPP/RNBQKBNR w KQkq - 0 1,d4,29,26,-3,1
rnbqkbnr/pppppppp/8/8/3P4/8/PPP1PPPP/RNBQKBNR b KQkq - 0 1,d5,35,34,-1,1
rnbqkbnr/ppp1pppp/8/3p4/3P4/8/PPP1PPPP/RNBQKBNR w KQkq - 0 2,c4,30,23,-7,1
rnbqkbnr/ppp1pppp/8/3p4/2PP4/8/PP2PPPP/RNBQKBNR b KQkq - 0 2,Bf5,24,59,35,1
rn1qkbnr/ppp1pppp/8/3p1b2/2PP4/8/PP2PPPP/RNBQKBNR w KQkq - 1 3,Nc3,58,34,-24,1
rn1qkbnr/ppp1pppp/8/3p1b2/2PP4/2N5/PP2PPPP/R1BQKBNR b KQkq - 2 3,dxc4,32,225,193,1
rn1qkbnr/ppp1pppp/8/5b2/2pP4/2N5/PP2PPPP/R1BQKBNR w KQkq - 0 4,e3,185,61,-124,0
rn1qkbnr/ppp1pppp/8/5b2/2pP4/2N1P3/PP3PPP/R1BQKBNR b KQkq - 0 4,e6,76,113,37,1
rn1qkbnr/ppp2ppp/4p3/5b2/2pP4/2N1P3/PP3PPP/R1BQKBNR w KQkq - 0 5,Bxc4,83,52,-31,1
rn1qkbnr/ppp2ppp/4p3/5b2/2BP4/2N1P3/PP3PPP/R1BQK1NR b KQkq - 0 5,Bb4,63,117,54,1
rn1qk1nr/ppp2ppp/4p3/5b2/1bBP4/2N1P3/PP3PPP/R1BQK1NR w KQkq - 1 6,Bd2,98,37,-61,1
rn1qk1nr/ppp2ppp/4p3/5b2/1bBP4/2N1P3/PP1B1PPP/R2QK1NR b KQkq - 2 6,Nf6,58,70,12,1
rn1qk2r/ppp2ppp/4pn2/5b2/1bBP4/2N1P3/PP1B1PPP/R2QK1NR w KQkq - 3 7,a3,56,23,-33,1
rn1qk2r/ppp2ppp/4pn2/5b2/1bBP4/P1N1P3/1P1B1PPP/R2QK1NR b KQkq - 0 7,Bxc3,31,66,35,1
rn1qk2r/ppp2ppp/4pn2/5b2/2BP4/P1b1P3/1P1B1PPP/R2QK1NR w KQkq - 0 8,Bxc3,53,49,-4,1
rn1qk2r/ppp2ppp/4pn2/5b2/2BP4/P1B1P3/1P3PPP/R2QK1NR b KQkq - 0 8,Ne4,62,61,-1,1
rn1qk2r/ppp2ppp/4p3/5b2/2BPn3/P1B1P3/1P3PPP/R2QK1NR w KQkq - 1 9,Ne2,63,50,-13,1
rn1qk2r/ppp2ppp/4p3/5b2/2BPn3/P1B1P3/1P2NPPP/R2QK2R b KQkq - 2 9,Qh4,43,70,27,1
rn2k2r/ppp2ppp/4p3/5b2/2BPn2q/P1B1P3/1P2NPPP/R2QK2R w KQkq - 3 10,O-O,77,84,7,1
rn2k2r/ppp2ppp/4p3/5b2/2BPn2q/P1B1P3/1P2NPPP/R2Q1RK1 b kq - 4 10,O-O,91,151,60,1
rn3rk1/ppp2ppp/4p3/5b2/2BPn2q/P1B1P3/1P2NPPP/R2Q1RK1 w - - 5 11,d5,174,-347,-521,0
rn3rk1/ppp2ppp/4p3/3P1b2/2B1n2q/P1B1P3/1P2NPPP/R2Q1RK1 b - - 0 11,exd5,-322,74,396,1
rn3rk1/ppp2ppp/8/3p1b2/2B1n2q/P1B1P3/1P2NPPP/R2Q1RK1 w - - 0 12,Qxd5,86,85,-1,1
rn3rk1/ppp2ppp/8/3Q1b2/2B1n2q/P1B1P3/1P2NPPP/R4RK1 b - - 0 12,Nxc3,85,77,-8,1
rn3rk1/ppp2ppp/8/3Q1b2/2B4q/P1n1P3/1P2NPPP/R4RK1 w - - 0 13,Nxc3,86,65,-21,1
rn3rk1/ppp2ppp/8/3Q1b2/2B4q/P1N1P3/1P3PPP/R4RK1 b - - 0 13,Be6,69,338,269,1
rn3rk1/ppp2ppp/4b3/3Q4/2B4q/P1N1P3/1P3PPP/R4RK1 w - - 1 14,Qxb7,318,314,-4,1
rn3rk1/pQp2ppp/4b3/8/2B4q/P1N1P3/1P3PPP/R4RK1 b - - 0 14,Nd7,315,331,16,1
r4rk1/pQpn1ppp/4b3/8/2B4q/P1N1P3/1P3PPP/R4RK1 w - - 1 15,Bxe6,341,332,-9,1
r4rk1/pQpn1ppp/4B3/8/7q/P1N1P3/1P3PPP/R4RK1 b - - 0 15,fxe6,351,359,8,1
r4rk1/pQpn2pp/4p3/8/7q/P1N1P3/1P3PPP/R4RK1 w - - 0 16,Qxc7,384,367,-17,1
r4rk1/p1Qn2pp/4p3/8/7q/P1N1P3/1P3PPP/R4RK1 b - - 0 16,Rad8,348,338,-10,1
3r1rk1/p1Qn2pp/4p3/8/7q/P1N1P3/1P3PPP/R4RK1 w - - 1 17,Rad1,356,440,84,1
3r1rk1/p1Qn2pp/4p3/8/7q/P1N1P3/1P3PPP/3R1RK1 b - - 2 17,Nb6,442,377,-65,1
3r1rk1/p1Q3pp/1n2p3/8/7q/P1N1P3/1P3PPP/3R1RK1 w - - 3 18,Rxd8,422,376,-46,1
3R1rk1/p1Q3pp/1n2p3/8/7q/P1N1P3/1P3PPP/5RK1 b - - 0 18,Rxd8,392,403,11,1
3r2k1/p1Q3pp/1n2p3/8/7q/P1N1P3/1P3PPP/5RK1 w - - 0 19,Qxa7,443,447,4,1
3r2k1/Q5pp/1n2p3/8/7q/P1N1P3/1P3PPP/5RK1 b - - 0 19,Nc4,445,493,48,1
3r2k1/Q5pp/4p3/8/2n4q/P1N1P3/1P3PPP/5RK1 w - - 1 20,g3,455,321,-134,0
3r2k1/Q5pp/4p3/8/2n4q/P1N1P1P1/1P3P1P/5RK1 b - - 0 20,Qg5,300,342,42,1
3r2k1/Q5pp/4p3/6q1/2n5/P1N1P1P1/1P3P1P/5RK1 w - - 1 21,Rd1,409,328,-81,1
3r2k1/Q5pp/4p3/6q1/2n5/P1N1P1P1/1P3P1P/3R2K1 b - - 2 21,Rf8,344,392,48,1
5rk1/Q5pp/4p3/6q1/2n5/P1N1P1P1/1P3P1P/3R2K1 w - - 3 22,Qd7,356,257,-99,1
5rk1/3Q2pp/4p3/6q1/2n5/P1N1P1P1/1P3P1P/3R2K1 b - - 4 22,Ne5,264,428,164,1
5rk1/3Q2pp/4p3/4n1q1/8/P1N1P1P1/1P3P1P/3R2K1 w - - 5 23,Qxe6+,449,472,23,1
5rk1/6pp/4Q3/4n1q1/8/P1N1P1P1/1P3P1P/3R2K1 b - - 0 23,Kh8,428,490,62,1
5r1k/6pp/4Q3/4n1q1/8/P1N1P1P1/1P3P1P/3R2K1 w - - 1 24,Rd5,500,513,13,1
5r1k/6pp/4Q3/3Rn1q1/8/P1N1P1P1/1P3P1P/6K1 b - - 2 24,Nf3+,490,528,38,1
5r1k/6pp/4Q3/3R2q1/8/P1N1PnP1/1P3P1P/6K1 w - - 3 25,Kg2,516,521,5,1
5r1k/6pp/4Q3/3R2q1/8/P1N1PnP1/1P3PKP/8 b - - 4 25,Nh4+,547,531,-16,1
5r1k/6pp/4Q3/3R2q1/7n/P1N1P1P1/1P3PKP/8 w - - 5 26,Kg1,530,527,-3,1
5r1k/6pp/4Q3/3R2q1/7n/P1N1P1P1/1P3P1P/6K1 b - - 6 26,Nf3+,518,541,23,1
5r1k/6pp/4Q3/3R2q1/8/P1N1PnP1/1P3P1P/6K1 w - - 7 27,Kh1,535,553,18,1
5r1k/6pp/4Q3/3R2q1/8/P1N1PnP1/1P3P1P/7K b - - 8 27,Qf6,525,530,5,1
5r1k/6pp/4Qq2/3R4/8/P1N1PnP1/1P3P1P/7K w - - 9 28,Qxf6,545,537,-8,1
5r1k/6pp/5Q2/3R4/8/P1N1PnP1/1P3P1P/7K b - - 0 28,gxf6,557,551,-6,1
5r1k/7p/5p2/3R4/8/P1N1PnP1/1P3P1P/7K w - - 0 29,Ne4,532,516,-16,1
5r1k/7p/5p2/3R4/4N3/P3PnP1/1P3P1P/7K b - - 1 29,Kg7,480,543,63,1
5r2/6kp/5p2/3R4/4N3/P3PnP1/1P3P1P/7K w - - 2 30,Rd7+,552,516,-36,1
5r2/3R2kp/5p2/8/4N3/P3PnP1/1P3P1P/7K b - - 3 30,Kg6,516,543,27,1
5r2/3R3p/5pk1/8/4N3/P3PnP1/1P3P1P/7K w - - 4 31,Nc5,508,540,32,1
5r2/3R3p/5pk1/2N5/8/P3PnP1/1P3P1P/7K b - - 5 31,Ne1,501,544,43,1
5r2/3R3p/5pk1/2N5/8/P3P1P1/1P3P1P/4n2K w - - 6 32,Kg1,562,526,-36,1
5r2/3R3p/5pk1/2N5/8/P3P1P1/1P3P1P/4n1K1 b - - 7 32,Nf3+,489,520,31,1
5r2/3R3p/5pk1/2N5/8/P3PnP1/1P3P1P/6K1 w - - 8 33,Kg2,514,540,26,1
5r2/3R3p/5pk1/2N5/8/P3PnP1/1P3PKP/8 b - - 9 33,Ng5,536,589,53,1
5r2/3R3p/5pk1/2N3n1/8/P3P1P1/1P3PKP/8 w - - 10 34,h4,576,563,-13,1
5r2/3R3p/5pk1/2N3n1/7P/P3P1P1/1P3PK1/8 b - - 0 34,h6,574,707,133,1
rnbqkbnr/pppppppp/8/8/8/8/PPPPPPPP/RNBQKBNR w KQkq - 0 1,d4,30,23,-7,1
rnbqkbnr/pppppppp/8/8/3P4/8/PPP1PPPP/RNBQKBNR b KQkq - 0 1,Nf6,22,25,3,1
rnbqkb1r/pppppppp/5n2/8/3P4/8/PPP1PPPP/RNBQKBNR w KQkq - 1 2,c4,26,19,-7,1
rnbqkb1r/pppppppp/5n2/8/2PP4/8/PP2PPPP/RNBQKBNR b KQkq - 0 2,e6,16,15,-1,1
rnbqkb1r/pppp1ppp/4pn2/8/2PP4/8/PP2PPPP/RNBQKBNR w KQkq - 0 3,Nc3,19,14,-5,1
rnbqkb1r/pppp1ppp/4pn2/8/2PP4/2N5/PP2PPPP/R1BQKBNR b KQkq - 1 3,d5,26,26,0,1
rnbqkb1r/ppp2ppp/4pn2/3p4/2PP4/2N5/PP2PPPP/R1BQKBNR w KQkq - 0 4,Bg5,26,25,-1,1
rnbqkb1r/ppp2ppp/4pn2/3p2B1/2PP4/2N5/PP2PPPP/R2QKBNR b KQkq - 1 4,Be7,22,30,8,1
rnbqk2r/ppp1bppp/4pn2/3p2B1/2PP4/2N5/PP2PPPP/R2QKBNR w KQkq - 2 5,cxd5,29,12,-17,1
rnbqk2r/ppp1bppp/4pn2/3P2B1/3P4/2N5/PP2PPPP/R2QKBNR b KQkq - 0 5,exd5,12,27,15,1
rnbqk2r/ppp1bppp/5n2/3p2B1/3P4/2N5/PP2PPPP/R2QKBNR w KQkq - 0 6,e3,30,33,3,1
rnbqk2r/ppp1bppp/5n2/3p2B1/3P4/2N1P3/PP3PPP/R2QKBNR b KQkq - 0 6,O-O,32,24,-8,1
rnbq1rk1/ppp1bppp/5n2/3p2B1/3P4/2N1P3/PP3PPP/R2QKBNR w KQ - 1 7,Bd3,27,31,4,1
rnbq1rk1/ppp1bppp/5n2/3p2B1/3P4/2NBP3/PP3PPP/R2QK1NR b KQ - 2 7,c6,24,29,5,1
rnbq1rk1/pp2bppp/2p2n2/3p2B1/3P4/2NBP3/PP3PPP/R2QK1NR w KQ - 0 8,f3,30,-4,-34,1
rnbq1rk1/pp2bppp/2p2n2/3p2B1/3P4/2NBPP2/PP4PP/R2QK1NR b KQ - 0 8,h6,-8,11,19,1
rnbq1rk1/pp2bpp1/2p2n1p/3p2B1/3P4/2NBPP2/PP4PP/R2QK1NR w KQ - 0 9,Bh4,13,6,-7,1
rnbq1rk1/pp2bpp1/2p2n1p/3p4/3P3B/2NBPP2/PP4PP/R2QK1NR b KQ - 1 9,Re8,11,30,19,1
rnbqr1k1/pp2bpp1/2p2n1p/3p4/3P3B/2NBPP2/PP4PP/R2QK1NR w KQ - 2 10,Nge2,30,22,-8,1
rnbqr1k1/pp2bpp1/2p2n1p/3p4/3P3B/2NBPP2/PP2N1PP/R2QK2R b KQ - 3 10,c5,29,25,-4,1
rnbqr1k1/pp2bpp1/5n1p/2pp4/3P3B/2NBPP2/PP2N1PP/R2QK2R w KQ - 0 11,Rc1,31,33,2,1
rnbqr1k1/pp2bpp1/5n1p/2pp4/3P3B/2NBPP2/PP2N1PP/2RQK2R b K - 1 11,Nc6,39,36,-3,1
r1bqr1k1/pp2bpp1/2n2n1p/2pp4/3P3B/2NBPP2/PP2N1PP/2RQK2R w K - 2 12,O-O,26,24,-2,1
r1bqr1k1/pp2bpp1/2n2n1p/2pp4/3P3B/2NBPP2/PP2N1PP/2RQ1RK1 b - - 3 12,Qb6,34,233,199,1
r1b1r1k1/pp2bpp1/1qn2n1p/2pp4/3P3B/2NBPP2/PP2N1PP/2RQ1RK1 w - - 4 13,Na4,257,78,-179,0
r1b1r1k1/pp2bpp1/1qn2n1p/2pp4/N2P3B/3BPP2/PP2N1PP/2RQ1RK1 b - - 5 13,Qb4,155,476,321,1
r1b1r1k1/pp2bpp1/2n2n1p/2pp4/Nq1P3B/3BPP2/PP2N1PP/2RQ1RK1 w - - 6 14,a3,472,241,-231,0
r1b1r1k1/pp2bpp1/2n2n1p/2pp4/Nq1P3B/P2BPP2/1P2N1PP/2RQ1RK1 b - - 0 14,Qa5,239,228,-11,1
r1b1r1k1/pp2bpp1/2n2n1p/q1pp4/N2P3B/P2BPP2/1P2N1PP/2RQ1RK1 w - - 1 15,Nxc5,237,241,4,1
r1b1r1k1/pp2bpp1/2n2n1p/q1Np4/3P3B/P2BPP2/1P2N1PP/2RQ1RK1 b - - 0 15,Bxc5,231,332,101,1
r1b1r1k1/pp3pp1/2n2n1p/q1bp4/3P3B/P2BPP2/1P2N1PP/2RQ1RK1 w - - 0 16,Rxc5,320,352,32,1
r1b1r1k1/pp3pp1/2n2n1p/q1Rp4/3P3B/P2BPP2/1P2N1PP/3Q1RK1 b - - 0 16,Qb6,342,353,11,1
r1b1r1k1/pp3pp1/1qn2n1p/2Rp4/3P3B/P2BPP2/1P2N1PP/3Q1RK1 w - - 1 17,Bxf6,377,385,8,1
r1b1r1k1/pp3pp1/1qn2B1p/2Rp4/3P4/P2BPP2/1P2N1PP/3Q1RK1 b - - 0 17,gxf6,365,416,51,1
r1b1r1k1/pp3p2/1qn2p1p/2Rp4/3P4/P2BPP2/1P2N1PP/3Q1RK1 w - - 0 18,Qc1,363,376,13,1
r1b1r1k1/pp3p2/1qn2p1p/2Rp4/3P4/P2BPP2/1P2N1PP/2Q2RK1 b - - 1 18,Be6,355,411,56,1
r3r1k1/pp3p2/1qn1bp1p/2Rp4/3P4/P2BPP2/1P2N1PP/2Q2RK1 w - - 2 19,Nf4,375,375,0,1
r3r1k1/pp3p2/1qn1bp1p/2Rp4/3P1N2/P2BPP2/1P4PP/2Q2RK1 b - - 3 19,Rad8,357,443,86,1
3rr1k1/pp3p2/1qn1bp1p/2Rp4/3P1N2/P2BPP2/1P4PP/2Q2RK1 w - - 4 20,Nh5,485,491,6,1
3rr1k1/pp3p2/1qn1bp1p/2Rp3N/3P4/P2BPP2/1P4PP/2Q2RK1 b - - 5 20,Na5,527,652,125,1
3rr1k1/pp3p2/1q2bp1p/n1Rp3N/3P4/P2BPP2/1P4PP/2Q2RK1 w - - 6 21,Nxf6+,645,520,-125,0
rnbqkbnr/pppppppp/8/8/8/8/PPPPPPPP/RNBQKBNR w KQkq - 0 1,b3,33,-19,-52,1
rnbqkbnr/pppppppp/8/8/8/1P6/P1PPPPPP/RNBQKBNR b KQkq - 0 1,c5,-23,-3,20,1
rnbqkbnr/pp1ppppp/8/2p5/8/1P6/P1PPPPPP/RNBQKBNR w KQkq - 0 2,Bb2,1,-9,-10,1
rnbqkbnr/pp1ppppp/8/2p5/8/1P6/PBPPPPPP/RN1QKBNR b KQkq - 1 2,Nc6,2,6,4,1
r1bqkbnr/pp1ppppp/2n5/2p5/8/1P6/PBPPPPPP/RN1QKBNR w KQkq - 2 3,c4,11,-10,-21,1
r1bqkbnr/pp1ppppp/2n5/2p5/2P5/1P6/PB1PPPPP/RN1QKBNR b KQkq - 0 3,d5,-13,38,51,1
r1bqkbnr/pp2pppp/2n5/2pp4/2P5/1P6/PB1PPPPP/RN1QKBNR w KQkq - 0 4,g3,26,-102,-128,0
r1bqkbnr/pp2pppp/2n5/2pp4/2P5/1P4P1/PB1PPP1P/RN1QKBNR b KQkq - 0 4,d4,-117,-98,19,1
r1bqkbnr/pp2pppp/2n5/2p5/2Pp4/1P4P1/PB1PPP1P/RN1QKBNR w KQkq - 0 5,Bg2,-80,-101,-21,1
r1bqkbnr/pp2pppp/2n5/2p5/2Pp4/1P4P1/PB1PPPBP/RN1QK1NR b KQkq - 1 5,e5,-106,-109,-3,1
r1bqkbnr/pp3ppp/2n5/2p1p3/2Pp4/1P4P1/PB1PPPBP/RN1QK1NR w KQkq - 0 6,d3,-109,-98,11,1
r1bqkbnr/pp3ppp/2n5/2p1p3/2Pp4/1P1P2P1/PB2PPBP/RN1QK1NR b KQkq - 0 6,Nf6,-104,-99,5,1
r1bqkb1r/pp3ppp/2n2n2/2p1p3/2Pp4/1P1P2P1/PB2PPBP/RN1QK1NR w KQkq - 1 7,e3,-101,-114,-13,1
r1bqkb1r/pp3ppp/2n2n2/2p1p3/2Pp4/1P1PP1P1/PB3PBP/RN1QK1NR b KQkq - 0 7,Be7,-115,-100,15,1
r1bqk2r/pp2bppp/2n2n2/2p1p3/2Pp4/1P1PP1P1/PB3PBP/RN1QK1NR w KQkq - 1 8,exd4,-97,-119,-22,1
r1bqk2r/pp2bppp/2n2n2/2p1p3/2PP4/1P1P2P1/PB3PBP/RN1QK1NR b KQkq - 0 8,Qd7,-125,335,460,1
r1b1k2r/pp1qbppp/2n2n2/2p1p3/2PP4/1P1P2P1/PB3PBP/RN1QK1NR w KQkq - 1 9,d5,325,200,-125,0
r1b1k2r/pp1qbppp/2n2n2/2pPp3/2P5/1P1P2P1/PB3PBP/RN1QK1NR b KQkq - 0 9,Nd4,207,204,-3,1
r1b1k2r/pp1qbppp/5n2/2pPp3/2Pn4/1P1P2P1/PB3PBP/RN1QK1NR w KQkq - 1 10,Ne2,189,180,-9,1
r1b1k2r/pp1qbppp/5n2/2pPp3/2Pn4/1P1P2P1/PB2NPBP/RN1QK2R b KQkq - 2 10,Nxe2,176,280,104,1
r1b1k2r/pp1qbppp/5n2/2pPp3/2P5/1P1P2P1/PB2nPBP/RN1QK2R w KQkq - 0 11,Qxe2,298,286,-12,1
r1b1k2r/pp1qbppp/5n2/2pPp3/2P5/1P1P2P1/PB2QPBP/RN2K2R b KQkq - 0 11,Qd6,273,364,91,1
r1b1k2r/pp2bppp/3q1n2/2pPp3/2P5/1P1P2P1/PB2QPBP/RN2K2R w KQkq - 1 12,O-O,375,381,6,1
r1b1k2r/pp2bppp/3q1n2/2pPp3/2P5/1P1P2P1/PB2QPBP/RN3RK1 b kq - 2 12,Bg4,365,453,88,1
r3k2r/pp2bppp/3q1n2/2pPp3/2P3b1/1P1P2P1/PB2QPBP/RN3RK1 w kq - 3 13,Nd2,405,-486,-891,0
r3k2r/pp2bppp/3q1n2/2pPp3/2P3b1/1P1P2P1/PB1NQPBP/R4RK1 b kq - 4 13,Bxe2,-453,-456,-3,1
r3k2r/pp2bppp/3q1n2/2pPp3/2P5/1P1P2P1/PB1NbPBP/R4RK1 w kq - 0 14,Rfe1,-453,-451,2,1
r3k2r/pp2bppp/3q1n2/2pPp3/2P5/1P1P2P1/PB1NbPBP/R3R1K1 b kq - 1 14,Bxd3,-448,-464,-16,1
r3k2r/pp2bppp/3q1n2/2pPp3/2P5/1P1b2P1/PB1N1PBP/R3R1K1 w kq - 0 15,Ne4,-458,-683,-225,0
r3k2r/pp2bppp/3q1n2/2pPp3/2P1N3/1P1b2P1/PB3PBP/R3R1K1 b kq - 1 15,Nxe4,-636,-588,48,1
r3k2r/pp2bppp/3q4/2pPp3/2P1n3/1P1b2P1/PB3PBP/R3R1K1 w kq - 0 16,Bxe4,-618,-578,40,1
r3k2r/pp2bppp/3q4/2pPp3/2P1B3/1P1b2P1/PB3P1P/R3R1K1 b kq - 0 16,Bxe4,-602,-562,40,1
r3k2r/pp2bppp/3q4/2pPp3/2P1b3/1P4P1/PB3P1P/R3R1K1 w kq - 0 17,Rxe4,-580,-645,-65,1
r3k2r/pp2bppp/3q4/2pPp3/2P1R3/1P4P1/PB3P1P/R5K1 b kq - 0 17,f6,-583,-557,26,1
r3k2r/pp2b1pp/3q1p2/2pPp3/2P1R3/1P4P1/PB3P1P/R5K1 w kq - 0 18,f4,-585,-561,24,1
r3k2r/pp2b1pp/3q1p2/2pPp3/2P1RP2/1P4P1/PB5P/R5K1 b kq - 0 18,O-O,-566,-597,-31,1
r4rk1/pp2b1pp/3q1p2/2pPp3/2P1RP2/1P4P1/PB5P/R5K1 w - - 1 19,fxe5,-521,-538,-17,1
r4rk1/pp2b1pp/3q1p2/2pPP3/2P1R3/1P4P1/PB5P/R5K1 b - - 0 19,fxe5,-537,-558,-21,1
r4rk1/pp2b1pp/3q4/2pPp3/2P1R3/1P4P1/PB5P/R5K1 w - - 0 20,Rae1,-626,-616,10,1
r4rk1/pp2b1pp/3q4/2pPp3/2P1R3/1P4P1/PB5P/4R1K1 b - - 1 20,Qd8,-598,-532,66,1
r2q1rk1/pp2b1pp/8/2pPp3/2P1R3/1P4P1/PB5P/4R1K1 w - - 2 21,Rxe5,-559,-545,14,1
r2q1rk1/pp2b1pp/8/2pPR3/2P5/1P4P1/PB5P/4R1K1 b - - 0 21,Bf6,-576,-584,-8,1
r2q1rk1/pp4pp/5b2/2pPR3/2P5/1P4P1/PB5P/4R1K1 w - - 1 22,Re6,-597,-660,-63,1
r2q1rk1/pp4pp/4Rb2/2pP4/2P5/1P4P1/PB5P/4R1K1 b - - 2 22,Bxb2,-628,-622,6,1
r2q1rk1/pp4pp/4R3/2pP4/2P5/1P4P1/Pb5P/4R1K1 w - - 0 23,d6,-660,-686,-26,1
r2q1rk1/pp4pp/3PR3/2p5/2P5/1P4P1/Pb5P/4R1K1 b - - 0 23,Bd4+,-812,-792,20,1
r2q1rk1/pp4pp/3PR3/2p5/2Pb4/1P4P1/P6P/4R1K1 w - - 1 24,Kg2,-840,-921,-81,1
r2q1rk1/pp4pp/3PR3/2p5/2Pb4/1P4P1/P5KP/4R3 b - - 2 24,Qg5,-893,-621,272,1
r4rk1/pp4pp/3PR3/2p3q1/2Pb4/1P4P1/P5KP/4R3 w - - 3 25,R1e2,-656,-730,-74,1
r4rk1/pp4pp/3PR3/2p3q1/2Pb4/1P4P1/P3R1KP/8 b - - 4 25,Qf5,-789,-1199,-410,0
r4rk1/pp4pp/3PR3/2p2q2/2Pb4/1P4P1/P3R1KP/8 w - - 5 26,d7,-9991,-9999,-8,1
r4rk1/pp1P2pp/4R3/2p2q2/2Pb4/1P4P1/P3R1KP/8 b - - 0 26,Qf1#,-9999,-10000,-1,1
rnbqkbnr/pppppppp/8/8/8/8/PPPPPPPP/RNBQKBNR w KQkq - 0 1,e4,35,26,-9,1
rnbqkbnr/pppppppp/8/8/4P3/8/PPPP1PPP/RNBQKBNR b KQkq - 0 1,a6,24,67,43,1
rnbqkbnr/1ppppppp/p7/8/4P3/8/PPPP1PPP/RNBQKBNR w KQkq - 0 2,Nf3,72,45,-27,1
rnbqkbnr/1ppppppp/p7/8/4P3/5N2/PPPP1PPP/RNBQKB1R b KQkq - 1 2,e6,40,76,36,1
rnbqkbnr/1ppp1ppp/p3p3/8/4P3/5N2/PPPP1PPP/RNBQKB1R w KQkq - 0 3,d4,66,68,2,1
rnbqkbnr/1ppp1ppp/p3p3/8/3PP3/5N2/PPP2PPP/RNBQKB1R b KQkq - 0 3,h6,64,108,44,1
rnbqkbnr/1ppp1pp1/p3p2p/8/3PP3/5N2/PPP2PPP/RNBQKB1R w KQkq - 0 4,Nc3,117,109,-8,1
rnbqkbnr/1ppp1pp1/p3p2p/8/3PP3/2N2N2/PPP2PPP/R1BQKB1R b KQkq - 1 4,c6,91,135,44,1
rnbqkbnr/1p1p1pp1/p1p1p2p/8/3PP3/2N2N2/PPP2PPP/R1BQKB1R w KQkq - 0 5,Bc4,136,106,-30,1
rnbqkbnr/1p1p1pp1/p1p1p2p/8/2BPP3/2N2N2/PPP2PPP/R1BQK2R b KQkq - 1 5,g6,106,153,47,1
rnbqkbnr/1p1p1p2/p1p1p1pp/8/2BPP3/2N2N2/PPP2PPP/R1BQK2R w KQkq - 0 6,d5,151,123,-28,1
rnbqkbnr/1p1p1p2/p1p1p1pp/3P4/2B1P3/2N2N2/PPP2PPP/R1BQK2R b KQkq - 0 6,e5,129,235,106,1
rnbqkbnr/1p1p1p2/p1p3pp/3Pp3/2B1P3/2N2N2/PPP2PPP/R1BQK2R w KQkq - 0 7,Nxe5,309,210,-99,1
rnbqkbnr/1p1p1p2/p1p3pp/3PN3/2B1P3/2N5/PPP2PPP/R1BQK2R b KQkq - 0 7,f6,202,731,529,1
rnbqkbnr/1p1p4/p1p2ppp/3PN3/2B1P3/2N5/PPP2PPP/R1BQK2R w KQkq - 0 8,Nxg6,681,693,12,1
rnbqkbnr/1p1p4/p1p2pNp/3P4/2B1P3/2N5/PPP2PPP/R1BQK2R b KQkq - 0 8,Rh7,719,725,6,1
rnbqkbn1/1p1p3r/p1p2pNp/3P4/2B1P3/2N5/PPP2PPP/R1BQK2R w KQq - 1 9,Qh5,700,697,-3,1
rnbqkbn1/1p1p3r/p1p2pNp/3P3Q/2B1P3/2N5/PPP2PPP/R1B1K2R b KQq - 2 9,Rf7,680,784,104,1
rnbqkbn1/1p1p1r2/p1p2pNp/3P3Q/2B1P3/2N5/PPP2PPP/R1B1K2R w KQq - 3 10,Nxf8,905,690,-215,0
rnbqkNn1/1p1p1r2/p1p2p1p/3P3Q/2B1P3/2N5/PPP2PPP/R1B1K2R b KQq - 0 10,Kxf8,724,754,30,1
rnbq1kn1/1p1p1r2/p1p2p1p/3P3Q/2B1P3/2N5/PPP2PPP/R1B1K2R w KQ - 0 11,d6,780,829,49,1
rnbq1kn1/1p1p1r2/p1pP1p1p/7Q/2B1P3/2N5/PPP2PPP/R1B1K2R b KQ - 0 11,Rg7,845,1156,311,1
rnbq1kn1/1p1p2r1/p1pP1p1p/7Q/2B1P3/2N5/PPP2PPP/R1B1K2R w KQ - 1 12,Bxh6,1180,1104,-76,1
rnbq1kn1/1p1p2r1/p1pP1p1B/7Q/2B1P3/2N5/PPP2PPP/R3K2R b KQ - 0 12,Qe7,1106,1125,19,1
rnb2kn1/1p1pq1r1/p1pP1p1B/7Q/2B1P3/2N5/PPP2PPP/R3K2R w KQ - 1 13,dxe7+,1091,1089,-2,1
rnb2kn1/1p1pP1r1/p1p2p1B/7Q/2B1P3/2N5/PPP2PPP/R3K2R b KQ - 0 13,Nxe7,1140,9999,8859,1
rnb2k2/1p1pn1r1/p1p2p1B/7Q/2B1P3/2N5/PPP2PPP/R3K2R w KQ - 0 14,Bxg7+,9999,1149,-8850,0
rnb2k2/1p1pn1B1/p1p2p2/7Q/2B1P3/2N5/PPP2PPP/R3K2R b KQ - 0 14,Kxg7,1152,1203,51,1
rnb5/1p1pn1k1/p1p2p2/7Q/2B1P3/2N5/PPP2PPP/R3K2R w KQ - 0 15,Qf7+,1187,1193,6,1
rnb5/1p1pnQk1/p1p2p2/8/2B1P3/2N5/PPP2PPP/R3K2R b KQ - 1 15,Kh6,1185,1218,33,1
rnb5/1p1pnQ2/p1p2p1k/8/2B1P3/2N5/PPP2PPP/R3K2R w KQ - 2 16,Qf8+,1208,1174,-34,1
rnb2Q2/1p1pn3/p1p2p1k/8/2B1P3/2N5/PPP2PPP/R3K2R b KQ - 3 16,Kg6,1245,1216,-29,1
rnb2Q2/1p1pn3/p1p2pk1/8/2B1P3/2N5/PPP2PPP/R3K2R w KQ - 4 17,Qxe7,1244,1120,-124,0
rnb5/1p1pQ3/p1p2pk1/8/2B1P3/2N5/PPP2PPP/R3K2R b KQ - 0 17,d5,1170,1154,-16,1
rnb5/1p2Q3/p1p2pk1/3p4/2B1P3/2N5/PPP2PPP/R3K2R w KQ - 0 18,exd5,1157,1096,-61,1
rnb5/1p2Q3/p1p2pk1/3P4/2B5/2N5/PPP2PPP/R3K2R b KQ - 0 18,Nd7,1099,9994,8895,1
r1b5/1p1nQ3/p1p2pk1/3P4/2B5/2N5/PPP2PPP/R3K2R w KQ - 1 19,d6,9994,997,-8997,0
r1b5/1p1nQ3/p1pP1pk1/8/2B5/2N5/PPP2PPP/R3K2R b KQ - 0 19,Ne5,1045,1028,-17,1
r1b5/1p2Q3/p1pP1pk1/4n3/2B5/2N5/PPP2PPP/R3K2R w KQ - 1 20,Qe8+,1048,1102,54,1
r1b1Q3/1p6/p1pP1pk1/4n3/2B5/2N5/PPP2PPP/R3K2R b KQ - 2 20,Kg5,1094,1157,63,1
r1b1Q3/1p6/p1pP1p2/4n1k1/2B5/2N5/PPP2PPP/R3K2R w KQ - 3 21,f4+,1109,1183,74,1
r1b1Q3/1p6/p1pP1p2/4n1k1/2B2P2/2N5/PPP3PP/R3K2R b KQ - 0 21,Kxf4,1173,1271,98,1
r1b1Q3/1p6/p1pP1p2/4n3/2B2k2/2N5/PPP3PP/R3K2R w KQ - 0 22,O-O+,1430,1338,-92,1
r1b1Q3/1p6/p1pP1p2/4n3/2B2k2/2N5/PPP3PP/R4RK1 b - - 1 22,Kg5,1223,9997,8774,1
r1b1Q3/1p6/p1pP1p2/4n1k1/2B5/2N5/PPP3PP/R4RK1 w - - 2 23,Qg8+,9997,1185,-8812,0
r1b3Q1/1p6/p1pP1p2/4n1k1/2B5/2N5/PPP3PP/R4RK1 b - - 3 23,Ng6,1157,1140,-17,1
r1b3Q1/1p6/p1pP1pn1/6k1/2B5/2N5/PPP3PP/R4RK1 w - - 4 24,Ne4+,9992,9994,2,1
r1b3Q1/1p6/p1pP1pn1/6k1/2B1N3/8/PPP3PP/R4RK1 b - - 5 24,Kh5,9994,9998,4,1
r1b3Q1/1p6/p1pP1pn1/7k/2B1N3/8/PPP3PP/R4RK1 w - - 6 25,Nxf6+,9998,9997,-1,1
r1b3Q1/1p6/p1pP1Nn1/7k/2B5/8/PPP3PP/R4RK1 b - - 0 25,Kh4,9997,9998,1,1
r1b3Q1/1p6/p1pP1Nn1/8/2B4k/8/PPP3PP/R4RK1 w - - 1 26,Qh7+,9998,9999,1,1
r1b5/1p5Q/p1pP1Nn1/8/2B4k/8/PPP3PP/R4RK1 b - - 2 26,Kg5,9999,9999,0,1
r1b5/1p5Q/p1pP1Nn1/6k1/2B5/8/PPP3PP/R4RK1 w - - 3 27,Bd3,9999,9997,-2,1
r1b5/1p5Q/p1pP1Nn1/6k1/8/3B4/PPP3PP/R4RK1 b - - 4 27,Bf5,9997,9999,2,1
r7/1p5Q/p1pP1Nn1/5bk1/8/3B4/PPP3PP/R4RK1 w - - 5 28,Rxf5#,9999,10000,1,1
rnbqkbnr/pppppppp/8/8/8/8/PPPPPPPP/RNBQKBNR w KQkq - 0 1,e3,32,13,-19,1
rnbqkbnr/pppppppp/8/8/8/4P3/PPPP1PPP/RNBQKBNR b KQkq - 0 1,d5,15,11,-4,1
rnbqkbnr/ppp1pppp/8/3p4/8/4P3/PPPP1PPP/RNBQKBNR w KQkq - 0 2,g4,10,-128,-138,0
rnbqkbnr/ppp1pppp/8/3p4/6P1/4P3/PPPP1P1P/RNBQKBNR b KQkq - 0 2,Nf6,-161,-52,109,1
rnbqkb1r/ppp1pppp/5n2/3p4/6P1/4P3/PPPP1P1P/RNBQKBNR w KQkq - 1 3,Bg2,-43,-243,-200,0
rnbqkb1r/ppp1pppp/5n2/3p4/6P1/4P3/PPPP1PBP/RNBQK1NR b KQkq - 2 3,Bxg4,-235,-228,7,1
rn1qkb1r/ppp1pppp/5n2/3p4/6b1/4P3/PPPP1PBP/RNBQK1NR w KQkq - 0 4,f3,-220,-234,-14,1
rn1qkb1r/ppp1pppp/5n2/3p4/6b1/4PP2/PPPP2BP/RNBQK1NR b KQkq - 0 4,Bc8,-245,-247,-2,1
rnbqkb1r/ppp1pppp/5n2/3p4/8/4PP2/PPPP2BP/RNBQK1NR w KQkq - 1 5,e4,-245,-277,-32,1
rnbqkb1r/ppp1pppp/5n2/3p4/4P3/5P2/PPPP2BP/RNBQK1NR b KQkq - 0 5,dxe4,-291,-273,18,1
rnbqkb1r/ppp1pppp/5n2/8/4p3/5P2/PPPP2BP/RNBQK1NR w KQkq - 0 6,fxe4,-274,-265,9,1
rnbqkb1r/ppp1pppp/5n2/8/4P3/8/PPPP2BP/RNBQK1NR b KQkq - 0 6,Nc6,-270,-262,8,1
r1bqkb1r/ppp1pppp/2n2n2/8/4P3/8/PPPP2BP/RNBQK1NR w KQkq - 1 7,c4,-259,-368,-109,0
r1bqkb1r/ppp1pppp/2n2n2/8/2P1P3/8/PP1P2BP/RNBQK1NR b KQkq - 0 7,e6,-387,-312,75,1
r1bqkb1r/ppp2ppp/2n1pn2/8/2P1P3/8/PP1P2BP/RNBQK1NR w KQkq - 0 8,d3,-330,-336,-6,1
r1bqkb1r/ppp2ppp/2n1pn2/8/2P1P3/3P4/PP4BP/RNBQK1NR b KQkq - 0 8,Bd7,-318,-212,106,1
r2qkb1r/pppb1ppp/2n1pn2/8/2P1P3/3P4/PP4BP/RNBQK1NR w KQkq - 1 9,b3,-240,-345,-105,0
r2qkb1r/pppb1ppp/2n1pn2/8/2P1P3/1P1P4/P5BP/RNBQK1NR b KQkq - 0 9,Bb4+,-345,-353,-8,1
r2qk2r/pppb1ppp/2n1pn2/8/1bP1P3/1P1P4/P5BP/RNBQK1NR w KQkq - 1 10,Bd2,-320,-329,-9,1
r2qk2r/pppb1ppp/2n1pn2/8/1bP1P3/1P1P4/P2B2BP/RN1QK1NR b KQkq - 2 10,Bxd2+,-341,-254,87,1
r2qk2r/pppb1ppp/2n1pn2/8/2P1P3/1P1P4/P2b2BP/RN1QK1NR w KQkq - 0 11,Qxd2,-244,-253,-9,1
r2qk2r/pppb1ppp/2n1pn2/8/2P1P3/1P1P4/P2Q2BP/RN2K1NR b KQkq - 0 11,O-O,-240,-249,-9,1
r2q1rk1/pppb1ppp/2n1pn2/8/2P1P3/1P1P4/P2Q2BP/RN2K1NR w KQ - 1 12,Nc3,-237,-235,2,1
r2q1rk1/pppb1ppp/2n1pn2/8/2P1P3/1PNP4/P2Q2BP/R3K1NR b KQ - 2 12,Nb4,-243,-118,125,1
r2q1rk1/pppb1ppp/4pn2/8/1nP1P3/1PNP4/P2Q2BP/R3K1NR w KQ - 3 13,O-O-O,-92,-170,-78,1
r2q1rk1/pppb1ppp/4pn2/8/1nP1P3/1PNP4/P2Q2BP/2KR2NR b - - 4 13,Qe7,-175,-136,39,1
r4rk1/pppbqppp/4pn2/8/1nP1P3/1PNP4/P2Q2BP/2KR2NR w - - 5 14,Nce2,-136,-278,-142,0
r4rk1/pppbqppp/4pn2/8/1nP1P3/1P1P4/P2QN1BP/2KR2NR b - - 6 14,Rfe8,-276,-122,154,1
r3r1k1/pppbqppp/4pn2/8/1nP1P3/1P1P4/P2QN1BP/2KR2NR w - - 7 15,Nf4,-111,-295,-184,0
r3r1k1/pppbqppp/4pn2/8/1nP1PN2/1P1P4/P2Q2BP/2KR2NR b - - 8 15,Bc6,-289,-195,94,1
r3r1k1/ppp1qppp/2b1pn2/8/1nP1PN2/1P1P4/P2Q2BP/2KR2NR w - - 9 16,Bh3,-182,-456,-274,0
r3r1k1/ppp1qppp/2b1pn2/8/1nP1PN2/1P1P3B/P2Q3P/2KR2NR b - - 10 16,e5,-393,-323,70,1
r3r1k1/ppp1qppp/2b2n2/4p3/1nP1PN2/1P1P3B/P2Q3P/2KR2NR w - - 0 17,Nf3,-354,-516,-162,0
r3r1k1/ppp1qppp/2b2n2/4p3/1nP1PN2/1P1P1N1B/P2Q3P/2KR3R b - - 1 17,exf4,-543,-577,-34,1
r3r1k1/ppp1qppp/2b2n2/8/1nP1Pp2/1P1P1N1B/P2Q3P/2KR3R w - - 0 18,Rhg1,-541,-604,-63,1
r3r1k1/ppp1qppp/2b2n2/8/1nP1Pp2/1P1P1N1B/P2Q3P/2KR2R1 b - - 1 18,Rad8,-653,-484,169,1
3rr1k1/ppp1qppp/2b2n2/8/1nP1Pp2/1P1P1N1B/P2Q3P/2KR2R1 w - - 2 19,Qxf4,-535,-617,-82,1
3rr1k1/ppp1qppp/2b2n2/8/1nP1PQ2/1P1P1N1B/P6P/2KR2R1 b - - 0 19,Qd6,-633,-229,404,1
3rr1k1/ppp2ppp/2bq1n2/8/1nP1PQ2/1P1P1N1B/P6P/2KR2R1 w - - 1 20,Qg3,-361,-629,-268,0
3rr1k1/ppp2ppp/2bq1n2/8/1nP1P3/1P1P1NQB/P6P/2KR2R1 b - - 2 20,Qxg3,-653,-730,-77,1
3rr1k1/ppp2ppp/2b2n2/8/1nP1P3/1P1P1NqB/P6P/2KR2R1 w - - 0 21,hxg3,-636,-727,-91,1
3rr1k1/ppp2ppp/2b2n2/8/1nP1P3/1P1P1NPB/P7/2KR2R1 b - - 0 21,Nxa2+,-731,-593,138,1
3rr1k1/ppp2ppp/2b2n2/8/2P1P3/1P1P1NPB/n7/2KR2R1 w - - 0 22,Kb2,-604,-551,53,1
3rr1k1/ppp2ppp/2b2n2/8/2P1P3/1P1P1NPB/nK6/3R2R1 b - - 1 22,Nb4,-568,-560,8,1
3rr1k1/ppp2ppp/2b2n2/8/1nP1P3/1P1P1NPB/1K6/3R2R1 w - - 2 23,g4,-583,-714,-131,0
3rr1k1/ppp2ppp/2b2n2/8/1nP1P1P1/1P1P1N1B/1K6/3R2R1 b - - 0 23,h5,-709,-463,246,1
3rr1k1/ppp2pp1/2b2n2/7p/1nP1P1P1/1P1P1N1B/1K6/3R2R1 w - - 0 24,g5,-462,-544,-82,1
3rr1k1/ppp2pp1/2b2n2/6Pp/1nP1P3/1P1P1N1B/1K6/3R2R1 b - - 0 24,Nh7,-567,-480,87,1
3rr1k1/ppp2ppn/2b5/6Pp/1nP1P3/1P1P1N1B/1K6/3R2R1 w - - 1 25,Kc3,-494,-514,-20,1
3rr1k1/ppp2ppn/2b5/6Pp/1nP1P3/1PKP1N1B/8/3R2R1 b - - 2 25,Na2+,-583,-496,87,1
3rr1k1/ppp2ppn/2b5/6Pp/2P1P3/1PKP1N1B/n7/3R2R1 w - - 3 26,Kb2,-503,-508,-5,1
3rr1k1/ppp2ppn/2b5/6Pp/2P1P3/1P1P1N1B/nK6/3R2R1 b - - 4 26,Nb4,-539,-539,0,1
3rr1k1/ppp2ppn/2b5/6Pp/1nP1P3/1P1P1N1B/1K6/3R2R1 w - - 5 27,Kc3,-508,-571,-63,1
3rr1k1/ppp2ppn/2b5/6Pp/1nP1P3/1PKP1N1B/8/3R2R1 b - - 6 27,Na6,-594,-402,192,1
3rr1k1/ppp2ppn/n1b5/6Pp/2P1P3/1PKP1N1B/8/3R2R1 w - - 7 28,Kb2,-403,-523,-120,0
3rr1k1/ppp2ppn/n1b5/6Pp/2P1P3/1P1P1N1B/1K6/3R2R1 b - - 8 28,b5,-506,-369,137,1
3rr1k1/p1p2ppn/n1b5/1p4Pp/2P1P3/1P1P1N1B/1K6/3R2R1 w - - 0 29,Bf5,-369,-421,-52,1
3rr1k1/p1p2ppn/n1b5/1p3BPp/2P1P3/1P1P1N2/1K6/3R2R1 b - - 1 29,bxc4,-395,-356,39,1
3rr1k1/p1p2ppn/n1b5/5BPp/2p1P3/1P1P1N2/1K6/3R2R1 w - - 0 30,bxc4,-388,-511,-123,0
3rr1k1/p1p2ppn/n1b5/5BPp/2P1P3/3P1N2/1K6/3R2R1 b - - 0 30,Ra8,-521,-263,258,1
r3r1k1/p1p2ppn/n1b5/5BPp/2P1P3/3P1N2/1K6/3R2R1 w - - 1 31,d4,-261,-501,-240,0
r3r1k1/p1p2ppn/n1b5/5BPp/2PPP3/5N2/1K6/3R2R1 b - - 0 31,Rab8+,-506,-467,39,1
1r2r1k1/p1p2ppn/n1b5/5BPp/2PPP3/5N2/1K6/3R2R1 w - - 1 32,Kc3,-478,-466,12,1
1r2r1k1/p1p2ppn/n1b5/5BPp/2PPP3/2K2N2/8/3R2R1 b - - 2 32,Ba4,-475,-317,158,1
1r2r1k1/p1p2ppn/n7/5BPp/b1PPP3/2K2N2/8/3R2R1 w - - 3 33,Ra1,-338,-346,-8,1
1r2r1k1/p1p2ppn/n7/5BPp/b1PPP3/2K2N2/8/R5R1 b - - 4 33,Rb4,-339,-213,126,1
4r1k1/p1p2ppn/n7/5BPp/brPPP3/2K2N2/8/R5R1 w - - 5 34,c5,-222,-361,-139,0
4r1k1/p1p2ppn/n7/2P2BPp/br1PP3/2K2N2/8/R5R1 b - - 0 34,Rb3+,-342,-324,18,1
4r1k1/p1p2ppn/n7/2P2BPp/b2PP3/1rK2N2/8/R5R1 w - - 1 35,Kc4,-329,-359,-30,1
4r1k1/p1p2ppn/n7/2P2BPp/b1KPP3/1r3N2/8/R5R1 b - - 2 35,Bb5+,-380,130,510,1
4r1k1/p1p2ppn/n7/1bP2BPp/2KPP3/1r3N2/8/R5R1 w - - 3 36,Kd5,97,-9999,-10096,0
4r1k1/p1p2ppn/n7/1bPK1BPp/3PP3/1r3N2/8/R5R1 b - - 4 36,Rxf3,-9999,-600,9399,1
4r1k1/p1p2ppn/n7/1bPK1BPp/3PP3/5r2/8/R5R1 w - - 0 37,Bg4,-636,-9999,-9363,0
4r1k1/p1p2ppn/n7/1bPK2Pp/3PP1B1/5r2/8/R5R1 b - - 1 37,hxg4,-9999,-982,9017,1
4r1k1/p1p2ppn/n7/1bPK2P1/3PP1p1/5r2/8/R5R1 w - - 0 38,Rxg4,-797,-9999,-9202,0
4r1k1/p1p2ppn/n7/1bPK2P1/3PP1R1/5r2/8/R7 b - - 0 38,Rc8,-9999,-907,9092,1
2r3k1/p1p2ppn/n7/1bPK2P1/3PP1R1/5r2/8/R7 w - - 1 39,c6,-843,-900,-57,1
2r3k1/p1p2ppn/n1P5/1b1K2P1/3PP1R1/5r2/8/R7 b - - 0 39,Rd8+,-864,-881,-17,1
3r2k1/p1p2ppn/n1P5/1b1K2P1/3PP1R1/5r2/8/R7 w - - 1 40,Ke5,-875,-888,-13,1
3r2k1/p1p2ppn/n1P5/1b2K1P1/3PP1R1/5r2/8/R7 b - - 2 40,Bxc6,-888,-863,25,1
3r2k1/p1p2ppn/n1b5/4K1P1/3PP1R1/5r2/8/R7 w - - 0 41,d5,-880,-883,-3,1
3r2k1/p1p2ppn/n1b5/3PK1P1/4P1R1/5r2/8/R7 b - - 0 41,f6+,-865,-748,117,1
3r2k1/p1p3pn/n1b2p2/3PK1P1/4P1R1/5r2/8/R7 w - - 0 42,Kd4,-747,-857,-110,0
3r2k1/p1p3pn/n1b2p2/3P2P1/3KP1R1/5r2/8/R7 b - - 1 42,fxg5,-866,-623,243,1
3r2k1/p1p3pn/n1b5/3P2p1/3KP1R1/5r2/8/R7 w - - 0 43,Rxa6,-653,-639,14,1
3r2k1/p1p3pn/R1b5/3P2p1/3KP1R1/5r2/8/8 b - - 0 43,Bxd5,-647,-589,58,1
3r2k1/p1p3pn/R7/3b2p1/3KP1R1/5r2/8/8 w - - 0 44,Rxa7,-561,-841,-280,0
3r2k1/R1p3pn/8/3b2p1/3KP1R1/5r2/8/8 b - - 0 44,Bxe4+,-846,-514,332,1
3r2k1/R1p3pn/8/6p1/3Kb1R1/5r2/8/8 w - - 0 45,Kxe4,-511,-512,-1,1
3r2k1/R1p3pn/8/6p1/4K1R1/5r2/8/8 b - - 0 45,Rf4+,-568,-403,165,1
3r2k1/R1p3pn/8/6p1/4KrR1/8/8/8 w - - 1 46,Rxf4,-417,-412,5,1
3r2k1/R1p3pn/8/6p1/4KR2/8/8/8 b - - 0 46,g4,-414,-11,403,1
rnbqkbnr/pppppppp/8/8/8/8/PPPPPPPP/RNBQKBNR w KQkq - 0 1,f3,32,-66,-98,1
rnbqkbnr/pppppppp/8/8/8/5P2/PPPPP1PP/RNBQKBNR b KQkq - 0 1,c6,-71,19,90,1
rnbqkbnr/pp1ppppp/2p5/8/8/5P2/PPPPP1PP/RNBQKBNR w KQkq - 0 2,Kf2,1,-119,-120,0
rnbqkbnr/pp1ppppp/2p5/8/8/5P2/PPPPPKPP/RNBQ1BNR b kq - 1 2,d5,-128,-109,19,1
rnbqkbnr/pp2pppp/2p5/3p4/8/5P2/PPPPPKPP/RNBQ1BNR w kq - 0 3,e3,-120,-131,-11,1
rnbqkbnr/pp2pppp/2p5/3p4/8/4PP2/PPPP1KPP/RNBQ1BNR b kq - 0 3,Nf6,-144,-109,35,1
rnbqkb1r/pp2pppp/2p2n2/3p4/8/4PP2/PPPP1KPP/RNBQ1BNR w kq - 1 4,d4,-104,-107,-3,1
rnbqkb1r/pp2pppp/2p2n2/3p4/3P4/4PP2/PPP2KPP/RNBQ1BNR b kq - 0 4,e5,-92,37,129,1
rnbqkb1r/pp3ppp/2p2n2/3pp3/3P4/4PP2/PPP2KPP/RNBQ1BNR w kq - 0 5,c3,43,-171,-214,0
rnbqkb1r/pp3ppp/2p2n2/3pp3/3P4/2P1PP2/PP3KPP/RNBQ1BNR b kq - 0 5,exd4,-182,-86,96,1
rnbqkb1r/pp3ppp/2p2n2/3p4/3p4/2P1PP2/PP3KPP/RNBQ1BNR w kq - 0 6,exd4,-91,-72,19,1
rnbqkb1r/pp3ppp/2p2n2/3p4/3P4/2P2P2/PP3KPP/RNBQ1BNR b kq - 0 6,Bd6,-80,-76,4,1
rnbqk2r/pp3ppp/2pb1n2/3p4/3P4/2P2P2/PP3KPP/RNBQ1BNR w kq - 1 7,Bd3,-76,-99,-23,1
rnbqk2r/pp3ppp/2pb1n2/3p4/3P4/2PB1P2/PP3KPP/RNBQ2NR b kq - 2 7,Qc7,-89,-36,53,1
rnb1k2r/ppq2ppp/2pb1n2/3p4/3P4/2PB1P2/PP3KPP/RNBQ2NR w kq - 3 8,Ne2,-40,-46,-6,1
rnb1k2r/ppq2ppp/2pb1n2/3p4/3P4/2PB1P2/PP2NKPP/RNBQ3R b kq - 4 8,O-O,-51,-51,0,1
rnb2rk1/ppq2ppp/2pb1n2/3p4/3P4/2PB1P2/PP2NKPP/RNBQ3R w - - 5 9,g3,-40,-51,-11,1
rnb2rk1/ppq2ppp/2pb1n2/3p4/3P4/2PB1PP1/PP2NK1P/RNBQ3R b - - 0 9,Nh5,-56,-33,23,1
rnb2rk1/ppq2ppp/2pb4/3p3n/3P4/2PB1PP1/PP2NK1P/RNBQ3R w - - 1 10,g4,-32,-34,-2,1
rnb2rk1/ppq2ppp/2pb4/3p3n/3P2P1/2PB1P2/PP2NK1P/RNBQ3R b - - 0 10,Nf6,-22,-15,7,1
rnb2rk1/ppq2ppp/2pb1n2/3p4/3P2P1/2PB1P2/PP2NK1P/RNBQ3R w - - 1 11,Be3,4,-118,-122,0
rnb2rk1/ppq2ppp/2pb1n2/3p4/3P2P1/2PBBP2/PP2NK1P/RN1Q3R b - - 2 11,Bxg4,-113,-117,-4,1
rn3rk1/ppq2ppp/2pb1n2/3p4/3P2b1/2PBBP2/PP2NK1P/RN1Q3R w - - 0 12,h3,-103,-337,-234,0
rn3rk1/ppq2ppp/2pb1n2/3p4/3P2b1/2PBBP1P/PP2NK2/RN1Q3R b - - 0 12,Bxf3,-356,-59,297,1
rn3rk1/ppq2ppp/2pb1n2/3p4/3P4/2PBBb1P/PP2NK2/RN1Q3R w - - 0 13,Kxf3,-56,-61,-5,1
rn3rk1/ppq2ppp/2pb1n2/3p4/3P4/2PBBK1P/PP2N3/RN1Q3R b - - 0 13,Re8,-91,20,111,1
rn2r1k1/ppq2ppp/2pb1n2/3p4/3P4/2PBBK1P/PP2N3/RN1Q3R w - - 1 14,Qd2,23,-117,-140,0
rn2r1k1/ppq2ppp/2pb1n2/3p4/3P4/2PBBK1P/PP1QN3/RN5R b - - 2 14,Ne4,-140,46,186,1
rn2r1k1/ppq2ppp/2pb4/3p4/3Pn3/2PBBK1P/PP1QN3/RN5R w - - 3 15,Bxe4,17,51,34,1
rn2r1k1/ppq2ppp/2pb4/3p4/3PB3/2P1BK1P/PP1QN3/RN5R b - - 0 15,dxe4+,56,132,76,1
rn2r1k1/ppq2ppp/2pb4/8/3Pp3/2P1BK1P/PP1QN3/RN5R w - - 0 16,Kf2,107,40,-67,1
rn2r1k1/ppq2ppp/2pb4/8/3Pp3/2P1B2P/PP1QNK2/RN5R b - - 1 16,Qe7,71,73,2,1
rn2r1k1/pp2qppp/2pb4/8/3Pp3/2P1B2P/PP1QNK2/RN5R w - - 2 17,Rg1,46,-151,-197,0
rn2r1k1/pp2qppp/2pb4/8/3Pp3/2P1B2P/PP1QNK2/RN4R1 b - - 3 17,Qh4+,-133,-119,14,1
rn2r1k1/pp3ppp/2pb4/8/3Pp2q/2P1B2P/PP1QNK2/RN4R1 w - - 4 18,Kg2,-148,-182,-34,1
rn2r1k1/pp3ppp/2pb4/8/3Pp2q/2P1B2P/PP1QN1K1/RN4R1 b - - 5 18,Re6,-157,-178,-21,1
rn4k1/pp3ppp/2pbr3/8/3Pp2q/2P1B2P/PP1QN1K1/RN4R1 w - - 6 19,Bf2,-162,-153,9,1
rn4k1/pp3ppp/2pbr3/8/3Pp2q/2P4P/PP1QNBK1/RN4R1 b - - 7 19,Rg6+,-154,-164,-10,1
rn4k1/pp3ppp/2pb2r1/8/3Pp2q/2P4P/PP1QNBK1/RN4R1 w - - 8 20,Kf1,-168,-160,8,1
rn4k1/pp3ppp/2pb2r1/8/3Pp2q/2P4P/PP1QNB2/RN3KR1 b - - 9 20,Qxh3+,-167,-164,3,1
rn4k1/pp3ppp/2pb2r1/8/3Pp3/2P4q/PP1QNB2/RN3KR1 w - - 0 21,Ke1,-175,-159,16,1
rn4k1/pp3ppp/2pb2r1/8/3Pp3/2P4q/PP1QNB2/RN2K1R1 b - - 1 21,e3,-184,151,335,1
rn4k1/pp3ppp/2pb2r1/8/3P4/2P1p2q/PP1QNB2/RN2K1R1 w - - 0 22,Qxe3,136,119,-17,1
rn4k1/pp3ppp/2pb2r1/8/3P4/2P1Q2q/PP2NB2/RN2K1R1 b - - 0 22,Qxe3,76,168,92,1
rn4k1/pp3ppp/2pb2r1/8/3P4/2P1q3/PP2NB2/RN2K1R1 w - - 0 23,Bxe3,163,156,-7,1
rn4k1/pp3ppp/2pb2r1/8/3P4/2P1B3/PP2N3/RN2K1R1 b - - 0 23,Rxg1+,165,159,-6,1
rn4k1/pp3ppp/2pb4/8/3P4/2P1B3/PP2N3/RN2K1r1 w - - 0 24,Bxg1,166,176,10,1
rn4k1/pp3ppp/2pb4/8/3P4/2P5/PP2N3/RN2K1B1 b - - 0 24,Nd7,173,163,-10,1
r5k1/pp1n1ppp/2pb4/8/3P4/2P5/PP2N3/RN2K1B1 w - - 1 25,Kd2,168,100,-68,1
r5k1/pp1n1ppp/2pb4/8/3P4/2P5/PP1KN3/RN4B1 b - - 2 25,Nf6,108,188,80,1
r5k1/pp3ppp/2pb1n2/8/3P4/2P5/PP1KN3/RN4B1 w - - 3 26,Na3,166,134,-32,1
r5k1/pp3ppp/2pb1n2/8/3P4/N1P5/PP1KN3/R5B1 b - - 4 26,Ne4+,129,132,3,1
r5k1/pp3ppp/2pb4/8/3Pn3/N1P5/PP1KN3/R5B1 w - - 5 27,Kd3,152,127,-25,1
r5k1/pp3ppp/2pb4/8/3Pn3/N1PK4/PP2N3/R5B1 b - - 6 27,Nf6,131,212,81,1
r5k1/pp3ppp/2pb1n2/8/3P4/N1PK4/PP2N3/R5B1 w - - 7 28,Kc2,199,123,-76,1
r5k1/pp3ppp/2pb1n2/8/3P4/N1P5/PPK1N3/R5B1 b - - 8 28,Ng4,120,217,97,1
r5k1/pp3ppp/2pb4/8/3P2n1/N1P5/PPK1N3/R5B1 w - - 9 29,Kb3,144,-66,-210,0
r5k1/pp3ppp/2pb4/8/3P2n1/NKP5/PP2N3/R5B1 b - - 10 29,Re8,-55,-55,0,1
4r1k1/pp3ppp/2pb4/8/3P2n1/NKP5/PP2N3/R5B1 w - - 11 30,Re1,-54,-524,-470,0
4r1k1/pp3ppp/2pb4/8/3P2n1/NKP5/PP2N3/4R1B1 b - - 12 30,Bg3,-314,-358,-44,1
4r1k1/pp3ppp/2p5/8/3P2n1/NKP3b1/PP2N3/4R1B1 w - - 13 31,Nxg3,-347,-562,-215,0
4r1k1/pp3ppp/2p5/8/3P2n1/NKP3N1/PP6/4R1B1 b - - 0 31,Rxe1,-519,-537,-18,1
6k1/pp3ppp/2p5/8/3P2n1/NKP3N1/PP6/4r1B1 w - - 0 32,Nf5,-547,-556,-9,1
6k1/pp3ppp/2p5/5N2/3P2n1/NKP5/PP6/4r1B1 b - - 1 32,Rxg1,-574,-574,0,1
6k1/pp3ppp/2p5/5N2/3P2n1/NKP5/PP6/6r1 w - - 0 33,Ne7+,-562,-569,-7,1
6k1/pp2Nppp/2p5/8/3P2n1/NKP5/PP6/6r1 b - - 1 33,Kf8,-578,-559,19,1
5k2/pp2Nppp/2p5/8/3P2n1/NKP5/PP6/6r1 w - - 2 34,Nc8,-581,-610,-29,1
2N2k2/pp3ppp/2p5/8/3P2n1/NKP5/PP6/6r1 b - - 3 34,a6,-571,-570,1,1
2N2k2/1p3ppp/p1p5/8/3P2n1/NKP5/PP6/6r1 w - - 0 35,Nb6,-562,-587,-25,1
5k2/1p3ppp/pNp5/8/3P2n1/NKP5/PP6/6r1 b - - 1 35,h5,-566,-568,-2,1
5k2/1p3pp1/pNp5/7p/3P2n1/NKP5/PP6/6r1 w - - 0 36,Nbc4,-540,-618,-78,1
5k2/1p3pp1/p1p5/7p/2NP2n1/NKP5/PP6/6r1 b - - 1 36,h4,-611,-602,9,1
5k2/1p3pp1/p1p5/8/2NP2np/NKP5/PP6/6r1 w - - 0 37,Ne5,-648,-662,-14,1
5k2/1p3pp1/p1p5/4N3/3P2np/NKP5/PP6/6r1 b - - 1 37,h3,-697,-603,94,1
5k2/1p3pp1/p1p5/4N3/3P2n1/NKP4p/PP6/6r1 w - - 0 38,Nxg4,-643,-701,-58,1
5k2/1p3pp1/p1p5/8/3P2N1/NKP4p/PP6/6r1 b - - 0 38,Rxg4,-645,-699,-54,1
5k2/1p3pp1/p1p5/8/3P2r1/NKP4p/PP6/8 w - - 0 39,Nc4,-733,-744,-11,1
5k2/1p3pp1/p1p5/8/2NP2r1/1KP4p/PP6/8 b - - 1 39,h2,-751,-730,21,1
5k2/1p3pp1/p1p5/8/2NP2r1/1KP5/PP5p/8 w - - 0 40,Ne5,-770,-805,-35,1
5k2/1p3pp1/p1p5/4N3/3P2r1/1KP5/PP5p/8 b - - 1 40,h1=Q,-801,-724,77,1
5k2/1p3pp1/p1p5/4N3/3P2r1/1KP5/PP6/7q w - - 0 41,Nxg4,-739,-698,41,1
5k2/1p3pp1/p1p5/8/3P2N1/1KP5/PP6/7q b - - 0 41,Qg2,-713,-671,42,1
5k2/1p3pp1/p1p5/8/3P2N1/1KP5/PP4q1/8 w - - 1 42,Ne5,-672,-702,-30,1
5k2/1p3pp1/p1p5/4N3/3P4/1KP5/PP4q1/8 b - - 2 42,Qf1,-673,-628,45,1
5k2/1p3pp1/p1p5/4N3/3P4/1KP5/PP6/5q2 w - - 3 43,Nd7+,-656,-691,-35,1
5k2/1p1N1pp1/p1p5/8/3P4/1KP5/PP6/5q2 b - - 4 43,Ke7,-701,-678,23,1
8/1p1Nkpp1/p1p5/8/3P4/1KP5/PP6/5q2 w - - 5 44,Nc5,-667,-673,-6,1
8/1p2kpp1/p1p5/2N5/3P4/1KP5/PP6/5q2 b - - 6 44,Qb5+,-738,-654,84,1
rnbqkbnr/pppppppp/8/8/8/8/PPPPPPPP/RNBQKBNR w KQkq - 0 1,e4,39,39,0,1
rnbqkbnr/pppppppp/8/8/4P3/8/PPPP1PPP/RNBQKBNR b KQkq - 0 1,e5,40,43,3,1
rnbqkbnr/pppp1ppp/8/4p3/4P3/8/PPPP1PPP/RNBQKBNR w KQkq - 0 2,Nf3,42,37,-5,1
rnbqkbnr/pppp1ppp/8/4p3/4P3/5N2/PPPP1PPP/RNBQKB1R b KQkq - 1 2,Bc5,31,131,100,1
rnbqk1nr/pppp1ppp/8/2b1p3/4P3/5N2/PPPP1PPP/RNBQKB1R w KQkq - 2 3,Bc4,148,40,-108,0
rnbqk1nr/pppp1ppp/8/2b1p3/2B1P3/5N2/PPPP1PPP/RNBQK2R b KQkq - 3 3,Nf6,30,137,107,1
rnbqk2r/pppp1ppp/5n2/2b1p3/2B1P3/5N2/PPPP1PPP/RNBQK2R w KQkq - 4 4,Nc3,157,2,-155,0
rnbqk2r/pppp1ppp/5n2/2b1p3/2B1P3/2N2N2/PPPP1PPP/R1BQK2R b KQkq - 5 4,c6,7,165,158,1
rnbqk2r/pp1p1ppp/2p2n2/2b1p3/2B1P3/2N2N2/PPPP1PPP/R1BQK2R w KQkq - 0 5,d3,149,-3,-152,0
rnbqk2r/pp1p1ppp/2p2n2/2b1p3/2B1P3/2NP1N2/PPP2PPP/R1BQK2R b KQkq - 0 5,d5,-4,29,33,1
rnbqk2r/pp3ppp/2p2n2/2bpp3/2B1P3/2NP1N2/PPP2PPP/R1BQK2R w KQkq - 0 6,exd5,71,17,-54,1
rnbqk2r/pp3ppp/2p2n2/2bPp3/2B5/2NP1N2/PPP2PPP/R1BQK2R b KQkq - 0 6,cxd5,-11,0,11,1
rnbqk2r/pp3ppp/5n2/2bpp3/2B5/2NP1N2/PPP2PPP/R1BQK2R w KQkq - 0 7,Bb5+,0,-18,-18,1
rnbqk2r/pp3ppp/5n2/1Bbpp3/8/2NP1N2/PPP2PPP/R1BQK2R b KQkq - 1 7,Nc6,-13,142,155,1
r1bqk2r/pp3ppp/2n2n2/1Bbpp3/8/2NP1N2/PPP2PPP/R1BQK2R w KQkq - 2 8,Bxc6+,33,0,-33,1
r1bqk2r/pp3ppp/2B2n2/2bpp3/8/2NP1N2/PPP2PPP/R1BQK2R b KQkq - 0 8,bxc6,19,20,1,1
r1bqk2r/p4ppp/2p2n2/2bpp3/8/2NP1N2/PPP2PPP/R1BQK2R w KQkq - 0 9,Nxe5,11,1,-10,1
r1bqk2r/p4ppp/2p2n2/2bpN3/8/2NP4/PPP2PPP/R1BQK2R b KQkq - 0 9,Bxf2+,2,341,339,1
r1bqk2r/p4ppp/2p2n2/3pN3/8/2NP4/PPP2bPP/R1BQK2R w KQkq - 0 10,Kxf2,365,350,-15,1
r1bqk2r/p4ppp/2p2n2/3pN3/8/2NP4/PPP2KPP/R1BQ3R b kq - 0 10,d4,381,376,-5,1
r1bqk2r/p4ppp/2p2n2/4N3/3p4/2NP4/PPP2KPP/R1BQ3R w kq - 0 11,Nxc6,408,223,-185,0
r1bqk2r/p4ppp/2N2n2/8/3p4/2NP4/PPP2KPP/R1BQ3R b kq - 0 11,Qb6,193,191,-2,1
r1b1k2r/p4ppp/1qN2n2/8/3p4/2NP4/PPP2KPP/R1BQ3R w kq - 1 12,Qe2+,189,83,-106,0
r1b1k2r/p4ppp/1qN2n2/8/3p4/2NP4/PPP1QKPP/R1B4R b kq - 2 12,Be6,133,115,-18,1
r3k2r/p4ppp/1qN1bn2/8/3p4/2NP4/PPP1QKPP/R1B4R w kq - 3 13,Nxa7,114,-274,-388,0
r3k2r/N4ppp/1q2bn2/8/3p4/2NP4/PPP1QKPP/R1B4R b kq - 0 13,dxc3+,-287,-283,4,1
r3k2r/N4ppp/1q2bn2/8/8/2pP4/PPP1QKPP/R1B4R w kq - 0 14,Be3,-257,-181,76,1
r3k2r/N4ppp/1q2bn2/8/8/2pPB3/PPP1QKPP/R6R b kq - 1 14,Qxb2,-218,138,356,1
r3k2r/N4ppp/4bn2/8/8/2pPB3/PqP1QKPP/R6R w kq - 0 15,Rab1,154,-21,-175,0
r3k2r/N4ppp/4bn2/8/8/2pPB3/PqP1QKPP/1R5R b kq - 1 15,Qa3,-24,71,95,1
r3k2r/N4ppp/4bn2/8/8/q1pPB3/P1P1QKPP/1R5R w kq - 2 16,Nc6,78,-112,-190,0
r3k2r/5ppp/2N1bn2/8/8/q1pPB3/P1P1QKPP/1R5R b kq - 3 16,O-O,-125,-103,22,1
r4rk1/5ppp/2N1bn2/8/8/q1pPB3/P1P1QKPP/1R5R w - - 4 17,Nd4,-108,-282,-174,0
r4rk1/5ppp/4bn2/8/3N4/q1pPB3/P1P1QKPP/1R5R b - - 5 17,Bg4,-221,-262,-41,1
r4rk1/5ppp/5n2/8/3N2b1/q1pPB3/P1P1QKPP/1R5R w - - 6 18,Nf3,-250,-239,11,1
r4rk1/5ppp/5n2/8/6b1/q1pPBN2/P1P1QKPP/1R5R b - - 7 18,Rae8,-273,-220,53,1
4rrk1/5ppp/5n2/8/6b1/q1pPBN2/P1P1QKPP/1R5R w - - 8 19,h3,-218,-311,-93,1
4rrk1/5ppp/5n2/8/6b1/q1pPBN1P/P1P1QKP1/1R5R b - - 0 19,Bxf3,-323,-20,303,1
4rrk1/5ppp/5n2/8/8/q1pPBb1P/P1P1QKP1/1R5R w - - 0 20,Qxf3,-33,-33,0,1
4rrk1/5ppp/5n2/8/8/q1pPBQ1P/P1P2KP1/1R5R b - - 0 20,Qxa2,-80,-1,79,1
4rrk1/5ppp/5n2/8/8/2pPBQ1P/q1P2KP1/1R5R w - - 0 21,Rbc1,2,-83,-85,1
4rrk1/5ppp/5n2/8/8/2pPBQ1P/q1P2KP1/2R4R b - - 1 21,Rb8,-72,12,84,1
1r3rk1/5ppp/5n2/8/8/2pPBQ1P/q1P2KP1/2R4R w - - 2 22,Bc5,-14,-11,3,1
1r3rk1/5ppp/5n2/2B5/8/2pP1Q1P/q1P2KP1/2R4R b - - 3 22,Rfe8,-25,-16,9,1
1r2r1k1/5ppp/5n2/2B5/8/2pP1Q1P/q1P2KP1/2R4R w - - 4 23,Bd4,-5,-14,-9,1
1r2r1k1/5ppp/5n2/8/3B4/2pP1Q1P/q1P2KP1/2R4R b - - 5 23,Rb2,-8,-5,3,1
4r1k1/5ppp/5n2/8/3B4/2pP1Q1P/qrP2KP1/2R4R w - - 6 24,Bxf6,-14,-58,-44,1
4r1k1/5ppp/5B2/8/8/2pP1Q1P/qrP2KP1/2R4R b - - 0 24,Rxc2+,-25,0,25,1
4r1k1/5ppp/5B2/8/8/2pP1Q1P/q1r2KP1/2R4R w - - 0 25,Rxc2,0,-136,-136,0
4r1k1/5ppp/5B2/8/8/2pP1Q1P/q1R2KP1/7R b - - 0 25,Qxc2+,-20,-13,7,1
4r1k1/5ppp/5B2/8/8/2pP1Q1P/2q2KP1/7R w - - 0 26,Kg3,-15,-46,-31,1
4r1k1/5ppp/5B2/8/8/2pP1QKP/2q3P1/7R b - - 1 26,gxf6,-61,-5,56,1
4r1k1/5p1p/5p2/8/8/2pP1QKP/2q3P1/7R w - - 0 27,Qxf6,-1,-174,-173,0
4r1k1/5p1p/5Q2/8/8/2pP2KP/2q3P1/7R b - - 0 27,Qxd3+,-156,-190,-34,1
4r1k1/5p1p/5Q2/8/8/2pq2KP/6P1/7R w - - 0 28,Kh2,-225,-226,-1,1
4r1k1/5p1p/5Q2/8/8/2pq3P/6PK/7R b - - 1 28,Re2,-208,-86,122,1
6k1/5p1p/5Q2/8/8/2pq3P/4r1PK/7R w - - 2 29,Rf1,-63,-80,-17,1
6k1/5p1p/5Q2/8/8/2pq3P/4r1PK/5R2 b - - 3 29,Qc4,-108,0,108,1
6k1/5p1p/5Q2/8/2q5/2p4P/4r1PK/5R2 w - - 4 30,Qg5+,0,0,0,1
6k1/5p1p/8/6Q1/2q5/2p4P/4r1PK/5R2 b - - 5 30,Kf8,0,0,0,1
5k2/5p1p/8/6Q1/2q5/2p4P/4r1PK/5R2 w - - 6 31,Qh6+,0,-92,-92,1
5k2/5p1p/7Q/8/2q5/2p4P/4r1PK/5R2 b - - 7 31,Ke7,-66,23,89,1
8/4kp1p/7Q/8/2q5/2p4P/4r1PK/5R2 w - - 8 32,Qxh7,15,-109,-124,0
rnbqkbnr/pppppppp/8/8/8/8/PPPPPPPP/RNBQKBNR w KQkq - 0 1,e4,39,33,-6,1
rnbqkbnr/pppppppp/8/8/4P3/8/PPPP1PPP/RNBQKBNR b KQkq - 0 1,d6,16,62,46,1
rnbqkbnr/ppp1pppp/3p4/8/4P3/8/PPPP1PPP/RNBQKBNR w KQkq - 0 2,f4,51,14,-37,1
rnbqkbnr/ppp1pppp/3p4/8/4PP2/8/PPPP2PP/RNBQKBNR b KQkq - 0 2,g6,16,62,46,1
rnbqkbnr/ppp1pp1p/3p2p1/8/4PP2/8/PPPP2PP/RNBQKBNR w KQkq - 0 3,Nf3,50,27,-23,1
rnbqkbnr/ppp1pp1p/3p2p1/8/4PP2/5N2/PPPP2PP/RNBQKB1R b KQkq - 1 3,Bg7,20,35,15,1
rnbqk1nr/ppp1ppbp/3p2p1/8/4PP2/5N2/PPPP2PP/RNBQKB1R w KQkq - 2 4,c3,36,15,-21,1
rnbqk1nr/ppp1ppbp/3p2p1/8/4PP2/2P2N2/PP1P2PP/RNBQKB1R b KQkq - 0 4,Bg4,11,60,49,1
rn1qk1nr/ppp1ppbp/3p2p1/8/4PPb1/2P2N2/PP1P2PP/RNBQKB1R w KQkq - 1 5,Na3,69,35,-34,1
rn1qk1nr/ppp1ppbp/3p2p1/8/4PPb1/N1P2N2/PP1P2PP/R1BQKB1R b KQkq - 2 5,c5,32,44,12,1
rn1qk1nr/pp2ppbp/3p2p1/2p5/4PPb1/N1P2N2/PP1P2PP/R1BQKB1R w KQkq - 0 6,Nc2,39,29,-10,1
rn1qk1nr/pp2ppbp/3p2p1/2p5/4PPb1/2P2N2/PPNP2PP/R1BQKB1R b KQkq - 1 6,Nf6,18,35,17,1
rn1qk2r/pp2ppbp/3p1np1/2p5/4PPb1/2P2N2/PPNP2PP/R1BQKB1R w KQkq - 2 7,d3,24,19,-5,1
rn1qk2r/pp2ppbp/3p1np1/2p5/4PPb1/2PP1N2/PPN3PP/R1BQKB1R b KQkq - 0 7,O-O,14,20,6,1
rn1q1rk1/pp2ppbp/3p1np1/2p5/4PPb1/2PP1N2/PPN3PP/R1BQKB1R w KQ - 1 8,Be2,17,-1,-18,1
rn1q1rk1/pp2ppbp/3p1np1/2p5/4PPb1/2PP1N2/PPN1B1PP/R1BQK2R b KQ - 2 8,Nc6,1,16,15,1
r2q1rk1/pp2ppbp/2np1np1/2p5/4PPb1/2PP1N2/PPN1B1PP/R1BQK2R w KQ - 3 9,O-O,21,0,-21,1
r2q1rk1/pp2ppbp/2np1np1/2p5/4PPb1/2PP1N2/PPN1B1PP/R1BQ1RK1 b - - 4 9,e6,-6,63,69,1
r2q1rk1/pp3pbp/2nppnp1/2p5/4PPb1/2PP1N2/PPN1B1PP/R1BQ1RK1 w - - 0 10,h3,47,45,-2,1
r2q1rk1/pp3pbp/2nppnp1/2p5/4PPb1/2PP1N1P/PPN1B1P1/R1BQ1RK1 b - - 0 10,Bxf3,41,50,9,1
r2q1rk1/pp3pbp/2nppnp1/2p5/4PP2/2PP1b1P/PPN1B1P1/R1BQ1RK1 w - - 0 11,Bxf3,45,43,-2,1
r2q1rk1/pp3pbp/2nppnp1/2p5/4PP2/2PP1B1P/PPN3P1/R1BQ1RK1 b - - 0 11,Qb6,51,54,3,1
r4rk1/pp3pbp/1qnppnp1/2p5/4PP2/2PP1B1P/PPN3P1/R1BQ1RK1 w - - 1 12,Kh1,57,39,-18,1
r4rk1/pp3pbp/1qnppnp1/2p5/4PP2/2PP1B1P/PPN3P1/R1BQ1R1K b - - 2 12,Rad8,50,58,8,1
3r1rk1/pp3pbp/1qnppnp1/2p5/4PP2/2PP1B1P/PPN3P1/R1BQ1R1K w - - 3 13,d4,62,-11,-73,1
3r1rk1/pp3pbp/1qnppnp1/2p5/3PPP2/2P2B1P/PPN3P1/R1BQ1R1K b - - 0 13,cxd4,-4,-3,1,1
3r1rk1/pp3pbp/1qnppnp1/8/3pPP2/2P2B1P/PPN3P1/R1BQ1R1K w - - 0 14,cxd4,-1,-54,-53,1
3r1rk1/pp3pbp/1qnppnp1/8/3PPP2/5B1P/PPN3P1/R1BQ1R1K b - - 0 14,Ne7,-56,26,82,1
3r1rk1/pp2npbp/1q1ppnp1/8/3PPP2/5B1P/PPN3P1/R1BQ1R1K w - - 1 15,e5,-26,-87,-61,1
3r1rk1/pp2npbp/1q1ppnp1/4P3/3P1P2/5B1P/PPN3P1/R1BQ1R1K b - - 0 15,dxe5,-108,-92,16,1
3r1rk1/pp2npbp/1q2pnp1/4p3/3P1P2/5B1P/PPN3P1/R1BQ1R1K w - - 0 16,fxe5,-112,-106,6,1
3r1rk1/pp2npbp/1q2pnp1/4P3/3P4/5B1P/PPN3P1/R1BQ1R1K b - - 0 16,Nfd5,-92,-104,-12,1
3r1rk1/pp2npbp/1q2p1p1/3nP3/3P4/5B1P/PPN3P1/R1BQ1R1K w - - 1 17,Bg5,-98,-98,0,1
3r1rk1/pp2npbp/1q2p1p1/3nP1B1/3P4/5B1P/PPN3P1/R2Q1R1K b - - 2 17,h6,-126,-93,33,1
3r1rk1/pp2npb1/1q2p1pp/3nP1B1/3P4/5B1P/PPN3P1/R2Q1R1K w - - 0 18,Bd2,-84,-211,-127,0
3r1rk1/pp2npb1/1q2p1pp/3nP3/3P4/5B1P/PPNB2P1/R2Q1R1K b - - 1 18,Nf5,-216,-186,30,1
3r1rk1/pp3pb1/1q2p1pp/3nPn2/3P4/5B1P/PPNB2P1/R2Q1R1K w - - 2 19,Ne3,-171,-651,-480,0
3r1rk1/pp3pb1/1q2p1pp/3nPn2/3P4/4NB1P/PP1B2P1/R2Q1R1K b - - 3 19,Ndxe3,-593,-615,-22,1
3r1rk1/pp3pb1/1q2p1pp/4Pn2/3P4/4nB1P/PP1B2P1/R2Q1R1K w - - 0 20,Bxe3,-626,-634,-8,1
3r1rk1/pp3pb1/1q2p1pp/4Pn2/3P4/4BB1P/PP4P1/R2Q1R1K b - - 0 20,Nxe3,-641,-648,-7,1
rnbqkbnr/pppppppp/8/8/8/8/PPPPPPPP/RNBQKBNR w KQkq - 0 1,f4,33,-30,-63,1
rnbqkbnr/pppppppp/8/8/5P2/8/PPPPP1PP/RNBQKBNR b KQkq - 0 1,e5,-66,23,89,1
rnbqkbnr/pppp1ppp/8/4p3/5P2/8/PPPPP1PP/RNBQKBNR w KQkq - 0 2,fxe5,58,57,-1,1
rnbqkbnr/pppp1ppp/8/4P3/8/8/PPPPP1PP/RNBQKBNR b KQkq - 0 2,Nc6,43,63,20,1
r1bqkbnr/pppp1ppp/2n5/4P3/8/8/PPPPP1PP/RNBQKBNR w KQkq - 1 3,Nf3,68,54,-14,1
r1bqkbnr/pppp1ppp/2n5/4P3/8/5N2/PPPPP1PP/RNBQKB1R b KQkq - 2 3,Nge7,46,181,135,1
r1bqkb1r/ppppnppp/2n5/4P3/8/5N2/PPPPP1PP/RNBQKB1R w KQkq - 3 4,d4,184,188,4,1
r1bqkb1r/ppppnppp/2n5/4P3/3P4/5N2/PPP1P1PP/RNBQKB1R b KQkq - 0 4,Ng6,176,195,19,1
r1bqkb1r/pppp1ppp/2n3n1/4P3/3P4/5N2/PPP1P1PP/RNBQKB1R w KQkq - 1 5,e3,196,179,-17,1
r1bqkb1r/pppp1ppp/2n3n1/4P3/3P4/4PN2/PPP3PP/RNBQKB1R b KQkq - 0 5,d5,135,200,65,1
r1bqkb1r/ppp2ppp/2n3n1/3pP3/3P4/4PN2/PPP3PP/RNBQKB1R w KQkq d6 0 6,c3,223,152,-71,1
r1bqkb1r/ppp2ppp/2n3n1/3pP3/3P4/2P1PN2/PP4PP/RNBQKB1R b KQkq - 0 6,Bg4,135,148,13,1
r2qkb1r/ppp2ppp/2n3n1/3pP3/3P2b1/2P1PN2/PP4PP/RNBQKB1R w KQkq - 1 7,Bd3,120,128,8,1
r2qkb1r/ppp2ppp/2n3n1/3pP3/3P2b1/2PBPN2/PP4PP/RNBQK2R b KQkq - 2 7,Nh4,106,131,25,1
r2qkb1r/ppp2ppp/2n5/3pP3/3P2bn/2PBPN2/PP4PP/RNBQK2R w KQkq - 3 8,O-O,151,127,-24,1
r2qkb1r/ppp2ppp/2n5/3pP3/3P2bn/2PBPN2/PP4PP/RNBQ1RK1 b kq - 4 8,Nxf3+,120,137,17,1
r2qkb1r/ppp2ppp/2n5/3pP3/3P2b1/2PBPn2/PP4PP/RNBQ1RK1 w kq - 0 9,Rxf3,122,129,7,1
r2qkb1r/ppp2ppp/2n5/3pP3/3P2b1/2PBPR2/PP4PP/RNBQ2K1 b kq - 0 9,Bxf3,124,208,84,1
r2qkb1r/ppp2ppp/2n5/3pP3/3P4/2PBPb2/PP4PP/RNBQ2K1 w kq - 0 10,Qxf3,197,193,-4,1
r2qkb1r/ppp2ppp/2n5/3pP3/3P4/2PBPQ2/PP4PP/RNB3K1 b kq - 0 10,Be7,170,201,31,1
r2qk2r/ppp1bppp/2n5/3pP3/3P4/2PBPQ2/PP4PP/RNB3K1 w kq - 1 11,Qh3,196,92,-104,0
r2qk2r/ppp1bppp/2n5/3pP3/3P4/2PBP2Q/PP4PP/RNB3K1 b kq - 2 11,Qd7,73,124,51,1
r3k2r/pppqbppp/2n5/3pP3/3P4/2PBP2Q/PP4PP/RNB3K1 w kq - 3 12,Qh5,148,-51,-199,0
r3k2r/pppqbppp/2n5/3pP2Q/3P4/2PBP3/PP4PP/RNB3K1 b kq - 4 12,g6,-50,-30,20,1
r3k2r/pppqbp1p/2n3p1/3pP2Q/3P4/2PBP3/PP4PP/RNB3K1 w kq - 0 13,Qf3,-22,-119,-97,1
r3k2r/pppqbp1p/2n3p1/3pP3/3P4/2PBPQ2/PP4PP/RNB3K1 b kq - 1 13,Rf8,-113,22,135,1
r3kr2/pppqbp1p/2n3p1/3pP3/3P4/2PBPQ2/PP4PP/RNB3K1 w q - 2 14,Nd2,-38,-66,-28,1
r3kr2/pppqbp1p/2n3p1/3pP3/3P4/2PBPQ2/PP1N2PP/R1B3K1 b q - 3 14,f5,-75,31,106,1
r3kr2/pppqb2p/2n3p1/3pPp2/3P4/2PBPQ2/PP1N2PP/R1B3K1 w q f6 0 15,Nb3,29,23,-6,1
r3kr2/pppqb2p/2n3p1/3pPp2/3P4/1NPBPQ2/PP4PP/R1B3K1 b q - 1 15,O-O-O,13,4,-9,1
2kr1r2/pppqb2p/2n3p1/3pPp2/3P4/1NPBPQ2/PP4PP/R1B3K1 w - - 2 16,Bd2,10,9,-1,1
2kr1r2/pppqb2p/2n3p1/3pPp2/3P4/1NPBPQ2/PP1B2PP/R5K1 b - - 3 16,Bg5,-11,220,231,1
2kr1r2/pppq3p/2n3p1/3pPpb1/3P4/1NPBPQ2/PP1B2PP/R5K1 w - - 4 17,Nc5,186,184,-2,1
2kr1r2/pppq3p/2n3p1/2NpPpb1/3P4/2PBPQ2/PP1B2PP/R5K1 b - - 5 17,Qg7,192,301,109,1
2kr1r2/ppp3qp/2n3p1/2NpPpb1/3P4/2PBPQ2/PP1B2PP/R5K1 w - - 6 18,a4,282,155,-127,0
2kr1r2/ppp3qp/2n3p1/2NpPpb1/P2P4/2PBPQ2/1P1B2PP/R5K1 b - - 0 18,Rfe8,155,193,38,1
2krr3/ppp3qp/2n3p1/2NpPpb1/P2P4/2PBPQ2/1P1B2PP/R5K1 w - - 1 19,a5,205,163,-42,1
2krr3/ppp3qp/2n3p1/P1NpPpb1/3P4/2PBPQ2/1P1B2PP/R5K1 b - - 0 19,Be7,143,342,199,1
2krr3/ppp1b1qp/2n3p1/P1NpPp2/3P4/2PBPQ2/1P1B2PP/R5K1 w - - 1 20,b4,363,205,-158,0
2krr3/ppp1b1qp/2n3p1/P1NpPp2/1P1P4/2PBPQ2/3B2PP/R5K1 b - - 0 20,Bxc5,185,176,-9,1
2krr3/ppp3qp/2n3p1/P1bpPp2/1P1P4/2PBPQ2/3B2PP/R5K1 w - - 0 21,bxc5,171,180,9,1
2krr3/ppp3qp/2n3p1/P1PpPp2/3P4/2PBPQ2/3B2PP/R5K1 b - - 0 21,Rf8,174,311,137,1
2kr1r2/ppp3qp/2n3p1/P1PpPp2/3P4/2PBPQ2/3B2PP/R5K1 w - - 1 22,a6,339,316,-23,1
2kr1r2/ppp3qp/P1n3p1/2PpPp2/3P4/2PBPQ2/3B2PP/R5K1 b - - 0 22,f4,369,406,37,1
2kr1r2/ppp3qp/P1n3p1/2PpP3/3P1p2/2PBPQ2/3B2PP/R5K1 w - - 0 23,exf4,392,354,-38,1
2kr1r2/ppp3qp/P1n3p1/2PpP3/3P1P2/2PB1Q2/3B2PP/R5K1 b - - 0 23,g5,350,549,199,1
2kr1r2/ppp3qp/P1n5/2PpP1p1/3P1P2/2PB1Q2/3B2PP/R5K1 w - - 0 24,f5,521,531,10,1
2kr1r2/ppp3qp/P1n5/2PpPPp1/3P4/2PB1Q2/3B2PP/R5K1 b - - 0 24,g4,526,543,17,1
2kr1r2/ppp3qp/P1n5/2PpPP2/3P2p1/2PB1Q2/3B2PP/R5K1 w - - 0 25,Qe2,564,550,-14,1
2kr1r2/ppp3qp/P1n5/2PpPP2/3P2p1/2PB4/3BQ1PP/R5K1 b - - 1 25,g3,528,533,5,1
2kr1r2/ppp3qp/P1n5/2PpPP2/3P4/2PB2p1/3BQ1PP/R5K1 w - - 0 26,h3,557,548,-9,1
2kr1r2/ppp3qp/P1n5/2PpPP2/3P4/2PB2pP/3BQ1P1/R5K1 b - - 0 26,Rf7,558,641,83,1
2kr4/ppp2rqp/P1n5/2PpPP2/3P4/2PB2pP/3BQ1P1/R5K1 w - - 1 27,axb7+,583,532,-51,1
2kr4/pPp2rqp/2n5/2PpPP2/3P4/2PB2pP/3BQ1P1/R5K1 b - - 0 27,Kb8,511,542,31,1
1k1r4/pPp2rqp/2n5/2PpPP2/3P4/2PB2pP/3BQ1P1/R5K1 w - - 1 28,Bb5,542,533,-9,1
1k1r4/pPp2rqp/2n5/1BPpPP2/3P4/2P3pP/3BQ1P1/R5K1 b - - 2 28,Rdf8,498,763,265,1
1k3r2/pPp2rqp/2n5/1BPpPP2/3P4/2P3pP/3BQ1P1/R5K1 w - - 3 29,Bxc6,755,818,63,1
1k3r2/pPp2rqp/2B5/2PpPP2/3P4/2P3pP/3BQ1P1/R5K1 b - - 0 29,Rxf5,910,1015,105,1
1k3r2/pPp3qp/2B5/2PpPr2/3P4/2P3pP/3BQ1P1/R5K1 w - - 0 30,Bxd5,1051,501,-550,0
1k3r2/pPp3qp/8/2PBPr2/3P4/2P3pP/3BQ1P1/R5K1 b - - 0 30,Rf2,628,809,181,1
1k3r2/pPp3qp/8/2PBP3/3P4/2P3pP/3BQrP1/R5K1 w - - 1 31,Qa6,847,847,0,1
1k3r2/pPp3qp/Q7/2PBP3/3P4/2P3pP/3B1rP1/R5K1 b - - 2 31,Rxd2,821,9999,9178,1
1k3r2/pPp3qp/Q7/2PBP3/3P4/2P3pP/3r2P1/R5K1 w - - 0 32,Qxa7#,9999,10000,1,1
rnbqkbnr/pppppppp/8/8/8/8/PPPPPPPP/RNBQKBNR w KQkq - 0 1,e4,30,37,7,1
rnbqkbnr/pppppppp/8/8/4P3/8/PPPP1PPP/RNBQKBNR b KQkq - 0 1,e5,30,44,14,1
rnbqkbnr/pppp1ppp/8/4p3/4P3/8/PPPP1PPP/RNBQKBNR w KQkq - 0 2,Nf3,31,32,1,1
rnbqkbnr/pppp1ppp/8/4p3/4P3/5N2/PPPP1PPP/RNBQKB1R b KQkq - 1 2,Nc6,34,34,0,1
r1bqkbnr/pppp1ppp/2n5/4p3/4P3/5N2/PPPP1PPP/RNBQKB1R w KQkq - 2 3,Bc4,42,22,-20,1
r1bqkbnr/pppp1ppp/2n5/4p3/2B1P3/5N2/PPPP1PPP/RNBQK2R b KQkq - 3 3,Bc5,18,25,7,1
r1bqk1nr/pppp1ppp/2n5/2b1p3/2B1P3/5N2/PPPP1PPP/RNBQK2R w KQkq - 4 4,d3,31,6,-25,1
r1bqk1nr/pppp1ppp/2n5/2b1p3/2B1P3/3P1N2/PPP2PPP/RNBQK2R b KQkq - 0 4,Nf6,3,14,11,1
r1bqk2r/pppp1ppp/2n2n2/2b1p3/2B1P3/3P1N2/PPP2PPP/RNBQK2R w KQkq - 1 5,Ng5,22,-54,-76,1
r1bqk2r/pppp1ppp/2n2n2/2b1p1N1/2B1P3/3P4/PPP2PPP/RNBQK2R b KQkq - 2 5,O-O,-44,-44,0,1
r1bq1rk1/pppp1ppp/2n2n2/2b1p1N1/2B1P3/3P4/PPP2PPP/RNBQK2R w KQ - 3 6,Nxf7,-54,-244,-190,0
r1bq1rk1/pppp1Npp/2n2n2/2b1p3/2B1P3/3P4/PPP2PPP/RNBQK2R b KQ - 0 6,Rxf7,-230,-231,-1,1
r1bq2k1/pppp1rpp/2n2n2/2b1p3/2B1P3/3P4/PPP2PPP/RNBQK2R w KQ - 0 7,Bxf7+,-240,-231,9,1
r1bq2k1/pppp1Bpp/2n2n2/2b1p3/4P3/3P4/PPP2PPP/RNBQK2R b KQ - 0 7,Kxf7,-242,-247,-5,1
r1bq4/pppp1kpp/2n2n2/2b1p3/4P3/3P4/PPP2PPP/RNBQK2R w KQ - 0 8,Be3,-244,-266,-22,1
r1bq4/pppp1kpp/2n2n2/2b1p3/4P3/3PB3/PPP2PPP/RN1QK2R b KQ - 1 8,Bb6,-275,-208,67,1
r1bq4/pppp1kpp/1bn2n2/4p3/4P3/3PB3/PPP2PPP/RN1QK2R w KQ - 2 9,Bxb6,-208,-228,-20,1
r1bq4/pppp1kpp/1Bn2n2/4p3/4P3/3P4/PPP2PPP/RN1QK2R b KQ - 0 9,axb6,-242,-234,8,1
r1bq4/1ppp1kpp/1pn2n2/4p3/4P3/3P4/PPP2PPP/RN1QK2R w KQ - 0 10,Nd2,-216,-280,-64,1
r1bq4/1ppp1kpp/1pn2n2/4p3/4P3/3P4/PPPN1PPP/R2QK2R b KQ - 1 10,Kg8,-279,-282,-3,1
r1bq2k1/1ppp2pp/1pn2n2/4p3/4P3/3P4/PPPN1PPP/R2QK2R w KQ - 2 11,Nf3,-284,-314,-30,1
r1bq2k1/1ppp2pp/1pn2n2/4p3/4P3/3P1N2/PPP2PPP/R2QK2R b KQ - 3 11,d6,-329,-304,25,1
r1bq2k1/1pp3pp/1pnp1n2/4p3/4P3/3P1N2/PPP2PPP/R2QK2R w KQ - 0 12,O-O,-297,-336,-39,1
r1bq2k1/1pp3pp/1pnp1n2/4p3/4P3/3P1N2/PPP2PPP/R2Q1RK1 b - - 1 12,Bg4,-319,-324,-5,1
r2q2k1/1pp3pp/1pnp1n2/4p3/4P1b1/3P1N2/PPP2PPP/R2Q1RK1 w - - 2 13,a3,-307,-490,-183,0
r2q2k1/1pp3pp/1pnp1n2/4p3/4P1b1/P2P1N2/1PP2PPP/R2Q1RK1 b - - 0 13,Nd4,-503,-464,39,1
r2q2k1/1pp3pp/1p1p1n2/4p3/3nP1b1/P2P1N2/1PP2PPP/R2Q1RK1 w - - 1 14,c3,-498,-479,19,1
r2q2k1/1pp3pp/1p1p1n2/4p3/3nP1b1/P1PP1N2/1P3PPP/R2Q1RK1 b - - 0 14,Bxf3,-506,-395,111,1
r2q2k1/1pp3pp/1p1p1n2/4p3/3nP3/P1PP1b2/1P3PPP/R2Q1RK1 w - - 0 15,gxf3,-381,-391,-10,1
r2q2k1/1pp3pp/1p1p1n2/4p3/3nP3/P1PP1P2/1P3P1P/R2Q1RK1 b - - 0 15,Ne6,-410,-435,-25,1
r2q2k1/1pp3pp/1p1pnn2/4p3/4P3/P1PP1P2/1P3P1P/R2Q1RK1 w - - 1 16,Qb3,-417,-469,-52,1
r2q2k1/1pp3pp/1p1pnn2/4p3/4P3/PQPP1P2/1P3P1P/R4RK1 b - - 2 16,Qe7,-471,-418,53,1
r5k1/1pp1q1pp/1p1pnn2/4p3/4P3/PQPP1P2/1P3P1P/R4RK1 w - - 3 17,d4,-399,-489,-90,1
r5k1/1pp1q1pp/1p1pnn2/4p3/3PP3/PQP2P2/1P3P1P/R4RK1 b - - 0 17,Kh8,-480,-410,70,1
r6k/1pp1q1pp/1p1pnn2/4p3/3PP3/PQP2P2/1P3P1P/R4RK1 w - - 1 18,dxe5,-454,-474,-20,1
r6k/1pp1q1pp/1p1pnn2/4P3/4P3/PQP2P2/1P3P1P/R4RK1 b - - 0 18,dxe5,-429,-469,-40,1
r6k/1pp1q1pp/1p2nn2/4p3/4P3/PQP2P2/1P3P1P/R4RK1 w - - 0 19,Qc2,-439,-513,-74,1
r6k/1pp1q1pp/1p2nn2/4p3/4P3/P1P2P2/1PQ2P1P/R4RK1 b - - 1 19,Nf4,-526,-525,1,1
r6k/1pp1q1pp/1p3n2/4p3/4Pn2/P1P2P2/1PQ2P1P/R4RK1 w - - 2 20,b4,-522,-677,-155,0
r6k/1pp1q1pp/1p3n2/4p3/1P2Pn2/P1P2P2/2Q2P1P/R4RK1 b - - 0 20,N6h5,-684,-489,195,1
r6k/1pp1q1pp/1p6/4p2n/1P2Pn2/P1P2P2/2Q2P1P/R4RK1 w - - 1 21,Rfd1,-483,-567,-84,1
r6k/1pp1q1pp/1p6/4p2n/1P2Pn2/P1P2P2/2Q2P1P/R2R2K1 b - - 2 21,Qg5+,-547,-543,4,1
r6k/1pp3pp/1p6/4p1qn/1P2Pn2/P1P2P2/2Q2P1P/R2R2K1 w - - 3 22,Kf1,-536,-539,-3,1
r6k/1pp3pp/1p6/4p1qn/1P2Pn2/P1P2P2/2Q2P1P/R2R1K2 b - - 4 22,Qg2+,-540,-483,57,1
r6k/1pp3pp/1p6/4p2n/1P2Pn2/P1P2P2/2Q2PqP/R2R1K2 w - - 5 23,Ke1,-487,-509,-22,1
r6k/1pp3pp/1p6/4p2n/1P2Pn2/P1P2P2/2Q2PqP/R2RK3 b - - 6 23,Qg1+,-483,-440,43,1
r6k/1pp3pp/1p6/4p2n/1P2Pn2/P1P2P2/2Q2P1P/R2RK1q1 w - - 7 24,Kd2,-442,-455,-13,1
r6k/1pp3pp/1p6/4p2n/1P2Pn2/P1P2P2/2QK1P1P/R2R2q1 b - - 8 24,Qxf2+,-418,-476,-58,1
r6k/1pp3pp/1p6/4p2n/1P2Pn2/P1P2P2/2QK1q1P/R2R4 w - - 0 25,Kc1,-470,-455,15,1
r6k/1pp3pp/1p6/4p2n/1P2Pn2/P1P2P2/2Q2q1P/R1KR4 b - - 1 25,Qxf3,-448,-466,-18,1
r6k/1pp3pp/1p6/4p2n/1P2Pn2/P1P2q2/2Q4P/R1KR4 w - - 0 26,Rd2,-452,-444,8,1
r6k/1pp3pp/1p6/4p2n/1P2Pn2/P1P2q2/2QR3P/R1K5 b - - 1 26,Qf1+,-468,-359,109,1
r6k/1pp3pp/1p6/4p2n/1P2Pn2/P1P5/2QR3P/R1K2q2 w - - 2 27,Kb2,-340,-341,-1,1
r6k/1pp3pp/1p6/4p2n/1P2Pn2/P1P5/1KQR3P/R4q2 b - - 3 27,Qc4,-411,-406,5,1
r6k/1pp3pp/1p6/4p2n/1Pq1Pn2/P1P5/1KQR3P/R7 w - - 4 28,Qd1,-381,-392,-11,1
r6k/1pp3pp/1p6/4p2n/1Pq1Pn2/P1P5/1K1R3P/R2Q4 b - - 5 28,h6,-441,-455,-14,1
r6k/1pp3p1/1p5p/4p2n/1Pq1Pn2/P1P5/1K1R3P/R2Q4 w - - 0 29,Rc2,-384,-720,-336,0
r6k/1pp3p1/1p5p/4p2n/1Pq1Pn2/P1P5/1KR4P/R2Q4 b - - 1 29,Nd3+,-711,-698,13,1
r6k/1pp3p1/1p5p/4p2n/1Pq1P3/P1Pn4/1KR4P/R2Q4 w - - 2 30,Kb1,-737,-9998,-9261,0
r6k/1pp3p1/1p5p/4p2n/1Pq1P3/P1Pn4/2R4P/RK1Q4 b - - 3 30,Qb3+,-9998,-9999,-1,1
r6k/1pp3p1/1p5p/4p2n/1P2P3/PqPn4/2R4P/RK1Q4 w - - 4 31,Rb2,-9999,-9999,0,1
r6k/1pp3p1/1p5p/4p2n/1P2P3/PqPn4/1R5P/RK1Q4 b - - 5 31,Qxb2#,-9999,-10000,-1,1
rnbqkbnr/pppppppp/8/8/8/8/PPPPPPPP/RNBQKBNR w KQkq - 0 1,e4,29,29,0,1
rnbqkbnr/pppppppp/8/8/4P3/8/PPPP1PPP/RNBQKBNR b KQkq - 0 1,e5,24,45,21,1
rnbqkbnr/pppp1ppp/8/4p3/4P3/8/PPPP1PPP/RNBQKBNR w KQkq - 0 2,Nf3,45,30,-15,1
rnbqkbnr/pppp1ppp/8/4p3/4P3/5N2/PPPP1PPP/RNBQKB1R b KQkq - 1 2,Nc6,29,38,9,1
r1bqkbnr/pppp1ppp/2n5/4p3/4P3/5N2/PPPP1PPP/RNBQKB1R w KQkq - 2 3,d4,31,18,-13,1
r1bqkbnr/pppp1ppp/2n5/4p3/3PP3/5N2/PPP2PPP/RNBQKB1R b KQkq - 0 3,Nce7,15,244,229,1
r1bqkbnr/ppppnppp/8/4p3/3PP3/5N2/PPP2PPP/RNBQKB1R w KQkq - 1 4,dxe5,246,260,14,1
r1bqkbnr/ppppnppp/8/4P3/4P3/5N2/PPP2PPP/RNBQKB1R b KQkq - 0 4,b6,257,318,61,1
r1bqkbnr/p1ppnppp/1p6/4P3/4P3/5N2/PPP2PPP/RNBQKB1R w KQkq - 0 5,Nc3,304,289,-15,1
r1bqkbnr/p1ppnppp/1p6/4P3/4P3/2N2N2/PPP2PPP/R1BQKB1R b KQkq - 1 5,Bb7,306,321,15,1
r2qkbnr/pbppnppp/1p6/4P3/4P3/2N2N2/PPP2PPP/R1BQKB1R w KQkq - 2 6,Bd3,328,255,-73,1
r2qkbnr/pbppnppp/1p6/4P3/4P3/2NB1N2/PPP2PPP/R1BQK2R b KQkq - 3 6,Ng6,244,261,17,1
r2qkbnr/pbpp1ppp/1p4n1/4P3/4P3/2NB1N2/PPP2PPP/R1BQK2R w KQkq - 4 7,O-O,249,208,-41,1
r2qkbnr/pbpp1ppp/1p4n1/4P3/4P3/2NB1N2/PPP2PPP/R1BQ1RK1 b kq - 5 7,d6,238,245,7,1
r2qkbnr/pbp2ppp/1p1p2n1/4P3/4P3/2NB1N2/PPP2PPP/R1BQ1RK1 w kq - 0 8,exd6,247,290,43,1
r2qkbnr/pbp2ppp/1p1P2n1/8/4P3/2NB1N2/PPP2PPP/R1BQ1RK1 b kq - 0 8,Bxd6,285,286,1,1
r2qk1nr/pbp2ppp/1p1b2n1/8/4P3/2NB1N2/PPP2PPP/R1BQ1RK1 w kq - 0 9,Bb5+,267,231,-36,1
r2qk1nr/pbp2ppp/1p1b2n1/1B6/4P3/2N2N2/PPP2PPP/R1BQ1RK1 b kq - 1 9,c6,211,211,0,1
r2qk1nr/pb3ppp/1ppb2n1/1B6/4P3/2N2N2/PPP2PPP/R1BQ1RK1 w kq - 0 10,Ba4,190,164,-26,1
r2qk1nr/pb3ppp/1ppb2n1/8/B3P3/2N2N2/PPP2PPP/R1BQ1RK1 b kq - 1 10,a5,152,275,123,1
r2qk1nr/1b3ppp/1ppb2n1/p7/B3P3/2N2N2/PPP2PPP/R1BQ1RK1 w kq - 0 11,Bb3,211,208,-3,1
r2qk1nr/1b3ppp/1ppb2n1/p7/4P3/1BN2N2/PPP2PPP/R1BQ1RK1 b kq - 1 11,b5,211,317,106,1
r2qk1nr/1b3ppp/2pb2n1/pp6/4P3/1BN2N2/PPP2PPP/R1BQ1RK1 w kq - 0 12,a4,281,303,22,1
r2qk1nr/1b3ppp/2pb2n1/pp6/P3P3/1BN2N2/1PP2PPP/R1BQ1RK1 b kq - 0 12,b4,312,279,-33,1
r2qk1nr/1b3ppp/2pb2n1/p7/Pp2P3/1BN2N2/1PP2PPP/R1BQ1RK1 w kq - 0 13,Ne2,295,121,-174,0
r2qk1nr/1b3ppp/2pb2n1/p7/Pp2P3/1B3N2/1PP1NPPP/R1BQ1RK1 b kq - 1 13,c5,131,193,62,1
r2qk1nr/1b3ppp/3b2n1/p1p5/Pp2P3/1B3N2/1PP1NPPP/R1BQ1RK1 w kq - 0 14,c3,215,91,-124,0
r2qk1nr/1b3ppp/3b2n1/p1p5/Pp2P3/1BP2N2/1P2NPPP/R1BQ1RK1 b kq - 0 14,Nh4,73,505,432,1
r2qk1nr/1b3ppp/3b4/p1p5/Pp2P2n/1BP2N2/1P2NPPP/R1BQ1RK1 w kq - 1 15,Nd2,486,219,-267,0
r2qk1nr/1b3ppp/3b4/p1p5/Pp2P2n/1BP5/1P1NNPPP/R1BQ1RK1 b kq - 2 15,Nf3+,234,484,250,1
r2qk1nr/1b3ppp/3b4/p1p5/Pp2P3/1BP2n2/1P1NNPPP/R1BQ1RK1 w kq - 3 16,Nxf3,550,565,15,1
r2qk1nr/1b3ppp/3b4/p1p5/Pp2P3/1BP2N2/1P2NPPP/R1BQ1RK1 b kq - 0 16,Nf6,563,565,2,1
r2qk2r/1b3ppp/3b1n2/p1p5/Pp2P3/1BP2N2/1P2NPPP/R1BQ1RK1 w kq - 1 17,Qd3,598,-297,-895,0
r2qk2r/1b3ppp/3b1n2/p1p5/Pp2P3/1BPQ1N2/1P2NPPP/R1B2RK1 b kq - 2 17,O-O,-278,511,789,1
r2q1rk1/1b3ppp/3b1n2/p1p5/Pp2P3/1BPQ1N2/1P2NPPP/R1B2RK1 w - - 3 18,cxb4,522,-400,-922,0
r2q1rk1/1b3ppp/3b1n2/p1p5/PP2P3/1B1Q1N2/1P2NPPP/R1B2RK1 b - - 0 18,Bxe4,-405,371,776,1
r2q1rk1/5ppp/3b1n2/p1p5/PP2b3/1B1Q1N2/1P2NPPP/R1B2RK1 w - - 0 19,Qc4,331,213,-118,0
r2q1rk1/5ppp/3b1n2/p1p5/PPQ1b3/1B3N2/1P2NPPP/R1B2RK1 b - - 1 19,cxb4,101,410,309,1
r2q1rk1/5ppp/3b1n2/p7/PpQ1b3/1B3N2/1P2NPPP/R1B2RK1 w - - 0 20,Nfd4,385,281,-104,0
r2q1rk1/5ppp/3b1n2/p7/PpQNb3/1B6/1P2NPPP/R1B2RK1 b - - 1 20,Ng4,275,269,-6,1
r2q1rk1/5ppp/3b4/p7/PpQNb1n1/1B6/1P2NPPP/R1B2RK1 w - - 2 21,g3,327,-779,-1106,0
r2q1rk1/5ppp/3b4/p7/PpQNb1n1/1B4P1/1P2NP1P/R1B2RK1 b - - 0 21,Rc8,-649,-286,363,1
2rq1rk1/5ppp/3b4/p7/PpQNb1n1/1B4P1/1P2NP1P/R1B2RK1 w - - 1 22,Qb5,-287,-604,-317,0
2rq1rk1/5ppp/3b4/pQ6/Pp1Nb1n1/1B4P1/1P2NP1P/R1B2RK1 b - - 2 22,Qf6,-794,388,1182,1
2r2rk1/5ppp/3b1q2/pQ6/Pp1Nb1n1/1B4P1/1P2NP1P/R1B2RK1 w - - 3 23,Bf4,360,205,-155,0
2r2rk1/5ppp/3b1q2/pQ6/Pp1NbBn1/1B4P1/1P2NP1P/R4RK1 b - - 4 23,Bc5,145,221,76,1
2r2rk1/5ppp/5q2/pQb5/Pp1NbBn1/1B4P1/1P2NP1P/R4RK1 w - - 5 24,Qc4,282,-216,-498,0
2r2rk1/5ppp/5q2/p1b5/PpQNbBn1/1B4P1/1P2NP1P/R4RK1 b - - 6 24,Rfd8,-156,55,211,1
2rr2k1/5ppp/5q2/p1b5/PpQNbBn1/1B4P1/1P2NP1P/R4RK1 w - - 7 25,f3,109,-416,-525,0
2rr2k1/5ppp/5q2/p1b5/PpQNbBn1/1B3PP1/1P2N2P/R4RK1 b - - 0 25,Bxd4+,-440,-439,1,1
2rr2k1/5ppp/5q2/p7/PpQbbBn1/1B3PP1/1P2N2P/R4RK1 w - - 0 26,Kg2,-464,-525,-61,1
2rr2k1/5ppp/5q2/p7/PpQbbBn1/1B3PP1/1P2N1KP/R4R2 b - - 1 26,Ne3+,-521,-202,319,1
2rr2k1/5ppp/5q2/p7/PpQbbB2/1B2nPP1/1P2N1KP/R4R2 w - - 2 27,Bxe3,-140,-202,-62,1
2rr2k1/5ppp/5q2/p7/PpQbb3/1B2BPP1/1P2N1KP/R4R2 b - - 0 27,Rxc4,-147,-121,26,1
3r2k1/5ppp/5q2/p7/Pprbb3/1B2BPP1/1P2N1KP/R4R2 w - - 0 28,Bxd4,-138,-327,-189,0
3r2k1/5ppp/5q2/p7/PprBb3/1B3PP1/1P2N1KP/R4R2 b - - 0 28,Rdxd4,-317,-55,262,1
6k1/5ppp/5q2/p7/Pprrb3/1B3PP1/1P2N1KP/R4R2 w - - 0 29,Nxd4,-40,-294,-254,0
6k1/5ppp/5q2/p7/PprNb3/1B3PP1/1P4KP/R4R2 b - - 0 29,Qxd4,-316,-286,30,1
6k1/5ppp/8/p7/Pprqb3/1B3PP1/1P4KP/R4R2 w - - 0 30,Bxc4,-302,-295,7,1
6k1/5ppp/8/p7/PpBqb3/5PP1/1P4KP/R4R2 b - - 0 30,Qxc4,-331,-119,212,1
6k1/5ppp/8/p7/Ppq1b3/5PP1/1P4KP/R4R2 w - - 0 31,fxe4,-90,-122,-32,1
6k1/5ppp/8/p7/Ppq1P3/6P1/1P4KP/R4R2 b - - 0 31,Qxe4+,-125,-142,-17,1
6k1/5ppp/8/p7/Pp2q3/6P1/1P4KP/R4R2 w - - 0 32,Kh3,-165,-195,-30,1
6k1/5ppp/8/p7/Pp2q3/6PK/1P5P/R4R2 b - - 1 32,g5,-179,-107,72,1
6k1/5p1p/8/p5p1/Pp2q3/6PK/1P5P/R4R2 w - - 0 33,Rfe1,-104,-281,-177,0
6k1/5p1p/8/p5p1/Pp2q3/6PK/1P5P/R3R3 b - - 1 33,g4+,-302,-179,123,1
6k1/5p1p/8/p7/Pp2q1p1/6PK/1P5P/R3R3 w - - 0 34,Kh4,-530,-617,-87,1
6k1/5p1p/8/p7/Pp2q1pK/6P1/1P5P/R3R3 b - - 1 34,Qg6,-658,-620,38,1
6k1/5p1p/6q1/p7/Pp4pK/6P1/1P5P/R3R3 w - - 2 35,Re5,-651,-698,-47,1
6k1/5p1p/6q1/p3R3/Pp4pK/6P1/1P5P/R7 b - - 3 35,h6,-691,-19,672,1
6k1/5p2/6qp/p3R3/Pp4pK/6P1/1P5P/R7 w - - 0 36,Rf1,-39,-51,-12,1
6k1/5p2/6qp/p3R3/Pp4pK/6P1/1P5P/5R2 b - - 1 36,Qc2,-35,-25,10,1
6k1/5p2/7p/p3R3/Pp4pK/6P1/1Pq4P/5R2 w - - 2 37,Rff5,-24,-78,-54,1
6k1/5p2/7p/p3RR2/Pp4pK/6P1/1Pq4P/8 b - - 3 37,Qxh2+,-60,-55,5,1
6k1/5p2/7p/p3RR2/Pp4pK/6P1/1P5q/8 w - - 0 38,Kxg4,-45,-48,-3,1
6k1/5p2/7p/p3RR2/Pp4K1/6P1/1P5q/8 b - - 0 38,Kg7,-45,-25,20,1
8/5pk1/7p/p3RR2/Pp4K1/6P1/1P5q/8 w - - 1 39,Rxa5,-21,-30,-9,1
8/5pk1/7p/R4R2/Pp4K1/6P1/1P5q/8 b - - 0 39,f6,-16,-13,3,1
8/6k1/5p1p/R4R2/Pp4K1/6P1/1P5q/8 w - - 0 40,Rh5,-23,-61,-38,1
8/6k1/5p1p/R6R/Pp4K1/6P1/1P5q/8 b - - 1 40,Qe2+,-98,-48,50,1
8/6k1/5p1p/R6R/Pp4K1/6P1/1P2q3/8 w - - 2 41,Kh4,-30,-87,-57,1
8/6k1/5p1p/R6R/Pp5K/6P1/1P2q3/8 b - - 3 41,Kg6,-100,-47,53,1
8/8/5pkp/R6R/Pp5K/6P1/1P2q3/8 w - - 4 42,Kh3,-40,-40,0,1
8/8/5pkp/R6R/Pp6/6PK/1P2q3/8 b - - 5 42,Qf1+,-45,-35,10,1
8/8/5pkp/R6R/Pp6/6PK/1P6/5q2 w - - 6 43,Kg4,-32,-64,-32,1
8/8/5pkp/R6R/Pp4K1/6P1/1P6/5q2 b - - 7 43,Qe2+,-74,-29,45,1
8/8/5pkp/R6R/Pp4K1/6P1/1P2q3/8 w - - 8 44,Kh3,-26,-25,1,1
8/8/5pkp/R6R/Pp6/6PK/1P2q3/8 b - - 9 44,Qe6+,-29,0,29,1
8/8/4qpkp/R6R/Pp6/6PK/1P6/8 w - - 10 45,Kg2,0,-37,-37,1
8/8/4qpkp/R6R/Pp6/6P1/1P4K1/8 b - - 11 45,Qe2+,-52,-22,30,1
8/8/5pkp/R6R/Pp6/6P1/1P2q1K1/8 w - - 12 46,Kh3,-18,-32,-14,1
8/8/5pkp/R6R/Pp6/6PK/1P2q3/8 b - - 13 46,Qf1+,-18,-21,-3,1
8/8/5pkp/R6R/Pp6/6PK/1P6/5q2 w - - 14 47,Kg4,-14,-99,-85,1
8/8/5pkp/R6R/Pp4K1/6P1/1P6/5q2 b - - 15 47,Qd1+,-77,-60,17,1
8/8/5pkp/R6R/Pp4K1/6P1/1P6/3q4 w - - 16 48,Kh3,-53,-57,-4,1
8/8/5pkp/R6R/Pp6/6PK/1P6/3q4 b - - 17 48,Qd7+,-71,-9,62,1
8/3q4/5pkp/R6R/Pp6/6PK/1P6/8 w - - 18 49,Kg2,-3,-21,-18,1
8/3q4/5pkp/R6R/Pp6/6P1/1P4K1/8 b - - 19 49,Qd2+,-21,-16,5,1
8/8/5pkp/R6R/Pp6/6P1/1P1q2K1/8 w - - 20 50,Kh3,-19,-20,-1,1
8/8/5pkp/R6R/Pp6/6PK/1P1q4/8 b - - 21 50,Qd7+,-15,0,15,1
8/3q4/5pkp/R6R/Pp6/6PK/1P6/8 w - - 22 51,Kg2,0,-22,-22,1
8/3q4/5pkp/R6R/Pp6/6P1/1P4K1/8 b - - 23 51,Qd2+,-7,-6,1,1
8/8/5pkp/R6R/Pp6/6P1/1P1q2K1/8 w - - 24 52,Kh3,-5,-15,-10,1
8/8/5pkp/R6R/Pp6/6PK/1P1q4/8 b - - 25 52,b3,-6,-6,0,1
8/8/5pkp/R6R/P7/1p4PK/1P1q4/8 w - - 0 53,Rad5,-2,-318,-316,0
8/8/5pkp/3R3R/P7/1p4PK/1P1q4/8 b - - 1 53,Qxb2,-333,-323,10,1
8/8/5pkp/3R3R/P7/1p4PK/1q6/8 w - - 0 54,Kh4,-325,-548,-223,0
8/8/5pkp/3R3R/P6K/1p4P1/1q6/8 b - - 1 54,Qa3,-630,-389,241,1
8/8/5pkp/3R3R/P6K/qp4P1/8/8 w - - 2 55,Kh3,-374,-428,-54,1
8/8/5pkp/3R3R/P7/qp4PK/8/8 b - - 3 55,b2,-384,-379,5,1
8/8/5pkp/3R3R/P7/q5PK/1p6/8 w - - 0 56,Kh4,-342,-9994,-9652,0
8/8/5pkp/3R3R/P6K/q5P1/1p6/8 b - - 1 56,b1=Q,-9994,-9995,-1,1
8/8/5pkp/3R3R/P6K/q5P1/8/1q6 w - - 0 57,Kh3,-9995,-9998,-3,1
8/8/5pkp/3R3R/P7/q5PK/8/1q6 b - - 1 57,Qh1+,-9998,-9999,-1,1
rnbqkbnr/pppppppp/8/8/8/8/PPPPPPPP/RNBQKBNR w KQkq - 0 1,c4,31,-11,-42,1
rnbqkbnr/pppppppp/8/8/2P5/8/PP1PPPPP/RNBQKBNR b KQkq - 0 1,e5,7,11,4,1
rnbqkbnr/pppp1ppp/8/4p3/2P5/8/PP1PPPPP/RNBQKBNR w KQkq - 0 2,Nc3,18,13,-5,1
rnbqkbnr/pppp1ppp/8/4p3/2P5/2N5/PP1PPPPP/R1BQKBNR b KQkq - 1 2,f5,4,31,27,1
rnbqkbnr/pppp2pp/8/4pp2/2P5/2N5/PP1PPPPP/R1BQKBNR w KQkq - 0 3,d3,37,27,-10,1
rnbqkbnr/pppp2pp/8/4pp2/2P5/2NP4/PP2PPPP/R1BQKBNR b KQkq - 0 3,c6,20,28,8,1
rnbqkbnr/pp1p2pp/2p5/4pp2/2P5/2NP4/PP2PPPP/R1BQKBNR w KQkq - 0 4,g3,39,-20,-59,1
rnbqkbnr/pp1p2pp/2p5/4pp2/2P5/2NP2P1/PP2PP1P/R1BQKBNR b KQkq - 0 4,Na6,-16,69,85,1
r1bqkbnr/pp1p2pp/n1p5/4pp2/2P5/2NP2P1/PP2PP1P/R1BQKBNR w KQkq - 1 5,Bg2,41,25,-16,1
r1bqkbnr/pp1p2pp/n1p5/4pp2/2P5/2NP2P1/PP2PPBP/R1BQK1NR b KQkq - 2 5,Nc7,46,74,28,1
r1bqkbnr/ppnp2pp/2p5/4pp2/2P5/2NP2P1/PP2PPBP/R1BQK1NR w KQkq - 3 6,e3,69,-9,-78,1
r1bqkbnr/ppnp2pp/2p5/4pp2/2P5/2NPP1P1/PP3PBP/R1BQK1NR b KQkq - 0 6,Nf6,37,35,-2,1
r1bqkb1r/ppnp2pp/2p2n2/4pp2/2P5/2NPP1P1/PP3PBP/R1BQK1NR w KQkq - 1 7,Nge2,55,24,-31,1
r1bqkb1r/ppnp2pp/2p2n2/4pp2/2P5/2NPP1P1/PP2NPBP/R1BQK2R b KQkq - 2 7,d5,24,27,3,1
r1bqkb1r/ppn3pp/2p2n2/3ppp2/2P5/2NPP1P1/PP2NPBP/R1BQK2R w KQkq - 0 8,cxd5,27,15,-12,1
r1bqkb1r/ppn3pp/2p2n2/3Ppp2/8/2NPP1P1/PP2NPBP/R1BQK2R b KQkq - 0 8,cxd5,19,-4,-23,1
r1bqkb1r/ppn3pp/5n2/3ppp2/8/2NPP1P1/PP2NPBP/R1BQK2R w KQkq - 0 9,O-O,-6,-13,-7,1
r1bqkb1r/ppn3pp/5n2/3ppp2/8/2NPP1P1/PP2NPBP/R1BQ1RK1 b kq - 1 9,e4,-18,119,137,1
r1bqkb1r/ppn3pp/5n2/3p1p2/4p3/2NPP1P1/PP2NPBP/R1BQ1RK1 w kq - 0 10,dxe4,133,119,-14,1
r1bqkb1r/ppn3pp/5n2/3p1p2/4P3/2N1P1P1/PP2NPBP/R1BQ1RK1 b kq - 0 10,fxe4,117,155,38,1
r1bqkb1r/ppn3pp/5n2/3p4/4p3/2N1P1P1/PP2NPBP/R1BQ1RK1 w kq - 0 11,h3,108,53,-55,1
r1bqkb1r/ppn3pp/5n2/3p4/4p3/2N1P1PP/PP2NPB1/R1BQ1RK1 b kq - 0 11,Be7,49,71,22,1
r1bqk2r/ppn1b1pp/5n2/3p4/4p3/2N1P1PP/PP2NPB1/R1BQ1RK1 w kq - 1 12,Nf4,79,69,-10,1
r1bqk2r/ppn1b1pp/5n2/3p4/4pN2/2N1P1PP/PP3PB1/R1BQ1RK1 b kq - 2 12,O-O,63,78,15,1
r1bq1rk1/ppn1b1pp/5n2/3p4/4pN2/2N1P1PP/PP3PB1/R1BQ1RK1 w - - 3 13,Bd2,92,18,-74,1
r1bq1rk1/ppn1b1pp/5n2/3p4/4pN2/2N1P1PP/PP1B1PB1/R2Q1RK1 b - - 4 13,g5,21,37,16,1
r1bq1rk1/ppn1b2p/5n2/3p2p1/4pN2/2N1P1PP/PP1B1PB1/R2Q1RK1 w - - 0 14,Nh5,47,-3,-50,1
r1bq1rk1/ppn1b2p/5n2/3p2pN/4p3/2N1P1PP/PP1B1PB1/R2Q1RK1 b - - 1 14,h6,-1,69,70,1
r1bq1rk1/ppn1b3/5n1p/3p2pN/4p3/2N1P1PP/PP1B1PB1/R2Q1RK1 w - - 0 15,Nxf6+,43,31,-12,1
r1bq1rk1/ppn1b3/5N1p/3p2p1/4p3/2N1P1PP/PP1B1PB1/R2Q1RK1 b - - 0 15,Bxf6,26,48,22,1
r1bq1rk1/ppn5/5b1p/3p2p1/4p3/2N1P1PP/PP1B1PB1/R2Q1RK1 w - - 0 16,Rb1,25,-21,-46,1
r1bq1rk1/ppn5/5b1p/3p2p1/4p3/2N1P1PP/PP1B1PB1/1R1Q1RK1 b - - 1 16,Be6,-20,-6,14,1
r2q1rk1/ppn5/4bb1p/3p2p1/4p3/2N1P1PP/PP1B1PB1/1R1Q1RK1 w - - 2 17,Ne2,31,25,-6,1
r2q1rk1/ppn5/4bb1p/3p2p1/4p3/4P1PP/PP1BNPB1/1R1Q1RK1 b - - 3 17,Qd7,11,16,5,1
r4rk1/ppnq4/4bb1p/3p2p1/4p3/4P1PP/PP1BNPB1/1R1Q1RK1 w - - 4 18,Kh2,6,7,1,1
r4rk1/ppnq4/4bb1p/3p2p1/4p3/4P1PP/PP1BNPBK/1R1Q1R2 b - - 5 18,Nb5,10,24,14,1
r4rk1/pp1q4/4bb1p/1n1p2p1/4p3/4P1PP/PP1BNPBK/1R1Q1R2 w - - 6 19,a4,21,15,-6,1
r4rk1/pp1q4/4bb1p/1n1p2p1/P3p3/4P1PP/1P1BNPBK/1R1Q1R2 b - - 0 19,Nd6,19,20,1,1
r4rk1/pp1q4/3nbb1p/3p2p1/P3p3/4P1PP/1P1BNPBK/1R1Q1R2 w - - 1 20,Bc3,15,-27,-42,1
r4rk1/pp1q4/3nbb1p/3p2p1/P3p3/2B1P1PP/1P2NPBK/1R1Q1R2 b - - 2 20,Bxc3,-29,-26,3,1
r4rk1/pp1q4/3nb2p/3p2p1/P3p3/2b1P1PP/1P2NPBK/1R1Q1R2 w - - 0 21,Nxc3,-29,-10,19,1
r4rk1/pp1q4/3nb2p/3p2p1/P3p3/2N1P1PP/1P3PBK/1R1Q1R2 b - - 0 21,Nf5,-11,18,29,1
r4rk1/pp1q4/4b2p/3p1np1/P3p3/2N1P1PP/1P3PBK/1R1Q1R2 w - - 1 22,b3,24,-36,-60,1
r4rk1/pp1q4/4b2p/3p1np1/P3p3/1PN1P1PP/5PBK/1R1Q1R2 b - - 0 22,a6,-15,10,25,1
r4rk1/1p1q4/p3b2p/3p1np1/P3p3/1PN1P1PP/5PBK/1R1Q1R2 w - - 0 23,Ne2,22,-6,-28,1
r4rk1/1p1q4/p3b2p/3p1np1/P3p3/1P2P1PP/4NPBK/1R1Q1R2 b - - 1 23,h5,6,32,26,1
r4rk1/1p1q4/p3b3/3p1npp/P3p3/1P2P1PP/4NPBK/1R1Q1R2 w - - 0 24,Rc1,35,-1,-36,1
r4rk1/1p1q4/p3b3/3p1npp/P3p3/1P2P1PP/4NPBK/2RQ1R2 b - - 1 24,Rf7,1,21,20,1
r5k1/1p1q1r2/p3b3/3p1npp/P3p3/1P2P1PP/4NPBK/2RQ1R2 w - - 2 25,Qd2,32,-13,-45,1
r5k1/1p1q1r2/p3b3/3p1npp/P3p3/1P2P1PP/3QNPBK/2R2R2 b - - 3 25,Raf8,-22,-23,-1,1
5rk1/1p1q1r2/p3b3/3p1npp/P3p3/1P2P1PP/3QNPBK/2R2R2 w - - 4 26,Nd4,-25,-48,-23,1
5rk1/1p1q1r2/p3b3/3p1npp/P2Np3/1P2P1PP/3Q1PBK/2R2R2 b - - 5 26,Nxd4,-37,-49,-12,1
5rk1/1p1q1r2/p3b3/3p2pp/P2np3/1P2P1PP/3Q1PBK/2R2R2 w - - 0 27,exd4,-39,-47,-8,1
5rk1/1p1q1r2/p3b3/3p2pp/P2Pp3/1P4PP/3Q1PBK/2R2R2 b - - 0 27,g4,-59,-5,54,1
5rk1/1p1q1r2/p3b3/3p3p/P2Pp1p1/1P4PP/3Q1PBK/2R2R2 w - - 0 28,h4,-39,-33,6,1
5rk1/1p1q1r2/p3b3/3p3p/P2Pp1pP/1P4P1/3Q1PBK/2R2R2 b - - 0 28,Bf5,-32,50,82,1
5rk1/1p1q1r2/p7/3p1b1p/P2Pp1pP/1P4P1/3Q1PBK/2R2R2 w - - 1 29,Qg5+,45,1,-44,1
5rk1/1p1q1r2/p7/3p1bQp/P2Pp1pP/1P4P1/5PBK/2R2R2 b - - 2 29,Bg6,-13,446,459,1
5rk1/1p1q1r2/p5b1/3p2Qp/P2Pp1pP/1P4P1/5PBK/2R2R2 w - - 3 30,Qxg6+,434,468,34,1
5rk1/1p1q1r2/p5Q1/3p3p/P2Pp1pP/1P4P1/5PBK/2R2R2 b - - 0 30,Rg7,454,466,12,1
5rk1/1p1q2r1/p5Q1/3p3p/P2Pp1pP/1P4P1/5PBK/2R2R2 w - - 1 31,Qxh5,443,329,-114,0
5rk1/1p1q2r1/p7/3p3Q/P2Pp1pP/1P4P1/5PBK/2R2R2 b - - 0 31,Qf7,358,409,51,1
5rk1/1p3qr1/p7/3p3Q/P2Pp1pP/1P4P1/5PBK/2R2R2 w - - 1 32,Qxf7+,457,456,-1,1
5rk1/1p3Qr1/p7/3p4/P2Pp1pP/1P4P1/5PBK/2R2R2 b - - 0 32,Rfxf7,439,481,42,1
6k1/1p3rr1/p7/3p4/P2Pp1pP/1P4P1/5PBK/2R2R2 w - - 0 33,Rc5,526,529,3,1
6k1/1p3rr1/p7/2Rp4/P2Pp1pP/1P4P1/5PBK/5R2 b - - 1 33,Rf5,508,622,114,1
6k1/1p4r1/p7/2Rp1r2/P2Pp1pP/1P4P1/5PBK/5R2 w - - 2 34,Bxe4,608,643,35,1
rnbqkbnr/pppppppp/8/8/8/8/PPPPPPPP/RNBQKBNR w KQkq - 0 1,d4,31,9,-22,1
rnbqkbnr/pppppppp/8/8/3P4/8/PPP1PPPP/RNBQKBNR b KQkq - 0 1,c5,22,55,33,1
rnbqkbnr/pp1ppppp/8/2p5/3P4/8/PPP1PPPP/RNBQKBNR w KQkq - 0 2,Bf4,63,-67,-130,0
rnbqkbnr/pp1ppppp/8/2p5/3P1B2/8/PPP1PPPP/RN1QKBNR b KQkq - 1 2,Qa5+,-48,58,106,1
rnb1kbnr/pp1ppppp/8/q1p5/3P1B2/8/PPP1PPPP/RN1QKBNR w KQkq - 2 3,Bd2,27,62,35,1
rnb1kbnr/pp1ppppp/8/q1p5/3P4/8/PPPBPPPP/RN1QKBNR b KQkq - 3 3,Qb5,78,115,37,1
rnb1kbnr/pp1ppppp/8/1qp5/3P4/8/PPPBPPPP/RN1QKBNR w KQkq - 4 4,dxc5,118,23,-95,1
rnb1kbnr/pp1ppppp/8/1qP5/8/8/PPPBPPPP/RN1QKBNR b KQkq - 0 4,Qxb2,55,39,-16,1
rnb1kbnr/pp1ppppp/8/2P5/8/8/PqPBPPPP/RN1QKBNR w KQkq - 0 5,Nc3,74,50,-24,1
rnb1kbnr/pp1ppppp/8/2P5/8/2N5/PqPBPPPP/R2QKBNR b KQkq - 1 5,Qb4,61,63,2,1
rnb1kbnr/pp1ppppp/8/2P5/1q6/2N5/P1PBPPPP/R2QKBNR w KQkq - 2 6,e3,67,-57,-124,0
rnb1kbnr/pp1ppppp/8/2P5/1q6/2N1P3/P1PB1PPP/R2QKBNR b KQkq - 0 6,Qxc5,-75,-61,14,1
rnb1kbnr/pp1ppppp/8/2q5/8/2N1P3/P1PB1PPP/R2QKBNR w KQkq - 0 7,Bd3,-79,-72,7,1
rnb1kbnr/pp1ppppp/8/2q5/8/2NBP3/P1PB1PPP/R2QK1NR b KQkq - 1 7,a6,-81,-9,72,1
rnb1kbnr/1p1ppppp/p7/2q5/8/2NBP3/P1PB1PPP/R2QK1NR w KQkq - 0 8,Nge2,27,-46,-73,1
rnb1kbnr/1p1ppppp/p7/2q5/8/2NBP3/P1PBNPPP/R2QK2R b KQkq - 1 8,Nf6,-43,-20,23,1
rnb1kb1r/1p1ppppp/p4n2/2q5/8/2NBP3/P1PBNPPP/R2QK2R w KQkq - 2 9,O-O,-44,-65,-21,1
rnb1kb1r/1p1ppppp/p4n2/2q5/8/2NBP3/P1PBNPPP/R2Q1RK1 b kq - 3 9,e6,-62,-67,-5,1
rnb1kb1r/1p1p1ppp/p3pn2/2q5/8/2NBP3/P1PBNPPP/R2Q1RK1 w kq - 0 10,Ng3,-32,-58,-26,1
rnb1kb1r/1p1p1ppp/p3pn2/2q5/8/2NBP1N1/P1PB1PPP/R2Q1RK1 b kq - 1 10,Bd6,-41,173,214,1
rnb1k2r/1p1p1ppp/p2bpn2/2q5/8/2NBP1N1/P1PB1PPP/R2Q1RK1 w kq - 2 11,Nce2,143,-67,-210,0
rnb1k2r/1p1p1ppp/p2bpn2/2q5/8/3BP1N1/P1PBNPPP/R2Q1RK1 b kq - 3 11,h5,-89,-81,8,1
rnb1k2r/1p1p1pp1/p2bpn2/2q4p/8/3BP1N1/P1PBNPPP/R2Q1RK1 w kq - 0 12,e4,-81,-247,-166,0
rnb1k2r/1p1p1pp1/p2bpn2/2q4p/4P3/3B2N1/P1PBNPPP/R2Q1RK1 b kq - 0 12,h4,-242,-233,9,1
rnb1k2r/1p1p1pp1/p2bpn2/2q5/4P2p/3B2N1/P1PBNPPP/R2Q1RK1 w kq - 0 13,Nh1,-218,-224,-6,1
rnb1k2r/1p1p1pp1/p2bpn2/2q5/4P2p/3B4/P1PBNPPP/R2Q1RKN b kq - 1 13,Qc7,-222,-216,6,1
rnb1k2r/1pqp1pp1/p2bpn2/8/4P2p/3B4/P1PBNPPP/R2Q1RKN w kq - 2 14,g3,-214,-328,-114,0
rnb1k2r/1pqp1pp1/p2bpn2/8/4P2p/3B2P1/P1PBNP1P/R2Q1RKN b kq - 0 14,hxg3,-331,-292,39,1
rnb1k2r/1pqp1pp1/p2bpn2/8/4P3/3B2p1/P1PBNP1P/R2Q1RKN w kq - 0 15,hxg3,-316,-315,1,1
rnb1k2r/1pqp1pp1/p2bpn2/8/4P3/3B2P1/P1PBNP2/R2Q1RKN b kq - 0 15,Ng4,-353,-237,116,1
rnb1k2r/1pqp1pp1/p2bp3/8/4P1n1/3B2P1/P1PBNP2/R2Q1RKN w kq - 1 16,Bf4,-228,-303,-75,1
rnb1k2r/1pqp1pp1/p2bp3/8/4PBn1/3B2P1/P1P1NP2/R2Q1RKN b kq - 2 16,Nh2,-323,-341,-18,1
rnb1k2r/1pqp1pp1/p2bp3/8/4PB2/3B2P1/P1P1NP1n/R2Q1RKN w kq - 3 17,Re1,-379,-426,-47,1
rnb1k2r/1pqp1pp1/p2bp3/8/4PB2/3B2P1/P1P1NP1n/R2QR1KN b kq - 4 17,Nf3+,-410,-390,20,1
rnb1k2r/1pqp1pp1/p2bp3/8/4PB2/3B1nP1/P1P1NP2/R2QR1KN w kq - 5 18,Kg2,-395,-369,26,1
rnb1k2r/1pqp1pp1/p2bp3/8/4PB2/3B1nP1/P1P1NPK1/R2QR2N b kq - 6 18,Nxe1+,-399,-384,15,1
rnb1k2r/1pqp1pp1/p2bp3/8/4PB2/3B2P1/P1P1NPK1/R2Qn2N w kq - 0 19,Qxe1,-410,-420,-10,1
rnb1k2r/1pqp1pp1/p2bp3/8/4PB2/3B2P1/P1P1NPK1/R3Q2N b kq - 0 19,b6,-382,-356,26,1
rnb1k2r/2qp1pp1/pp1bp3/8/4PB2/3B2P1/P1P1NPK1/R3Q2N w kq - 0 20,Bxd6,-352,-319,33,1
rnb1k2r/2qp1pp1/pp1Bp3/8/4P3/3B2P1/P1P1NPK1/R3Q2N b kq - 0 20,Qxd6,-326,-289,37,1
rnb1k2r/3p1pp1/pp1qp3/8/4P3/3B2P1/P1P1NPK1/R3Q2N w kq - 0 21,Nf4,-298,-455,-157,0
rnb1k2r/3p1pp1/pp1qp3/8/4PN2/3B2P1/P1P2PK1/R3Q2N b kq - 1 21,Bb7,-424,-355,69,1
rn2k2r/1b1p1pp1/pp1qp3/8/4PN2/3B2P1/P1P2PK1/R3Q2N w kq - 2 22,f3,-383,-398,-15,1
rn2k2r/1b1p1pp1/pp1qp3/8/4PN2/3B1PP1/P1P3K1/R3Q2N b kq - 0 22,Nc6,-430,-361,69,1
r3k2r/1b1p1pp1/ppnqp3/8/4PN2/3B1PP1/P1P3K1/R3Q2N w kq - 1 23,Nf2,-409,-427,-18,1
r3k2r/1b1p1pp1/ppnqp3/8/4PN2/3B1PP1/P1P2NK1/R3Q3 b kq - 2 23,Nd4,-398,-375,23,1
r3k2r/1b1p1pp1/pp1qp3/8/3nPN2/3B1PP1/P1P2NK1/R3Q3 w kq - 3 24,Ne2,-372,-516,-144,0
r3k2r/1b1p1pp1/pp1qp3/8/3nP3/3B1PP1/P1P1NNK1/R3Q3 b kq - 4 24,e5,-523,-325,198,1
r3k2r/1b1p1pp1/pp1q4/4p3/3nP3/3B1PP1/P1P1NNK1/R3Q3 w kq - 0 25,Nxd4,-317,-322,-5,1
r3k2r/1b1p1pp1/pp1q4/4p3/3NP3/3B1PP1/P1P2NK1/R3Q3 b kq - 0 25,exd4,-333,-336,-3,1
r3k2r/1b1p1pp1/pp1q4/8/3pP3/3B1PP1/P1P2NK1/R3Q3 w kq - 0 26,Ng4,-330,-361,-31,1
r3k2r/1b1p1pp1/pp1q4/8/3pP1N1/3B1PP1/P1P3K1/R3Q3 b kq - 1 26,Qg6,-359,-158,201,1
r3k2r/1b1p1pp1/pp4q1/8/3pP1N1/3B1PP1/P1P3K1/R3Q3 w kq - 2 27,e5,-149,-657,-508,0
r3k2r/1b1p1pp1/pp4q1/4P3/3p2N1/3B1PP1/P1P3K1/R3Q3 b kq - 0 27,Qh5,-721,-234,487,1
r3k2r/1b1p1pp1/pp6/4P2q/3p2N1/3B1PP1/P1P3K1/R3Q3 w kq - 1 28,Kf2,-280,-272,8,1
r3k2r/1b1p1pp1/pp6/4P2q/3p2N1/3B1PP1/P1P2K2/R3Q3 b kq - 2 28,O-O-O,-254,-192,62,1
2kr3r/1b1p1pp1/pp6/4P2q/3p2N1/3B1PP1/P1P2K2/R3Q3 w - - 3 29,Be4,-217,-322,-105,0
2kr3r/1b1p1pp1/pp6/4P2q/3pB1N1/5PP1/P1P2K2/R3Q3 b - - 4 29,f5,-382,-319,63,1
2kr3r/1b1p2p1/pp6/4Pp1q/3pB1N1/5PP1/P1P2K2/R3Q3 w - f6 0 30,Bxb7+,-346,-467,-121,0
2kr3r/1B1p2p1/pp6/4Pp1q/3p2N1/5PP1/P1P2K2/R3Q3 b - - 0 30,Kxb7,-493,-488,5,1
3r3r/1k1p2p1/pp6/4Pp1q/3p2N1/5PP1/P1P2K2/R3Q3 w - - 0 31,Ne3,-552,-641,-89,1
3r3r/1k1p2p1/pp6/4Pp1q/3p4/4NPP1/P1P2K2/R3Q3 b - - 1 31,dxe3+,-575,-612,-37,1
3r3r/1k1p2p1/pp6/4Pp1q/8/4pPP1/P1P2K2/R3Q3 w - - 0 32,Kxe3,-598,-655,-57,1
3r3r/1k1p2p1/pp6/4Pp1q/8/4KPP1/P1P5/R3Q3 b - - 0 32,Rhe8,-602,-539,63,1
3rr3/1k1p2p1/pp6/4Pp1q/8/4KPP1/P1P5/R3Q3 w - - 1 33,f4,-535,-542,-7,1
3rr3/1k1p2p1/pp6/4Pp1q/5P2/4K1P1/P1P5/R3Q3 b - - 0 33,d6,-535,-575,-40,1
3rr3/1k4p1/pp1p4/4Pp1q/5P2/4K1P1/P1P5/R3Q3 w - - 0 34,Kf2,-507,-587,-80,1
3rr3/1k4p1/pp1p4/4Pp1q/5P2/6P1/P1P2K2/R3Q3 b - - 1 34,dxe5,-601,-626,-25,1
3rr3/1k4p1/pp6/4pp1q/5P2/6P1/P1P2K2/R3Q3 w - - 0 35,fxe5,-632,-744,-112,0
3rr3/1k4p1/pp6/4Pp1q/8/6P1/P1P2K2/R3Q3 b - - 0 35,Qh2+,-754,-618,136,1
3rr3/1k4p1/pp6/4Pp2/8/6P1/P1P2K1q/R3Q3 w - - 1 36,Kf3,-568,-634,-66,1
3rr3/1k4p1/pp6/4Pp2/8/5KP1/P1P4q/R3Q3 b - - 2 36,Qxc2,-633,-644,-11,1
3rr3/1k4p1/pp6/4Pp2/8/5KP1/P1q5/R3Q3 w - - 0 37,Qh1,-634,-758,-124,0
3rr3/1k4p1/pp6/4Pp2/8/5KP1/P1q5/R6Q b - - 1 37,Rd3+,-747,-745,2,1
4r3/1k4p1/pp6/4Pp2/8/3r1KP1/P1q5/R6Q w - - 2 38,Kf4+,-745,-799,-54,1
4r3/1k4p1/pp6/4Pp2/5K2/3r2P1/P1q5/R6Q b - - 3 38,Ka7,-859,-747,112,1
4r3/k5p1/pp6/4Pp2/5K2/3r2P1/P1q5/R6Q w - - 4 39,Qh7,-810,-9997,-9187,0
4r3/k5pQ/pp6/4Pp2/5K2/3r2P1/P1q5/R7 b - - 5 39,Qc4+,-9997,-9997,0,1
4r3/k5pQ/pp6/4Pp2/2q2K2/3r2P1/P7/R7 w - - 6 40,Kxf5,-9997,-9997,0,1
4r3/k5pQ/pp6/4PK2/2q5/3r2P1/P7/R7 b - - 0 40,Rf3+,-9997,-9998,-1,1
4r3/k5pQ/pp6/4PK2/2q5/5rP1/P7/R7 w - - 1 41,Kg6,-9998,-9999,-1,1
4r3/k5pQ/pp4K1/4P3/2q5/5rP1/P7/R7 b - - 2 41,Qg4#,-9999,-10000,-1,1
rnbqkbnr/pppppppp/8/8/8/8/PPPPPPPP/RNBQKBNR w KQkq - 0 1,e4,16,11,-5,1
rnbqkbnr/pppppppp/8/8/4P3/8/PPPP1PPP/RNBQKBNR b KQkq - 0 1,e5,24,36,12,1
rnbqkbnr/pppp1ppp/8/4p3/4P3/8/PPPP1PPP/RNBQKBNR w KQkq - 0 2,Nf3,32,28,-4,1
rnbqkbnr/pppp1ppp/8/4p3/4P3/5N2/PPPP1PPP/RNBQKB1R b KQkq - 1 2,Nc6,23,41,18,1
r1bqkbnr/pppp1ppp/2n5/4p3/4P3/5N2/PPPP1PPP/RNBQKB1R w KQkq - 2 3,a3,35,-18,-53,1
r1bqkbnr/pppp1ppp/2n5/4p3/4P3/P4N2/1PPP1PPP/RNBQKB1R b KQkq - 0 3,Nf6,-18,-6,12,1
r1bqkb1r/pppp1ppp/2n2n2/4p3/4P3/P4N2/1PPP1PPP/RNBQKB1R w KQkq - 1 4,Nc3,-4,-1,3,1
r1bqkb1r/pppp1ppp/2n2n2/4p3/4P3/P1N2N2/1PPP1PPP/R1BQKB1R b KQkq - 2 4,Bc5,-6,89,95,1
r1bqk2r/pppp1ppp/2n2n2/2b1p3/4P3/P1N2N2/1PPP1PPP/R1BQKB1R w KQkq - 3 5,Bb5,88,-41,-129,0
r1bqk2r/pppp1ppp/2n2n2/1Bb1p3/4P3/P1N2N2/1PPP1PPP/R1BQK2R b KQkq - 4 5,d6,-29,16,45,1
r1bqk2r/ppp2ppp/2np1n2/1Bb1p3/4P3/P1N2N2/1PPP1PPP/R1BQK2R w KQkq - 0 6,Bxc6+,-1,-16,-15,1
r1bqk2r/ppp2ppp/2Bp1n2/2b1p3/4P3/P1N2N2/1PPP1PPP/R1BQK2R b KQkq - 0 6,bxc6,-16,-10,6,1
r1bqk2r/p1p2ppp/2pp1n2/2b1p3/4P3/P1N2N2/1PPP1PPP/R1BQK2R w KQkq - 0 7,b4,-12,-41,-29,1
r1bqk2r/p1p2ppp/2pp1n2/2b1p3/1P2P3/P1N2N2/2PP1PPP/R1BQK2R b KQkq - 0 7,Bd4,-33,11,44,1
r1bqk2r/p1p2ppp/2pp1n2/4p3/1P1bP3/P1N2N2/2PP1PPP/R1BQK2R w KQkq - 1 8,Nxd4,4,-6,-10,1
r1bqk2r/p1p2ppp/2pp1n2/4p3/1P1NP3/P1N5/2PP1PPP/R1BQK2R b KQkq - 0 8,exd4,-2,2,4,1
r1bqk2r/p1p2ppp/2pp1n2/8/1P1pP3/P1N5/2PP1PPP/R1BQK2R w KQkq - 0 9,Na4,4,-102,-106,0
r1bqk2r/p1p2ppp/2pp1n2/8/NP1pP3/P7/2PP1PPP/R1BQK2R b KQkq - 1 9,Rb8,-119,2,121,1
1rbqk2r/p1p2ppp/2pp1n2/8/NP1pP3/P7/2PP1PPP/R1BQK2R w KQk - 2 10,O-O,21,-6,-27,1
1rbqk2r/p1p2ppp/2pp1n2/8/NP1pP3/P7/2PP1PPP/R1BQ1RK1 b k - 3 10,c5,7,19,12,1
1rbqk2r/p1p2ppp/3p1n2/2p5/NP1pP3/P7/2PP1PPP/R1BQ1RK1 w k - 0 11,bxc5,21,-7,-28,1
1rbqk2r/p1p2ppp/3p1n2/2P5/N2pP3/P7/2PP1PPP/R1BQ1RK1 b k - 0 11,dxc5,-21,94,115,1
1rbqk2r/p1p2ppp/5n2/2p5/N2pP3/P7/2PP1PPP/R1BQ1RK1 w k - 0 12,Nxc5,66,94,28,1
1rbqk2r/p1p2ppp/5n2/2N5/3pP3/P7/2PP1PPP/R1BQ1RK1 b k - 0 12,Rb5,58,155,97,1
2bqk2r/p1p2ppp/5n2/1rN5/3pP3/P7/2PP1PPP/R1BQ1RK1 w k - 1 13,Nb3,165,185,20,1
2bqk2r/p1p2ppp/5n2/1r6/3pP3/PN6/2PP1PPP/R1BQ1RK1 b k - 2 13,Bb7,135,244,109,1
3qk2r/pbp2ppp/5n2/1r6/3pP3/PN6/2PP1PPP/R1BQ1RK1 w k - 3 14,d3,262,261,-1,1
3qk2r/pbp2ppp/5n2/1r6/3pP3/PN1P4/2P2PPP/R1BQ1RK1 b k - 0 14,Qd6,258,292,34,1
4k2r/pbp2ppp/3q1n2/1r6/3pP3/PN1P4/2P2PPP/R1BQ1RK1 w k - 1 15,Re1,316,292,-24,1
4k2r/pbp2ppp/3q1n2/1r6/3pP3/PN1P4/2P2PPP/R1BQR1K1 b k - 2 15,Rh5,285,302,17,1
4k2r/pbp2ppp/3q1n2/7r/3pP3/PN1P4/2P2PPP/R1BQR1K1 w k - 3 16,h3,309,307,-2,1
4k2r/pbp2ppp/3q1n2/7r/3pP3/PN1P3P/2P2PP1/R1BQR1K1 b k - 0 16,Rg8,268,360,92,1
4k1r1/pbp2ppp/3q1n2/7r/3pP3/PN1P3P/2P2PP1/R1BQR1K1 w - - 1 17,Qf3,312,317,5,1
4k1r1/pbp2ppp/3q1n2/7r/3pP3/PN1P1Q1P/2P2PP1/R1B1R1K1 b - - 2 17,g5,328,332,4,1
4k1r1/pbp2p1p/3q1n2/6pr/3pP3/PN1P1Q1P/2P2PP1/R1B1R1K1 w - - 0 18,Qg3,308,357,49,1
4k1r1/pbp2p1p/3q1n2/6pr/3pP3/PN1P2QP/2P2PP1/R1B1R1K1 b - - 1 18,Qc6,339,502,163,1
4k1r1/pbp2p1p/2q2n2/6pr/3pP3/PN1P2QP/2P2PP1/R1B1R1K1 w - - 2 19,c4,513,348,-165,0
4k1r1/pbp2p1p/2q2n2/6pr/2PpP3/PN1P2QP/5PP1/R1B1R1K1 b - c3 0 19,dxc3,327,341,14,1
4k1r1/pbp2p1p/2q2n2/6pr/4P3/PNpP2QP/5PP1/R1B1R1K1 w - - 0 20,Na5,304,311,7,1
4k1r1/pbp2p1p/2q2n2/N5pr/4P3/P1pP2QP/5PP1/R1B1R1K1 b - - 1 20,Qb6,295,298,3,1
4k1r1/pbp2p1p/1q3n2/N5pr/4P3/P1pP2QP/5PP1/R1B1R1K1 w - - 2 21,Nxb7,305,366,61,1
4k1r1/pNp2p1p/1q3n2/6pr/4P3/P1pP2QP/5PP1/R1B1R1K1 b - - 0 21,Qxb7,347,493,146,1
4k1r1/pqp2p1p/5n2/6pr/4P3/P1pP2QP/5PP1/R1B1R1K1 w - - 0 22,e5,523,219,-304,0
4k1r1/pqp2p1p/5n2/4P1pr/8/P1pP2QP/5PP1/R1B1R1K1 b - - 0 22,Nd5,233,246,13,1
4k1r1/pqp2p1p/8/3nP1pr/8/P1pP2QP/5PP1/R1B1R1K1 w - - 1 23,e6,299,274,-25,1
4k1r1/pqp2p1p/4P3/3n2pr/8/P1pP2QP/5PP1/R1B1R1K1 b - - 0 23,Ne7,250,498,248,1
4k1r1/pqp1np1p/4P3/6pr/8/P1pP2QP/5PP1/R1B1R1K1 w - - 1 24,exf7+,487,518,31,1
4k1r1/pqp1nP1p/8/6pr/8/P1pP2QP/5PP1/R1B1R1K1 b - - 0 24,Kxf7,467,479,12,1
6r1/pqp1nk1p/8/6pr/8/P1pP2QP/5PP1/R1B1R1K1 w - - 0 25,Be3,500,290,-210,0
6r1/pqp1nk1p/8/6pr/8/P1pPB1QP/5PP1/R3R1K1 b - - 1 25,g4,284,296,12,1
6r1/pqp1nk1p/8/7r/6p1/P1pPB1QP/5PP1/R3R1K1 w - - 0 26,Qf4+,326,97,-229,0
6r1/pqp1nk1p/8/7r/5Qp1/P1pPB2P/5PP1/R3R1K1 b - - 1 26,Rf5,57,62,5,1
6r1/pqp1nk1p/8/5r2/5Qp1/P1pPB2P/5PP1/R3R1K1 w - - 2 27,Qc4+,64,-19,-83,1
6r1/pqp1nk1p/8/5r2/2Q3p1/P1pPB2P/5PP1/R3R1K1 b - - 3 27,Qd5,-47,-13,34,1
6r1/p1p1nk1p/8/3q1r2/2Q3p1/P1pPB2P/5PP1/R3R1K1 w - - 4 28,Qxd5+,-11,-60,-49,1
6r1/p1p1nk1p/8/3Q1r2/6p1/P1pPB2P/5PP1/R3R1K1 b - - 0 28,Nxd5,-50,-38,12,1
6r1/p1p2k1p/8/3n1r2/6p1/P1pPB2P/5PP1/R3R1K1 w - - 0 29,hxg4,-23,-50,-27,1
6r1/p1p2k1p/8/3n1r2/6P1/P1pPB3/5PP1/R3R1K1 b - - 0 29,Rxg4,-50,-41,9,1
8/p1p2k1p/8/3n1r2/6r1/P1pPB3/5PP1/R3R1K1 w - - 0 30,g3,-35,-69,-34,1
8/p1p2k1p/8/3n1r2/6r1/P1pPB1P1/5P2/R3R1K1 b - - 0 30,Nxe3,-71,-5,66,1
8/p1p2k1p/8/5r2/6r1/P1pPn1P1/5P2/R3R1K1 w - - 0 31,Rxe3,20,6,-14,1
8/p1p2k1p/8/5r2/6r1/P1pPR1P1/5P2/R5K1 b - - 0 31,h5,5,8,3,1
8/p1p2k2/8/5r1p/6r1/P1pPR1P1/5P2/R5K1 w - - 0 32,Rc1,29,7,-22,1
8/p1p2k2/8/5r1p/6r1/P1pPR1P1/5P2/2R3K1 b - - 1 32,Rc5,51,7,-44,1
8/p1p2k2/8/2r4p/6r1/P1pPR1P1/5P2/2R3K1 w - - 2 33,Rf3+,6,-47,-53,1
8/p1p2k2/8/2r4p/6r1/P1pP1RP1/5P2/2R3K1 b - - 3 33,Kg6,0,2,2,1
8/p1p5/6k1/2r4p/6r1/P1pP1RP1/5P2/2R3K1 w - - 4 34,Kg2,5,-32,-37,1
8/p1p5/6k1/2r4p/6r1/P1pP1RP1/5PK1/2R5 b - - 5 34,c2,-33,6,39,1
8/p1p5/6k1/2r4p/6r1/P2P1RP1/2p2PK1/2R5 w - - 0 35,Re3,0,13,13,1
8/p1p5/6k1/2r4p/6r1/P2PR1P1/2p2PK1/2R5 b - - 1 35,a5,-4,31,35,1
8/2p5/6k1/p1r4p/6r1/P2PR1P1/2p2PK1/2R5 w - - 0 36,Re6+,14,23,9,1
8/2p5/4R1k1/p1r4p/6r1/P2P2P1/2p2PK1/2R5 b - - 1 36,Kf5,10,20,10,1
8/2p5/4R3/p1r2k1p/6r1/P2P2P1/2p2PK1/2R5 w - - 2 37,Ra6,15,-392,-407,0
8/2p5/R7/p1r2k1p/6r1/P2P2P1/2p2PK1/2R5 b - - 3 37,h4,-379,-16,363,1
8/2p5/R7/p1r2k2/6rp/P2P2P1/2p2PK1/2R5 w - - 0 38,Rh6,-6,0,6,1
8/2p5/7R/p1r2k2/6rp/P2P2P1/2p2PK1/2R5 b - - 1 38,hxg3,-1,-3,-2,1
8/2p5/7R/p1r2k2/6r1/P2P2p1/2p2PK1/2R5 w - - 0 39,fxg3,2,-30,-32,1
8/2p5/7R/p1r2k2/6r1/P2P2P1/2p3K1/2R5 b - - 0 39,Rc3,-24,-17,7,1
8/2p5/7R/p4k2/6r1/P1rP2P1/2p3K1/2R5 w - - 1 40,Kh3,-14,-400,-386,0
8/2p5/7R/p4k2/6r1/P1rP2PK/2p5/2R5 b - - 2 40,Rd4,-395,-346,49,1
8/2p5/7R/p4k2/3r4/P1rP2PK/2p5/2R5 w - - 3 41,Rh5+,-382,-404,-22,1
8/2p5/8/p4k1R/3r4/P1rP2PK/2p5/2R5 b - - 4 41,Kg6,-384,-173,211,1
8/2p5/6k1/p6R/3r4/P1rP2PK/2p5/2R5 w - - 5 42,Rxa5,-190,-408,-218,0
8/2p5/6k1/R7/3r4/P1rP2PK/2p5/2R5 b - - 0 42,Rdxd3,-447,-434,13,1
8/2p5/6k1/R7/8/P1rr2PK/2p5/2R5 w - - 0 43,Ra6+,-408,-478,-70,1
8/2p5/R5k1/8/8/P1rr2PK/2p5/2R5 b - - 1 43,Kf5,-430,-464,-34,1
8/2p5/R7/5k2/8/P1rr2PK/2p5/2R5 w - - 2 44,Ra5+,-445,-476,-31,1
8/2p5/8/R4k2/8/P1rr2PK/2p5/2R5 b - - 3 44,Ke6,-449,-425,24,1
8/2p5/4k3/R7/8/P1rr2PK/2p5/2R5 w - - 4 45,Rg5,-443,-441,2,1
8/2p5/4k3/6R1/8/P1rr2PK/2p5/2R5 b - - 5 45,Rxa3,-463,0,463,1
8/2p5/4k3/6R1/8/r2r2PK/2p5/2R5 w - - 0 46,Re1+,2,-468,-470,0
8/2p5/4k3/6R1/8/r2r2PK/2p5/4R3 b - - 1 46,Kf6,-456,-209,247,1
8/2p5/5k2/6R1/8/r2r2PK/2p5/4R3 w - - 2 47,Rc5,-213,-435,-222,0
8/2p5/5k2/2R5/8/r2r2PK/2p5/4R3 b - - 3 47,Rd1,-445,0,445,1
8/2p5/5k2/2R5/8/r5PK/2p5/3rR3 w - - 4 48,Rc6+,0,0,0,1
8/2p5/2R2k2/8/8/r5PK/2p5/3rR3 b - - 5 48,Kf7,0,0,0,1
8/2p2k2/2R5/8/8/r5PK/2p5/3rR3 w - - 6 49,Rxc7+,0,0,0,1
8/2R2k2/8/8/8/r5PK/2p5/3rR3 b - - 0 49,Kf6,0,0,0,1
8/2R5/5k2/8/8/r5PK/2p5/3rR3 w - - 1 50,Rc6+,0,0,0,1
8/8/2R2k2/8/8/r5PK/2p5/3rR3 b - - 2 50,Kf5,0,0,0,1
8/8/2R5/5k2/8/r5PK/2p5/3rR3 w - - 3 51,Rc5+,0,0,0,1
8/8/8/2R2k2/8/r5PK/2p5/3rR3 b - - 4 51,Kg6,0,0,0,1
8/8/6k1/2R5/8/r5PK/2p5/3rR3 w - - 5 52,Re6+,0,0,0,1
8/8/4R1k1/2R5/8/r5PK/2p5/3r4 b - - 6 52,Kf7,0,0,0,1
8/5k2/4R3/2R5/8/r5PK/2p5/3r4 w - - 7 53,Rec6,0,0,0,1
8/5k2/2R5/2R5/8/r5PK/2p5/3r4 b - - 8 53,c1=Q,0,9,9,1
8/5k2/2R5/2R5/8/r5PK/8/2qr4 w - - 0 54,Rxc1,4,0,-4,1
8/5k2/2R5/8/8/r5PK/8/2Rr4 b - - 0 54,Rxc1,0,12,12,1
8/5k2/2R5/8/8/r5PK/8/2r5 w - - 0 55,Rxc1,4,5,1,1
8/5k2/8/8/8/r5PK/8/2R5 b - - 0 55,Ra6,3,1,-2,1
8/5k2/r7/8/8/6PK/8/2R5 w - - 1 56,Rf1+,4,3,-1,1
8/5k2/r7/8/8/6PK/8/5R2 b - - 2 56,Ke6,0,13,13,1
8/8/r3k3/8/8/6PK/8/5R2 w - - 3 57,Rf4,7,0,-7,1
8/8/r3k3/8/5R2/6PK/8/8 b - - 4 57,Ke5,0,22,22,1
8/8/r7/4k3/5R2/6PK/8/8 w - - 5 58,Kg2,8,0,-8,1
8/8/r7/4k3/5R2/6P1/6K1/8 b - - 6 58,Ra3,0,7,7,1
8/8/8/4k3/5R2/r5P1/6K1/8 w - - 7 59,Rf3,4,0,-4,1
8/8/8/4k3/8/r4RP1/6K1/8 b - - 8 59,Ra4,13,11,-2,1
8/8/8/4k3/r7/5RP1/6K1/8 w - - 9 60,Re3+,10,-3,-13,1
8/8/8/4k3/r7/4R1P1/6K1/8 b - - 10 60,Kd4,-1,2,3,1
8/8/8/8/r2k4/4R1P1/6K1/8 w - - 11 61,Rf3,0,0,0,1
8/8/8/8/r2k4/5RP1/6K1/8 b - - 12 61,Ke4,0,564,564,1
8/8/8/8/r3k3/5RP1/6K1/8 w - - 13 62,g4,555,0,-555,0
8/8/8/8/r3k1P1/5R2/6K1/8 b - - 0 62,Ra5,0,258,258,1
8/8/8/r7/4k1P1/5R2/6K1/8 w - - 1 63,Kg3,350,314,-36,1
8/8/8/r7/4k1P1/5RK1/8/8 b - - 2 63,Rg5,391,448,57,1
8/8/8/6r1/4k1P1/5RK1/8/8 w - - 3 64,Rf4+,418,449,31,1
8/8/8/6r1/4kRP1/6K1/8/8 b - - 4 64,Ke5,448,451,3,1
8/8/8/4k1r1/5RP1/6K1/8/8 w - - 5 65,Rf3,436,17,-419,0
8/8/8/4k1r1/6P1/5RK1/8/8 b - - 6 65,Ke4,14,397,383,1
8/8/8/6r1/4k1P1/5RK1/8/8 w - - 7 66,Rf4+,438,450,12,1
8/8/8/6r1/4kRP1/6K1/8/8 b - - 8 66,Ke5,435,435,0,1
8/8/8/4k1r1/5RP1/6K1/8/8 w - - 9 67,Rb4,445,10,-435,0
8/8/8/4k1r1/1R4P1/6K1/8/8 b - - 10 67,Kd5,-14,632,646,1
8/8/8/3k2r1/1R4P1/6K1/8/8 w - - 11 68,Kh4,633,466,-167,0
8/8/8/3k2r1/1R4PK/8/8/8 b - - 12 68,Re5,450,661,211,1
8/8/8/3kr3/1R4PK/8/8/8 w - - 13 69,Rb5+,657,675,18,1
8/8/8/1R1kr3/6PK/8/8/8 b - - 14 69,Kd4,583,568,-15,1
8/8/8/1R2r3/3k2PK/8/8/8 w - - 15 70,Rxe5,527,549,22,1
8/8/8/4R3/3k2PK/8/8/8 b - - 0 70,Kxe5,530,530,0,1
8/8/8/4k3/6PK/8/8/8 w - - 0 71,g5,530,527,-3,1
8/8/8/4k1P1/7K/8/8/8 b - - 0 71,Kf5,536,531,-5,1
8/8/8/5kP1/7K/8/8/8 w - - 1 72,Kh5,603,526,-77,1
8/8/8/5kPK/8/8/8/8 b - - 2 72,Ke6,595,523,-72,1
8/8/4k3/6PK/8/8/8/8 w - - 3 73,g6,519,519,0,1
8/8/4k1P1/7K/8/8/8/8 b - - 0 73,Kf6,521,533,12,1
8/8/5kP1/7K/8/8/8/8 w - - 1 74,Kh6,530,509,-21,1
8/8/5kPK/8/8/8/8/8 b - - 2 74,Ke7,524,537,13,1
8/4k3/6PK/8/8/8/8/8 w - - 3 75,g7,536,525,-11,1
8/4k1P1/7K/8/8/8/8/8 b - - 0 75,Kf7,532,537,5,1
8/5kP1/7K/8/8/8/8/8 w - - 1 76,Kh7,523,521,-2,1
rnbqkbnr/pppppppp/8/8/8/8/PPPPPPPP/RNBQKBNR w KQkq - 0 1,f4,34,-32,-66,1
rnbqkbnr/pppppppp/8/8/5P2/8/PPPPP1PP/RNBQKBNR b KQkq - 0 1,e6,-27,-4,23,1
rnbqkbnr/pppp1ppp/4p3/8/5P2/8/PPPPP1PP/RNBQKBNR w KQkq - 0 2,Nf3,-22,-26,-4,1
rnbqkbnr/pppp1ppp/4p3/8/5P2/5N2/PPPPP1PP/RNBQKB1R b KQkq - 1 2,d6,-30,34,64,1
rnbqkbnr/ppp2ppp/3pp3/8/5P2/5N2/PPPPP1PP/RNBQKB1R w KQkq - 0 3,e3,35,-2,-37,1
rnbqkbnr/ppp2ppp/3pp3/8/5P2/4PN2/PPPP2PP/RNBQKB1R b KQkq - 0 3,Ne7,-8,38,46,1
rnbqkb1r/ppp1nppp/3pp3/8/5P2/4PN2/PPPP2PP/RNBQKB1R w KQkq - 1 4,d3,44,-5,-49,1
rnbqkb1r/ppp1nppp/3pp3/8/5P2/3PPN2/PPP3PP/RNBQKB1R b KQkq - 0 4,h5,7,35,28,1
rnbqkb1r/ppp1npp1/3pp3/7p/5P2/3PPN2/PPP3PP/RNBQKB1R w KQkq - 0 5,Be2,47,36,-11,1
rnbqkb1r/ppp1npp1/3pp3/7p/5P2/3PPN2/PPP1B1PP/RNBQK2R b KQkq - 1 5,Nbc6,41,61,20,1
r1bqkb1r/ppp1npp1/2npp3/7p/5P2/3PPN2/PPP1B1PP/RNBQK2R w KQkq - 2 6,O-O,66,51,-15,1
r1bqkb1r/ppp1npp1/2npp3/7p/5P2/3PPN2/PPP1B1PP/RNBQ1RK1 b kq - 3 6,Bd7,71,108,37,1
r2qkb1r/pppbnpp1/2npp3/7p/5P2/3PPN2/PPP1B1PP/RNBQ1RK1 w kq - 4 7,c3,104,100,-4,1
r2qkb1r/pppbnpp1/2npp3/7p/5P2/2PPPN2/PP2B1PP/RNBQ1RK1 b kq - 0 7,Nf5,111,125,14,1
r2qkb1r/pppb1pp1/2npp3/5n1p/5P2/2PPPN2/PP2B1PP/RNBQ1RK1 w kq - 1 8,Qc2,130,115,-15,1
r2qkb1r/pppb1pp1/2npp3/5n1p/5P2/2PPPN2/PPQ1B1PP/RNB2RK1 b kq - 2 8,g6,105,95,-10,1
r2qkb1r/pppb1p2/2npp1p1/5n1p/5P2/2PPPN2/PPQ1B1PP/RNB2RK1 w kq - 0 9,e4,105,111,6,1
r2qkb1r/pppb1p2/2npp1p1/5n1p/4PP2/2PP1N2/PPQ1B1PP/RNB2RK1 b kq - 0 9,Ng7,123,156,33,1
r2qkb1r/pppb1pn1/2npp1p1/7p/4PP2/2PP1N2/PPQ1B1PP/RNB2RK1 w kq - 1 10,Nbd2,148,119,-29,1
r2qkb1r/pppb1pn1/2npp1p1/7p/4PP2/2PP1N2/PPQNB1PP/R1B2RK1 b kq - 2 10,Be7,124,168,44,1
r2qk2r/pppbbpn1/2npp1p1/7p/4PP2/2PP1N2/PPQNB1PP/R1B2RK1 w kq - 3 11,Nc4,163,135,-28,1
r2qk2r/pppbbpn1/2npp1p1/7p/2N1PP2/2PP1N2/PPQ1B1PP/R1B2RK1 b kq - 4 11,O-O,140,133,-7,1
r2q1rk1/pppbbpn1/2npp1p1/7p/2N1PP2/2PP1N2/PPQ1B1PP/R1B2RK1 w - - 5 12,Ne3,125,141,16,1
r2q1rk1/pppbbpn1/2npp1p1/7p/4PP2/2PPNN2/PPQ1B1PP/R1B2RK1 b - - 6 12,a6,141,193,52,1
r2q1rk1/1ppbbpn1/p1npp1p1/7p/4PP2/2PPNN2/PPQ1B1PP/R1B2RK1 w - - 0 13,f5,183,59,-124,0
r2q1rk1/1ppbbpn1/p1npp1p1/5P1p/4P3/2PPNN2/PPQ1B1PP/R1B2RK1 b - - 0 13,exf5,50,54,4,1
r2q1rk1/1ppbbpn1/p1np2p1/5p1p/4P3/2PPNN2/PPQ1B1PP/R1B2RK1 w - - 0 14,exf5,48,-24,-72,1
r2q1rk1/1ppbbpn1/p1np2p1/5P1p/8/2PPNN2/PPQ1B1PP/R1B2RK1 b - - 0 14,Nxf5,-12,24,36,1
r2q1rk1/1ppbbp2/p1np2p1/5n1p/8/2PPNN2/PPQ1B1PP/R1B2RK1 w - - 0 15,Nxf5,43,-39,-82,1
r2q1rk1/1ppbbp2/p1np2p1/5N1p/8/2PP1N2/PPQ1B1PP/R1B2RK1 b - - 0 15,Bxf5,-16,-27,-11,1
r2q1rk1/1pp1bp2/p1np2p1/5b1p/8/2PP1N2/PPQ1B1PP/R1B2RK1 w - - 0 16,Qd2,-33,-121,-88,1
r2q1rk1/1pp1bp2/p1np2p1/5b1p/8/2PP1N2/PP1QB1PP/R1B2RK1 b - - 1 16,Ne5,-112,-6,106,1
r2q1rk1/1pp1bp2/p2p2p1/4nb1p/8/2PP1N2/PP1QB1PP/R1B2RK1 w - - 2 17,Qf4,12,-257,-269,0
r2q1rk1/1pp1bp2/p2p2p1/4nb1p/5Q2/2PP1N2/PP2B1PP/R1B2RK1 b - - 3 17,Ng4,-309,-39,270,1
r2q1rk1/1pp1bp2/p2p2p1/5b1p/5Qn1/2PP1N2/PP2B1PP/R1B2RK1 w - - 4 18,Nd4,-62,-70,-8,1
r2q1rk1/1pp1bp2/p2p2p1/5b1p/3N1Qn1/2PP4/PP2B1PP/R1B2RK1 b - - 5 18,Be6,-78,79,157,1
r2q1rk1/1pp1bp2/p2pb1p1/7p/3N1Qn1/2PP4/PP2B1PP/R1B2RK1 w - - 6 19,Bxg4,61,-61,-122,0
r2q1rk1/1pp1bp2/p2pb1p1/7p/3N1QB1/2PP4/PP4PP/R1B2RK1 b - - 0 19,Bxg4,-50,-38,12,1
r2q1rk1/1pp1bp2/p2p2p1/7p/3N1Qb1/2PP4/PP4PP/R1B2RK1 w - - 0 20,Qh6,-48,-165,-117,0
r2q1rk1/1pp1bp2/p2p2pQ/7p/3N2b1/2PP4/PP4PP/R1B2RK1 b - - 1 20,Bf6,-139,-118,21,1
r2q1rk1/1pp2p2/p2p1bpQ/7p/3N2b1/2PP4/PP4PP/R1B2RK1 w - - 2 21,Nf3,-132,-225,-93,1
r2q1rk1/1pp2p2/p2p1bpQ/7p/6b1/2PP1N2/PP4PP/R1B2RK1 b - - 3 21,Bg7,-234,-230,4,1
r2q1rk1/1pp2pb1/p2p2pQ/7p/6b1/2PP1N2/PP4PP/R1B2RK1 w - - 4 22,Qd2,-224,-232,-8,1
r2q1rk1/1pp2pb1/p2p2p1/7p/6b1/2PP1N2/PP1Q2PP/R1B2RK1 b - - 5 22,Bh6,-221,531,752,1
r2q1rk1/1pp2p2/p2p2pb/7p/6b1/2PP1N2/PP1Q2PP/R1B2RK1 w - - 6 23,Qe1,555,-200,-755,0
r2q1rk1/1pp2p2/p2p2pb/7p/6b1/2PP1N2/PP4PP/R1B1QRK1 b - - 7 23,Bg7,-188,-187,1,1
r2q1rk1/1pp2pb1/p2p2p1/7p/6b1/2PP1N2/PP4PP/R1B1QRK1 w - - 8 24,Qd1,-201,-205,-4,1
r2q1rk1/1pp2pb1/p2p2p1/7p/6b1/2PP1N2/PP4PP/R1BQ1RK1 b - - 9 24,Qe7,-207,-153,54,1
r4rk1/1pp1qpb1/p2p2p1/7p/6b1/2PP1N2/PP4PP/R1BQ1RK1 w - - 10 25,Bg5,-174,-253,-79,1
r4rk1/1pp1qpb1/p2p2p1/6Bp/6b1/2PP1N2/PP4PP/R2Q1RK1 b - - 11 25,f6,-259,-167,92,1
r4rk1/1pp1q1b1/p2p1pp1/6Bp/6b1/2PP1N2/PP4PP/R2Q1RK1 w - - 0 26,Bh4,-143,-165,-22,1
r4rk1/1pp1q1b1/p2p1pp1/7p/6bB/2PP1N2/PP4PP/R2Q1RK1 b - - 1 26,g5,-149,-152,-3,1
r4rk1/1pp1q1b1/p2p1p2/6pp/6bB/2PP1N2/PP4PP/R2Q1RK1 w - - 0 27,Bg3,-167,-246,-79,1
r4rk1/1pp1q1b1/p2p1p2/6pp/6b1/2PP1NB1/PP4PP/R2Q1RK1 b - - 1 27,Qd7,-259,-120,139,1
r4rk1/1ppq2b1/p2p1p2/6pp/6b1/2PP1NB1/PP4PP/R2Q1RK1 w - - 2 28,Qd2,-127,-295,-168,0
r4rk1/1ppq2b1/p2p1p2/6pp/6b1/2PP1NB1/PP1Q2PP/R4RK1 b - - 3 28,Rae8,-291,-211,80,1
4rrk1/1ppq2b1/p2p1p2/6pp/6b1/2PP1NB1/PP1Q2PP/R4RK1 w - - 4 29,Be1,-195,-266,-71,1
4rrk1/1ppq2b1/p2p1p2/6pp/6b1/2PP1N2/PP1Q2PP/R3BRK1 b - - 5 29,h4,-265,-233,32,1
4rrk1/1ppq2b1/p2p1p2/6p1/6bp/2PP1N2/PP1Q2PP/R3BRK1 w - - 0 30,Nd4,-223,-364,-141,0
4rrk1/1ppq2b1/p2p1p2/6p1/3N2bp/2PP4/PP1Q2PP/R3BRK1 b - - 1 30,h3,-355,-302,53,1
4rrk1/1ppq2b1/p2p1p2/6p1/3N2b1/2PP3p/PP1Q2PP/R3BRK1 w - - 0 31,g3,-329,-468,-139,0
4rrk1/1ppq2b1/p2p1p2/6p1/3N2b1/2PP2Pp/PP1Q3P/R3BRK1 b - - 0 31,c5,-485,-450,35,1
4rrk1/1p1q2b1/p2p1p2/2p3p1/3N2b1/2PP2Pp/PP1Q3P/R3BRK1 w - - 0 32,Nf3,-468,-485,-17,1
4rrk1/1p1q2b1/p2p1p2/2p3p1/6b1/2PP1NPp/PP1Q3P/R3BRK1 b - - 1 32,Qc6,-437,-409,28,1
4rrk1/1p4b1/p1qp1p2/2p3p1/6b1/2PP1NPp/PP1Q3P/R3BRK1 w - - 2 33,Qf2,-440,-423,17,1
4rrk1/1p4b1/p1qp1p2/2p3p1/6b1/2PP1NPp/PP3Q1P/R3BRK1 b - - 3 33,f5,-446,-361,85,1
4rrk1/1p4b1/p1qp4/2p2pp1/6b1/2PP1NPp/PP3Q1P/R3BRK1 w - - 0 34,Nxg5,-364,-573,-209,0
4rrk1/1p4b1/p1qp4/2p2pN1/6b1/2PP2Pp/PP3Q1P/R3BRK1 b - - 0 34,Bh6,-527,-502,25,1
4rrk1/1p6/p1qp3b/2p2pN1/6b1/2PP2Pp/PP3Q1P/R3BRK1 w - - 1 35,Bd2,-500,-551,-51,1
4rrk1/1p6/p1qp3b/2p2pN1/6b1/2PP2Pp/PP1B1Q1P/R4RK1 b - - 2 35,Re2,-589,-580,9,1
5rk1/1p6/p1qp3b/2p2pN1/6b1/2PP2Pp/PP1BrQ1P/R4RK1 w - - 3 36,Qf4,-554,-9999,-9445,0
5rk1/1p6/p1qp3b/2p2pN1/5Qb1/2PP2Pp/PP1Br2P/R4RK1 b - - 4 36,Qg2#,-9999,-10000,-1,1
rnbqkbnr/pppppppp/8/8/8/8/PPPPPPPP/RNBQKBNR w KQkq - 0 1,d4,38,16,-22,1
rnbqkbnr/pppppppp/8/8/3P4/8/PPP1PPPP/RNBQKBNR b KQkq - 0 1,d5,13,18,5,1
rnbqkbnr/ppp1pppp/8/3p4/3P4/8/PPP1PPPP/RNBQKBNR w KQkq - 0 2,Bg5,13,-20,-33,1
rnbqkbnr/ppp1pppp/8/3p2B1/3P4/8/PPP1PPPP/RN1QKBNR b KQkq - 1 2,h6,-28,-10,18,1
rnbqkbnr/ppp1ppp1/7p/3p2B1/3P4/8/PPP1PPPP/RN1QKBNR w KQkq - 0 3,Bh4,-15,-15,0,1
rnbqkbnr/ppp1ppp1/7p/3p4/3P3B/8/PPP1PPPP/RN1QKBNR b KQkq - 1 3,g5,-16,17,33,1
rnbqkbnr/ppp1pp2/7p/3p2p1/3P3B/8/PPP1PPPP/RN1QKBNR w KQkq - 0 4,Bg3,22,16,-6,1
rnbqkbnr/ppp1pp2/7p/3p2p1/3P4/6B1/PPP1PPPP/RN1QKBNR b KQkq - 1 4,Nc6,11,54,43,1
r1bqkbnr/ppp1pp2/2n4p/3p2p1/3P4/6B1/PPP1PPPP/RN1QKBNR w KQkq - 2 5,e3,64,50,-14,1
r1bqkbnr/ppp1pp2/2n4p/3p2p1/3P4/4P1B1/PPP2PPP/RN1QKBNR b KQkq - 0 5,Bg7,48,68,20,1
r1bqk1nr/ppp1ppb1/2n4p/3p2p1/3P4/4P1B1/PPP2PPP/RN1QKBNR w KQkq - 1 6,Nc3,63,62,-1,1
r1bqk1nr/ppp1ppb1/2n4p/3p2p1/3P4/2N1P1B1/PPP2PPP/R2QKBNR b KQkq - 2 6,Nf6,57,72,15,1
r1bqk2r/ppp1ppb1/2n2n1p/3p2p1/3P4/2N1P1B1/PPP2PPP/R2QKBNR w KQkq - 3 7,Nb5,83,-34,-117,0
r1bqk2r/ppp1ppb1/2n2n1p/1N1p2p1/3P4/4P1B1/PPP2PPP/R2QKBNR b KQkq - 4 7,O-O,77,99,22,1
r1bq1rk1/ppp1ppb1/2n2n1p/1N1p2p1/3P4/4P1B1/PPP2PPP/R2QKBNR w KQ - 5 8,Nxc7,81,103,22,1
r1bq1rk1/ppN1ppb1/2n2n1p/3p2p1/3P4/4P1B1/PPP2PPP/R2QKBNR b KQ - 0 8,Rb8,92,90,-2,1
1rbq1rk1/ppN1ppb1/2n2n1p/3p2p1/3P4/4P1B1/PPP2PPP/R2QKBNR w KQ - 1 9,Nxd5,84,-142,-226,0
1rbq1rk1/pp2ppb1/2n2n1p/3N2p1/3P4/4P1B1/PPP2PPP/R2QKBNR b KQ - 0 9,Qxd5,-144,-143,1,1
1rb2rk1/pp2ppb1/2n2n1p/3q2p1/3P4/4P1B1/PPP2PPP/R2QKBNR w KQ - 0 10,Bxb8,-153,-161,-8,1
1Bb2rk1/pp2ppb1/2n2n1p/3q2p1/3P4/4P3/PPP2PPP/R2QKBNR b KQ - 0 10,Nxb8,-149,-147,2,1
1nb2rk1/pp2ppb1/5n1p/3q2p1/3P4/4P3/PPP2PPP/R2QKBNR w KQ - 0 11,Nf3,-147,-192,-45,1
1nb2rk1/pp2ppb1/5n1p/3q2p1/3P4/4PN2/PPP2PPP/R2QKB1R b KQ - 1 11,Bg4,-192,-35,157,1
1n3rk1/pp2ppb1/5n1p/3q2p1/3P2b1/4PN2/PPP2PPP/R2QKB1R w KQ - 2 12,Be2,-50,-54,-4,1
1n3rk1/pp2ppb1/5n1p/3q2p1/3P2b1/4PN2/PPP1BPPP/R2QK2R b KQ - 3 12,Qa5+,-53,-46,7,1
1n3rk1/pp2ppb1/5n1p/q5p1/3P2b1/4PN2/PPP1BPPP/R2QK2R w KQ - 4 13,c3,-37,-34,3,1
1n3rk1/pp2ppb1/5n1p/q5p1/3P2b1/2P1PN2/PP2BPPP/R2QK2R b KQ - 0 13,Qb6,-40,-2,38,1
1n3rk1/pp2ppb1/1q3n1p/6p1/3P2b1/2P1PN2/PP2BPPP/R2QK2R w KQ - 1 14,O-O,-20,-27,-7,1
1n3rk1/pp2ppb1/1q3n1p/6p1/3P2b1/2P1PN2/PP2BPPP/R2Q1RK1 b - - 2 14,Be6,-44,4,48,1
1n3rk1/pp2ppb1/1q2bn1p/6p1/3P4/2P1PN2/PP2BPPP/R2Q1RK1 w - - 3 15,Ne5,28,-83,-111,0
1n3rk1/pp2ppb1/1q2bn1p/4N1p1/3P4/2P1P3/PP2BPPP/R2Q1RK1 b - - 4 15,Qxb2,-67,-84,-17,1
1n3rk1/pp2ppb1/4bn1p/4N1p1/3P4/2P1P3/Pq2BPPP/R2Q1RK1 w - - 0 16,c4,-51,-134,-83,1
1n3rk1/pp2ppb1/4bn1p/4N1p1/2PP4/4P3/Pq2BPPP/R2Q1RK1 b - - 0 16,b6,-121,-86,35,1
1n3rk1/p3ppb1/1p2bn1p/4N1p1/2PP4/4P3/Pq2BPPP/R2Q1RK1 w - - 0 17,Bf3,-69,-124,-55,1
1n3rk1/p3ppb1/1p2bn1p/4N1p1/2PP4/4PB2/Pq3PPP/R2Q1RK1 b - - 1 17,Qa3,-120,-116,4,1
1n3rk1/p3ppb1/1p2bn1p/4N1p1/2PP4/q3PB2/P4PPP/R2Q1RK1 w - - 2 18,d5,-115,-326,-211,0
1n3rk1/p3ppb1/1p2bn1p/3PN1p1/2P5/q3PB2/P4PPP/R2Q1RK1 b - - 0 18,Bf5,-282,-296,-14,1
1n3rk1/p3ppb1/1p3n1p/3PNbp1/2P5/q3PB2/P4PPP/R2Q1RK1 w - - 1 19,e4,-316,-392,-76,1
1n3rk1/p3ppb1/1p3n1p/3PNbp1/2P1P3/q4B2/P4PPP/R2Q1RK1 b - - 0 19,Bxe4,-405,-294,111,1
1n3rk1/p3ppb1/1p3n1p/3PN1p1/2P1b3/q4B2/P4PPP/R2Q1RK1 w - - 0 20,Bxe4,-309,-416,-107,0
1n3rk1/p3ppb1/1p3n1p/3PN1p1/2P1B3/q7/P4PPP/R2Q1RK1 b - - 0 20,Nxe4,-437,-389,48,1
1n3rk1/p3ppb1/1p5p/3PN1p1/2P1n3/q7/P4PPP/R2Q1RK1 w - - 0 21,Nc6,-393,-479,-86,1
1n3rk1/p3ppb1/1pN4p/3P2p1/2P1n3/q7/P4PPP/R2Q1RK1 b - - 1 21,Nxc6,-482,-412,70,1
5rk1/p3ppb1/1pn4p/3P2p1/2P1n3/q7/P4PPP/R2Q1RK1 w - - 0 22,dxc6,-429,-444,-15,1
5rk1/p3ppb1/1pP4p/6p1/2P1n3/q7/P4PPP/R2Q1RK1 b - - 0 22,Bxa1,-462,-459,3,1
5rk1/p3pp2/1pP4p/6p1/2P1n3/q7/P4PPP/b2Q1RK1 w - - 0 23,c7,-477,-488,-11,1
5rk1/p1P1pp2/1p5p/6p1/2P1n3/q7/P4PPP/b2Q1RK1 b - - 0 23,Nd6,-500,-419,81,1
5rk1/p1P1pp2/1p1n3p/6p1/2P5/q7/P4PPP/b2Q1RK1 w - - 1 24,Qxa1,-447,-439,8,1
5rk1/p1P1pp2/1p1n3p/6p1/2P5/q7/P4PPP/Q4RK1 b - - 0 24,Qc5,-417,-441,-24,1
5rk1/p1P1pp2/1p1n3p/2q3p1/2P5/8/P4PPP/Q4RK1 w - - 1 25,Re1,-437,-436,1,1
5rk1/p1P1pp2/1p1n3p/2q3p1/2P5/8/P4PPP/Q3R1K1 b - - 2 25,Qxc7,-418,-426,-8,1
5rk1/p1q1pp2/1p1n3p/6p1/2P5/8/P4PPP/Q3R1K1 w - - 0 26,Re3,-421,-464,-43,1
5rk1/p1q1pp2/1p1n3p/6p1/2P5/4R3/P4PPP/Q5K1 b - - 1 26,Nf5,-474,-488,-14,1
5rk1/p1q1pp2/1p5p/5np1/2P5/4R3/P4PPP/Q5K1 w - - 2 27,Rh3,-482,-589,-107,0
5rk1/p1q1pp2/1p5p/5np1/2P5/7R/P4PPP/Q5K1 b - - 3 27,Qxc4,-547,-563,-16,1
5rk1/p3pp2/1p5p/5np1/2q5/7R/P4PPP/Q5K1 w - - 0 28,g3,-510,-593,-83,1
5rk1/p3pp2/1p5p/5np1/2q5/6PR/P4P1P/Q5K1 b - - 0 28,Qg4,-620,-678,-58,1
5rk1/p3pp2/1p5p/5np1/6q1/6PR/P4P1P/Q5K1 w - - 1 29,Kg2,-689,-710,-21,1
5rk1/p3pp2/1p5p/5np1/6q1/6PR/P4PKP/Q7 b - - 2 29,h5,-715,-590,125,1
5rk1/p3pp2/1p6/5npp/6q1/6PR/P4PKP/Q7 w - - 0 30,Qe5,-557,-599,-42,1
5rk1/p3pp2/1p6/4Qnpp/6q1/6PR/P4PKP/8 b - - 1 30,f6,-635,-575,60,1
5rk1/p3p3/1p3p2/4Qnpp/6q1/6PR/P4PKP/8 w - - 0 31,Qe6+,-584,-633,-49,1
5rk1/p3p3/1p2Qp2/5npp/6q1/6PR/P4PKP/8 b - - 1 31,Rf7,-586,-562,24,1
6k1/p3pr2/1p2Qp2/5npp/6q1/6PR/P4PKP/8 w - - 2 32,Qc8+,-595,-694,-99,1
2Q3k1/p3pr2/1p3p2/5npp/6q1/6PR/P4PKP/8 b - - 3 32,Kg7,-641,-640,1,1
2Q5/p3prk1/1p3p2/5npp/6q1/6PR/P4PKP/8 w - - 4 33,f3,-629,-941,-312,0
2Q5/p3prk1/1p3p2/5npp/6q1/5PPR/P5KP/8 b - - 0 33,Ne3+,-937,-863,74,1
2Q5/p3prk1/1p3p2/6pp/6q1/4nPPR/P5KP/8 w - - 1 34,Kf2,-931,-892,39,1
2Q5/p3prk1/1p3p2/6pp/6q1/4nPPR/P4K1P/8 b - - 2 34,Nd1+,-959,-976,-17,1
2Q5/p3prk1/1p3p2/6pp/6q1/5PPR/P4K1P/3n4 w - - 3 35,Ke1,-940,-997,-57,1
2Q5/p3prk1/1p3p2/6pp/6q1/5PPR/P6P/3nK3 b - - 4 35,Qxh3,-1013,126,1139,1
2Q5/p3prk1/1p3p2/6pp/8/5PPq/P6P/3nK3 w - - 0 36,Qxh3,96,95,-1,1
8/p3prk1/1p3p2/6pp/8/5PPQ/P6P/3nK3 b - - 0 36,Ne3,87,131,44,1
8/p3prk1/1p3p2/6pp/8/4nPPQ/P6P/4K3 w - - 1 37,Qc8,70,24,-46,1
2Q5/p3prk1/1p3p2/6pp/8/4nPP1/P6P/4K3 b - - 2 37,e5,39,49,10,1
2Q5/p4rk1/1p3p2/4p1pp/8/4nPP1/P6P/4K3 w - - 0 38,Kf2,32,11,-21,1
2Q5/p4rk1/1p3p2/4p1pp/8/4nPP1/P4K1P/8 b - - 1 38,Nd5,26,34,8,1
2Q5/p4rk1/1p3p2/3np1pp/8/5PP1/P4K1P/8 w - - 2 39,Qc4,79,-19,-98,1
8/p4rk1/1p3p2/3np1pp/2Q5/5PP1/P4K1P/8 b - - 3 39,Ne7,-26,-25,1,1
8/p3nrk1/1p3p2/4p1pp/2Q5/5PP1/P4K1P/8 w - - 4 40,Qc7,-26,-16,10,1
8/p1Q1nrk1/1p3p2/4p1pp/8/5PP1/P4K1P/8 b - - 5 40,Ng6,-18,-14,4,1
8/p1Q2rk1/1p3pn1/4p1pp/8/5PP1/P4K1P/8 w - - 6 41,Qc1,-14,-18,-4,1
8/p4rk1/1p3pn1/4p1pp/8/5PP1/P4K1P/2Q5 b - - 7 41,h4,-19,-20,-1,1
8/p4rk1/1p3pn1/4p1p1/7p/5PP1/P4K1P/2Q5 w - - 0 42,g4,-9,-22,-13,1
8/p4rk1/1p3pn1/4p1p1/6Pp/5P2/P4K1P/2Q5 b - - 0 42,Nf4,-27,0,27,1
8/p4rk1/1p3p2/4p1p1/5nPp/5P2/P4K1P/2Q5 w - - 1 43,Qa3,0,-23,-23,1
8/p4rk1/1p3p2/4p1p1/5nPp/Q4P2/P4K1P/8 b - - 2 43,Rd7,-21,-16,5,1
8/p2r2k1/1p3p2/4p1p1/5nPp/Q4P2/P4K1P/8 w - - 3 44,Qa4,-19,-29,-10,1
8/p2r2k1/1p3p2/4p1p1/Q4nPp/5P2/P4K1P/8 b - - 4 44,Rf7,-26,0,26,1
8/p4rk1/1p3p2/4p1p1/Q4nPp/5P2/P4K1P/8 w - - 5 45,Qe8,-2,-6,-4,1
4Q3/p4rk1/1p3p2/4p1p1/5nPp/5P2/P4K1P/8 b - - 6 45,Nd3+,0,0,0,1
4Q3/p4rk1/1p3p2/4p1p1/6Pp/3n1P2/P4K1P/8 w - - 7 46,Ke3,0,0,0,1
4Q3/p4rk1/1p3p2/4p1p1/6Pp/3nKP2/P6P/8 b - - 8 46,Nc5,0,0,0,1
4Q3/p4rk1/1p3p2/2n1p1p1/6Pp/4KP2/P6P/8 w - - 9 47,Kd2,0,0,0,1
4Q3/p4rk1/1p3p2/2n1p1p1/6Pp/5P2/P2K3P/8 b - - 10 47,Rd7+,0,0,0,1
4Q3/p2r2k1/1p3p2/2n1p1p1/6Pp/5P2/P2K3P/8 w - - 11 48,Kc2,0,0,0,1
4Q3/p2r2k1/1p3p2/2n1p1p1/6Pp/5P2/P1K4P/8 b - - 12 48,Rf7,0,0,0,1
4Q3/p4rk1/1p3p2/2n1p1p1/6Pp/5P2/P1K4P/8 w - - 13 49,h3,0,-72,-72,1
4Q3/p4rk1/1p3p2/2n1p1p1/6Pp/5P1P/P1K5/8 b - - 0 49,Na6,-121,-45,76,1
4Q3/p4rk1/np3p2/4p1p1/6Pp/5P1P/P1K5/8 w - - 1 50,Qb5,-48,-122,-74,1
8/p4rk1/np3p2/1Q2p1p1/6Pp/5P1P/P1K5/8 b - - 2 50,Nc5,-120,-118,2,1
8/p4rk1/1p3p2/1Qn1p1p1/6Pp/5P1P/P1K5/8 w - - 3 51,a4,-110,-99,11,1
8/p4rk1/1p3p2/1Qn1p1p1/P5Pp/5P1P/2K5/8 b - - 0 51,Nd7,-103,-125,-22,1
8/p2n1rk1/1p3p2/1Q2p1p1/P5Pp/5P1P/2K5/8 w - - 1 52,Qa6,-105,-123,-18,1
8/p2n1rk1/Qp3p2/4p1p1/P5Pp/5P1P/2K5/8 b - - 2 52,Nf8,-112,-103,9,1
5n2/p4rk1/Qp3p2/4p1p1/P5Pp/5P1P/2K5/8 w - - 3 53,Qc8,-99,-98,1,1
2Q2n2/p4rk1/1p3p2/4p1p1/P5Pp/5P1P/2K5/8 b - - 4 53,Ng6,-109,-105,4,1
2Q5/p4rk1/1p3pn1/4p1p1/P5Pp/5P1P/2K5/8 w - - 5 54,Qb8,-142,-152,-10,1
1Q6/p4rk1/1p3pn1/4p1p1/P5Pp/5P1P/2K5/8 b - - 6 54,Nf4,-116,-127,-11,1
1Q6/p4rk1/1p3p2/4p1p1/P4nPp/5P1P/2K5/8 w - - 7 55,Qe8,-126,-274,-148,0
4Q3/p4rk1/1p3p2/4p1p1/P4nPp/5P1P/2K5/8 b - - 8 55,Nxh3,-366,-366,0,1
4Q3/p4rk1/1p3p2/4p1p1/P5Pp/5P1n/2K5/8 w - - 0 56,Qb5,-356,-424,-68,1
8/p4rk1/1p3p2/1Q2p1p1/P5Pp/5P1n/2K5/8 b - - 1 56,Nf4,-360,-367,-7,1
8/p4rk1/1p3p2/1Q2p1p1/P4nPp/5P2/2K5/8 w - - 2 57,Qf1,-334,-363,-29,1
8/p4rk1/1p3p2/4p1p1/P4nPp/5P2/2K5/5Q2 b - - 3 57,Rc7+,-358,-307,51,1
8/p1r3k1/1p3p2/4p1p1/P4nPp/5P2/2K5/5Q2 w - - 4 58,Kb3,-322,-334,-12,1
8/p1r3k1/1p3p2/4p1p1/P4nPp/1K3P2/8/5Q2 b - - 5 58,Rf7,-322,-294,28,1
8/p4rk1/1p3p2/4p1p1/P4nPp/1K3P2/8/5Q2 w - - 6 59,Kb4,-288,-275,13,1
8/p4rk1/1p3p2/4p1p1/PK3nPp/5P2/8/5Q2 b - - 7 59,Nd5+,-251,-241,10,1
8/p4rk1/1p3p2/3np1p1/PK4Pp/5P2/8/5Q2 w - - 8 60,Kb5,-260,-275,-15,1
8/p4rk1/1p3p2/1K1np1p1/P5Pp/5P2/8/5Q2 b - - 9 60,Nf4,-278,-241,37,1
8/p4rk1/1p3p2/1K2p1p1/P4nPp/5P2/8/5Q2 w - - 10 61,Ka6,-231,-246,-15,1
8/p4rk1/Kp3p2/4p1p1/P4nPp/5P2/8/5Q2 b - - 11 61,h3,-265,-203,62,1
8/p4rk1/Kp3p2/4p1p1/P4nP1/5P1p/8/5Q2 w - - 0 62,Qc1,-205,-209,-4,1
8/p4rk1/Kp3p2/4p1p1/P4nP1/5P1p/8/2Q5 b - - 1 62,Ng6,-257,-202,55,1
8/p4rk1/Kp3pn1/4p1p1/P5P1/5P1p/8/2Q5 w - - 2 63,Kb5,-206,-237,-31,1
8/p4rk1/1p3pn1/1K2p1p1/P5P1/5P1p/8/2Q5 b - - 3 63,Nf4,-223,-207,16,1
8/p4rk1/1p3p2/1K2p1p1/P4nP1/5P1p/8/2Q5 w - - 4 64,Ka6,-215,-213,2,1
8/p4rk1/Kp3p2/4p1p1/P4nP1/5P1p/8/2Q5 b - - 5 64,Nd3,-223,-198,25,1
8/p4rk1/Kp3p2/4p1p1/P5P1/3n1P1p/8/2Q5 w - - 6 65,Qa1,-196,-241,-45,1
rnbqkbnr/pppppppp/8/8/8/8/PPPPPPPP/RNBQKBNR w KQkq - 0 1,e3,34,1,-33,1
rnbqkbnr/pppppppp/8/8/8/4P3/PPPP1PPP/RNBQKBNR b KQkq - 0 1,e5,14,14,0,1
rnbqkbnr/pppp1ppp/8/4p3/8/4P3/PPPP1PPP/RNBQKBNR w KQkq - 0 2,Bc4,10,-66,-76,1
rnbqkbnr/pppp1ppp/8/4p3/2B5/4P3/PPPP1PPP/RNBQK1NR b KQkq - 1 2,Nf6,-82,-43,39,1
rnbqkb1r/pppp1ppp/5n2/4p3/2B5/4P3/PPPP1PPP/RNBQK1NR w KQkq - 2 3,Be2,-37,-68,-31,1
rnbqkb1r/pppp1ppp/5n2/4p3/8/4P3/PPPPBPPP/RNBQK1NR b KQkq - 3 3,Be7,-69,-58,11,1
rnbqk2r/ppppbppp/5n2/4p3/8/4P3/PPPPBPPP/RNBQK1NR w KQkq - 4 4,d3,-61,-64,-3,1
rnbqk2r/ppppbppp/5n2/4p3/8/3PP3/PPP1BPPP/RNBQK1NR b KQkq - 0 4,O-O,-50,-17,33,1
rnbq1rk1/ppppbppp/5n2/4p3/8/3PP3/PPP1BPPP/RNBQK1NR w KQ - 1 5,Nf3,-22,-38,-16,1
rnbq1rk1/ppppbppp/5n2/4p3/8/3PPN2/PPP1BPPP/RNBQK2R b KQ - 2 5,Nc6,-29,-11,18,1
r1bq1rk1/ppppbppp/2n2n2/4p3/8/3PPN2/PPP1BPPP/RNBQK2R w KQ - 3 6,Nc3,-27,-76,-49,1
r1bq1rk1/ppppbppp/2n2n2/4p3/8/2NPPN2/PPP1BPPP/R1BQK2R b KQ - 4 6,d5,-79,-81,-2,1
r1bq1rk1/ppp1bppp/2n2n2/3pp3/8/2NPPN2/PPP1BPPP/R1BQK2R w KQ - 0 7,Bd2,-75,-101,-26,1
r1bq1rk1/ppp1bppp/2n2n2/3pp3/8/2NPPN2/PPPBBPPP/R2QK2R b KQ - 1 7,Bf5,-100,-112,-12,1
r2q1rk1/ppp1bppp/2n2n2/3ppb2/8/2NPPN2/PPPBBPPP/R2QK2R w KQ - 2 8,O-O,-102,-112,-10,1
r2q1rk1/ppp1bppp/2n2n2/3ppb2/8/2NPPN2/PPPBBPPP/R2Q1RK1 b - - 3 8,Bd6,-99,-20,79,1
r2q1rk1/ppp2ppp/2nb1n2/3ppb2/8/2NPPN2/PPPBBPPP/R2Q1RK1 w - - 4 9,Qc1,-30,-105,-75,1
r2q1rk1/ppp2ppp/2nb1n2/3ppb2/8/2NPPN2/PPPBBPPP/R1Q2RK1 b - - 5 9,Bc5,-110,-71,39,1
r2q1rk1/ppp2ppp/2n2n2/2bppb2/8/2NPPN2/PPPBBPPP/R1Q2RK1 w - - 6 10,Re1,-80,-108,-28,1
r2q1rk1/ppp2ppp/2n2n2/2bppb2/8/2NPPN2/PPPBBPPP/R1Q1R1K1 b - - 7 10,d4,-119,-50,69,1
r2q1rk1/ppp2ppp/2n2n2/2b1pb2/3p4/2NPPN2/PPPBBPPP/R1Q1R1K1 w - - 0 11,exd4,-58,-51,7,1
r2q1rk1/ppp2ppp/2n2n2/2b1pb2/3P4/2NP1N2/PPPBBPPP/R1Q1R1K1 b - - 0 11,exd4,-48,-50,-2,1
r2q1rk1/ppp2ppp/2n2n2/2b2b2/3p4/2NP1N2/PPPBBPPP/R1Q1R1K1 w - - 0 12,Nxd4,-42,-494,-452,0
r2q1rk1/ppp2ppp/2n2n2/2b2b2/3N4/2NP4/PPPBBPPP/R1Q1R1K1 b - - 0 12,Bxd4,-532,-483,49,1
r2q1rk1/ppp2ppp/2n2n2/5b2/3b4/2NP4/PPPBBPPP/R1Q1R1K1 w - - 0 13,Be3,-468,-523,-55,1
r2q1rk1/ppp2ppp/2n2n2/5b2/3b4/2NPB3/PPP1BPPP/R1Q1R1K1 b - - 1 13,Re8,-514,-500,14,1
r2qr1k1/ppp2ppp/2n2n2/5b2/3b4/2NPB3/PPP1BPPP/R1Q1R1K1 w - - 2 14,Ne4,-511,-577,-66,1
r2qr1k1/ppp2ppp/2n2n2/5b2/3bN3/3PB3/PPP1BPPP/R1Q1R1K1 b - - 3 14,Nxe4,-535,-497,38,1
r2qr1k1/ppp2ppp/2n5/5b2/3bn3/3PB3/PPP1BPPP/R1Q1R1K1 w - - 0 15,dxe4,-514,-509,5,1
r2qr1k1/ppp2ppp/2n5/5b2/3bP3/4B3/PPP1BPPP/R1Q1R1K1 b - - 0 15,Bxe4,-531,-524,7,1
r2qr1k1/ppp2ppp/2n5/8/3bb3/4B3/PPP1BPPP/R1Q1R1K1 w - - 0 16,Rd1,-502,-550,-48,1
r2qr1k1/ppp2ppp/2n5/8/3bb3/4B3/PPP1BPPP/R1QR2K1 b - - 1 16,a5,-531,-498,33,1
r2qr1k1/1pp2ppp/2n5/p7/3bb3/4B3/PPP1BPPP/R1QR2K1 w - - 0 17,Bb5,-492,-493,-1,1
r2qr1k1/1pp2ppp/2n5/pB6/3bb3/4B3/PPP2PPP/R1QR2K1 b - - 1 17,Bxg2,-555,-435,120,1
r2qr1k1/1pp2ppp/2n5/pB6/3b4/4B3/PPP2PbP/R1QR2K1 w - - 0 18,Qb1,-438,-567,-129,0
r2qr1k1/1pp2ppp/2n5/pB6/3b4/4B3/PPP2PbP/RQ1R2K1 b - - 1 18,Qd5,-645,-516,129,1
r3r1k1/1pp2ppp/2n5/pB1q4/3b4/4B3/PPP2PbP/RQ1R2K1 w - - 2 19,Bxd4,-553,-677,-124,0
r3r1k1/1pp2ppp/2n5/pB1q4/3B4/8/PPP2PbP/RQ1R2K1 b - - 0 19,Bh1,-713,-588,125,1
r3r1k1/1pp2ppp/2n5/pB1q4/3B4/8/PPP2P1P/RQ1R2Kb w - - 1 20,Be3,-576,-9999,-9423,0
r3r1k1/1pp2ppp/2n5/pB1q4/8/4B3/PPP2P1P/RQ1R2Kb b - - 2 20,Qg2#,-9999,-10000,-1,1
rnbqkbnr/pppppppp/8/8/8/8/PPPPPPPP/RNBQKBNR w KQkq - 0 1,d4,35,24,-11,1
rnbqkbnr/pppppppp/8/8/3P4/8/PPP1PPPP/RNBQKBNR b KQkq - 0 1,d5,19,24,5,1
rnbqkbnr/ppp1pppp/8/3p4/3P4/8/PPP1PPPP/RNBQKBNR w KQkq - 0 2,e3,21,5,-16,1
rnbqkbnr/ppp1pppp/8/3p4/3P4/4P3/PPP2PPP/RNBQKBNR b KQkq - 0 2,c6,8,22,14,1
rnbqkbnr/pp2pppp/2p5/3p4/3P4/4P3/PPP2PPP/RNBQKBNR w KQkq - 0 3,f4,15,-26,-41,1
rnbqkbnr/pp2pppp/2p5/3p4/3P1P2/4P3/PPP3PP/RNBQKBNR b KQkq - 0 3,Nf6,-28,-23,5,1
rnbqkb1r/pp2pppp/2p2n2/3p4/3P1P2/4P3/PPP3PP/RNBQKBNR w KQkq - 1 4,Bd3,-12,-33,-21,1
rnbqkb1r/pp2pppp/2p2n2/3p4/3P1P2/3BP3/PPP3PP/RNBQK1NR b KQkq - 2 4,Bg4,-26,-23,3,1
rn1qkb1r/pp2pppp/2p2n2/3p4/3P1Pb1/3BP3/PPP3PP/RNBQK1NR w KQkq - 3 5,Nf3,-17,-21,-4,1
rn1qkb1r/pp2pppp/2p2n2/3p4/3P1Pb1/3BPN2/PPP3PP/RNBQK2R b KQkq - 4 5,e6,-21,-17,4,1
rn1qkb1r/pp3ppp/2p1pn2/3p4/3P1Pb1/3BPN2/PPP3PP/RNBQK2R w KQkq - 0 6,Nbd2,-16,-58,-42,1
rn1qkb1r/pp3ppp/2p1pn2/3p4/3P1Pb1/3BPN2/PPPN2PP/R1BQK2R b KQkq - 1 6,Nbd7,-58,-18,40,1
r2qkb1r/pp1n1ppp/2p1pn2/3p4/3P1Pb1/3BPN2/PPPN2PP/R1BQK2R w KQkq - 2 7,h3,-15,-26,-11,1
r2qkb1r/pp1n1ppp/2p1pn2/3p4/3P1Pb1/3BPN1P/PPPN2P1/R1BQK2R b KQkq - 0 7,Bf5,-40,-45,-5,1
r2qkb1r/pp1n1ppp/2p1pn2/3p1b2/3P1P2/3BPN1P/PPPN2P1/R1BQK2R w KQkq - 1 8,g4,-36,-43,-7,1
r2qkb1r/pp1n1ppp/2p1pn2/3p1b2/3P1PP1/3BPN1P/PPPN4/R1BQK2R b KQkq - 0 8,Bxd3,-41,-6,35,1
r2qkb1r/pp1n1ppp/2p1pn2/3p4/3P1PP1/3bPN1P/PPPN4/R1BQK2R w KQkq - 0 9,cxd3,4,-33,-37,1
r2qkb1r/pp1n1ppp/2p1pn2/3p4/3P1PP1/3PPN1P/PP1N4/R1BQK2R b KQkq - 0 9,Qa5,-32,12,44,1
r3kb1r/pp1n1ppp/2p1pn2/q2p4/3P1PP1/3PPN1P/PP1N4/R1BQK2R w KQkq - 1 10,Ne5,6,-14,-20,1
r3kb1r/pp1n1ppp/2p1pn2/q2pN3/3P1PP1/3PP2P/PP1N4/R1BQK2R b KQkq - 2 10,c5,-30,31,61,1
r3kb1r/pp1n1ppp/4pn2/q1ppN3/3P1PP1/3PP2P/PP1N4/R1BQK2R w KQkq - 0 11,g5,18,-70,-88,1
r3kb1r/pp1n1ppp/4pn2/q1ppN1P1/3P1P2/3PP2P/PP1N4/R1BQK2R b KQkq - 0 11,Nxe5,-98,-56,42,1
r3kb1r/pp3ppp/4pn2/q1ppn1P1/3P1P2/3PP2P/PP1N4/R1BQK2R w KQkq - 0 12,dxe5,-48,-84,-36,1
r3kb1r/pp3ppp/4pn2/q1ppP1P1/5P2/3PP2P/PP1N4/R1BQK2R b KQkq - 0 12,Nd7,-100,-72,28,1
r3kb1r/pp1n1ppp/4p3/q1ppP1P1/5P2/3PP2P/PP1N4/R1BQK2R w KQkq - 1 13,d4,-56,-85,-29,1
r3kb1r/pp1n1ppp/4p3/q1ppP1P1/3P1P2/4P2P/PP1N4/R1BQK2R b KQkq - 0 13,c4,-72,-38,34,1
r3kb1r/pp1n1ppp/4p3/q2pP1P1/2pP1P2/4P2P/PP1N4/R1BQK2R w KQkq - 0 14,Kf2,-38,-13,25,1
r3kb1r/pp1n1ppp/4p3/q2pP1P1/2pP1P2/4P2P/PP1N1K2/R1BQ3R b kq - 1 14,Rc8,-15,29,44,1
2r1kb1r/pp1n1ppp/4p3/q2pP1P1/2pP1P2/4P2P/PP1N1K2/R1BQ3R w k - 2 15,Nf3,30,33,3,1
2r1kb1r/pp1n1ppp/4p3/q2pP1P1/2pP1P2/4PN1P/PP3K2/R1BQ3R b k - 3 15,c3,8,53,45,1
2r1kb1r/pp1n1ppp/4p3/q2pP1P1/3P1P2/2p1PN1P/PP3K2/R1BQ3R w k - 0 16,bxc3,66,62,-4,1
2r1kb1r/pp1n1ppp/4p3/q2pP1P1/3P1P2/2P1PN1P/P4K2/R1BQ3R b k - 0 16,Qxc3,54,74,20,1
2r1kb1r/pp1n1ppp/4p3/3pP1P1/3P1P2/2q1PN1P/P4K2/R1BQ3R w k - 0 17,Qb3,98,-406,-504,0
2r1kb1r/pp1n1ppp/4p3/3pP1P1/3P1P2/1Qq1PN1P/P4K2/R1B4R b k - 1 17,Qxb3,-404,32,436,1
2r1kb1r/pp1n1ppp/4p3/3pP1P1/3P1P2/1q2PN1P/P4K2/R1B4R w k - 0 18,axb3,40,19,-21,1
2r1kb1r/pp1n1ppp/4p3/3pP1P1/3P1P2/1P2PN1P/5K2/R1B4R b k - 0 18,Rc2+,27,89,62,1
4kb1r/pp1n1ppp/4p3/3pP1P1/3P1P2/1P2PN1P/2r2K2/R1B4R w k - 1 19,Bd2,110,110,0,1
4kb1r/pp1n1ppp/4p3/3pP1P1/3P1P2/1P2PN1P/2rB1K2/R6R b k - 2 19,a6,109,122,13,1
4kb1r/1p1n1ppp/p3p3/3pP1P1/3P1P2/1P2PN1P/2rB1K2/R6R w k - 0 20,Rhc1,121,128,7,1
4kb1r/1p1n1ppp/p3p3/3pP1P1/3P1P2/1P2PN1P/2rB1K2/R1R5 b k - 1 20,Rxc1,115,118,3,1
4kb1r/1p1n1ppp/p3p3/3pP1P1/3P1P2/1P2PN1P/3B1K2/R1r5 w k - 0 21,Rxc1,119,118,-1,1
4kb1r/1p1n1ppp/p3p3/3pP1P1/3P1P2/1P2PN1P/3B1K2/2R5 b k - 0 21,Kd8,109,138,29,1
3k1b1r/1p1n1ppp/p3p3/3pP1P1/3P1P2/1P2PN1P/3B1K2/2R5 w - - 1 22,b4,131,5,-126,0
3k1b1r/1p1n1ppp/p3p3/3pP1P1/1P1P1P2/4PN1P/3B1K2/2R5 b - - 0 22,Nb6,12,66,54,1
3k1b1r/1p3ppp/pn2p3/3pP1P1/1P1P1P2/4PN1P/3B1K2/2R5 w - - 1 23,b5,92,77,-15,1
3k1b1r/1p3ppp/pn2p3/1P1pP1P1/3P1P2/4PN1P/3B1K2/2R5 b - - 0 23,Ba3,76,117,41,1
3k3r/1p3ppp/pn2p3/1P1pP1P1/3P1P2/b3PN1P/3B1K2/2R5 w - - 1 24,Ra1,108,63,-45,1
3k3r/1p3ppp/pn2p3/1P1pP1P1/3P1P2/b3PN1P/3B1K2/R7 b - - 2 24,Nc4,53,75,22,1
3k3r/1p3ppp/p3p3/1P1pP1P1/2nP1P2/b3PN1P/3B1K2/R7 w - - 3 25,bxa6,84,92,8,1
3k3r/1p3ppp/P3p3/3pP1P1/2nP1P2/b3PN1P/3B1K2/R7 b - - 0 25,bxa6,76,82,6,1
3k3r/5ppp/p3p3/3pP1P1/2nP1P2/b3PN1P/3B1K2/R7 w - - 0 26,Ra2,72,-43,-115,0
3k3r/5ppp/p3p3/3pP1P1/2nP1P2/b3PN1P/R2B1K2/8 b - - 1 26,Kd7,-42,-75,-33,1
7r/3k1ppp/p3p3/3pP1P1/2nP1P2/b3PN1P/R2B1K2/8 w - - 2 27,Bc3,-58,-73,-15,1
7r/3k1ppp/p3p3/3pP1P1/2nP1P2/b1B1PN1P/R4K2/8 b - - 3 27,Rb8,-52,-35,17,1
1r6/3k1ppp/p3p3/3pP1P1/2nP1P2/b1B1PN1P/R4K2/8 w - - 4 28,Nd2,-25,-19,6,1
1r6/3k1ppp/p3p3/3pP1P1/2nP1P2/b1B1P2P/R2N1K2/8 b - - 5 28,Bb2,-44,-5,39,1
1r6/3k1ppp/p3p3/3pP1P1/2nP1P2/2B1P2P/Rb1N1K2/8 w - - 6 29,Bxb2,5,-157,-162,0
1r6/3k1ppp/p3p3/3pP1P1/2nP1P2/4P2P/RB1N1K2/8 b - - 0 29,Rxb2,-147,-139,8,1
8/3k1ppp/p3p3/3pP1P1/2nP1P2/4P2P/Rr1N1K2/8 w - - 0 30,Rxb2,-123,-155,-32,1
8/3k1ppp/p3p3/3pP1P1/2nP1P2/4P2P/1R1N1K2/8 b - - 0 30,Nxb2,-167,-156,11,1
8/3k1ppp/p3p3/3pP1P1/3P1P2/4P2P/1n1N1K2/8 w - - 0 31,e4,-157,-210,-53,1
8/3k1ppp/p3p3/3pP1P1/3PPP2/7P/1n1N1K2/8 b - - 0 31,Kc6,-193,-214,-21,1
8/5ppp/p1k1p3/3pP1P1/3PPP2/7P/1n1N1K2/8 w - - 1 32,Ke3,-154,-283,-129,0
8/5ppp/p1k1p3/3pP1P1/3PPP2/4K2P/1n1N4/8 b - - 2 32,Nc4+,-247,267,514,1
8/5ppp/p1k1p3/3pP1P1/2nPPP2/4K2P/3N4/8 w - - 3 33,Kd3,271,-446,-717,0
8/5ppp/p1k1p3/3pP1P1/2nPPP2/3K3P/3N4/8 b - - 4 33,Nxd2,-495,-498,-3,1
8/5ppp/p1k1p3/3pP1P1/3PPP2/3K3P/3n4/8 w - - 0 34,exd5+,-504,-547,-43,1
8/5ppp/p1k1p3/3PP1P1/3P1P2/3K3P/3n4/8 b - - 0 34,Kxd5,-525,-525,0,1
rnbqkbnr/pppppppp/8/8/8/8/PPPPPPPP/RNBQKBNR w KQkq - 0 1,e4,25,24,-1,1
rnbqkbnr/pppppppp/8/8/4P3/8/PPPP1PPP/RNBQKBNR b KQkq - 0 1,b6,32,104,72,1
rnbqkbnr/p1pppppp/1p6/8/4P3/8/PPPP1PPP/RNBQKBNR w KQkq - 0 2,Nf3,88,63,-25,1
rnbqkbnr/p1pppppp/1p6/8/4P3/5N2/PPPP1PPP/RNBQKB1R b KQkq - 1 2,Bb7,63,56,-7,1
rn1qkbnr/pbpppppp/1p6/8/4P3/5N2/PPPP1PPP/RNBQKB1R w KQkq - 2 3,Nc3,53,52,-1,1
rn1qkbnr/pbpppppp/1p6/8/4P3/2N2N2/PPPP1PPP/R1BQKB1R b KQkq - 3 3,g6,41,132,91,1
rn1qkbnr/pbpppp1p/1p4p1/8/4P3/2N2N2/PPPP1PPP/R1BQKB1R w KQkq - 0 4,d4,108,117,9,1
rn1qkbnr/pbpppp1p/1p4p1/8/3PP3/2N2N2/PPP2PPP/R1BQKB1R b KQkq - 0 4,Bg7,115,113,-2,1
rn1qk1nr/pbppppbp/1p4p1/8/3PP3/2N2N2/PPP2PPP/R1BQKB1R w KQkq - 1 5,Be3,122,122,0,1
rn1qk1nr/pbppppbp/1p4p1/8/3PP3/2N1BN2/PPP2PPP/R2QKB1R b KQkq - 2 5,d6,126,135,9,1
rn1qk1nr/pbp1ppbp/1p1p2p1/8/3PP3/2N1BN2/PPP2PPP/R2QKB1R w KQkq - 0 6,Bd3,118,86,-32,1
rn1qk1nr/pbp1ppbp/1p1p2p1/8/3PP3/2NBBN2/PPP2PPP/R2QK2R b KQkq - 1 6,Nd7,82,77,-5,1
r2qk1nr/pbpnppbp/1p1p2p1/8/3PP3/2NBBN2/PPP2PPP/R2QK2R w KQkq - 2 7,Qd2,85,99,14,1
r2qk1nr/pbpnppbp/1p1p2p1/8/3PP3/2NBBN2/PPPQ1PPP/R3K2R b KQkq - 3 7,e6,87,110,23,1
r2qk1nr/pbpn1pbp/1p1pp1p1/8/3PP3/2NBBN2/PPPQ1PPP/R3K2R w KQkq - 0 8,h4,124,91,-33,1
r2qk1nr/pbpn1pbp/1p1pp1p1/8/3PP2P/2NBBN2/PPPQ1PP1/R3K2R b KQkq - 0 8,Qe7,91,178,87,1
r3k1nr/pbpnqpbp/1p1pp1p1/8/3PP2P/2NBBN2/PPPQ1PP1/R3K2R w KQkq - 1 9,h5,157,171,14,1
r3k1nr/pbpnqpbp/1p1pp1p1/7P/3PP3/2NBBN2/PPPQ1PP1/R3K2R b KQkq - 0 9,e5,145,236,91,1
r3k1nr/pbpnqpbp/1p1p2p1/4p2P/3PP3/2NBBN2/PPPQ1PP1/R3K2R w KQkq - 0 10,hxg6,266,154,-112,0
r3k1nr/pbpnqpbp/1p1p2P1/4p3/3PP3/2NBBN2/PPPQ1PP1/R3K2R b KQkq - 0 10,fxg6,130,173,43,1
r3k1nr/pbpnq1bp/1p1p2p1/4p3/3PP3/2NBBN2/PPPQ1PP1/R3K2R w KQkq - 0 11,Bg5,174,136,-38,1
r3k1nr/pbpnq1bp/1p1p2p1/4p1B1/3PP3/2NB1N2/PPPQ1PP1/R3K2R b KQkq - 1 11,Bf6,142,167,25,1
r3k1nr/pbpnq2p/1p1p1bp1/4p1B1/3PP3/2NB1N2/PPPQ1PP1/R3K2R w KQkq - 2 12,Bxf6,154,95,-59,1
r3k1nr/pbpnq2p/1p1p1Bp1/4p3/3PP3/2NB1N2/PPPQ1PP1/R3K2R b KQkq - 0 12,Ngxf6,87,106,19,1
r3k2r/pbpnq2p/1p1p1np1/4p3/3PP3/2NB1N2/PPPQ1PP1/R3K2R w KQkq - 0 13,d5,114,79,-35,1
r3k2r/pbpnq2p/1p1p1np1/3Pp3/4P3/2NB1N2/PPPQ1PP1/R3K2R b KQkq - 0 13,Nc5,74,106,32,1
r3k2r/pbp1q2p/1p1p1np1/2nPp3/4P3/2NB1N2/PPPQ1PP1/R3K2R w KQkq - 1 14,Qh6,99,36,-63,1
r3k2r/pbp1q2p/1p1p1npQ/2nPp3/4P3/2NB1N2/PPP2PP1/R3K2R b KQkq - 2 14,O-O-O,37,53,16,1
2kr3r/pbp1q2p/1p1p1npQ/2nPp3/4P3/2NB1N2/PPP2PP1/R3K2R w KQ - 3 15,Ng5,49,12,-37,1
2kr3r/pbp1q2p/1p1p1npQ/2nPp1N1/4P3/2NB4/PPP2PP1/R3K2R b KQ - 4 15,Nxd3+,-13,-3,10,1
2kr3r/pbp1q2p/1p1p1npQ/3Pp1N1/4P3/2Nn4/PPP2PP1/R3K2R w KQ - 0 16,cxd3,-1,-15,-14,1
2kr3r/pbp1q2p/1p1p1npQ/3Pp1N1/4P3/2NP4/PP3PP1/R3K2R b KQ - 0 16,Rdf8,-9,42,51,1
2k2r1r/pbp1q2p/1p1p1npQ/3Pp1N1/4P3/2NP4/PP3PP1/R3K2R w KQ - 1 17,Ne6,39,38,-1,1
2k2r1r/pbp1q2p/1p1pNnpQ/3Pp3/4P3/2NP4/PP3PP1/R3K2R b KQ - 2 17,Rf7,44,30,-14,1
2k4r/pbp1qr1p/1p1pNnpQ/3Pp3/4P3/2NP4/PP3PP1/R3K2R w KQ - 3 18,Qd2,40,19,-21,1
2k4r/pbp1qr1p/1p1pNnp1/3Pp3/4P3/2NP4/PP1Q1PP1/R3K2R b KQ - 4 18,Kb8,41,61,20,1
1k5r/pbp1qr1p/1p1pNnp1/3Pp3/4P3/2NP4/PP1Q1PP1/R3K2R w KQ - 5 19,a4,47,51,4,1
1k5r/pbp1qr1p/1p1pNnp1/3Pp3/P3P3/2NP4/1P1Q1PP1/R3K2R b KQ - 0 19,Bc8,53,89,36,1
1kb4r/p1p1qr1p/1p1pNnp1/3Pp3/P3P3/2NP4/1P1Q1PP1/R3K2R w KQ - 1 20,Ng5,97,85,-12,1
1kb4r/p1p1qr1p/1p1p1np1/3Pp1N1/P3P3/2NP4/1P1Q1PP1/R3K2R b KQ - 2 20,h6,85,349,264,1
1kb4r/p1p1qr2/1p1p1npp/3Pp1N1/P3P3/2NP4/1P1Q1PP1/R3K2R w KQ - 0 21,Nf3,306,-93,-399,0
1kb4r/p1p1qr2/1p1p1npp/3Pp3/P3P3/2NP1N2/1P1Q1PP1/R3K2R b KQ - 1 21,g5,-38,71,109,1
1kb4r/p1p1qr2/1p1p1n1p/3Pp1p1/P3P3/2NP1N2/1P1Q1PP1/R3K2R w KQ - 0 22,a5,81,94,13,1
1kb4r/p1p1qr2/1p1p1n1p/P2Pp1p1/4P3/2NP1N2/1P1Q1PP1/R3K2R b KQ - 0 22,Bg4,97,235,138,1
1k5r/p1p1qr2/1p1p1n1p/P2Pp1p1/4P1b1/2NP1N2/1P1Q1PP1/R3K2R w KQ - 1 23,axb6,269,168,-101,0
1k5r/p1p1qr2/1P1p1n1p/3Pp1p1/4P1b1/2NP1N2/1P1Q1PP1/R3K2R b KQ - 0 23,cxb6,151,165,14,1
1k5r/p3qr2/1p1p1n1p/3Pp1p1/4P1b1/2NP1N2/1P1Q1PP1/R3K2R w KQ - 0 24,Nb5,194,201,7,1
1k5r/p3qr2/1p1p1n1p/1N1Pp1p1/4P1b1/3P1N2/1P1Q1PP1/R3K2R b KQ - 1 24,a6,185,327,142,1
1k5r/4qr2/pp1p1n1p/1N1Pp1p1/4P1b1/3P1N2/1P1Q1PP1/R3K2R w KQ - 0 25,Rxa6,365,360,-5,1
1k5r/4qr2/Rp1p1n1p/1N1Pp1p1/4P1b1/3P1N2/1P1Q1PP1/4K2R b K - 0 25,Bxf3,385,578,193,1
1k5r/4qr2/Rp1p1n1p/1N1Pp1p1/4P3/3P1b2/1P1Q1PP1/4K2R w K - 0 26,gxf3,530,354,-176,0
1k5r/4qr2/Rp1p1n1p/1N1Pp1p1/4P3/3P1P2/1P1Q1P2/4K2R b K - 0 26,g4,381,709,328,1
1k5r/4qr2/Rp1p1n1p/1N1Pp3/4P1p1/3P1P2/1P1Q1P2/4K2R w K - 0 27,Rxb6+,705,723,18,1
1k5r/4qr2/1R1p1n1p/1N1Pp3/4P1p1/3P1P2/1P1Q1P2/4K2R b K - 0 27,Kc8,680,693,13,1
2k4r/4qr2/1R1p1n1p/1N1Pp3/4P1p1/3P1P2/1P1Q1P2/4K2R w K - 1 28,Nxd6+,731,698,-33,1
2k4r/4qr2/1R1N1n1p/3Pp3/4P1p1/3P1P2/1P1Q1P2/4K2R b K - 0 28,Kd8,621,9991,9370,1
3k3r/4qr2/1R1N1n1p/3Pp3/4P1p1/3P1P2/1P1Q1P2/4K2R w K - 1 29,Nxf7+,9991,541,-9450,0
3k3r/4qN2/1R3n1p/3Pp3/4P1p1/3P1P2/1P1Q1P2/4K2R b K - 0 29,Qxf7,677,728,51,1
3k3r/5q2/1R3n1p/3Pp3/4P1p1/3P1P2/1P1Q1P2/4K2R w K - 0 30,Qb4,715,537,-178,0
3k3r/5q2/1R3n1p/3Pp3/1Q2P1p1/3P1P2/1P3P2/4K2R b K - 1 30,Qc7,558,718,160,1
3k3r/2q5/1R3n1p/3Pp3/1Q2P1p1/3P1P2/1P3P2/4K2R w K - 2 31,Rd6+,732,440,-292,0
3k3r/2q5/3R1n1p/3Pp3/1Q2P1p1/3P1P2/1P3P2/4K2R b K - 3 31,Ke8,434,558,124,1
4k2r/2q5/3R1n1p/3Pp3/1Q2P1p1/3P1P2/1P3P2/4K2R w K - 4 32,Qb5+,598,511,-87,1
4k2r/2q5/3R1n1p/1Q1Pp3/4P1p1/3P1P2/1P3P2/4K2R b K - 5 32,Kf7,506,533,27,1
7r/2q2k2/3R1n1p/1Q1Pp3/4P1p1/3P1P2/1P3P2/4K2R w K - 6 33,Qc6,507,507,0,1
7r/2q2k2/2QR1n1p/3Pp3/4P1p1/3P1P2/1P3P2/4K2R b K - 7 33,Qxc6,546,530,-16,1
7r/5k2/2qR1n1p/3Pp3/4P1p1/3P1P2/1P3P2/4K2R w K - 0 34,Rxc6,505,551,46,1
7r/5k2/2R2n1p/3Pp3/4P1p1/3P1P2/1P3P2/4K2R b K - 0 34,h5,513,551,38,1
7r/5k2/2R2n2/3Pp2p/4P1p1/3P1P2/1P3P2/4K2R w K - 0 35,Rxf6+,526,460,-66,1
7r/5k2/5R2/3Pp2p/4P1p1/3P1P2/1P3P2/4K2R b K - 0 35,Kxf6,443,450,7,1
7r/8/5k2/3Pp2p/4P1p1/3P1P2/1P3P2/4K2R w K - 0 36,fxg4,429,427,-2,1
7r/8/5k2/3Pp2p/4P1P1/3P4/1P3P2/4K2R b K - 0 36,Kg5,445,742,297,1
7r/8/8/3Pp1kp/4P1P1/3P4/1P3P2/4K2R w K - 1 37,Rxh5+,580,770,190,1
7r/8/8/3Pp1kR/4P1P1/3P4/1P3P2/4K3 b - - 0 37,Rxh5,784,782,-2,1
8/8/8/3Pp1kr/4P1P1/3P4/1P3P2/4K3 w - - 0 38,gxh5,788,793,5,1
8/8/8/3Pp1kP/4P3/3P4/1P3P2/4K3 b - - 0 38,Kxh5,804,812,8,1
8/8/8/3Pp2k/4P3/3P4/1P3P2/4K3 w - - 0 39,Kd2,744,638,-106,0
8/8/8/3Pp2k/4P3/3P4/1P1K1P2/8 b - - 1 39,Kg6,682,703,21,1
8/8/6k1/3Pp3/4P3/3P4/1P1K1P2/8 w - - 2 40,b4,688,792,104,1
8/8/6k1/3Pp3/1P2P3/3P4/3K1P2/8 b - - 0 40,Kf7,781,830,49,1
8/5k2/8/3Pp3/1P2P3/3P4/3K1P2/8 w - - 1 41,Kc3,906,913,7,1
8/5k2/8/3Pp3/1P2P3/2KP4/5P2/8 b - - 2 41,Ke7,908,908,0,1
8/4k3/8/3Pp3/1P2P3/2KP4/5P2/8 w - - 3 42,Kc4,921,932,11,1
8/4k3/8/3Pp3/1PK1P3/3P4/5P2/8 b - - 4 42,Kd7,956,967,11,1
8/3k4/8/3Pp3/1PK1P3/3P4/5P2/8 w - - 5 43,d4,983,675,-308,0
8/3k4/8/3Pp3/1PKPP3/8/5P2/8 b - - 0 43,Kc7,682,722,40,1
8/2k5/8/3Pp3/1PKPP3/8/5P2/8 w - - 1 44,dxe5,848,830,-18,1
8/2k5/8/3PP3/1PK1P3/8/5P2/8 b - - 0 44,Kd7,958,960,2,1
8/3k4/8/3PP3/1PK1P3/8/5P2/8 w - - 1 45,f4,931,727,-204,0
8/3k4/8/3PP3/1PK1PP2/8/8/8 b - - 0 45,Ke7,744,787,43,1
8/4k3/8/3PP3/1PK1PP2/8/8/8 w - - 1 46,f5,825,833,8,1
8/4k3/8/3PPP2/1PK1P3/8/8/8 b - - 0 46,Kf7,872,989,117,1
8/5k2/8/3PPP2/1PK1P3/8/8/8 w - - 1 47,Kc5,908,814,-94,1
8/5k2/8/2KPPP2/1P2P3/8/8/8 b - - 2 47,Ke7,937,967,30,1
8/4k3/8/2KPPP2/1P2P3/8/8/8 w - - 3 48,b5,1024,903,-121,0
8/4k3/8/1PKPPP2/4P3/8/8/8 b - - 0 48,Kd7,1012,1070,58,1
8/3k4/8/1PKPPP2/4P3/8/8/8 w - - 1 49,b6,1235,1032,-203,0
8/3k4/1P6/2KPPP2/4P3/8/8/8 b - - 0 49,Kc8,1110,9993,8883,1
2k5/8/1P6/2KPPP2/4P3/8/8/8 w - - 1 50,d6,9994,1032,-8962,0
2k5/8/1P1P4/2K1PP2/4P3/8/8/8 b - - 0 50,Kd8,1422,9991,8569,1
3k4/8/1P1P4/2K1PP2/4P3/8/8/8 w - - 1 51,e6,9991,1455,-8536,0
3k4/8/1P1PP3/2K2P2/4P3/8/8/8 b - - 0 51,Ke8,1434,9992,8558,1
4k3/8/1P1PP3/2K2P2/4P3/8/8/8 w - - 1 52,f6,9992,9993,1,1
4k3/8/1P1PPP2/2K5/4P3/8/8/8 b - - 0 52,Kf8,9993,9993,0,1
5k2/8/1P1PPP2/2K5/4P3/8/8/8 w - - 1 53,e5,9993,1074,-8919,0
5k2/8/1P1PPP2/2K1P3/8/8/8/8 b - - 0 53,Kg8,1110,1339,229,1
6k1/8/1P1PPP2/2K1P3/8/8/8/8 w - - 1 54,b7,1480,1501,21,1
6k1/1P6/3PPP2/2K1P3/8/8/8/8 b - - 0 54,Kh7,1472,1745,273,1
8/1P5k/3PPP2/2K1P3/8/8/8/8 w - - 1 55,b8=Q,1718,1682,-36,1
1Q6/7k/3PPP2/2K1P3/8/8/8/8 b - - 0 55,Kg6,9987,9987,0,1
1Q6/8/3PPPk1/2K1P3/8/8/8/8 w - - 1 56,f7,9987,9993,6,1
1Q6/5P2/3PP1k1/2K1P3/8/8/8/8 b - - 0 56,Kf5,9993,9993,0,1
1Q6/5P2/3PP3/2K1Pk2/8/8/8/8 w - - 1 57,f8=N,9994,1253,-8741,0
1Q3N2/8/3PP3/2K1Pk2/8/8/8/8 b - - 0 57,Ke4,1352,1350,-2,1
1Q3N2/8/3PP3/2K1P3/4k3/8/8/8 w - - 1 58,e7,1402,1402,0,1
1Q3N2/4P3/3P4/2K1P3/4k3/8/8/8 b - - 0 58,Kd3,1480,9995,8515,1
rnbqkbnr/pppppppp/8/8/8/8/PPPPPPPP/RNBQKBNR w KQkq - 0 1,e4,35,40,5,1
rnbqkbnr/pppppppp/8/8/4P3/8/PPPP1PPP/RNBQKBNR b KQkq - 0 1,g5,40,195,155,1
rnbqkbnr/pppppp1p/8/6p1/4P3/8/PPPP1PPP/RNBQKBNR w KQkq - 0 2,d4,196,191,-5,1
rnbqkbnr/pppppp1p/8/6p1/3PP3/8/PPP2PPP/RNBQKBNR b KQkq - 0 2,e6,200,193,-7,1
rnbqkbnr/pppp1p1p/4p3/6p1/3PP3/8/PPP2PPP/RNBQKBNR w KQkq - 0 3,Nf3,198,141,-57,1
rnbqkbnr/pppp1p1p/4p3/6p1/3PP3/5N2/PPP2PPP/RNBQKB1R b KQkq - 1 3,h6,161,154,-7,1
rnbqkbnr/pppp1p2/4p2p/6p1/3PP3/5N2/PPP2PPP/RNBQKB1R w KQkq - 0 4,Nc3,168,152,-16,1
rnbqkbnr/pppp1p2/4p2p/6p1/3PP3/2N2N2/PPP2PPP/R1BQKB1R b KQkq - 1 4,a6,143,186,43,1
rnbqkbnr/1ppp1p2/p3p2p/6p1/3PP3/2N2N2/PPP2PPP/R1BQKB1R w KQkq - 0 5,d5,177,131,-46,1
rnbqkbnr/1ppp1p2/p3p2p/3P2p1/4P3/2N2N2/PPP2PPP/R1BQKB1R b KQkq - 0 5,e5,135,232,97,1
rnbqkbnr/1ppp1p2/p6p/3Pp1p1/4P3/2N2N2/PPP2PPP/R1BQKB1R w KQkq - 0 6,Nxe5,246,252,6,1
rnbqkbnr/1ppp1p2/p6p/3PN1p1/4P3/2N5/PPP2PPP/R1BQKB1R b KQkq - 0 6,Bg7,255,254,-1,1
rnbqk1nr/1ppp1pb1/p6p/3PN1p1/4P3/2N5/PPP2PPP/R1BQKB1R w KQkq - 1 7,Ng4,245,223,-22,1
rnbqk1nr/1ppp1pb1/p6p/3P2p1/4P1N1/2N5/PPP2PPP/R1BQKB1R b KQkq - 2 7,d6,219,207,-12,1
rnbqk1nr/1pp2pb1/p2p3p/3P2p1/4P1N1/2N5/PPP2PPP/R1BQKB1R w KQkq - 0 8,Be3,214,-72,-286,0
rnbqk1nr/1pp2pb1/p2p3p/3P2p1/4P1N1/2N1B3/PPP2PPP/R2QKB1R b KQkq - 1 8,Nd7,-9,239,248,1
r1bqk1nr/1ppn1pb1/p2p3p/3P2p1/4P1N1/2N1B3/PPP2PPP/R2QKB1R w KQkq - 2 9,Bd4,248,251,3,1
r1bqk1nr/1ppn1pb1/p2p3p/3P2p1/3BP1N1/2N5/PPP2PPP/R2QKB1R b KQkq - 3 9,Bxd4,257,272,15,1
r1bqk1nr/1ppn1p2/p2p3p/3P2p1/3bP1N1/2N5/PPP2PPP/R2QKB1R w KQkq - 0 10,Qxd4,320,286,-34,1
r1bqk1nr/1ppn1p2/p2p3p/3P2p1/3QP1N1/2N5/PPP2PPP/R3KB1R b KQkq - 0 10,Ngf6,309,329,20,1
r1bqk2r/1ppn1p2/p2p1n1p/3P2p1/3QP1N1/2N5/PPP2PPP/R3KB1R w KQkq - 1 11,Nxf6+,318,210,-108,0
r1bqk2r/1ppn1p2/p2p1N1p/3P2p1/3QP3/2N5/PPP2PPP/R3KB1R b KQkq - 0 11,Nxf6,211,262,51,1
r1bqk2r/1pp2p2/p2p1n1p/3P2p1/3QP3/2N5/PPP2PPP/R3KB1R w KQkq - 0 12,e5,274,118,-156,0
r1bqk2r/1pp2p2/p2p1n1p/3PP1p1/3Q4/2N5/PPP2PPP/R3KB1R b KQkq - 0 12,Ng4,110,352,242,1
r1bqk2r/1pp2p2/p2p3p/3PP1p1/3Q2n1/2N5/PPP2PPP/R3KB1R w KQkq - 1 13,exd6,356,374,18,1
r1bqk2r/1pp2p2/p2P3p/3P2p1/3Q2n1/2N5/PPP2PPP/R3KB1R b KQkq - 0 13,Nf6,389,539,150,1
r1bqk2r/1pp2p2/p2P1n1p/3P2p1/3Q4/2N5/PPP2PPP/R3KB1R w KQkq - 1 14,dxc7,510,522,12,1
r1bqk2r/1pP2p2/p4n1p/3P2p1/3Q4/2N5/PPP2PPP/R3KB1R b KQkq - 0 14,Qd6,517,572,55,1
r1b1k2r/1pP2p2/p2q1n1p/3P2p1/3Q4/2N5/PPP2PPP/R3KB1R w KQkq - 1 15,Ne4,538,578,40,1
r1b1k2r/1pP2p2/p2q1n1p/3P2p1/3QN3/8/PPP2PPP/R3KB1R b KQkq - 2 15,Qxd5,572,1100,528,1
r1b1k2r/1pP2p2/p4n1p/3q2p1/3QN3/8/PPP2PPP/R3KB1R w KQkq - 0 16,Qxf6,1083,368,-715,0
r1b1k2r/1pP2p2/p4Q1p/3q2p1/4N3/8/PPP2PPP/R3KB1R b KQkq - 0 16,Qxe4+,316,327,11,1
r1b1k2r/1pP2p2/p4Q1p/6p1/4q3/8/PPP2PPP/R3KB1R w KQkq - 0 17,Be2,384,382,-2,1
r1b1k2r/1pP2p2/p4Q1p/6p1/4q3/8/PPP1BPPP/R3K2R b KQkq - 1 17,Rh7,370,9999,9629,1
r1b1k3/1pP2p1r/p4Q1p/6p1/4q3/8/PPP1BPPP/R3K2R w KQq - 2 18,O-O-O,9999,675,-9324,0
r1b1k3/1pP2p1r/p4Q1p/6p1/4q3/8/PPP1BPPP/2KR3R b q - 3 18,Qf4+,651,658,7,1
r1b1k3/1pP2p1r/p4Q1p/6p1/5q2/8/PPP1BPPP/2KR3R w q - 4 19,Qxf4,704,662,-42,1
r1b1k3/1pP2p1r/p6p/6p1/5Q2/8/PPP1BPPP/2KR3R b q - 0 19,gxf4,679,675,-4,1
r1b1k3/1pP2p1r/p6p/8/5p2/8/PPP1BPPP/2KR3R w q - 0 20,Bd3,677,453,-224,0
r1b1k3/1pP2p1r/p6p/8/5p2/3B4/PPP2PPP/2KR3R b q - 1 20,f5,486,482,-4,1
r1b1k3/1pP4r/p6p/5p2/5p2/3B4/PPP2PPP/2KR3R w q - 0 21,Rhe1+,475,495,20,1
r1b1k3/1pP4r/p6p/5p2/5p2/3B4/PPP2PPP/2KRR3 b q - 1 21,Kf8,498,511,13,1
r1b2k2/1pP4r/p6p/5p2/5p2/3B4/PPP2PPP/2KRR3 w - - 2 22,Bxf5,457,485,28,1
r1b2k2/1pP4r/p6p/5B2/5p2/8/PPP2PPP/2KRR3 b - - 0 22,Bxf5,486,690,204,1
r4k2/1pP4r/p6p/5b2/5p2/8/PPP2PPP/2KRR3 w - - 0 23,Rd8+,701,641,-60,1
r2R1k2/1pP4r/p6p/5b2/5p2/8/PPP2PPP/2K1R3 b - - 1 23,Rxd8,680,874,194,1
3r1k2/1pP4r/p6p/5b2/5p2/8/PPP2PPP/2K1R3 w - - 0 24,cxd8=Q+,915,912,-3,1
3Q1k2/1p5r/p6p/5b2/5p2/8/PPP2PPP/2K1R3 b - - 0 24,Kg7,922,949,27,1
3Q4/1p4kr/p6p/5b2/5p2/8/PPP2PPP/2K1R3 w - - 1 25,Qd7+,929,-116,-1045,0
8/1p1Q2kr/p6p/5b2/5p2/8/PPP2PPP/2K1R3 b - - 2 25,Kg6,-206,877,1083,1
8/1p1Q3r/p5kp/5b2/5p2/8/PPP2PPP/2K1R3 w - - 3 26,Qd6+,860,989,129,1
8/1p5r/p2Q2kp/5b2/5p2/8/PPP2PPP/2K1R3 b - - 4 26,Kg5,1040,9989,8949,1
8/1p5r/p2Q3p/5bk1/5p2/8/PPP2PPP/2K1R3 w - - 5 27,Re7,9989,823,-9166,0
8/1p2R2r/p2Q3p/5bk1/5p2/8/PPP2PPP/2K5 b - - 6 27,Rh8,808,940,132,1
7r/1p2R3/p2Q3p/5bk1/5p2/8/PPP2PPP/2K5 w - - 7 28,Rg7+,1026,9995,8969,1
7r/1p4R1/p2Q3p/5bk1/5p2/8/PPP2PPP/2K5 b - - 8 28,Kh5,9995,9995,0,1
7r/1p4R1/p2Q3p/5b1k/5p2/8/PPP2PPP/2K5 w - - 9 29,Qf6,9995,9993,-2,1
7r/1p4R1/p4Q1p/5b1k/5p2/8/PPP2PPP/2K5 b - - 10 29,Bg4,9993,9998,5,1
7r/1p4R1/p4Q1p/7k/5pb1/8/PPP2PPP/2K5 w - - 11 30,Rxg4,9998,9997,-1,1
7r/1p6/p4Q1p/7k/5pR1/8/PPP2PPP/2K5 b - - 0 30,Kxg4,9997,9997,0,1
7r/1p6/p4Q1p/8/5pk1/8/PPP2PPP/2K5 w - - 0 31,Qxh8,9997,869,-9128,0
7Q/1p6/p6p/8/5pk1/8/PPP2PPP/2K5 b - - 0 31,Kh5,879,9996,9117,1
7Q/1p6/p6p/7k/5p2/8/PPP2PPP/2K5 w - - 1 32,f3,9996,909,-9087,0
rnbqkbnr/pppppppp/8/8/8/8/PPPPPPPP/RNBQKBNR w KQkq - 0 1,e4,31,44,13,1
rnbqkbnr/pppppppp/8/8/4P3/8/PPPP1PPP/RNBQKBNR b KQkq - 0 1,e5,30,36,6,1
rnbqkbnr/pppp1ppp/8/4p3/4P3/8/PPPP1PPP/RNBQKBNR w KQkq - 0 2,Nf3,37,41,4,1
rnbqkbnr/pppp1ppp/8/4p3/4P3/5N2/PPPP1PPP/RNBQKB1R b KQkq - 1 2,Nf6,39,48,9,1
rnbqkb1r/pppp1ppp/5n2/4p3/4P3/5N2/PPPP1PPP/RNBQKB1R w KQkq - 2 3,Nxe5,38,41,3,1
rnbqkb1r/pppp1ppp/5n2/4N3/4P3/8/PPPP1PPP/RNBQKB1R b KQkq - 0 3,Nxe4,29,31,2,1
rnbqkb1r/pppp1ppp/8/4N3/4n3/8/PPPP1PPP/RNBQKB1R w KQkq - 0 4,Qe2,37,97,60,1
rnbqkb1r/pppp1ppp/8/4N3/4n3/8/PPPPQPPP/RNB1KB1R b KQkq - 1 4,d5,92,173,81,1
rnbqkb1r/ppp2ppp/8/3pN3/4n3/8/PPPPQPPP/RNB1KB1R w KQkq - 0 5,d3,144,136,-8,1
rnbqkb1r/ppp2ppp/8/3pN3/4n3/3P4/PPP1QPPP/RNB1KB1R b KQkq - 0 5,Nxf2,110,502,392,1
rnbqkb1r/ppp2ppp/8/3pN3/8/3P4/PPP1QnPP/RNB1KB1R w KQkq - 0 6,Nc6+,522,344,-178,0
rnbqkb1r/ppp2ppp/2N5/3p4/8/3P4/PPP1QnPP/RNB1KB1R b KQkq - 1 6,Be7,394,334,-60,1
rnbqk2r/ppp1bppp/2N5/3p4/8/3P4/PPP1QnPP/RNB1KB1R w KQkq - 2 7,Nxd8,383,365,-18,1
rnbNk2r/ppp1bppp/8/3p4/8/3P4/PPP1QnPP/RNB1KB1R b KQkq - 0 7,Kxd8,371,544,173,1
rnbk3r/ppp1bppp/8/3p4/8/3P4/PPP1QnPP/RNB1KB1R w KQ - 0 8,Qxf2,596,616,20,1
rnbk3r/ppp1bppp/8/3p4/8/3P4/PPP2QPP/RNB1KB1R b KQ - 0 8,Re8,559,598,39,1
rnbkr3/ppp1bppp/8/3p4/8/3P4/PPP2QPP/RNB1KB1R w KQ - 1 9,Be2,587,606,19,1
rnbkr3/ppp1bppp/8/3p4/8/3P4/PPP1BQPP/RNB1K2R b KQ - 2 9,Bg4,611,666,55,1
rn1kr3/ppp1bppp/8/3p4/6b1/3P4/PPP1BQPP/RNB1K2R w KQ - 3 10,Be3,633,569,-64,1
rn1kr3/ppp1bppp/8/3p4/6b1/3PB3/PPP1BQPP/RN2K2R b KQ - 4 10,Bxe2,604,559,-45,1
rn1kr3/ppp1bppp/8/3p4/8/3PB3/PPP1bQPP/RN2K2R w KQ - 0 11,Kxe2,586,508,-78,1
rn1kr3/ppp1bppp/8/3p4/8/3PB3/PPP1KQPP/RN5R b - - 0 11,d4,534,575,41,1
rn1kr3/ppp1bppp/8/8/3p4/3PB3/PPP1KQPP/RN5R w - - 0 12,Qxf7,536,456,-80,1
rn1kr3/ppp1bQpp/8/8/3p4/3PB3/PPP1K1PP/RN5R b - - 0 12,dxe3,496,557,61,1
rn1kr3/ppp1bQpp/8/8/8/3Pp3/PPP1K1PP/RN5R w - - 0 13,Qd5+,596,593,-3,1
rn1kr3/ppp1b1pp/8/3Q4/8/3Pp3/PPP1K1PP/RN5R b - - 1 13,Bd6,565,573,8,1
rn1kr3/ppp3pp/3b4/3Q4/8/3Pp3/PPP1K1PP/RN5R w - - 2 14,Qxb7,628,614,-14,1
rn1kr3/pQp3pp/3b4/8/8/3Pp3/PPP1K1PP/RN5R b - - 0 14,Kd7,640,633,-7,1
rn2r3/pQpk2pp/3b4/8/8/3Pp3/PPP1K1PP/RN5R w - - 1 15,Qxa8,640,662,22,1
Qn2r3/p1pk2pp/3b4/8/8/3Pp3/PPP1K1PP/RN5R b - - 0 15,Nc6,660,669,9,1
Q3r3/p1pk2pp/2nb4/8/8/3Pp3/PPP1K1PP/RN5R w - - 1 16,Qb7,666,432,-234,0
4r3/pQpk2pp/2nb4/8/8/3Pp3/PPP1K1PP/RN5R b - - 2 16,Nb4,468,619,151,1
4r3/pQpk2pp/3b4/8/1n6/3Pp3/PPP1K1PP/RN5R w - - 3 17,Qb5+,639,588,-51,1
4r3/p1pk2pp/3b4/1Q6/1n6/3Pp3/PPP1K1PP/RN5R b - - 4 17,c6,594,628,34,1
4r3/p2k2pp/2pb4/1Q6/1n6/3Pp3/PPP1K1PP/RN5R w - - 0 18,Qb7+,611,689,78,1
4r3/pQ1k2pp/2pb4/8/1n6/3Pp3/PPP1K1PP/RN5R b - - 1 18,Ke6,673,806,133,1
4r3/pQ4pp/2pbk3/8/1n6/3Pp3/PPP1K1PP/RN5R w - - 2 19,Nc3,772,657,-115,0
4r3/pQ4pp/2pbk3/8/1n6/2NPp3/PPP1K1PP/R6R b - - 3 19,Nxc2,773,816,43,1
4r3/pQ4pp/2pbk3/8/8/2NPp3/PPn1K1PP/R6R w - - 0 20,Raf1,834,810,-24,1
4r3/pQ4pp/2pbk3/8/8/2NPp3/PPn1K1PP/5R1R b - - 1 20,Re7,734,887,153,1
8/pQ2r1pp/2pbk3/8/8/2NPp3/PPn1K1PP/5R1R w - - 2 21,Qb3+,963,840,-123,0
8/p3r1pp/2pbk3/8/8/1QNPp3/PPn1K1PP/5R1R b - - 3 21,Kd7,846,844,-2,1
8/p2kr1pp/2pb4/8/8/1QNPp3/PPn1K1PP/5R1R w - - 4 22,Qxc2,822,852,30,1
8/p2kr1pp/2pb4/8/8/2NPp3/PPQ1K1PP/5R1R b - - 0 22,Bc5,861,865,4,1
8/p2kr1pp/2p5/2b5/8/2NPp3/PPQ1K1PP/5R1R w - - 1 23,Ne4,859,879,20,1
8/p2kr1pp/2p5/2b5/4N3/3Pp3/PPQ1K1PP/5R1R b - - 2 23,Bb6,842,882,40,1
8/p2kr1pp/1bp5/8/4N3/3Pp3/PPQ1K1PP/5R1R w - - 3 24,Rf5,920,910,-10,1
8/p2kr1pp/1bp5/5R2/4N3/3Pp3/PPQ1K1PP/7R b - - 4 24,Kc7,897,913,16,1
8/p1k1r1pp/1bp5/5R2/4N3/3Pp3/PPQ1K1PP/7R w - - 5 25,Rhf1,914,847,-67,1
8/p1k1r1pp/1bp5/5R2/4N3/3Pp3/PPQ1K1PP/5R2 b - - 6 25,Kb7,905,884,-21,1
8/pk2r1pp/1bp5/5R2/4N3/3Pp3/PPQ1K1PP/5R2 w - - 7 26,Rf8,996,925,-71,1
5R2/pk2r1pp/1bp5/8/4N3/3Pp3/PPQ1K1PP/5R2 b - - 8 26,h5,972,1162,190,1
5R2/pk2r1p1/1bp5/7p/4N3/3Pp3/PPQ1K1PP/5R2 w - - 0 27,Rh8,1156,866,-290,0
7R/pk2r1p1/1bp5/7p/4N3/3Pp3/PPQ1K1PP/5R2 b - - 1 27,g6,936,9989,9053,1
7R/pk2r3/1bp3p1/7p/4N3/3Pp3/PPQ1K1PP/5R2 w - - 0 28,Rff8,9989,1089,-8900,0
5R1R/pk2r3/1bp3p1/7p/4N3/3Pp3/PPQ1K1PP/8 b - - 1 28,Bc7,959,9994,9035,1
5R1R/pkb1r3/2p3p1/7p/4N3/3Pp3/PPQ1K1PP/8 w - - 2 29,Qb3+,9994,1159,-8835,0
5R1R/pkb1r3/2p3p1/7p/4N3/1Q1Pp3/PP2K1PP/8 b - - 3 29,Ka6,9989,9997,8,1
5R1R/p1b1r3/k1p3p1/7p/4N3/1Q1Pp3/PP2K1PP/8 w - - 4 30,Nc5+,9997,9998,1,1
5R1R/p1b1r3/k1p3p1/2N4p/8/1Q1Pp3/PP2K1PP/8 b - - 5 30,Ka5,9998,9998,0,1
5R1R/p1b1r3/2p3p1/k1N4p/8/1Q1Pp3/PP2K1PP/8 w - - 6 31,Qa4+,9998,9999,1,1
5R1R/p1b1r3/2p3p1/k1N4p/Q7/3Pp3/PP2K1PP/8 b - - 7 31,Kb6,9999,9999,0,1
5R1R/p1b1r3/1kp3p1/2N4p/Q7/3Pp3/PP2K1PP/8 w - - 8 32,Qb4#,9999,10000,1,1
rnbqkbnr/pppppppp/8/8/8/8/PPPPPPPP/RNBQKBNR w KQkq - 0 1,d4,32,16,-16,1
rnbqkbnr/pppppppp/8/8/3P4/8/PPP1PPPP/RNBQKBNR b KQkq - 0 1,c5,21,48,27,1
rnbqkbnr/pp1ppppp/8/2p5/3P4/8/PPP1PPPP/RNBQKBNR w KQkq - 0 2,Nf3,61,-15,-76,1
rnbqkbnr/pp1ppppp/8/2p5/3P4/5N2/PPP1PPPP/RNBQKB1R b KQkq - 1 2,cxd4,-12,-14,-2,1
rnbqkbnr/pp1ppppp/8/8/3p4/5N2/PPP1PPPP/RNBQKB1R w KQkq - 0 3,Nxd4,-3,-12,-9,1
rnbqkbnr/pp1ppppp/8/8/3N4/8/PPP1PPPP/RNBQKB1R b KQkq - 0 3,d5,-26,4,30,1
rnbqkbnr/pp2pppp/8/3p4/3N4/8/PPP1PPPP/RNBQKB1R w KQkq - 0 4,g3,11,-64,-75,1
rnbqkbnr/pp2pppp/8/3p4/3N4/6P1/PPP1PP1P/RNBQKB1R b KQkq - 0 4,e5,-67,-55,12,1
rnbqkbnr/pp3ppp/8/3pp3/3N4/6P1/PPP1PP1P/RNBQKB1R w KQkq - 0 5,Nb3,-65,-50,15,1
rnbqkbnr/pp3ppp/8/3pp3/8/1N4P1/PPP1PP1P/RNBQKB1R b KQkq - 1 5,Nc6,-49,-39,10,1
r1bqkbnr/pp3ppp/2n5/3pp3/8/1N4P1/PPP1PP1P/RNBQKB1R w KQkq - 2 6,Bg2,-40,-59,-19,1
r1bqkbnr/pp3ppp/2n5/3pp3/8/1N4P1/PPP1PPBP/RNBQK2R b KQkq - 3 6,Nf6,-53,-33,20,1
r1bqkb1r/pp3ppp/2n2n2/3pp3/8/1N4P1/PPP1PPBP/RNBQK2R w KQkq - 4 7,O-O,-25,-50,-25,1
r1bqkb1r/pp3ppp/2n2n2/3pp3/8/1N4P1/PPP1PPBP/RNBQ1RK1 b kq - 5 7,Be6,-49,-10,39,1
r2qkb1r/pp3ppp/2n1bn2/3pp3/8/1N4P1/PPP1PPBP/RNBQ1RK1 w kq - 6 8,c4,-7,-124,-117,0
r2qkb1r/pp3ppp/2n1bn2/3pp3/2P5/1N4P1/PP2PPBP/RNBQ1RK1 b kq - 0 8,d4,-170,-69,101,1
r2qkb1r/pp3ppp/2n1bn2/4p3/2Pp4/1N4P1/PP2PPBP/RNBQ1RK1 w kq - 0 9,N1d2,-71,-168,-97,1
r2qkb1r/pp3ppp/2n1bn2/4p3/2Pp4/1N4P1/PP1NPPBP/R1BQ1RK1 b kq - 1 9,Be7,-150,-108,42,1
r2qk2r/pp2bppp/2n1bn2/4p3/2Pp4/1N4P1/PP1NPPBP/R1BQ1RK1 w kq - 2 10,Qc2,-138,-234,-96,1
r2qk2r/pp2bppp/2n1bn2/4p3/2Pp4/1N4P1/PPQNPPBP/R1B2RK1 b kq - 3 10,Nb4,-215,-156,59,1
r2qk2r/pp2bppp/4bn2/4p3/1nPp4/1N4P1/PPQNPPBP/R1B2RK1 w kq - 4 11,Qb1,-142,-163,-21,1
r2qk2r/pp2bppp/4bn2/4p3/1nPp4/1N4P1/PP1NPPBP/RQB2RK1 b kq - 5 11,O-O,-161,-134,27,1
r2q1rk1/pp2bppp/4bn2/4p3/1nPp4/1N4P1/PP1NPPBP/RQB2RK1 w - - 6 12,a3,-126,-208,-82,1
r2q1rk1/pp2bppp/4bn2/4p3/1nPp4/PN4P1/1P1NPPBP/RQB2RK1 b - - 0 12,Nc6,-206,-207,-1,1
r2q1rk1/pp2bppp/2n1bn2/4p3/2Pp4/PN4P1/1P1NPPBP/RQB2RK1 w - - 1 13,Qc2,-211,-249,-38,1
r2q1rk1/pp2bppp/2n1bn2/4p3/2Pp4/PN4P1/1PQNPPBP/R1B2RK1 b - - 2 13,a5,-244,-239,5,1
r2q1rk1/1p2bppp/2n1bn2/p3p3/2Pp4/PN4P1/1PQNPPBP/R1B2RK1 w - - 0 14,Nf3,-233,-228,5,1
r2q1rk1/1p2bppp/2n1bn2/p3p3/2Pp4/PN3NP1/1PQ1PPBP/R1B2RK1 b - - 1 14,Qd7,-248,-202,46,1
r4rk1/1p1qbppp/2n1bn2/p3p3/2Pp4/PN3NP1/1PQ1PPBP/R1B2RK1 w - - 2 15,Ng5,-192,-272,-80,1
r4rk1/1p1qbppp/2n1bn2/p3p1N1/2Pp4/PN4P1/1PQ1PPBP/R1B2RK1 b - - 3 15,Bf5,-251,-268,-17,1
r4rk1/1p1qbppp/2n2n2/p3pbN1/2Pp4/PN4P1/1PQ1PPBP/R1B2RK1 w - - 4 16,Qd1,-264,-370,-106,0
r4rk1/1p1qbppp/2n2n2/p3pbN1/2Pp4/PN4P1/1P2PPBP/R1BQ1RK1 b - - 5 16,h6,-360,-381,-21,1
r4rk1/1p1qbpp1/2n2n1p/p3pbN1/2Pp4/PN4P1/1P2PPBP/R1BQ1RK1 w - - 0 17,Nf3,-350,-350,0,1
r4rk1/1p1qbpp1/2n2n1p/p3pb2/2Pp4/PN3NP1/1P2PPBP/R1BQ1RK1 b - - 1 17,Rad8,-355,-330,25,1
3r1rk1/1p1qbpp1/2n2n1p/p3pb2/2Pp4/PN3NP1/1P2PPBP/R1BQ1RK1 w - - 2 18,Nh4,-355,-354,1,1
3r1rk1/1p1qbpp1/2n2n1p/p3pb2/2Pp3N/PN4P1/1P2PPBP/R1BQ1RK1 b - - 3 18,Bh7,-385,-298,87,1
3r1rk1/1p1qbppb/2n2n1p/p3p3/2Pp3N/PN4P1/1P2PPBP/R1BQ1RK1 w - - 4 19,Nd2,-291,-504,-213,0
3r1rk1/1p1qbppb/2n2n1p/p3p3/2Pp3N/P5P1/1P1NPPBP/R1BQ1RK1 b - - 5 19,g5,-449,-322,127,1
3r1rk1/1p1qbp1b/2n2n1p/p3p1p1/2Pp3N/P5P1/1P1NPPBP/R1BQ1RK1 w - - 0 20,Nhf3,-350,-372,-22,1
3r1rk1/1p1qbp1b/2n2n1p/p3p1p1/2Pp4/P4NP1/1P1NPPBP/R1BQ1RK1 b - - 1 20,e4,-336,-365,-29,1
3r1rk1/1p1qbp1b/2n2n1p/p5p1/2Ppp3/P4NP1/1P1NPPBP/R1BQ1RK1 w - - 0 21,Ne1,-349,-316,33,1
3r1rk1/1p1qbp1b/2n2n1p/p5p1/2Ppp3/P5P1/1P1NPPBP/R1BQNRK1 b - - 1 21,Rfe8,-334,-319,15,1
3rr1k1/1p1qbp1b/2n2n1p/p5p1/2Ppp3/P5P1/1P1NPPBP/R1BQNRK1 w - - 2 22,b3,-311,-380,-69,1
3rr1k1/1p1qbp1b/2n2n1p/p5p1/2Ppp3/PP4P1/3NPPBP/R1BQNRK1 b - - 0 22,b6,-408,-331,77,1
3rr1k1/3qbp1b/1pn2n1p/p5p1/2Ppp3/PP4P1/3NPPBP/R1BQNRK1 w - - 0 23,Bb2,-318,-346,-28,1
3rr1k1/3qbp1b/1pn2n1p/p5p1/2Ppp3/PP4P1/1B1NPPBP/R2QNRK1 b - - 1 23,Bc5,-329,-256,73,1
3rr1k1/3q1p1b/1pn2n1p/p1b3p1/2Ppp3/PP4P1/1B1NPPBP/R2QNRK1 w - - 2 24,Rc1,-252,-374,-122,0
3rr1k1/3q1p1b/1pn2n1p/p1b3p1/2Ppp3/PP4P1/1B1NPPBP/2RQNRK1 b - - 3 24,Qd6,-412,-266,146,1
3rr1k1/5p1b/1pnq1n1p/p1b3p1/2Ppp3/PP4P1/1B1NPPBP/2RQNRK1 w - - 4 25,Kh1,-282,-338,-56,1
3rr1k1/5p1b/1pnq1n1p/p1b3p1/2Ppp3/PP4P1/1B1NPPBP/2RQNR1K b - - 5 25,Bxa3,-337,-299,38,1
3rr1k1/5p1b/1pnq1n1p/p5p1/2Ppp3/bP4P1/1B1NPPBP/2RQNR1K w - - 0 26,Bxa3,-334,-328,6,1
3rr1k1/5p1b/1pnq1n1p/p5p1/2Ppp3/BP4P1/3NPPBP/2RQNR1K b - - 0 26,Qxa3,-325,-310,15,1
3rr1k1/5p1b/1pn2n1p/p5p1/2Ppp3/qP4P1/3NPPBP/2RQNR1K w - - 0 27,Nb1,-321,-402,-81,1
3rr1k1/5p1b/1pn2n1p/p5p1/2Ppp3/qP4P1/4PPBP/1NRQNR1K b - - 1 27,Qd6,-397,-395,2,1
3rr1k1/5p1b/1pnq1n1p/p5p1/2Ppp3/1P4P1/4PPBP/1NRQNR1K w - - 2 28,Nc2,-371,-377,-6,1
3rr1k1/5p1b/1pnq1n1p/p5p1/2Ppp3/1P4P1/2N1PPBP/1NRQ1R1K b - - 3 28,d3,-389,-330,59,1
3rr1k1/5p1b/1pnq1n1p/p5p1/2P1p3/1P1p2P1/2N1PPBP/1NRQ1R1K w - - 0 29,Ne3,-312,-338,-26,1
3rr1k1/5p1b/1pnq1n1p/p5p1/2P1p3/1P1pN1P1/4PPBP/1NRQ1R1K b - - 1 29,dxe2,-335,-238,97,1
3rr1k1/5p1b/1pnq1n1p/p5p1/2P1p3/1P2N1P1/4pPBP/1NRQ1R1K w - - 0 30,Qxe2,-232,-208,24,1
3rr1k1/5p1b/1pnq1n1p/p5p1/2P1p3/1P2N1P1/4QPBP/1NR2R1K b - - 0 30,Nd4,-206,-158,48,1
3rr1k1/5p1b/1p1q1n1p/p5p1/2Pnp3/1P2N1P1/4QPBP/1NR2R1K w - - 1 31,Qd1,-181,-261,-80,1
3rr1k1/5p1b/1p1q1n1p/p5p1/2Pnp3/1P2N1P1/5PBP/1NRQ1R1K b - - 2 31,Bg6,-303,-205,98,1
3rr1k1/5p2/1p1q1nbp/p5p1/2Pnp3/1P2N1P1/5PBP/1NRQ1R1K w - - 3 32,Nc3,-180,-182,-2,1
3rr1k1/5p2/1p1q1nbp/p5p1/2Pnp3/1PN1N1P1/5PBP/2RQ1R1K b - - 4 32,Bh5,-186,-183,3,1
3rr1k1/5p2/1p1q1n1p/p5pb/2Pnp3/1PN1N1P1/5PBP/2RQ1R1K w - - 5 33,Qe1,-207,-301,-94,1
3rr1k1/5p2/1p1q1n1p/p5pb/2Pnp3/1PN1N1P1/5PBP/2R1QR1K b - - 6 33,Nf3,-336,-240,96,1
3rr1k1/5p2/1p1q1n1p/p5pb/2P1p3/1PN1NnP1/5PBP/2R1QR1K w - - 7 34,Bxf3,-327,-531,-204,0
3rr1k1/5p2/1p1q1n1p/p5pb/2P1p3/1PN1NBP1/5P1P/2R1QR1K b - - 0 34,Bxf3+,-451,-536,-85,1
3rr1k1/5p2/1p1q1n1p/p5p1/2P1p3/1PN1NbP1/5P1P/2R1QR1K w - - 0 35,Kg1,-530,-534,-4,1
3rr1k1/5p2/1p1q1n1p/p5p1/2P1p3/1PN1NbP1/5P1P/2R1QRK1 b - - 1 35,Qe6,-575,-423,152,1
3rr1k1/5p2/1p2qn1p/p5p1/2P1p3/1PN1NbP1/5P1P/2R1QRK1 w - - 2 36,Ncd5,-436,-561,-125,0
3rr1k1/5p2/1p2qn1p/p2N2p1/2P1p3/1P2NbP1/5P1P/2R1QRK1 b - - 3 36,Nxd5,-588,-171,417,1
3rr1k1/5p2/1p2q2p/p2n2p1/2P1p3/1P2NbP1/5P1P/2R1QRK1 w - - 0 37,cxd5,-173,-112,61,1
3rr1k1/5p2/1p2q2p/p2P2p1/4p3/1P2NbP1/5P1P/2R1QRK1 b - - 0 37,Qh3,-136,-96,40,1
3rr1k1/5p2/1p5p/p2P2p1/4p3/1P2NbPq/5P1P/2R1QRK1 w - - 1 38,Rc2,-120,-247,-127,0
3rr1k1/5p2/1p5p/p2P2p1/4p3/1P2NbPq/2R2P1P/4QRK1 b - - 2 38,Rxd5,-278,-273,5,1
4r1k1/5p2/1p5p/p2r2p1/4p3/1P2NbPq/2R2P1P/4QRK1 w - - 0 39,Qc3,-287,-293,-6,1
4r1k1/5p2/1p5p/p2r2p1/4p3/1PQ1NbPq/2R2P1P/5RK1 b - - 1 39,Rd3,-262,-284,-22,1
4r1k1/5p2/1p5p/p5p1/4p3/1PQrNbPq/2R2P1P/5RK1 w - - 2 40,Qc6,-277,-287,-10,1
4r1k1/5p2/1pQ4p/p5p1/4p3/1P1rNbPq/2R2P1P/5RK1 b - - 3 40,Rxe3,-254,335,589,1
4r1k1/5p2/1pQ4p/p5p1/4p3/1P2rbPq/2R2P1P/5RK1 w - - 0 41,fxe3,375,0,-375,0
4r1k1/5p2/1pQ4p/p5p1/4p3/1P2PbPq/2R4P/5RK1 b - - 0 41,Rd8,-1,204,205,1
3r2k1/5p2/1pQ4p/p5p1/4p3/1P2PbPq/2R4P/5RK1 w - - 1 42,Qc7,97,-19,-116,0
3r2k1/2Q2p2/1p5p/p5p1/4p3/1P2PbPq/2R4P/5RK1 b - - 2 42,Rd7,0,36,36,1
6k1/2Qr1p2/1p5p/p5p1/4p3/1P2PbPq/2R4P/5RK1 w - - 3 43,Qc8+,54,0,-54,1
2Q3k1/3r1p2/1p5p/p5p1/4p3/1P2PbPq/2R4P/5RK1 b - - 4 43,Kg7,0,191,191,1
2Q5/3r1pk1/1p5p/p5p1/4p3/1P2PbPq/2R4P/5RK1 w - - 5 44,Rd2,216,190,-26,1
2Q5/3r1pk1/1p5p/p5p1/4p3/1P2PbPq/3R3P/5RK1 b - - 6 44,Qxf1+,194,492,298,1
2Q5/3r1pk1/1p5p/p5p1/4p3/1P2PbP1/3R3P/5qK1 w - - 0 45,Kxf1,455,494,39,1
2Q5/3r1pk1/1p5p/p5p1/4p3/1P2PbP1/3R3P/5K2 b - - 0 45,Rxd2,470,493,23,1
2Q5/5pk1/1p5p/p5p1/4p3/1P2PbP1/3r3P/5K2 w - - 0 46,Qc3+,523,511,-12,1
rnbqkbnr/pppppppp/8/8/8/8/PPPPPPPP/RNBQKBNR w KQkq - 0 1,e4,37,35,-2,1
rnbqkbnr/pppppppp/8/8/4P3/8/PPPP1PPP/RNBQKBNR b KQkq - 0 1,c5,37,35,-2,1
rnbqkbnr/pp1ppppp/8/2p5/4P3/8/PPPP1PPP/RNBQKBNR w KQkq - 0 2,Nf3,35,36,1,1
rnbqkbnr/pp1ppppp/8/2p5/4P3/5N2/PPPP1PPP/RNBQKB1R b KQkq - 1 2,Nc6,40,38,-2,1
r1bqkbnr/pp1ppppp/2n5/2p5/4P3/5N2/PPPP1PPP/RNBQKB1R w KQkq - 2 3,Nc3,31,20,-11,1
r1bqkbnr/pp1ppppp/2n5/2p5/4P3/2N2N2/PPPP1PPP/R1BQKB1R b KQkq - 3 3,g6,21,45,24,1
r1bqkbnr/pp1ppp1p/2n3p1/2p5/4P3/2N2N2/PPPP1PPP/R1BQKB1R w KQkq - 0 4,d4,48,35,-13,1
r1bqkbnr/pp1ppp1p/2n3p1/2p5/3PP3/2N2N2/PPP2PPP/R1BQKB1R b KQkq - 0 4,cxd4,49,50,1,1
r1bqkbnr/pp1ppp1p/2n3p1/8/3pP3/2N2N2/PPP2PPP/R1BQKB1R w KQkq - 0 5,Nxd4,47,30,-17,1
r1bqkbnr/pp1ppp1p/2n3p1/8/3NP3/2N5/PPP2PPP/R1BQKB1R b KQkq - 0 5,Bg7,47,52,5,1
r1bqk1nr/pp1pppbp/2n3p1/8/3NP3/2N5/PPP2PPP/R1BQKB1R w KQkq - 1 6,Be3,30,33,3,1
r1bqk1nr/pp1pppbp/2n3p1/8/3NP3/2N1B3/PPP2PPP/R2QKB1R b KQkq - 2 6,Nf6,48,40,-8,1
r1bqk2r/pp1pppbp/2n2np1/8/3NP3/2N1B3/PPP2PPP/R2QKB1R w KQkq - 3 7,Bc4,39,7,-32,1
r1bqk2r/pp1pppbp/2n2np1/8/2BNP3/2N1B3/PPP2PPP/R2QK2R b KQkq - 4 7,O-O,-3,13,16,1
r1bq1rk1/pp1pppbp/2n2np1/8/2BNP3/2N1B3/PPP2PPP/R2QK2R w KQ - 5 8,Qf3,51,-107,-158,0
r1bq1rk1/pp1pppbp/2n2np1/8/2BNP3/2N1BQ2/PPP2PPP/R3K2R b KQ - 6 8,Ne5,-145,-99,46,1
r1bq1rk1/pp1pppbp/5np1/4n3/2BNP3/2N1BQ2/PPP2PPP/R3K2R w KQ - 7 9,Qe2,-127,-125,2,1
r1bq1rk1/pp1pppbp/5np1/4n3/2BNP3/2N1B3/PPP1QPPP/R3K2R b KQ - 8 9,Nxe4,-153,-127,26,1
r1bq1rk1/pp1pppbp/6p1/4n3/2BNn3/2N1B3/PPP1QPPP/R3K2R w KQ - 0 10,Nxe4,-110,-105,5,1
r1bq1rk1/pp1pppbp/6p1/4n3/2BNN3/4B3/PPP1QPPP/R3K2R b KQ - 0 10,Nxc4,-134,-132,2,1
r1bq1rk1/pp1pppbp/6p1/8/2nNN3/4B3/PPP1QPPP/R3K2R w KQ - 0 11,O-O,-130,-374,-244,0
r1bq1rk1/pp1pppbp/6p1/8/2nNN3/4B3/PPP1QPPP/R4RK1 b - - 1 11,d5,-368,-379,-11,1
r1bq1rk1/pp2ppbp/6p1/3p4/2nNN3/4B3/PPP1QPPP/R4RK1 w - - 0 12,Nc3,-368,-333,35,1
r1bq1rk1/pp2ppbp/6p1/3p4/2nN4/2N1B3/PPP1QPPP/R4RK1 b - - 1 12,e5,-355,-329,26,1
r1bq1rk1/pp3pbp/6p1/3pp3/2nN4/2N1B3/PPP1QPPP/R4RK1 w - - 0 13,b3,-328,-662,-334,0
r1bq1rk1/pp3pbp/6p1/3pp3/2nN4/1PN1B3/P1P1QPPP/R4RK1 b - - 0 13,Nxe3,-646,-642,4,1
r1bq1rk1/pp3pbp/6p1/3pp3/3N4/1PN1n3/P1P1QPPP/R4RK1 w - - 0 14,fxe3,-637,-660,-23,1
r1bq1rk1/pp3pbp/6p1/3pp3/3N4/1PN1P3/P1P1Q1PP/R4RK1 b - - 0 14,exd4,-651,-672,-21,1
r1bq1rk1/pp3pbp/6p1/3p4/3p4/1PN1P3/P1P1Q1PP/R4RK1 w - - 0 15,Nb5,-630,-640,-10,1
r1bq1rk1/pp3pbp/6p1/1N1p4/3p4/1P2P3/P1P1Q1PP/R4RK1 b - - 1 15,dxe3,-671,-611,60,1
r1bq1rk1/pp3pbp/6p1/1N1p4/8/1P2p3/P1P1Q1PP/R4RK1 w - - 0 16,Rad1,-573,-621,-48,1
r1bq1rk1/pp3pbp/6p1/1N1p4/8/1P2p3/P1P1Q1PP/3R1RK1 b - - 1 16,Qb6,-713,-613,100,1
r1b2rk1/pp3pbp/1q4p1/1N1p4/8/1P2p3/P1P1Q1PP/3R1RK1 w - - 2 17,Rxd5,-571,-641,-70,1
r1b2rk1/pp3pbp/1q4p1/1N1R4/8/1P2p3/P1P1Q1PP/5RK1 b - - 0 17,Bg4,-673,-654,19,1
r4rk1/pp3pbp/1q4p1/1N1R4/6b1/1P2p3/P1P1Q1PP/5RK1 w - - 1 18,Qxg4,-689,-670,19,1
r4rk1/pp3pbp/1q4p1/1N1R4/6Q1/1P2p3/P1P3PP/5RK1 b - - 0 18,e2+,-698,-712,-14,1
r4rk1/pp3pbp/1q4p1/1N1R4/6Q1/1P6/P1P1p1PP/5RK1 w - - 0 19,Nd4,-685,-735,-50,1
r4rk1/pp3pbp/1q4p1/3R4/3N2Q1/1P6/P1P1p1PP/5RK1 b - - 1 19,exf1=Q+,-755,-705,50,1
r4rk1/pp3pbp/1q4p1/3R4/3N2Q1/1P6/P1P3PP/5qK1 w - - 0 20,Kxf1,-712,-719,-7,1
r4rk1/pp3pbp/1q4p1/3R4/3N2Q1/1P6/P1P3PP/5K2 b - - 0 20,Rfd8,-737,-707,30,1
r2r2k1/pp3pbp/1q4p1/3R4/3N2Q1/1P6/P1P3PP/5K2 w - - 1 21,c4,-720,-728,-8,1
r2r2k1/pp3pbp/1q4p1/3R4/2PN2Q1/1P6/P5PP/5K2 b - - 0 21,Rxd5,-746,-761,-15,1
r5k1/pp3pbp/1q4p1/3r4/2PN2Q1/1P6/P5PP/5K2 w - - 0 22,cxd5,-788,-813,-25,1
r5k1/pp3pbp/1q4p1/3P4/3N2Q1/1P6/P5PP/5K2 b - - 0 22,Bxd4,-819,-810,9,1
rnbqkbnr/pppppppp/8/8/8/8/PPPPPPPP/RNBQKBNR w KQkq - 0 1,e4,37,29,-8,1
rnbqkbnr/pppppppp/8/8/4P3/8/PPPP1PPP/RNBQKBNR b KQkq - 0 1,e5,19,38,19,1
rnbqkbnr/pppp1ppp/8/4p3/4P3/8/PPPP1PPP/RNBQKBNR w KQkq - 0 2,Nf3,41,38,-3,1
rnbqkbnr/pppp1ppp/8/4p3/4P3/5N2/PPPP1PPP/RNBQKB1R b KQkq - 1 2,d6,33,50,17,1
rnbqkbnr/ppp2ppp/3p4/4p3/4P3/5N2/PPPP1PPP/RNBQKB1R w KQkq - 0 3,Bc4,61,29,-32,1
rnbqkbnr/ppp2ppp/3p4/4p3/2B1P3/5N2/PPPP1PPP/RNBQK2R b KQkq - 1 3,Be6,35,95,60,1
rn1qkbnr/ppp2ppp/3pb3/4p3/2B1P3/5N2/PPPP1PPP/RNBQK2R w KQkq - 2 4,Bxe6,80,67,-13,1
rn1qkbnr/ppp2ppp/3pB3/4p3/4P3/5N2/PPPP1PPP/RNBQK2R b KQkq - 0 4,fxe6,64,62,-2,1
rn1qkbnr/ppp3pp/3pp3/4p3/4P3/5N2/PPPP1PPP/RNBQK2R w KQkq - 0 5,d3,78,22,-56,1
rn1qkbnr/ppp3pp/3pp3/4p3/4P3/3P1N2/PPP2PPP/RNBQK2R b KQkq - 0 5,Nf6,16,26,10,1
rn1qkb1r/ppp3pp/3ppn2/4p3/4P3/3P1N2/PPP2PPP/RNBQK2R w KQkq - 1 6,Bg5,26,0,-26,1
rn1qkb1r/ppp3pp/3ppn2/4p1B1/4P3/3P1N2/PPP2PPP/RN1QK2R b KQkq - 2 6,Be7,19,-6,-25,1
rn1qk2r/ppp1b1pp/3ppn2/4p1B1/4P3/3P1N2/PPP2PPP/RN1QK2R w KQkq - 3 7,O-O,-8,-13,-5,1
rn1qk2r/ppp1b1pp/3ppn2/4p1B1/4P3/3P1N2/PPP2PPP/RN1Q1RK1 b kq - 4 7,Nc6,-16,-2,14,1
r2qk2r/ppp1b1pp/2nppn2/4p1B1/4P3/3P1N2/PPP2PPP/RN1Q1RK1 w kq - 5 8,c3,23,10,-13,1
r2qk2r/ppp1b1pp/2nppn2/4p1B1/4P3/2PP1N2/PP3PPP/RN1Q1RK1 b kq - 0 8,Qd7,6,29,23,1
r3k2r/pppqb1pp/2nppn2/4p1B1/4P3/2PP1N2/PP3PPP/RN1Q1RK1 w kq - 1 9,Nbd2,25,9,-16,1
r3k2r/pppqb1pp/2nppn2/4p1B1/4P3/2PP1N2/PP1N1PPP/R2Q1RK1 b kq - 2 9,O-O-O,10,167,157,1
2kr3r/pppqb1pp/2nppn2/4p1B1/4P3/2PP1N2/PP1N1PPP/R2Q1RK1 w - - 3 10,Bxf6,173,-30,-203,0
2kr3r/pppqb1pp/2nppB2/4p3/4P3/2PP1N2/PP1N1PPP/R2Q1RK1 b - - 0 10,gxf6,-42,22,64,1
2kr3r/pppqb2p/2nppp2/4p3/4P3/2PP1N2/PP1N1PPP/R2Q1RK1 w - - 0 11,Nb3,6,-75,-81,1
2kr3r/pppqb2p/2nppp2/4p3/4P3/1NPP1N2/PP3PPP/R2Q1RK1 b - - 1 11,Rdg8,-60,-55,5,1
2k3rr/pppqb2p/2nppp2/4p3/4P3/1NPP1N2/PP3PPP/R2Q1RK1 w - - 2 12,g3,-65,-110,-45,1
2k3rr/pppqb2p/2nppp2/4p3/4P3/1NPP1NP1/PP3P1P/R2Q1RK1 b - - 0 12,h5,-124,-86,38,1
2k3rr/pppqb3/2nppp2/4p2p/4P3/1NPP1NP1/PP3P1P/R2Q1RK1 w - - 0 13,Nh4,-122,-267,-145,0
2k3rr/pppqb3/2nppp2/4p2p/4P2N/1NPP2P1/PP3P1P/R2Q1RK1 b - - 1 13,Rg4,-230,-193,37,1
2k4r/pppqb3/2nppp2/4p2p/4P1rN/1NPP2P1/PP3P1P/R2Q1RK1 w - - 2 14,h3,-192,-112,80,1
2k4r/pppqb3/2nppp2/4p2p/4P1rN/1NPP2PP/PP3P2/R2Q1RK1 b - - 0 14,Rg7,-112,-98,14,1
2k4r/pppqb1r1/2nppp2/4p2p/4P2N/1NPP2PP/PP3P2/R2Q1RK1 w - - 1 15,Kh2,-90,-185,-95,1
2k4r/pppqb1r1/2nppp2/4p2p/4P2N/1NPP2PP/PP3P1K/R2Q1R2 b - - 2 15,Rhg8,-227,-89,138,1
2k3r1/pppqb1r1/2nppp2/4p2p/4P2N/1NPP2PP/PP3P1K/R2Q1R2 w - - 3 16,Ng2,-105,-198,-93,1
2k3r1/pppqb1r1/2nppp2/4p2p/4P3/1NPP2PP/PP3PNK/R2Q1R2 b - - 4 16,h4,-203,-25,178,1
2k3r1/pppqb1r1/2nppp2/4p3/4P2p/1NPP2PP/PP3PNK/R2Q1R2 w - - 0 17,g4,-28,-124,-96,1
2k3r1/pppqb1r1/2nppp2/4p3/4P1Pp/1NPP3P/PP3PNK/R2Q1R2 b - - 0 17,f5,-141,-154,-13,1
2k3r1/pppqb1r1/2npp3/4pp2/4P1Pp/1NPP3P/PP3PNK/R2Q1R2 w - - 0 18,Nxh4,-128,-564,-436,0
2k3r1/pppqb1r1/2npp3/4pp2/4P1PN/1NPP3P/PP3P1K/R2Q1R2 b - - 0 18,fxg4,-539,-400,139,1
2k3r1/pppqb1r1/2npp3/4p3/4P1pN/1NPP3P/PP3P1K/R2Q1R2 w - - 0 19,Ng2,-491,-511,-20,1
2k3r1/pppqb1r1/2npp3/4p3/4P1p1/1NPP3P/PP3PNK/R2Q1R2 b - - 1 19,Rh8,-496,-393,103,1
2k4r/pppqb1r1/2npp3/4p3/4P1p1/1NPP3P/PP3PNK/R2Q1R2 w - - 2 20,h4,-356,-473,-117,0
2k4r/pppqb1r1/2npp3/4p3/4P1pP/1NPP4/PP3PNK/R2Q1R2 b - - 0 20,g3+,-492,-152,340,1
2k4r/pppqb1r1/2npp3/4p3/4P2P/1NPP2p1/PP3PNK/R2Q1R2 w - - 0 21,fxg3,-160,-158,2,1
2k4r/pppqb1r1/2npp3/4p3/4P2P/1NPP2P1/PP4NK/R2Q1R2 b - - 0 21,Rhg8,-163,-53,110,1
2k3r1/pppqb1r1/2npp3/4p3/4P2P/1NPP2P1/PP4NK/R2Q1R2 w - - 1 22,Rf3,-87,-86,1,1
2k3r1/pppqb1r1/2npp3/4p3/4P2P/1NPP1RP1/PP4NK/R2Q4 b - - 2 22,Nd8,-61,-37,24,1
2kn2r1/pppqb1r1/3pp3/4p3/4P2P/1NPP1RP1/PP4NK/R2Q4 w - - 3 23,Qe1,-43,-79,-36,1
2kn2r1/pppqb1r1/3pp3/4p3/4P2P/1NPP1RP1/PP4NK/R3Q3 b - - 4 23,Nf7,-70,89,159,1
2k3r1/pppqbnr1/3pp3/4p3/4P2P/1NPP1RP1/PP4NK/R3Q3 w - - 5 24,Ne3,79,-91,-170,0
2k3r1/pppqbnr1/3pp3/4p3/4P2P/1NPPNRP1/PP5K/R3Q3 b - - 6 24,Nh6,-109,-125,-16,1
2k3r1/pppqb1r1/3pp2n/4p3/4P2P/1NPPNRP1/PP5K/R3Q3 w - - 7 25,Qf2,-116,-144,-28,1
2k3r1/pppqb1r1/3pp2n/4p3/4P2P/1NPPNRP1/PP3Q1K/R7 b - - 8 25,Ng4+,-133,139,272,1
2k3r1/pppqb1r1/3pp3/4p3/4P1nP/1NPPNRP1/PP3Q1K/R7 w - - 9 26,Nxg4,160,171,11,1
2k3r1/pppqb1r1/3pp3/4p3/4P1NP/1NPP1RP1/PP3Q1K/R7 b - - 0 26,Rxg4,184,152,-32,1
2k3r1/pppqb3/3pp3/4p3/4P1rP/1NPP1RP1/PP3Q1K/R7 w - - 0 27,Rg1,158,0,-158,0
2k3r1/pppqb3/3pp3/4p3/4P1rP/1NPP1RP1/PP3Q1K/6R1 b - - 1 27,Rh8,0,256,256,1
2k4r/pppqb3/3pp3/4p3/4P1rP/1NPP1RP1/PP3Q1K/6R1 w - - 2 28,Kg2,257,15,-242,0
2k4r/pppqb3/3pp3/4p3/4P1rP/1NPP1RP1/PP3QK1/6R1 b - - 3 28,Bxh4,-26,7,33,1
2k4r/pppq4/3pp3/4p3/4P1rb/1NPP1RP1/PP3QK1/6R1 w - - 0 29,Kf1,6,0,-6,1
2k4r/pppq4/3pp3/4p3/4P1rb/1NPP1RP1/PP3Q2/5KR1 b - - 1 29,Bg5,0,84,84,1
2k4r/pppq4/3pp3/4p1b1/4P1r1/1NPP1RP1/PP3Q2/5KR1 w - - 2 30,Nd2,89,-131,-220,0
2k4r/pppq4/3pp3/4p1b1/4P1r1/2PP1RP1/PP1N1Q2/5KR1 b - - 3 30,Qb5,-124,7,131,1
2k4r/ppp5/3pp3/1q2p1b1/4P1r1/2PP1RP1/PP1N1Q2/5KR1 w - - 4 31,Nc4,21,-23,-44,1
2k4r/ppp5/3pp3/1q2p1b1/2N1P1r1/2PP1RP1/PP3Q2/5KR1 b - - 5 31,Rd8,-47,158,205,1
2kr4/ppp5/3pp3/1q2p1b1/2N1P1r1/2PP1RP1/PP3Q2/5KR1 w - - 6 32,a3,168,-98,-266,0
2kr4/ppp5/3pp3/1q2p1b1/2N1P1r1/P1PP1RP1/1P3Q2/5KR1 b - - 0 32,Qb3,-36,0,36,1
2kr4/ppp5/3pp3/4p1b1/2N1P1r1/PqPP1RP1/1P3Q2/5KR1 w - - 1 33,Qxa7,0,-80,-80,1
2kr4/Qpp5/3pp3/4p1b1/2N1P1r1/PqPP1RP1/1P6/5KR1 b - - 0 33,Qd1+,-59,80,139,1
2kr4/Qpp5/3pp3/4p1b1/2N1P1r1/P1PP1RP1/1P6/3q1KR1 w - - 1 34,Kg2,61,59,-2,1
2kr4/Qpp5/3pp3/4p1b1/2N1P1r1/P1PP1RP1/1P4K1/3q2R1 b - - 2 34,Qe2+,72,91,19,1
2kr4/Qpp5/3pp3/4p1b1/2N1P1r1/P1PP1RP1/1P2q1K1/6R1 w - - 3 35,Rf2,111,-173,-284,0
2kr4/Qpp5/3pp3/4p1b1/2N1P1r1/P1PP2P1/1P2qRK1/6R1 b - - 4 35,Qxd3,-170,0,170,1
2kr4/Qpp5/3pp3/4p1b1/2N1P1r1/P1Pq2P1/1P3RK1/6R1 w - - 0 36,Qa8+,0,-443,-443,0
Q1kr4/1pp5/3pp3/4p1b1/2N1P1r1/P1Pq2P1/1P3RK1/6R1 b - - 1 36,Kd7,-453,-547,-94,1
Q2r4/1ppk4/3pp3/4p1b1/2N1P1r1/P1Pq2P1/1P3RK1/6R1 w - - 2 37,Qxb7,-431,-9996,-9565,0
3r4/1Qpk4/3pp3/4p1b1/2N1P1r1/P1Pq2P1/1P3RK1/6R1 b - - 0 37,Qxg3+,-9996,-9997,-1,1
3r4/1Qpk4/3pp3/4p1b1/2N1P1r1/P1P3q1/1P3RK1/6R1 w - - 0 38,Kf1,-9997,-9997,0,1
3r4/1Qpk4/3pp3/4p1b1/2N1P1r1/P1P3q1/1P3R2/5KR1 b - - 1 38,Qd3+,-9997,-9998,-1,1
3r4/1Qpk4/3pp3/4p1b1/2N1P1r1/P1Pq4/1P3R2/5KR1 w - - 2 39,Re2,-9998,-9998,0,1
3r4/1Qpk4/3pp3/4p1b1/2N1P1r1/P1Pq4/1P2R3/5KR1 b - - 3 39,Rxg1+,-9998,-9997,1,1
3r4/1Qpk4/3pp3/4p1b1/2N1P3/P1Pq4/1P2R3/5Kr1 w - - 0 40,Kxg1,-9997,-9997,0,1
3r4/1Qpk4/3pp3/4p1b1/2N1P3/P1Pq4/1P2R3/6K1 b - - 0 40,Qxe2,-9997,-661,9336,1
3r4/1Qpk4/3pp3/4p1b1/2N1P3/P1P5/1P2q3/6K1 w - - 0 41,Nb6+,-713,-628,85,1
3r4/1Qpk4/1N1pp3/4p1b1/4P3/P1P5/1P2q3/6K1 b - - 1 41,Ke8,-719,-740,-21,1
3rk3/1Qp5/1N1pp3/4p1b1/4P3/P1P5/1P2q3/6K1 w - - 2 42,Qxc7,-715,-9997,-9282,0
3rk3/2Q5/1N1pp3/4p1b1/4P3/P1P5/1P2q3/6K1 b - - 0 42,Be3+,-9997,-9998,-1,1
3rk3/2Q5/1N1pp3/4p3/4P3/P1P1b3/1P2q3/6K1 w - - 1 43,Kh1,-9998,-9998,0,1
3rk3/2Q5/1N1pp3/4p3/4P3/P1P1b3/1P2q3/7K b - - 2 43,Qf1+,-9998,-9999,-1,1
3rk3/2Q5/1N1pp3/4p3/4P3/P1P1b3/1P6/5q1K w - - 3 44,Kh2,-9999,-9999,0,1
3rk3/2Q5/1N1pp3/4p3/4P3/P1P1b3/1P5K/5q2 b - - 4 44,Qg1+,-9999,-605,9394,1
3rk3/2Q5/1N1pp3/4p3/4P3/P1P1b3/1P5K/6q1 w - - 5 45,Kh3,-568,-627,-59,1
3rk3/2Q5/1N1pp3/4p3/4P3/P1P1b2K/1P6/6q1 b - - 6 45,Qh1+,-642,-622,20,1
3rk3/2Q5/1N1pp3/4p3/4P3/P1P1b2K/1P6/7q w - - 7 46,Kg4,-630,-627,3,1
3rk3/2Q5/1N1pp3/4p3/4P1K1/P1P1b3/1P6/7q b - - 8 46,Qg2+,-632,-642,-10,1
3rk3/2Q5/1N1pp3/4p3/4P1K1/P1P1b3/1P4q1/8 w - - 9 47,Kh5,-567,-9999,-9432,0
3rk3/2Q5/1N1pp3/4p2K/4P3/P1P1b3/1P4q1/8 b - - 10 47,Qh3+,-9999,-9999,0,1
3rk3/2Q5/1N1pp3/4p2K/4P3/P1P1b2q/1P6/8 w - - 11 48,Kg6,-9999,-9999,0,1
3rk3/2Q5/1N1pp1K1/4p3/4P3/P1P1b2q/1P6/8 b - - 12 48,Qh6#,-9999,-10000,-1,1
rnbqkbnr/pppppppp/8/8/8/8/PPPPPPPP/RNBQKBNR w KQkq - 0 1,e4,26,31,5,1
rnbqkbnr/pppppppp/8/8/4P3/8/PPPP1PPP/RNBQKBNR b KQkq - 0 1,e5,23,33,10,1
rnbqkbnr/pppp1ppp/8/4p3/4P3/8/PPPP1PPP/RNBQKBNR w KQkq - 0 2,d4,35,-19,-54,1
rnbqkbnr/pppp1ppp/8/4p3/3PP3/8/PPP2PPP/RNBQKBNR b KQkq - 0 2,d6,-6,46,52,1
rnbqkbnr/ppp2ppp/3p4/4p3/3PP3/8/PPP2PPP/RNBQKBNR w KQkq - 0 3,d5,42,14,-28,1
rnbqkbnr/ppp2ppp/3p4/3Pp3/4P3/8/PPP2PPP/RNBQKBNR b KQkq - 0 3,Nd7,32,45,13,1
r1bqkbnr/pppn1ppp/3p4/3Pp3/4P3/8/PPP2PPP/RNBQKBNR w KQkq - 1 4,Nf3,34,35,1,1
r1bqkbnr/pppn1ppp/3p4/3Pp3/4P3/5N2/PPP2PPP/RNBQKB1R b KQkq - 2 4,Ne7,27,62,35,1
r1bqkb1r/pppnnppp/3p4/3Pp3/4P3/5N2/PPP2PPP/RNBQKB1R w KQkq - 3 5,Bb5,61,-17,-78,1
r1bqkb1r/pppnnppp/3p4/1B1Pp3/4P3/5N2/PPP2PPP/RNBQK2R b KQkq - 4 5,f5,-27,296,323,1
r1bqkb1r/pppnn1pp/3p4/1B1Ppp2/4P3/5N2/PPP2PPP/RNBQK2R w KQkq - 0 6,exf5,281,64,-217,0
r1bqkb1r/pppnn1pp/3p4/1B1PpP2/8/5N2/PPP2PPP/RNBQK2R b KQkq - 0 6,Nxf5,24,221,197,1
r1bqkb1r/pppn2pp/3p4/1B1Ppn2/8/5N2/PPP2PPP/RNBQK2R w KQkq - 0 7,g4,232,108,-124,0
r1bqkb1r/pppn2pp/3p4/1B1Ppn2/6P1/5N2/PPP2P1P/RNBQK2R b KQkq - 0 7,Ne7,113,165,52,1
r1bqkb1r/pppnn1pp/3p4/1B1Pp3/6P1/5N2/PPP2P1P/RNBQK2R w KQkq - 1 8,Ng5,205,141,-64,1
r1bqkb1r/pppnn1pp/3p4/1B1Pp1N1/6P1/8/PPP2P1P/RNBQK2R b KQkq - 2 8,a6,155,280,125,1
r1bqkb1r/1ppnn1pp/p2p4/1B1Pp1N1/6P1/8/PPP2P1P/RNBQK2R w KQkq - 0 9,Ne6,281,283,2,1
r1bqkb1r/1ppnn1pp/p2pN3/1B1Pp3/6P1/8/PPP2P1P/RNBQK2R b KQkq - 1 9,axb5,268,312,44,1
r1bqkb1r/1ppnn1pp/3pN3/1p1Pp3/6P1/8/PPP2P1P/RNBQK2R w KQkq - 0 10,Nxd8,301,281,-20,1
r1bNkb1r/1ppnn1pp/3p4/1p1Pp3/6P1/8/PPP2P1P/RNBQK2R b KQkq - 0 10,Kxd8,282,285,3,1
r1bk1b1r/1ppnn1pp/3p4/1p1Pp3/6P1/8/PPP2P1P/RNBQK2R w KQ - 0 11,Bg5,265,230,-35,1
r1bk1b1r/1ppnn1pp/3p4/1p1Pp1B1/6P1/8/PPP2P1P/RN1QK2R b KQ - 1 11,h6,227,237,10,1
r1bk1b1r/1ppnn1p1/3p3p/1p1Pp1B1/6P1/8/PPP2P1P/RN1QK2R w KQ - 0 12,Bxe7+,221,241,20,1
r1bk1b1r/1ppnB1p1/3p3p/1p1Pp3/6P1/8/PPP2P1P/RN1QK2R b KQ - 0 12,Bxe7,207,221,14,1
r1bk3r/1ppnb1p1/3p3p/1p1Pp3/6P1/8/PPP2P1P/RN1QK2R w KQ - 0 13,Nc3,220,207,-13,1
r1bk3r/1ppnb1p1/3p3p/1p1Pp3/6P1/2N5/PPP2P1P/R2QK2R b KQ - 1 13,Rf8,225,259,34,1
r1bk1r2/1ppnb1p1/3p3p/1p1Pp3/6P1/2N5/PPP2P1P/R2QK2R w KQ - 2 14,Nxb5,247,175,-72,1
r1bk1r2/1ppnb1p1/3p3p/1N1Pp3/6P1/8/PPP2P1P/R2QK2R b KQ - 0 14,Ra5,188,274,86,1
2bk1r2/1ppnb1p1/3p3p/rN1Pp3/6P1/8/PPP2P1P/R2QK2R w KQ - 1 15,a4,287,266,-21,1
2bk1r2/1ppnb1p1/3p3p/rN1Pp3/P5P1/8/1PP2P1P/R2QK2R b KQ - 0 15,Bh4,276,345,69,1
2bk1r2/1ppn2p1/3p3p/rN1Pp3/P5Pb/8/1PP2P1P/R2QK2R w KQ - 1 16,Rf1,335,215,-120,0
2bk1r2/1ppn2p1/3p3p/rN1Pp3/P5Pb/8/1PP2P1P/R2QKR2 b Q - 2 16,Nf6,208,278,70,1
2bk1r2/1pp3p1/3p1n1p/rN1Pp3/P5Pb/8/1PP2P1P/R2QKR2 w Q - 3 17,Qd2,246,236,-10,1
2bk1r2/1pp3p1/3p1n1p/rN1Pp3/P5Pb/8/1PPQ1P1P/R3KR2 b Q - 4 17,Nxg4,268,530,262,1
2bk1r2/1pp3p1/3p3p/rN1Pp3/P5nb/8/1PPQ1P1P/R3KR2 w Q - 0 18,Qxa5,521,556,35,1
2bk1r2/1pp3p1/3p3p/QN1Pp3/P5nb/8/1PP2P1P/R3KR2 b Q - 0 18,Bxf2+,542,993,451,1
2bk1r2/1pp3p1/3p3p/QN1Pp3/P5n1/8/1PP2b1P/R3KR2 w Q - 0 19,Rxf2,9993,9994,1,1
2bk1r2/1pp3p1/3p3p/QN1Pp3/P5n1/8/1PP2R1P/R3K3 b Q - 0 19,Nxf2,9994,9998,4,1
2bk1r2/1pp3p1/3p3p/QN1Pp3/P7/8/1PP2n1P/R3K3 w Q - 0 20,Qxc7+,9998,9999,1,1
2bk1r2/1pQ3p1/3p3p/1N1Pp3/P7/8/1PP2n1P/R3K3 b Q - 0 20,Ke8,9999,9999,0,1
2b1kr2/1pQ3p1/3p3p/1N1Pp3/P7/8/1PP2n1P/R3K3 w Q - 1 21,Qxc8+,9999,9995,-4,1
2Q1kr2/1p4p1/3p3p/1N1Pp3/P7/8/1PP2n1P/R3K3 b Q - 0 21,Kf7,9995,9999,4,1
2Q2r2/1p3kp1/3p3p/1N1Pp3/P7/8/1PP2n1P/R3K3 w Q - 1 22,Nxd6+,9999,746,-9253,0
2Q2r2/1p3kp1/3N3p/3Pp3/P7/8/1PP2n1P/R3K3 b Q - 0 22,Kg8,812,850,38,1
2Q2rk1/1p4p1/3N3p/3Pp3/P7/8/1PP2n1P/R3K3 w Q - 1 23,Qe6+,844,714,-130,0
5rk1/1p4p1/3NQ2p/3Pp3/P7/8/1PP2n1P/R3K3 b Q - 2 23,Kh8,697,764,67,1
5r1k/1p4p1/3NQ2p/3Pp3/P7/8/1PP2n1P/R3K3 w Q - 3 24,Nf7+,740,785,45,1
5r1k/1p3Np1/4Q2p/3Pp3/P7/8/1PP2n1P/R3K3 b Q - 4 24,Kh7,779,788,9,1
5r2/1p3Npk/4Q2p/3Pp3/P7/8/1PP2n1P/R3K3 w Q - 5 25,Kxf2,811,862,51,1
5r2/1p3Npk/4Q2p/3Pp3/P7/8/1PP2K1P/R7 b - - 0 25,Rxf7+,831,981,150,1
8/1p3rpk/4Q2p/3Pp3/P7/8/1PP2K1P/R7 w - - 0 26,Qxf7,1045,1079,34,1
8/1p3Qpk/7p/3Pp3/P7/8/1PP2K1P/R7 b - - 0 26,Kh8,1126,9992,8866,1
7k/1p3Qp1/7p/3Pp3/P7/8/1PP2K1P/R7 w - - 1 27,Rg1,9992,9996,4,1
7k/1p3Qp1/7p/3Pp3/P7/8/1PP2K1P/6R1 b - - 2 27,g5,9996,9996,0,1
7k/1p3Q2/7p/3Pp1p1/P7/8/1PP2K1P/6R1 w - - 0 28,Qf8+,9996,9995,-1,1
5Q1k/1p6/7p/3Pp1p1/P7/8/1PP2K1P/6R1 b - - 1 28,Kh7,9995,9995,0,1
5Q2/1p5k/7p/3Pp1p1/P7/8/1PP2K1P/6R1 w - - 2 29,h4,9995,1007,-8988,0
5Q2/1p5k/7p/3Pp1p1/P6P/8/1PP2K2/6R1 b - - 0 29,gxh4,1173,9999,8826,1
5Q2/1p5k/7p/3Pp3/P6p/8/1PP2K2/6R1 w - - 0 30,Qg7#,9999,10000,1,1
rnbqkbnr/pppppppp/8/8/8/8/PPPPPPPP/RNBQKBNR w KQkq - 0 1,e4,29,22,-7,1
rnbqkbnr/pppppppp/8/8/4P3/8/PPPP1PPP/RNBQKBNR b KQkq - 0 1,e5,37,29,-8,1
rnbqkbnr/pppp1ppp/8/4p3/4P3/8/PPPP1PPP/RNBQKBNR w KQkq - 0 2,Nf3,27,29,2,1
rnbqkbnr/pppp1ppp/8/4p3/4P3/5N2/PPPP1PPP/RNBQKB1R b KQkq - 1 2,Nf6,31,22,-9,1
rnbqkb1r/pppp1ppp/5n2/4p3/4P3/5N2/PPPP1PPP/RNBQKB1R w KQkq - 2 3,d3,39,-11,-50,1
rnbqkb1r/pppp1ppp/5n2/4p3/4P3/3P1N2/PPP2PPP/RNBQKB1R b KQkq - 0 3,d6,-9,11,20,1
rnbqkb1r/ppp2ppp/3p1n2/4p3/4P3/3P1N2/PPP2PPP/RNBQKB1R w KQkq - 0 4,Be2,18,8,-10,1
rnbqkb1r/ppp2ppp/3p1n2/4p3/4P3/3P1N2/PPP1BPPP/RNBQK2R b KQkq - 1 4,Nbd7,3,35,32,1
r1bqkb1r/pppn1ppp/3p1n2/4p3/4P3/3P1N2/PPP1BPPP/RNBQK2R w KQkq - 2 5,O-O,35,34,-1,1
r1bqkb1r/pppn1ppp/3p1n2/4p3/4P3/3P1N2/PPP1BPPP/RNBQ1RK1 b kq - 3 5,a6,37,48,11,1
r1bqkb1r/1ppn1ppp/p2p1n2/4p3/4P3/3P1N2/PPP1BPPP/RNBQ1RK1 w kq - 0 6,Nc3,41,14,-27,1
r1bqkb1r/1ppn1ppp/p2p1n2/4p3/4P3/2NP1N2/PPP1BPPP/R1BQ1RK1 b kq - 1 6,c6,11,60,49,1
r1bqkb1r/1p1n1ppp/p1pp1n2/4p3/4P3/2NP1N2/PPP1BPPP/R1BQ1RK1 w kq - 0 7,Be3,21,5,-16,1
r1bqkb1r/1p1n1ppp/p1pp1n2/4p3/4P3/2NPBN2/PPP1BPPP/R2Q1RK1 b kq - 1 7,b6,16,50,34,1
r1bqkb1r/3n1ppp/pppp1n2/4p3/4P3/2NPBN2/PPP1BPPP/R2Q1RK1 w kq - 0 8,Qc1,53,21,-32,1
r1bqkb1r/3n1ppp/pppp1n2/4p3/4P3/2NPBN2/PPP1BPPP/R1Q2RK1 b kq - 1 8,Ng4,22,35,13,1
r1bqkb1r/3n1ppp/pppp4/4p3/4P1n1/2NPBN2/PPP1BPPP/R1Q2RK1 w kq - 2 9,h3,35,-9,-44,1
r1bqkb1r/3n1ppp/pppp4/4p3/4P1n1/2NPBN1P/PPP1BPP1/R1Q2RK1 b kq - 0 9,Nxe3,-13,-3,10,1
r1bqkb1r/3n1ppp/pppp4/4p3/4P3/2NPnN1P/PPP1BPP1/R1Q2RK1 w kq - 0 10,Qxe3,-4,-12,-8,1
r1bqkb1r/3n1ppp/pppp4/4p3/4P3/2NPQN1P/PPP1BPP1/R4RK1 b kq - 0 10,Be7,16,19,3,1
r1bqk2r/3nbppp/pppp4/4p3/4P3/2NPQN1P/PPP1BPP1/R4RK1 w kq - 1 11,Nh2,13,-132,-145,0
r1bqk2r/3nbppp/pppp4/4p3/4P3/2NPQ2P/PPP1BPPN/R4RK1 b kq - 2 11,Nf6,-87,-46,41,1
r1bqk2r/4bppp/pppp1n2/4p3/4P3/2NPQ2P/PPP1BPPN/R4RK1 w kq - 3 12,Bf3,-38,-52,-14,1
r1bqk2r/4bppp/pppp1n2/4p3/4P3/2NPQB1P/PPP2PPN/R4RK1 b kq - 4 12,Be6,-49,-41,8,1
r2qk2r/4bppp/ppppbn2/4p3/4P3/2NPQB1P/PPP2PPN/R4RK1 w kq - 5 13,Na4,-40,-83,-43,1
r2qk2r/4bppp/ppppbn2/4p3/N3P3/3PQB1P/PPP2PPN/R4RK1 b kq - 6 13,Rb8,-78,-45,33,1
1r1qk2r/4bppp/ppppbn2/4p3/N3P3/3PQB1P/PPP2PPN/R4RK1 w k - 7 14,Rfe1,-70,-86,-16,1
1r1qk2r/4bppp/ppppbn2/4p3/N3P3/3PQB1P/PPP2PPN/R3R1K1 b k - 8 14,d5,-92,23,115,1
1r1qk2r/4bppp/ppp1bn2/3pp3/N3P3/3PQB1P/PPP2PPN/R3R1K1 w k - 0 15,exd5,15,7,-8,1
1r1qk2r/4bppp/ppp1bn2/3Pp3/N7/3PQB1P/PPP2PPN/R3R1K1 b k - 0 15,Bxd5,6,145,139,1
1r1qk2r/4bppp/ppp2n2/3bp3/N7/3PQB1P/PPP2PPN/R3R1K1 w k - 0 16,Qxe5,136,167,31,1
1r1qk2r/4bppp/ppp2n2/3bQ3/N7/3P1B1P/PPP2PPN/R3R1K1 b k - 0 16,O-O,162,508,346,1
1r1q1rk1/4bppp/ppp2n2/3bQ3/N7/3P1B1P/PPP2PPN/R3R1K1 w - - 1 17,Qxe7,505,524,19,1
1r1q1rk1/4Qppp/ppp2n2/3b4/N7/3P1B1P/PPP2PPN/R3R1K1 b - - 0 17,b5,506,524,18,1
1r1q1rk1/4Qppp/p1p2n2/1p1b4/N7/3P1B1P/PPP2PPN/R3R1K1 w - - 0 18,Qxd8,514,524,10,1
1r1Q1rk1/5ppp/p1p2n2/1p1b4/N7/3P1B1P/PPP2PPN/R3R1K1 b - - 0 18,Rbxd8,502,518,16,1
3r1rk1/5ppp/p1p2n2/1p1b4/N7/3P1B1P/PPP2PPN/R3R1K1 w - - 0 19,Bxd5,505,468,-37,1
3r1rk1/5ppp/p1p2n2/1p1B4/N7/3P3P/PPP2PPN/R3R1K1 b - - 0 19,Nxd5,474,466,-8,1
3r1rk1/5ppp/p1p5/1p1n4/N7/3P3P/PPP2PPN/R3R1K1 w - - 0 20,Nc5,445,459,14,1
3r1rk1/5ppp/p1p5/1pNn4/8/3P3P/PPP2PPN/R3R1K1 b - - 1 20,h6,489,512,23,1
3r1rk1/5pp1/p1p4p/1pNn4/8/3P3P/PPP2PPN/R3R1K1 w - - 0 21,Re2,536,495,-41,1
3r1rk1/5pp1/p1p4p/1pNn4/8/3P3P/PPP1RPPN/R5K1 b - - 1 21,a5,505,489,-16,1
3r1rk1/5pp1/2p4p/ppNn4/8/3P3P/PPP1RPPN/R5K1 w - - 0 22,Rae1,481,453,-28,1
3r1rk1/5pp1/2p4p/ppNn4/8/3P3P/PPP1RPPN/4R1K1 b - - 1 22,Nf4,532,549,17,1
3r1rk1/5pp1/2p4p/ppN5/5n2/3P3P/PPP1RPPN/4R1K1 w - - 2 23,Re4,560,549,-11,1
3r1rk1/5pp1/2p4p/ppN5/4Rn2/3P3P/PPP2PPN/4R1K1 b - - 3 23,Nd5,558,517,-41,1
3r1rk1/5pp1/2p4p/ppNn4/4R3/3P3P/PPP2PPN/4R1K1 w - - 4 24,Nf3,519,542,23,1
3r1rk1/5pp1/2p4p/ppNn4/4R3/3P1N1P/PPP2PP1/4R1K1 b - - 5 24,f5,550,569,19,1
3r1rk1/6p1/2p4p/ppNn1p2/4R3/3P1N1P/PPP2PP1/4R1K1 w - - 0 25,Re5,582,561,-21,1
3r1rk1/6p1/2p4p/ppNnRp2/8/3P1N1P/PPP2PP1/4R1K1 b - - 1 25,Kh7,588,640,52,1
3r1r2/6pk/2p4p/ppNnRp2/8/3P1N1P/PPP2PP1/4R1K1 w - - 2 26,Ne6,671,642,-29,1
3r1r2/6pk/2p1N2p/pp1nRp2/8/3P1N1P/PPP2PP1/4R1K1 b - - 3 26,Rfe8,646,664,18,1
3rr3/6pk/2p1N2p/pp1nRp2/8/3P1N1P/PPP2PP1/4R1K1 w - - 4 27,Nxd8,650,634,-16,1
3Nr3/6pk/2p4p/pp1nRp2/8/3P1N1P/PPP2PP1/4R1K1 b - - 0 27,Rxe5,663,744,81,1
3N4/6pk/2p4p/pp1nrp2/8/3P1N1P/PPP2PP1/4R1K1 w - - 0 28,Rxe5,761,768,7,1
3N4/6pk/2p4p/pp1nRp2/8/3P1N1P/PPP2PP1/6K1 b - - 0 28,Nf4,774,823,49,1
3N4/6pk/2p4p/pp2Rp2/5n2/3P1N1P/PPP2PP1/6K1 w - - 1 29,Rxf5,810,769,-41,1
3N4/6pk/2p4p/pp3R2/5n2/3P1N1P/PPP2PP1/6K1 b - - 0 29,Ne2+,797,825,28,1
3N4/6pk/2p4p/pp3R2/8/3P1N1P/PPP1nPP1/6K1 w - - 1 30,Kh2,853,839,-14,1
3N4/6pk/2p4p/pp3R2/8/3P1N1P/PPP1nPPK/8 b - - 2 30,Nc1,844,850,6,1
3N4/6pk/2p4p/pp3R2/8/3P1N1P/PPP2PPK/2n5 w - - 3 31,Nxc6,888,883,-5,1
8/6pk/2N4p/pp3R2/8/3P1N1P/PPP2PPK/2n5 b - - 0 31,Nxa2,891,885,-6,1
8/6pk/2N4p/pp3R2/8/3P1N1P/nPP2PPK/8 w - - 0 32,Nxa5,898,817,-81,1
8/6pk/7p/Np3R2/8/3P1N1P/nPP2PPK/8 b - - 0 32,Nb4,865,867,2,1
8/6pk/7p/Np3R2/1n6/3P1N1P/1PP2PPK/8 w - - 1 33,Rxb5,874,841,-33,1
8/6pk/7p/NR6/1n6/3P1N1P/1PP2PPK/8 b - - 0 33,Nxc2,863,876,13,1
8/6pk/7p/NR6/8/3P1N1P/1Pn2PPK/8 w - - 0 34,d4,858,832,-26,1
8/6pk/7p/NR6/3P4/5N1P/1Pn2PPK/8 b - - 0 34,Nxd4,830,873,43,1
8/6pk/7p/NR6/3n4/5N1P/1P3PPK/8 w - - 0 35,Nxd4,873,850,-23,1
8/6pk/7p/NR6/3N4/7P/1P3PPK/8 b - - 0 35,Kg6,880,887,7,1
8/6p1/6kp/NR6/3N4/7P/1P3PPK/8 w - - 1 36,Re5,874,836,-38,1
8/6p1/6kp/N3R3/3N4/7P/1P3PPK/8 b - - 2 36,Kf6,838,871,33,1
8/6p1/5k1p/N3R3/3N4/7P/1P3PPK/8 w - - 3 37,f4,870,848,-22,1
8/6p1/5k1p/N3R3/3N1P2/7P/1P4PK/8 b - - 0 37,g5,853,866,13,1
8/8/5k1p/N3R1p1/3N1P2/7P/1P4PK/8 w - - 0 38,fxg5+,857,692,-165,0
8/8/5k1p/N3R1P1/3N4/7P/1P4PK/8 b - - 0 38,Kxe5,754,873,119,1
8/8/7p/N3k1P1/3N4/7P/1P4PK/8 w - - 0 39,gxh6,890,699,-191,0
8/8/7P/N3k3/3N4/7P/1P4PK/8 b - - 0 39,Kf6,701,760,59,1
8/8/5k1P/N7/3N4/7P/1P4PK/8 w - - 1 40,b4,803,791,-12,1
8/8/5k1P/N7/1P1N4/7P/6PK/8 b - - 0 40,Kg6,892,911,19,1
8/8/6kP/N7/1P1N4/7P/6PK/8 w - - 1 41,b5,912,850,-62,1
8/8/6kP/NP6/3N4/7P/6PK/8 b - - 0 41,Kxh6,928,937,9,1
8/8/7k/NP6/3N4/7P/6PK/8 w - - 0 42,b6,932,915,-17,1
8/8/1P5k/N7/3N4/7P/6PK/8 b - - 0 42,Kg7,910,933,23,1
8/6k1/1P6/N7/3N4/7P/6PK/8 w - - 1 43,b7,844,920,76,1
rnbqkbnr/pppppppp/8/8/8/8/PPPPPPPP/RNBQKBNR w KQkq - 0 1,d4,30,17,-13,1
rnbqkbnr/pppppppp/8/8/3P4/8/PPP1PPPP/RNBQKBNR b KQkq - 0 1,d5,18,21,3,1
rnbqkbnr/ppp1pppp/8/3p4/3P4/8/PPP1PPPP/RNBQKBNR w KQkq - 0 2,c4,22,24,2,1
rnbqkbnr/ppp1pppp/8/3p4/2PP4/8/PP2PPPP/RNBQKBNR b KQkq - 0 2,c6,21,26,5,1
rnbqkbnr/pp2pppp/2p5/3p4/2PP4/8/PP2PPPP/RNBQKBNR w KQkq - 0 3,Nc3,25,24,-1,1
rnbqkbnr/pp2pppp/2p5/3p4/2PP4/2N5/PP2PPPP/R1BQKBNR b KQkq - 1 3,Nf6,24,32,8,1
rnbqkb1r/pp2pppp/2p2n2/3p4/2PP4/2N5/PP2PPPP/R1BQKBNR w KQkq - 2 4,Nf3,32,23,-9,1
rnbqkb1r/pp2pppp/2p2n2/3p4/2PP4/2N2N2/PP2PPPP/R1BQKB1R b KQkq - 3 4,Bf5,17,52,35,1
rn1qkb1r/pp2pppp/2p2n2/3p1b2/2PP4/2N2N2/PP2PPPP/R1BQKB1R w KQkq - 4 5,Bf4,51,20,-31,1
rn1qkb1r/pp2pppp/2p2n2/3p1b2/2PP1B2/2N2N2/PP2PPPP/R2QKB1R b KQkq - 5 5,Nbd7,11,50,39,1
r2qkb1r/pp1npppp/2p2n2/3p1b2/2PP1B2/2N2N2/PP2PPPP/R2QKB1R w KQkq - 6 6,e3,66,37,-29,1
r2qkb1r/pp1npppp/2p2n2/3p1b2/2PP1B2/2N1PN2/PP3PPP/R2QKB1R b KQkq - 0 6,h6,45,49,4,1
r2qkb1r/pp1nppp1/2p2n1p/3p1b2/2PP1B2/2N1PN2/PP3PPP/R2QKB1R w KQkq - 0 7,Be2,45,22,-23,1
r2qkb1r/pp1nppp1/2p2n1p/3p1b2/2PP1B2/2N1PN2/PP2BPPP/R2QK2R b KQkq - 1 7,Nh5,26,165,139,1
r2qkb1r/pp1nppp1/2p4p/3p1b1n/2PP1B2/2N1PN2/PP2BPPP/R2QK2R w KQkq - 2 8,cxd5,138,136,-2,1
r2qkb1r/pp1nppp1/2p4p/3P1b1n/3P1B2/2N1PN2/PP2BPPP/R2QK2R b KQkq - 0 8,Nxf4,118,145,27,1
r2qkb1r/pp1nppp1/2p4p/3P1b2/3P1n2/2N1PN2/PP2BPPP/R2QK2R w KQkq - 0 9,exf4,159,135,-24,1
r2qkb1r/pp1nppp1/2p4p/3P1b2/3P1P2/2N2N2/PP2BPPP/R2QK2R b KQkq - 0 9,Rc8,150,209,59,1
2rqkb1r/pp1nppp1/2p4p/3P1b2/3P1P2/2N2N2/PP2BPPP/R2QK2R w KQk - 1 10,dxc6,225,259,34,1
2rqkb1r/pp1nppp1/2P4p/5b2/3P1P2/2N2N2/PP2BPPP/R2QK2R b KQk - 0 10,Rxc6,236,285,49,1
3qkb1r/pp1nppp1/2r4p/5b2/3P1P2/2N2N2/PP2BPPP/R2QK2R w KQk - 0 11,d5,271,248,-23,1
3qkb1r/pp1nppp1/2r4p/3P1b2/5P2/2N2N2/PP2BPPP/R2QK2R b KQk - 0 11,Rc8,267,355,88,1
2rqkb1r/pp1nppp1/7p/3P1b2/5P2/2N2N2/PP2BPPP/R2QK2R w KQk - 1 12,O-O,303,302,-1,1
2rqkb1r/pp1nppp1/7p/3P1b2/5P2/2N2N2/PP2BPPP/R2Q1RK1 b k - 2 12,e6,295,371,76,1
2rqkb1r/pp1n1pp1/4p2p/3P1b2/5P2/2N2N2/PP2BPPP/R2Q1RK1 w k - 0 13,Bc4,422,-206,-628,0
2rqkb1r/pp1n1pp1/4p2p/3P1b2/2B2P2/2N2N2/PP3PPP/R2Q1RK1 b k - 1 13,Rxc4,-187,-231,-44,1
3qkb1r/pp1n1pp1/4p2p/3P1b2/2r2P2/2N2N2/PP3PPP/R2Q1RK1 w k - 0 14,Qd2,-219,-289,-70,1
3qkb1r/pp1n1pp1/4p2p/3P1b2/2r2P2/2N2N2/PP1Q1PPP/R4RK1 b k - 1 14,Bb4,-332,-279,53,1
3qk2r/pp1n1pp1/4p2p/3P1b2/1br2P2/2N2N2/PP1Q1PPP/R4RK1 w k - 2 15,Rfe1,-255,-391,-136,0
3qk2r/pp1n1pp1/4p2p/3P1b2/1br2P2/2N2N2/PP1Q1PPP/R3R1K1 b k - 3 15,O-O,-329,-359,-30,1
3q1rk1/pp1n1pp1/4p2p/3P1b2/1br2P2/2N2N2/PP1Q1PPP/R3R1K1 w - - 4 16,dxe6,-396,-378,18,1
3q1rk1/pp1n1pp1/4P2p/5b2/1br2P2/2N2N2/PP1Q1PPP/R3R1K1 b - - 0 16,Bxe6,-368,-368,0,1
3q1rk1/pp1n1pp1/4b2p/8/1br2P2/2N2N2/PP1Q1PPP/R3R1K1 w - - 0 17,Rad1,-374,-370,4,1
3q1rk1/pp1n1pp1/4b2p/8/1br2P2/2N2N2/PP1Q1PPP/3RR1K1 b - - 1 17,Bxc3,-351,-399,-48,1
3q1rk1/pp1n1pp1/4b2p/8/2r2P2/2b2N2/PP1Q1PPP/3RR1K1 w - - 0 18,bxc3,-369,-389,-20,1
3q1rk1/pp1n1pp1/4b2p/8/2r2P2/2P2N2/P2Q1PPP/3RR1K1 b - - 0 18,Qf6,-402,-398,4,1
5rk1/pp1n1pp1/4bq1p/8/2r2P2/2P2N2/P2Q1PPP/3RR1K1 w - - 1 19,g3,-375,-469,-94,1
5rk1/pp1n1pp1/4bq1p/8/2r2P2/2P2NP1/P2Q1P1P/3RR1K1 b - - 0 19,Bg4,-431,-415,16,1
5rk1/pp1n1pp1/5q1p/8/2r2Pb1/2P2NP1/P2Q1P1P/3RR1K1 w - - 1 20,Qe3,-434,-503,-69,1
5rk1/pp1n1pp1/5q1p/8/2r2Pb1/2P1QNP1/P4P1P/3RR1K1 b - - 2 20,Bxf3,-561,-413,148,1
5rk1/pp1n1pp1/5q1p/8/2r2P2/2P1QbP1/P4P1P/3RR1K1 w - - 0 21,Qxf3,-361,-390,-29,1
5rk1/pp1n1pp1/5q1p/8/2r2P2/2P2QP1/P4P1P/3RR1K1 b - - 0 21,Nc5,-431,-380,51,1
5rk1/pp3pp1/5q1p/2n5/2r2P2/2P2QP1/P4P1P/3RR1K1 w - - 1 22,Re5,-363,-372,-9,1
5rk1/pp3pp1/5q1p/2n1R3/2r2P2/2P2QP1/P4P1P/3R2K1 b - - 2 22,Rd8,-381,-340,41,1
3r2k1/pp3pp1/5q1p/2n1R3/2r2P2/2P2QP1/P4P1P/3R2K1 w - - 3 23,Rde1,-346,-386,-40,1
3r2k1/pp3pp1/5q1p/2n1R3/2r2P2/2P2QP1/P4P1P/4R1K1 b - - 4 23,Nd3,-379,-337,42,1
3r2k1/pp3pp1/5q1p/4R3/2r2P2/2Pn1QP1/P4P1P/4R1K1 w - - 5 24,Re8+,-318,-315,3,1
3rR1k1/pp3pp1/5q1p/8/2r2P2/2Pn1QP1/P4P1P/4R1K1 b - - 6 24,Rxe8,-312,576,888,1
4r1k1/pp3pp1/5q1p/8/2r2P2/2Pn1QP1/P4P1P/4R1K1 w - - 0 25,Rxe8+,596,557,-39,1
4R1k1/pp3pp1/5q1p/8/2r2P2/2Pn1QP1/P4P1P/6K1 b - - 0 25,Kh7,566,590,24,1
4R3/pp3ppk/5q1p/8/2r2P2/2Pn1QP1/P4P1P/6K1 w - - 1 26,Qxd3+,593,604,11,1
rnbqkbnr/pppppppp/8/8/8/8/PPPPPPPP/RNBQKBNR w KQkq - 0 1,e4,29,22,-7,1
rnbqkbnr/pppppppp/8/8/4P3/8/PPPP1PPP/RNBQKBNR b KQkq - 0 1,e5,21,35,14,1
rnbqkbnr/pppp1ppp/8/4p3/4P3/8/PPPP1PPP/RNBQKBNR w KQkq - 0 2,Nf3,41,39,-2,1
rnbqkbnr/pppp1ppp/8/4p3/4P3/5N2/PPPP1PPP/RNBQKB1R b KQkq - 1 2,d6,45,57,12,1
rnbqkbnr/ppp2ppp/3p4/4p3/4P3/5N2/PPPP1PPP/RNBQKB1R w KQkq - 0 3,Bc4,64,37,-27,1
rnbqkbnr/ppp2ppp/3p4/4p3/2B1P3/5N2/PPPP1PPP/RNBQK2R b KQkq - 1 3,Bg4,36,82,46,1
rn1qkbnr/ppp2ppp/3p4/4p3/2B1P1b1/5N2/PPPP1PPP/RNBQK2R w KQkq - 2 4,c3,89,38,-51,1
rn1qkbnr/ppp2ppp/3p4/4p3/2B1P1b1/2P2N2/PP1P1PPP/RNBQK2R b KQkq - 0 4,Nf6,21,33,12,1
rn1qkb1r/ppp2ppp/3p1n2/4p3/2B1P1b1/2P2N2/PP1P1PPP/RNBQK2R w KQkq - 1 5,d3,30,-2,-32,1
rn1qkb1r/ppp2ppp/3p1n2/4p3/2B1P1b1/2PP1N2/PP3PPP/RNBQK2R b KQkq - 0 5,Be7,1,9,8,1
rn1qk2r/ppp1bppp/3p1n2/4p3/2B1P1b1/2PP1N2/PP3PPP/RNBQK2R w KQkq - 1 6,O-O,26,3,-23,1
rn1qk2r/ppp1bppp/3p1n2/4p3/2B1P1b1/2PP1N2/PP3PPP/RNBQ1RK1 b kq - 2 6,O-O,0,16,16,1
rn1q1rk1/ppp1bppp/3p1n2/4p3/2B1P1b1/2PP1N2/PP3PPP/RNBQ1RK1 w - - 3 7,h3,21,27,6,1
rn1q1rk1/ppp1bppp/3p1n2/4p3/2B1P1b1/2PP1N1P/PP3PP1/RNBQ1RK1 b - - 0 7,Bh5,27,32,5,1
rn1q1rk1/ppp1bppp/3p1n2/4p2b/2B1P3/2PP1N1P/PP3PP1/RNBQ1RK1 w - - 1 8,Nbd2,36,8,-28,1
rn1q1rk1/ppp1bppp/3p1n2/4p2b/2B1P3/2PP1N1P/PP1N1PP1/R1BQ1RK1 b - - 2 8,Nc6,-5,50,55,1
r2q1rk1/ppp1bppp/2np1n2/4p2b/2B1P3/2PP1N1P/PP1N1PP1/R1BQ1RK1 w - - 3 9,Bb3,64,43,-21,1
r2q1rk1/ppp1bppp/2np1n2/4p2b/4P3/1BPP1N1P/PP1N1PP1/R1BQ1RK1 b - - 4 9,a6,45,71,26,1
r2q1rk1/1pp1bppp/p1np1n2/4p2b/4P3/1BPP1N1P/PP1N1PP1/R1BQ1RK1 w - - 0 10,Re1,75,72,-3,1
r2q1rk1/1pp1bppp/p1np1n2/4p2b/4P3/1BPP1N1P/PP1N1PP1/R1BQR1K1 b - - 1 10,Re8,71,93,22,1
r2qr1k1/1pp1bppp/p1np1n2/4p2b/4P3/1BPP1N1P/PP1N1PP1/R1BQR1K1 w - - 2 11,Nf1,91,70,-21,1
r2qr1k1/1pp1bppp/p1np1n2/4p2b/4P3/1BPP1N1P/PP3PP1/R1BQRNK1 b - - 3 11,Bg6,73,104,31,1
r2qr1k1/1pp1bppp/p1np1nb1/4p3/4P3/1BPP1N1P/PP3PP1/R1BQRNK1 w - - 4 12,Ng3,105,76,-29,1
r2qr1k1/1pp1bppp/p1np1nb1/4p3/4P3/1BPP1NNP/PP3PP1/R1BQR1K1 b - - 5 12,Qd7,82,96,14,1
r3r1k1/1ppqbppp/p1np1nb1/4p3/4P3/1BPP1NNP/PP3PP1/R1BQR1K1 w - - 6 13,Nh4,103,72,-31,1
r3r1k1/1ppqbppp/p1np1nb1/4p3/4P2N/1BPP2NP/PP3PP1/R1BQR1K1 b - - 7 13,Rf8,78,130,52,1
r4rk1/1ppqbppp/p1np1nb1/4p3/4P2N/1BPP2NP/PP3PP1/R1BQR1K1 w - - 8 14,Bg5,131,105,-26,1
r4rk1/1ppqbppp/p1np1nb1/4p1B1/4P2N/1BPP2NP/PP3PP1/R2QR1K1 b - - 9 14,Ne8,128,83,-45,1
r3nrk1/1ppqbppp/p1np2b1/4p1B1/4P2N/1BPP2NP/PP3PP1/R2QR1K1 w - - 10 15,Nxg6,83,85,2,1
r3nrk1/1ppqbppp/p1np2N1/4p1B1/4P3/1BPP2NP/PP3PP1/R2QR1K1 b - - 0 15,hxg6,92,98,6,1
r3nrk1/1ppqbpp1/p1np2p1/4p1B1/4P3/1BPP2NP/PP3PP1/R2QR1K1 w - - 0 16,Be3,96,87,-9,1
r3nrk1/1ppqbpp1/p1np2p1/4p3/4P3/1BPPB1NP/PP3PP1/R2QR1K1 b - - 1 16,Bh4,89,140,51,1
r3nrk1/1ppq1pp1/p1np2p1/4p3/4P2b/1BPPB1NP/PP3PP1/R2QR1K1 w - - 2 17,Ne2,126,79,-47,1
r3nrk1/1ppq1pp1/p1np2p1/4p3/4P2b/1BPPB2P/PP2NPP1/R2QR1K1 b - - 3 17,Nf6,79,116,37,1
r4rk1/1ppq1pp1/p1np1np1/4p3/4P2b/1BPPB2P/PP2NPP1/R2QR1K1 w - - 4 18,Rf1,119,13,-106,0
r4rk1/1ppq1pp1/p1np1np1/4p3/4P2b/1BPPB2P/PP2NPP1/R2Q1RK1 b - - 5 18,Ne7,23,149,126,1
r4rk1/1ppqnpp1/p2p1np1/4p3/4P2b/1BPPB2P/PP2NPP1/R2Q1RK1 w - - 6 19,Kh2,138,156,18,1
r4rk1/1ppqnpp1/p2p1np1/4p3/4P2b/1BPPB2P/PP2NPPK/R2Q1R2 b - - 7 19,d5,146,342,196,1
r4rk1/1ppqnpp1/p4np1/3pp3/4P2b/1BPPB2P/PP2NPPK/R2Q1R2 w - - 0 20,g3,330,413,83,1
r4rk1/1ppqnpp1/p4np1/3pp3/4P2b/1BPPB1PP/PP2NP1K/R2Q1R2 b - - 0 20,Bxg3+,419,498,79,1
r4rk1/1ppqnpp1/p4np1/3pp3/4P3/1BPPB1bP/PP2NP1K/R2Q1R2 w - - 0 21,fxg3,470,339,-131,0
r4rk1/1ppqnpp1/p4np1/3pp3/4P3/1BPPB1PP/PP2N2K/R2Q1R2 b - - 0 21,Nh5,332,503,171,1
r4rk1/1ppqnpp1/p5p1/3pp2n/4P3/1BPPB1PP/PP2N2K/R2Q1R2 w - - 1 22,g4,508,489,-19,1
r4rk1/1ppqnpp1/p5p1/3pp2n/4P1P1/1BPPB2P/PP2N2K/R2Q1R2 b - - 0 22,Nf6,513,514,1,1
r4rk1/1ppqnpp1/p4np1/3pp3/4P1P1/1BPPB2P/PP2N2K/R2Q1R2 w - - 1 23,Bg5,489,407,-82,1
r4rk1/1ppqnpp1/p4np1/3pp1B1/4P1P1/1BPP3P/PP2N2K/R2Q1R2 b - - 2 23,Nh7,420,450,30,1
r4rk1/1ppqnppn/p5p1/3pp1B1/4P1P1/1BPP3P/PP2N2K/R2Q1R2 w - - 3 24,Bxe7,486,447,-39,1
r4rk1/1ppqBppn/p5p1/3pp3/4P1P1/1BPP3P/PP2N2K/R2Q1R2 b - - 0 24,Qxe7,428,437,9,1
r4rk1/1pp1qppn/p5p1/3pp3/4P1P1/1BPP3P/PP2N2K/R2Q1R2 w - - 0 25,Bxd5,405,337,-68,1
r4rk1/1pp1qppn/p5p1/3Bp3/4P1P1/2PP3P/PP2N2K/R2Q1R2 b - - 0 25,c6,381,405,24,1
r4rk1/1p2qppn/p1p3p1/3Bp3/4P1P1/2PP3P/PP2N2K/R2Q1R2 w - - 0 26,Bb3,413,393,-20,1
r4rk1/1p2qppn/p1p3p1/4p3/4P1P1/1BPP3P/PP2N2K/R2Q1R2 b - - 1 26,Kh8,396,469,73,1
r4r1k/1p2qppn/p1p3p1/4p3/4P1P1/1BPP3P/PP2N2K/R2Q1R2 w - - 2 27,Ng3,430,374,-56,1
r4r1k/1p2qppn/p1p3p1/4p3/4P1P1/1BPP2NP/PP5K/R2Q1R2 b - - 3 27,Ng5,317,447,130,1
r4r1k/1p2qpp1/p1p3p1/4p1n1/4P1P1/1BPP2NP/PP5K/R2Q1R2 w - - 4 28,Qd2,434,387,-47,1
r4r1k/1p2qpp1/p1p3p1/4p1n1/4P1P1/1BPP2NP/PP1Q3K/R4R2 b - - 5 28,Rad8,409,410,1,1
3r1r1k/1p2qpp1/p1p3p1/4p1n1/4P1P1/1BPP2NP/PP1Q3K/R4R2 w - - 6 29,Rad1,411,419,8,1
3r1r1k/1p2qpp1/p1p3p1/4p1n1/4P1P1/1BPP2NP/PP1Q3K/3R1R2 b - - 7 29,b6,396,405,9,1
3r1r1k/4qpp1/ppp3p1/4p1n1/4P1P1/1BPP2NP/PP1Q3K/3R1R2 w - - 0 30,Bc2,405,380,-25,1
3r1r1k/4qpp1/ppp3p1/4p1n1/4P1P1/2PP2NP/PPBQ3K/3R1R2 b - - 1 30,c5,408,407,-1,1
3r1r1k/4qpp1/pp4p1/2p1p1n1/4P1P1/2PP2NP/PPBQ3K/3R1R2 w - - 0 31,Qe3,435,411,-24,1
3r1r1k/4qpp1/pp4p1/2p1p1n1/4P1P1/2PPQ1NP/PPB4K/3R1R2 b - - 1 31,Ne6,416,458,42,1
3r1r1k/4qpp1/pp2n1p1/2p1p3/4P1P1/2PPQ1NP/PPB4K/3R1R2 w - - 2 32,Ne2,426,436,10,1
3r1r1k/4qpp1/pp2n1p1/2p1p3/4P1P1/2PPQ2P/PPB1N2K/3R1R2 b - - 3 32,Kg8,432,440,8,1
3r1rk1/4qpp1/pp2n1p1/2p1p3/4P1P1/2PPQ2P/PPB1N2K/3R1R2 w - - 4 33,Rd2,443,395,-48,1
3r1rk1/4qpp1/pp2n1p1/2p1p3/4P1P1/2PPQ2P/PPBRN2K/5R2 b - - 5 33,Kh8,418,451,33,1
3r1r1k/4qpp1/pp2n1p1/2p1p3/4P1P1/2PPQ2P/PPBRN2K/5R2 w - - 6 34,Rfd1,422,359,-63,1
3r1r1k/4qpp1/pp2n1p1/2p1p3/4P1P1/2PPQ2P/PPBRN2K/3R4 b - - 7 34,Qd7,317,448,131,1
3r1r1k/3q1pp1/pp2n1p1/2p1p3/4P1P1/2PPQ2P/PPBRN2K/3R4 w - - 8 35,d4,448,378,-70,1
3r1r1k/3q1pp1/pp2n1p1/2p1p3/3PP1P1/2P1Q2P/PPBRN2K/3R4 b - - 0 35,exd4,393,432,39,1
3r1r1k/3q1pp1/pp2n1p1/2p5/3pP1P1/2P1Q2P/PPBRN2K/3R4 w - - 0 36,cxd4,389,385,-4,1
3r1r1k/3q1pp1/pp2n1p1/2p5/3PP1P1/4Q2P/PPBRN2K/3R4 b - - 0 36,cxd4,399,379,-20,1
3r1r1k/3q1pp1/pp2n1p1/8/3pP1P1/4Q2P/PPBRN2K/3R4 w - - 0 37,Nxd4,366,19,-347,0
3r1r1k/3q1pp1/pp2n1p1/8/3NP1P1/4Q2P/PPBR3K/3R4 b - - 0 37,Nxd4,7,10,3,1
3r1r1k/3q1pp1/pp4p1/8/3nP1P1/4Q2P/PPBR3K/3R4 w - - 0 38,Rxd4,5,-3,-8,1
3r1r1k/3q1pp1/pp4p1/8/3RP1P1/4Q2P/PPB4K/3R4 b - - 0 38,Qc7+,-5,14,19,1
3r1r1k/2q2pp1/pp4p1/8/3RP1P1/4Q2P/PPB4K/3R4 w - - 1 39,Qg3,-17,-209,-192,0
3r1r1k/2q2pp1/pp4p1/8/3RP1P1/6QP/PPB4K/3R4 b - - 2 39,Qxc2+,-213,-203,10,1
3r1r1k/5pp1/pp4p1/8/3RP1P1/6QP/PPq4K/3R4 w - - 0 40,R1d2,-224,-411,-187,0
3r1r1k/5pp1/pp4p1/8/3RP1P1/6QP/PPqR3K/8 b - - 1 40,Rxd4,-402,425,827,1
5r1k/5pp1/pp4p1/8/3rP1P1/6QP/PPqR3K/8 w - - 0 41,Rxc2,426,395,-31,1
5r1k/5pp1/pp4p1/8/3rP1P1/6QP/PPR4K/8 b - - 0 41,Rfd8,403,405,2,1
3r3k/5pp1/pp4p1/8/3rP1P1/6QP/PPR4K/8 w - - 1 42,Re2,422,390,-32,1
3r3k/5pp1/pp4p1/8/3rP1P1/6QP/PP2R2K/8 b - - 2 42,Rd2,375,418,43,1
3r3k/5pp1/pp4p1/8/4P1P1/6QP/PP1rR2K/8 w - - 3 43,Qe3,407,442,35,1
3r3k/5pp1/pp4p1/8/4P1P1/4Q2P/PP1rR2K/8 b - - 4 43,Rxe2+,438,454,16,1
3r3k/5pp1/pp4p1/8/4P1P1/4Q2P/PP2r2K/8 w - - 0 44,Qxe2,470,453,-17,1
3r3k/5pp1/pp4p1/8/4P1P1/7P/PP2Q2K/8 b - - 0 44,b5,485,482,-3,1
3r3k/5pp1/p5p1/1p6/4P1P1/7P/PP2Q2K/8 w - - 0 45,Kg3,473,475,2,1
3r3k/5pp1/p5p1/1p6/4P1P1/6KP/PP2Q3/8 b - - 1 45,Kg8,487,479,-8,1
3r2k1/5pp1/p5p1/1p6/4P1P1/6KP/PP2Q3/8 w - - 2 46,Kf4,475,451,-24,1
3r2k1/5pp1/p5p1/1p6/4PKP1/7P/PP2Q3/8 b - - 3 46,Kf8,468,519,51,1
3r1k2/5pp1/p5p1/1p6/4PKP1/7P/PP2Q3/8 w - - 4 47,e5,497,485,-12,1
3r1k2/5pp1/p5p1/1p2P3/5KP1/7P/PP2Q3/8 b - - 0 47,Ke7,495,521,26,1
3r4/4kpp1/p5p1/1p2P3/5KP1/7P/PP2Q3/8 w - - 1 48,Qe4,537,538,1,1
3r4/4kpp1/p5p1/1p2P3/4QKP1/7P/PP6/8 b - - 2 48,Ke6,548,619,71,1
3r4/5pp1/p3k1p1/1p2P3/4QKP1/7P/PP6/8 w - - 3 49,Qc6+,584,601,17,1
3r4/5pp1/p1Q1k1p1/1p2P3/5KP1/7P/PP6/8 b - - 4 49,Ke7,582,612,30,1
3r4/4kpp1/p1Q3p1/1p2P3/5KP1/7P/PP6/8 w - - 5 50,g5,571,532,-39,1
3r4/4kpp1/p1Q3p1/1p2P1P1/5K2/7P/PP6/8 b - - 0 50,Rd4+,532,549,17,1
8/4kpp1/p1Q3p1/1p2P1P1/3r1K2/7P/PP6/8 w - - 1 51,Ke3,517,503,-14,1
8/4kpp1/p1Q3p1/1p2P1P1/3r4/4K2P/PP6/8 b - - 2 51,Rd7,493,602,109,1
8/3rkpp1/p1Q3p1/1p2P1P1/8/4K2P/PP6/8 w - - 3 52,Qxa6,576,593,17,1
8/3rkpp1/Q5p1/1p2P1P1/8/4K2P/PP6/8 b - - 0 52,Rc7,562,922,360,1
8/2r1kpp1/Q5p1/1p2P1P1/8/4K2P/PP6/8 w - - 1 53,Qxb5,9992,631,-9361,0
rnbqkbnr/pppppppp/8/8/8/8/PPPPPPPP/RNBQKBNR w KQkq - 0 1,e4,25,22,-3,1
rnbqkbnr/pppppppp/8/8/4P3/8/PPPP1PPP/RNBQKBNR b KQkq - 0 1,e5,37,31,-6,1
rnbqkbnr/pppp1ppp/8/4p3/4P3/8/PPPP1PPP/RNBQKBNR w KQkq - 0 2,Nf3,40,32,-8,1
rnbqkbnr/pppp1ppp/8/4p3/4P3/5N2/PPPP1PPP/RNBQKB1R b KQkq - 1 2,d6,38,106,68,1
rnbqkbnr/ppp2ppp/3p4/4p3/4P3/5N2/PPPP1PPP/RNBQKB1R w KQkq - 0 3,d4,90,54,-36,1
rnbqkbnr/ppp2ppp/3p4/4p3/3PP3/5N2/PPP2PPP/RNBQKB1R b KQkq - 0 3,Nd7,52,40,-12,1
r1bqkbnr/pppn1ppp/3p4/4p3/3PP3/5N2/PPP2PPP/RNBQKB1R w KQkq - 1 4,Bc4,68,71,3,1
r1bqkbnr/pppn1ppp/3p4/4p3/2BPP3/5N2/PPP2PPP/RNBQK2R b KQkq - 2 4,exd4,76,78,2,1
r1bqkbnr/pppn1ppp/3p4/8/2BpP3/5N2/PPP2PPP/RNBQK2R w KQkq - 0 5,Qxd4,79,77,-2,1
r1bqkbnr/pppn1ppp/3p4/8/2BQP3/5N2/PPP2PPP/RNB1K2R b KQkq - 0 5,Ngf6,72,72,0,1
r1bqkb1r/pppn1ppp/3p1n2/8/2BQP3/5N2/PPP2PPP/RNB1K2R w KQkq - 1 6,Nc3,72,65,-7,1
r1bqkb1r/pppn1ppp/3p1n2/8/2BQP3/2N2N2/PPP2PPP/R1B1K2R b KQkq - 2 6,Be7,71,70,-1,1
r1bqk2r/pppnbppp/3p1n2/8/2BQP3/2N2N2/PPP2PPP/R1B1K2R w KQkq - 3 7,Bf4,72,63,-9,1
r1bqk2r/pppnbppp/3p1n2/8/2BQPB2/2N2N2/PPP2PPP/R3K2R b KQkq - 4 7,O-O,49,61,12,1
r1bq1rk1/pppnbppp/3p1n2/8/2BQPB2/2N2N2/PPP2PPP/R3K2R w KQ - 5 8,O-O-O,61,64,3,1
r1bq1rk1/pppnbppp/3p1n2/8/2BQPB2/2N2N2/PPP2PPP/2KR3R b - - 6 8,Nb6,71,64,-7,1
r1bq1rk1/ppp1bppp/1n1p1n2/8/2BQPB2/2N2N2/PPP2PPP/2KR3R w - - 7 9,Bb3,79,56,-23,1
r1bq1rk1/ppp1bppp/1n1p1n2/8/3QPB2/1BN2N2/PPP2PPP/2KR3R b - - 8 9,a5,50,54,4,1
r1bq1rk1/1pp1bppp/1n1p1n2/p7/3QPB2/1BN2N2/PPP2PPP/2KR3R w - - 0 10,a4,47,44,-3,1
r1bq1rk1/1pp1bppp/1n1p1n2/p7/P2QPB2/1BN2N2/1PP2PPP/2KR3R b - - 0 10,Nfd7,41,102,61,1
r1bq1rk1/1ppnbppp/1n1p4/p7/P2QPB2/1BN2N2/1PP2PPP/2KR3R w - - 1 11,e5,112,126,14,1
r1bq1rk1/1ppnbppp/1n1p4/p3P3/P2Q1B2/1BN2N2/1PP2PPP/2KR3R b - - 0 11,dxe5,136,201,65,1
r1bq1rk1/1ppnbppp/1n6/p3p3/P2Q1B2/1BN2N2/1PP2PPP/2KR3R w - - 0 12,Nxe5,219,203,-16,1
r1bq1rk1/1ppnbppp/1n6/p3N3/P2Q1B2/1BN5/1PP2PPP/2KR3R b - - 0 12,Nxe5,228,240,12,1
r1bq1rk1/1pp1bppp/1n6/p3n3/P2Q1B2/1BN5/1PP2PPP/2KR3R w - - 0 13,Bxe5,204,97,-107,0
r1bq1rk1/1pp1bppp/1n6/p3B3/P2Q4/1BN5/1PP2PPP/2KR3R b - - 0 13,Qxd4,100,70,-30,1
r1b2rk1/1pp1bppp/1n6/p3B3/P2q4/1BN5/1PP2PPP/2KR3R w - - 0 14,Bxd4,88,90,2,1
r1b2rk1/1pp1bppp/1n6/p7/P2B4/1BN5/1PP2PPP/2KR3R b - - 0 14,Nd7,99,261,162,1
r1b2rk1/1ppnbppp/8/p7/P2B4/1BN5/1PP2PPP/2KR3R w - - 1 15,Rhe1,261,110,-151,0
r1b2rk1/1ppnbppp/8/p7/P2B4/1BN5/1PP2PPP/2KRR3 b - - 2 15,Bf6,125,302,177,1
r1b2rk1/1ppn1ppp/5b2/p7/P2B4/1BN5/1PP2PPP/2KRR3 w - - 3 16,Nd5,306,297,-9,1
r1b2rk1/1ppn1ppp/5b2/p2N4/P2B4/1B6/1PP2PPP/2KRR3 b - - 4 16,Bxd4,248,256,8,1
r1b2rk1/1ppn1ppp/8/p2N4/P2b4/1B6/1PP2PPP/2KRR3 w - - 0 17,Rxd4,254,267,13,1
r1b2rk1/1ppn1ppp/8/p2N4/P2R4/1B6/1PP2PPP/2K1R3 b - - 0 17,Nc5,303,304,1,1
r1b2rk1/1pp2ppp/8/p1nN4/P2R4/1B6/1PP2PPP/2K1R3 w - - 1 18,Nxc7,292,195,-97,1
r1b2rk1/1pN2ppp/8/p1n5/P2R4/1B6/1PP2PPP/2K1R3 b - - 0 18,Nxb3+,187,167,-20,1
r1b2rk1/1pN2ppp/8/p7/P2R4/1n6/1PP2PPP/2K1R3 w - - 0 19,cxb3,197,170,-27,1
r1b2rk1/1pN2ppp/8/p7/P2R4/1P6/1P3PPP/2K1R3 b - - 0 19,Rb8,175,214,39,1
1rb2rk1/1pN2ppp/8/p7/P2R4/1P6/1P3PPP/2K1R3 w - - 1 20,Re7,228,155,-73,1
1rb2rk1/1pN1Rppp/8/p7/P2R4/1P6/1P3PPP/2K5 b - - 2 20,Bf5,193,265,72,1
1r3rk1/1pN1Rppp/8/p4b2/P2R4/1P6/1P3PPP/2K5 w - - 3 21,f3,286,100,-186,0
1r3rk1/1pN1Rppp/8/p4b2/P2R4/1P3P2/1P4PP/2K5 b - - 0 21,Rfc8,110,99,-11,1
1rr3k1/1pN1Rppp/8/p4b2/P2R4/1P3P2/1P4PP/2K5 w - - 1 22,g4,116,-84,-200,0
1rr3k1/1pN1Rppp/8/p4b2/P2R2P1/1P3P2/1P5P/2K5 b - - 0 22,Bg6,-66,195,261,1
1rr3k1/1pN1Rppp/6b1/p7/P2R2P1/1P3P2/1P5P/2K5 w - - 1 23,Rdd7,210,95,-115,0
1rr3k1/1pNRRppp/6b1/p7/P5P1/1P3P2/1P5P/2K5 b - - 2 23,Kf8,107,352,245,1
1rr2k2/1pNRRppp/6b1/p7/P5P1/1P3P2/1P5P/2K5 w - - 3 24,h4,411,127,-284,0
1rr2k2/1pNRRppp/6b1/p7/P5PP/1P3P2/1P6/2K5 b - - 0 24,Rd8,177,477,300,1
rnbqkbnr/pppppppp/8/8/8/8/PPPPPPPP/RNBQKBNR w KQkq - 0 1,e4,38,25,-13,1
rnbqkbnr/pppppppp/8/8/4P3/8/PPPP1PPP/RNBQKBNR b KQkq - 0 1,e5,21,33,12,1
rnbqkbnr/pppp1ppp/8/4p3/4P3/8/PPPP1PPP/RNBQKBNR w KQkq - 0 2,d4,31,-1,-32,1
rnbqkbnr/pppp1ppp/8/4p3/3PP3/8/PPP2PPP/RNBQKBNR b KQkq - 0 2,exd4,-14,10,24,1
rnbqkbnr/pppp1ppp/8/8/3pP3/8/PPP2PPP/RNBQKBNR w KQkq - 0 3,Qxd4,1,-31,-32,1
rnbqkbnr/pppp1ppp/8/8/3QP3/8/PPP2PPP/RNB1KBNR b KQkq - 0 3,Nc6,-31,-26,5,1
r1bqkbnr/pppp1ppp/2n5/8/3QP3/8/PPP2PPP/RNB1KBNR w KQkq - 1 4,Qe3,-26,-35,-9,1
r1bqkbnr/pppp1ppp/2n5/8/4P3/4Q3/PPP2PPP/RNB1KBNR b KQkq - 2 4,b6,-19,85,104,1
r1bqkbnr/p1pp1ppp/1pn5/8/4P3/4Q3/PPP2PPP/RNB1KBNR w KQkq - 0 5,Nc3,87,90,3,1
r1bqkbnr/p1pp1ppp/1pn5/8/4P3/2N1Q3/PPP2PPP/R1B1KBNR b KQkq - 1 5,Nf6,113,140,27,1
r1bqkb1r/p1pp1ppp/1pn2n2/8/4P3/2N1Q3/PPP2PPP/R1B1KBNR w KQkq - 2 6,Be2,136,1,-135,0
r1bqkb1r/p1pp1ppp/1pn2n2/8/4P3/2N1Q3/PPP1BPPP/R1B1K1NR b KQkq - 3 6,Bc5,-4,59,63,1
r1bqk2r/p1pp1ppp/1pn2n2/2b5/4P3/2N1Q3/PPP1BPPP/R1B1K1NR w KQkq - 4 7,Qg3,43,50,7,1
r1bqk2r/p1pp1ppp/1pn2n2/2b5/4P3/2N3Q1/PPP1BPPP/R1B1K1NR b KQkq - 5 7,O-O,43,138,95,1
r1bq1rk1/p1pp1ppp/1pn2n2/2b5/4P3/2N3Q1/PPP1BPPP/R1B1K1NR w KQ - 6 8,Bh6,155,137,-18,1
r1bq1rk1/p1pp1ppp/1pn2n1B/2b5/4P3/2N3Q1/PPP1BPPP/R3K1NR b KQ - 7 8,g6,140,278,138,1
r1bq1rk1/p1pp1p1p/1pn2npB/2b5/4P3/2N3Q1/PPP1BPPP/R3K1NR w KQ - 0 9,Bxf8,255,271,16,1
r1bq1Bk1/p1pp1p1p/1pn2np1/2b5/4P3/2N3Q1/PPP1BPPP/R3K1NR b KQ - 0 9,Qxf8,280,301,21,1
r1b2qk1/p1pp1p1p/1pn2np1/2b5/4P3/2N3Q1/PPP1BPPP/R3K1NR w KQ - 0 10,O-O-O,263,180,-83,1
r1b2qk1/p1pp1p1p/1pn2np1/2b5/4P3/2N3Q1/PPP1BPPP/2KR2NR b - - 1 10,Nd4,170,287,117,1
r1b2qk1/p1pp1p1p/1p3np1/2b5/3nP3/2N3Q1/PPP1BPPP/2KR2NR w - - 2 11,h4,306,223,-83,1
r1b2qk1/p1pp1p1p/1p3np1/2b5/3nP2P/2N3Q1/PPP1BPP1/2KR2NR b - - 0 11,d6,242,240,-2,1
r1b2qk1/p1p2p1p/1p1p1np1/2b5/3nP2P/2N3Q1/PPP1BPP1/2KR2NR w - - 0 12,Na4,242,-131,-373,0
r1b2qk1/p1p2p1p/1p1p1np1/2b5/N2nP2P/6Q1/PPP1BPP1/2KR2NR b - - 1 12,h5,-175,181,356,1
r1b2qk1/p1p2p2/1p1p1np1/2b4p/N2nP2P/6Q1/PPP1BPP1/2KR2NR w - - 0 13,c3,176,-99,-275,0
r1b2qk1/p1p2p2/1p1p1np1/2b4p/N2nP2P/2P3Q1/PP2BPP1/2KR2NR b - - 0 13,Ne6,-88,152,240,1
r1b2qk1/p1p2p2/1p1pnnp1/2b4p/N3P2P/2P3Q1/PP2BPP1/2KR2NR w - - 1 14,b4,175,-150,-325,0
r1b2qk1/p1p2p2/1p1pnnp1/2b4p/NP2P2P/2P3Q1/P3BPP1/2KR2NR b - - 0 14,Nxe4,-146,-134,12,1
r1b2qk1/p1p2p2/1p1pn1p1/2b4p/NP2n2P/2P3Q1/P3BPP1/2KR2NR w - - 0 15,Qf3,-152,-140,12,1
r1b2qk1/p1p2p2/1p1pn1p1/2b4p/NP2n2P/2P2Q2/P3BPP1/2KR2NR b - - 1 15,Nxf2,-130,156,286,1
r1b2qk1/p1p2p2/1p1pn1p1/2b4p/NP5P/2P2Q2/P3BnP1/2KR2NR w - - 0 16,bxc5,176,133,-43,1
r1b2qk1/p1p2p2/1p1pn1p1/2P4p/N6P/2P2Q2/P3BnP1/2KR2NR b - - 0 16,Nxd1,93,119,26,1
r1b2qk1/p1p2p2/1p1pn1p1/2P4p/N6P/2P2Q2/P3B1P1/2Kn2NR w - - 0 17,Qxa8,118,84,-34,1
Q1b2qk1/p1p2p2/1p1pn1p1/2P4p/N6P/2P5/P3B1P1/2Kn2NR b - - 0 17,Nf2,93,80,-13,1
Q1b2qk1/p1p2p2/1p1pn1p1/2P4p/N6P/2P5/P3BnP1/2K3NR w - - 1 18,Rh2,102,0,-102,0
Q1b2qk1/p1p2p2/1p1pn1p1/2P4p/N6P/2P5/P3BnPR/2K3N1 b - - 2 18,Qh6+,-19,0,19,1
Q1b3k1/p1p2p2/1p1pn1pq/2P4p/N6P/2P5/P3BnPR/2K3N1 w - - 3 19,Kc2,0,0,0,1
rnbqkbnr/pppppppp/8/8/8/8/PPPPPPPP/RNBQKBNR w KQkq - 0 1,e4,26,29,3,1
rnbqkbnr/pppppppp/8/8/4P3/8/PPPP1PPP/RNBQKBNR b KQkq - 0 1,e5,26,31,5,1
rnbqkbnr/pppp1ppp/8/4p3/4P3/8/PPPP1PPP/RNBQKBNR w KQkq - 0 2,Nf3,38,35,-3,1
rnbqkbnr/pppp1ppp/8/4p3/4P3/5N2/PPPP1PPP/RNBQKB1R b KQkq - 1 2,d6,29,44,15,1
rnbqkbnr/ppp2ppp/3p4/4p3/4P3/5N2/PPPP1PPP/RNBQKB1R w KQkq - 0 3,Be2,55,3,-52,1
rnbqkbnr/ppp2ppp/3p4/4p3/4P3/5N2/PPPPBPPP/RNBQK2R b KQkq - 1 3,Nf6,5,7,2,1
rnbqkb1r/ppp2ppp/3p1n2/4p3/4P3/5N2/PPPPBPPP/RNBQK2R w KQkq - 2 4,Nc3,6,2,-4,1
rnbqkb1r/ppp2ppp/3p1n2/4p3/4P3/2N2N2/PPPPBPPP/R1BQK2R b KQkq - 3 4,Nc6,11,52,41,1
r1bqkb1r/ppp2ppp/2np1n2/4p3/4P3/2N2N2/PPPPBPPP/R1BQK2R w KQkq - 4 5,d4,55,48,-7,1
r1bqkb1r/ppp2ppp/2np1n2/4p3/3PP3/2N2N2/PPP1BPPP/R1BQK2R b KQkq - 0 5,exd4,49,51,2,1
r1bqkb1r/ppp2ppp/2np1n2/8/3pP3/2N2N2/PPP1BPPP/R1BQK2R w KQkq - 0 6,Nxd4,45,46,1,1
r1bqkb1r/ppp2ppp/2np1n2/8/3NP3/2N5/PPP1BPPP/R1BQK2R b KQkq - 0 6,Nxd4,46,110,64,1
r1bqkb1r/ppp2ppp/3p1n2/8/3nP3/2N5/PPP1BPPP/R1BQK2R w KQkq - 0 7,Qxd4,97,111,14,1
r1bqkb1r/ppp2ppp/3p1n2/8/3QP3/2N5/PPP1BPPP/R1B1K2R b KQkq - 0 7,c5,103,188,85,1
r1bqkb1r/pp3ppp/3p1n2/2p5/3QP3/2N5/PPP1BPPP/R1B1K2R w KQkq - 0 8,Qc4,185,104,-81,1
r1bqkb1r/pp3ppp/3p1n2/2p5/2Q1P3/2N5/PPP1BPPP/R1B1K2R b KQkq - 1 8,Bd7,108,196,88,1
r2qkb1r/pp1b1ppp/3p1n2/2p5/2Q1P3/2N5/PPP1BPPP/R1B1K2R w KQkq - 2 9,Bg5,206,90,-116,0
r2qkb1r/pp1b1ppp/3p1n2/2p3B1/2Q1P3/2N5/PPP1BPPP/R3K2R b KQkq - 3 9,h6,87,164,77,1
r2qkb1r/pp1b1pp1/3p1n1p/2p3B1/2Q1P3/2N5/PPP1BPPP/R3K2R w KQkq - 0 10,Bh4,177,58,-119,0
r2qkb1r/pp1b1pp1/3p1n1p/2p5/2Q1P2B/2N5/PPP1BPPP/R3K2R b KQkq - 1 10,Be7,55,55,0,1
r2qk2r/pp1bbpp1/3p1n1p/2p5/2Q1P2B/2N5/PPP1BPPP/R3K2R w KQkq - 2 11,O-O-O,84,95,11,1
r2qk2r/pp1bbpp1/3p1n1p/2p5/2Q1P2B/2N5/PPP1BPPP/2KR3R b kq - 3 11,a6,71,190,119,1
r2qk2r/1p1bbpp1/p2p1n1p/2p5/2Q1P2B/2N5/PPP1BPPP/2KR3R w kq - 0 12,f4,185,149,-36,1
r2qk2r/1p1bbpp1/p2p1n1p/2p5/2Q1PP1B/2N5/PPP1B1PP/2KR3R b kq - 0 12,Be6,141,190,49,1
r2qk2r/1p2bpp1/p2pbn1p/2p5/2Q1PP1B/2N5/PPP1B1PP/2KR3R w kq - 1 13,Qa4+,165,-174,-339,0
r2qk2r/1p2bpp1/p2pbn1p/2p5/Q3PP1B/2N5/PPP1B1PP/2KR3R b kq - 2 13,Qd7,-198,380,578,1
r3k2r/1p1qbpp1/p2pbn1p/2p5/Q3PP1B/2N5/PPP1B1PP/2KR3R w kq - 3 14,Qa3,397,195,-202,0
r3k2r/1p1qbpp1/p2pbn1p/2p5/4PP1B/Q1N5/PPP1B1PP/2KR3R b kq - 4 14,O-O,199,296,97,1
r4rk1/1p1qbpp1/p2pbn1p/2p5/4PP1B/Q1N5/PPP1B1PP/2KR3R w - - 5 15,g4,334,-53,-387,0
r4rk1/1p1qbpp1/p2pbn1p/2p5/4PPPB/Q1N5/PPP1B2P/2KR3R b - - 0 15,Nxg4,-64,50,114,1
r4rk1/1p1qbpp1/p2pb2p/2p5/4PPnB/Q1N5/PPP1B2P/2KR3R w - - 0 16,Bxg4,44,-86,-130,0
r4rk1/1p1qbpp1/p2pb2p/2p5/4PPBB/Q1N5/PPP4P/2KR3R b - - 0 16,Bxh4,-91,-105,-14,1
r4rk1/1p1q1pp1/p2pb2p/2p5/4PPBb/Q1N5/PPP4P/2KR3R w - - 0 17,Bxe6,-93,-130,-37,1
r4rk1/1p1q1pp1/p2pB2p/2p5/4PP1b/Q1N5/PPP4P/2KR3R b - - 0 17,Qxe6,-132,-142,-10,1
r4rk1/1p3pp1/p2pq2p/2p5/4PP1b/Q1N5/PPP4P/2KR3R w - - 0 18,Qa4,-108,-211,-103,0
r4rk1/1p3pp1/p2pq2p/2p5/Q3PP1b/2N5/PPP4P/2KR3R b - - 1 18,Qg4,-207,-100,107,1
r4rk1/1p3pp1/p2p3p/2p5/Q3PPqb/2N5/PPP4P/2KR3R w - - 2 19,Nd5,-142,-130,12,1
r4rk1/1p3pp1/p2p3p/2pN4/Q3PPqb/8/PPP4P/2KR3R b - - 3 19,Rfe8,-138,-83,55,1
r3r1k1/1p3pp1/p2p3p/2pN4/Q3PPqb/8/PPP4P/2KR3R w - - 4 20,Rhg1,-100,-99,1,1
r3r1k1/1p3pp1/p2p3p/2pN4/Q3PPqb/8/PPP4P/2KR2R1 b - - 5 20,Qe6,-126,167,293,1
r3r1k1/1p3pp1/p2pq2p/2pN4/Q3PP1b/8/PPP4P/2KR2R1 w - - 6 21,Nc7,165,198,33,1
r3r1k1/1pN2pp1/p2pq2p/2p5/Q3PP1b/8/PPP4P/2KR2R1 b - - 7 21,Qe7,187,180,-7,1
r3r1k1/1pN1qpp1/p2p3p/2p5/Q3PP1b/8/PPP4P/2KR2R1 w - - 8 22,Nxa8,192,150,-42,1
N3r1k1/1p2qpp1/p2p3p/2p5/Q3PP1b/8/PPP4P/2KR2R1 b - - 0 22,Rxa8,157,154,-3,1
r5k1/1p2qpp1/p2p3p/2p5/Q3PP1b/8/PPP4P/2KR2R1 w - - 0 23,Qc4,152,155,3,1
r5k1/1p2qpp1/p2p3p/2p5/2Q1PP1b/8/PPP4P/2KR2R1 b - - 1 23,b5,171,196,25,1
r5k1/4qpp1/p2p3p/1pp5/2Q1PP1b/8/PPP4P/2KR2R1 w - - 0 24,Qc3,174,136,-38,1
r5k1/4qpp1/p2p3p/1pp5/4PP1b/2Q5/PPP4P/2KR2R1 b - - 1 24,Bf6,122,125,3,1
r5k1/4qpp1/p2p1b1p/1pp5/4PP2/2Q5/PPP4P/2KR2R1 w - - 2 25,Qg3,136,19,-117,0
r5k1/4qpp1/p2p1b1p/1pp5/4PP2/6Q1/PPP4P/2KR2R1 b - - 3 25,Rd8,44,282,238,1
3r2k1/4qpp1/p2p1b1p/1pp5/4PP2/6Q1/PPP4P/2KR2R1 w - - 4 26,e5,214,161,-53,1
3r2k1/4qpp1/p2p1b1p/1pp1P3/5P2/6Q1/PPP4P/2KR2R1 b - - 0 26,dxe5,166,181,15,1
3r2k1/4qpp1/p4b1p/1pp1p3/5P2/6Q1/PPP4P/2KR2R1 w - - 0 27,Rxd8+,194,173,-21,1
3R2k1/4qpp1/p4b1p/1pp1p3/5P2/6Q1/PPP4P/2K3R1 b - - 0 27,Qxd8,176,166,-10,1
3q2k1/5pp1/p4b1p/1pp1p3/5P2/6Q1/PPP4P/2K3R1 w - - 0 28,fxe5,170,176,6,1
3q2k1/5pp1/p4b1p/1pp1P3/8/6Q1/PPP4P/2K3R1 b - - 0 28,Bg5+,172,205,33,1
3q2k1/5pp1/p6p/1pp1P1b1/8/6Q1/PPP4P/2K3R1 w - - 1 29,Kb1,189,181,-8,1
3q2k1/5pp1/p6p/1pp1P1b1/8/6Q1/PPP4P/1K4R1 b - - 2 29,c4,203,484,281,1
3q2k1/5pp1/p6p/1p2P1b1/2p5/6Q1/PPP4P/1K4R1 w - - 0 30,h4,484,533,49,1
3q2k1/5pp1/p6p/1p2P1b1/2p4P/6Q1/PPP5/1K4R1 b - - 0 30,g6,534,579,45,1
3q2k1/5p2/p5pp/1p2P1b1/2p4P/6Q1/PPP5/1K4R1 w - - 0 31,hxg5,553,550,-3,1
3q2k1/5p2/p5pp/1p2P1P1/2p5/6Q1/PPP5/1K4R1 b - - 0 31,hxg5,513,589,76,1
3q2k1/5p2/p5p1/1p2P1p1/2p5/6Q1/PPP5/1K4R1 w - - 0 32,Rh1,594,581,-13,1
3q2k1/5p2/p5p1/1p2P1p1/2p5/6Q1/PPP5/1K5R b - - 1 32,a5,571,756,185,1
3q2k1/5p2/6p1/pp2P1p1/2p5/6Q1/PPP5/1K5R w - - 0 33,Qh2,931,982,51,1
3q2k1/5p2/6p1/pp2P1p1/2p5/8/PPP4Q/1K5R b - - 1 33,Kf8,9991,9991,0,1
3q1k2/5p2/6p1/pp2P1p1/2p5/8/PPP4Q/1K5R w - - 2 34,Qh8+,9991,9992,1,1
3q1k1Q/5p2/6p1/pp2P1p1/2p5/8/PPP5/1K5R b - - 3 34,Ke7,9992,9992,0,1
3q3Q/4kp2/6p1/pp2P1p1/2p5/8/PPP5/1K5R w - - 4 35,Qf6+,9992,9993,1,1
3q4/4kp2/5Qp1/pp2P1p1/2p5/8/PPP5/1K5R b - - 5 35,Kd7,9993,9993,0,1
3q4/3k1p2/5Qp1/pp2P1p1/2p5/8/PPP5/1K5R w - - 6 36,Rd1+,9993,9994,1,1
rnbqkbnr/pppppppp/8/8/8/8/PPPPPPPP/RNBQKBNR w KQkq - 0 1,e4,28,27,-1,1
rnbqkbnr/pppppppp/8/8/4P3/8/PPPP1PPP/RNBQKBNR b KQkq - 0 1,e6,27,39,12,1
rnbqkbnr/pppp1ppp/4p3/8/4P3/8/PPPP1PPP/RNBQKBNR w KQkq - 0 2,e5,45,-32,-77,1
rnbqkbnr/pppp1ppp/4p3/4P3/8/8/PPPP1PPP/RNBQKBNR b KQkq - 0 2,d6,-37,-18,19,1
rnbqkbnr/ppp2ppp/3pp3/4P3/8/8/PPPP1PPP/RNBQKBNR w KQkq - 0 3,Bb5+,-19,-136,-117,0
rnbqkbnr/ppp2ppp/3pp3/1B2P3/8/8/PPPP1PPP/RNBQK1NR b KQkq - 1 3,Bd7,-157,-68,89,1
rn1qkbnr/pppb1ppp/3pp3/1B2P3/8/8/PPPP1PPP/RNBQK1NR w KQkq - 2 4,a4,-42,-132,-90,1
rn1qkbnr/pppb1ppp/3pp3/1B2P3/P7/8/1PPP1PPP/RNBQK1NR b KQkq - 0 4,Bxb5,-143,-77,66,1
rn1qkbnr/ppp2ppp/3pp3/1b2P3/P7/8/1PPP1PPP/RNBQK1NR w KQkq - 0 5,axb5,-67,-68,-1,1
rn1qkbnr/ppp2ppp/3pp3/1P2P3/8/8/1PPP1PPP/RNBQK1NR b KQkq - 0 5,dxe5,-75,-68,7,1
rn1qkbnr/ppp2ppp/4p3/1P2p3/8/8/1PPP1PPP/RNBQK1NR w KQkq - 0 6,Nf3,-74,-230,-156,0
rn1qkbnr/ppp2ppp/4p3/1P2p3/8/5N2/1PPP1PPP/RNBQK2R b KQkq - 1 6,Bc5,-211,3,214,1
rn1qk1nr/ppp2ppp/4p3/1Pb1p3/8/5N2/1PPP1PPP/RNBQK2R w KQkq - 2 7,Nxe5,16,-59,-75,1
rn1qk1nr/ppp2ppp/4p3/1Pb1N3/8/8/1PPP1PPP/RNBQK2R b KQkq - 0 7,Nf6,-93,21,114,1
rn1qk2r/ppp2ppp/4pn2/1Pb1N3/8/8/1PPP1PPP/RNBQK2R w KQkq - 1 8,Qe2,37,22,-15,1
rn1qk2r/ppp2ppp/4pn2/1Pb1N3/8/8/1PPPQPPP/RNB1K2R b KQkq - 2 8,O-O,20,21,1,1
rn1q1rk1/ppp2ppp/4pn2/1Pb1N3/8/8/1PPPQPPP/RNB1K2R w KQ - 3 9,Nc3,21,21,0,1
rn1q1rk1/ppp2ppp/4pn2/1Pb1N3/8/2N5/1PPPQPPP/R1B1K2R b KQ - 4 9,c6,17,37,20,1
rn1q1rk1/pp3ppp/2p1pn2/1Pb1N3/8/2N5/1PPPQPPP/R1B1K2R w KQ - 0 10,bxc6,39,30,-9,1
rn1q1rk1/pp3ppp/2P1pn2/2b1N3/8/2N5/1PPPQPPP/R1B1K2R b KQ - 0 10,bxc6,31,60,29,1
rn1q1rk1/p4ppp/2p1pn2/2b1N3/8/2N5/1PPPQPPP/R1B1K2R w KQ - 0 11,Qf3,70,23,-47,1
rn1q1rk1/p4ppp/2p1pn2/2b1N3/8/2N2Q2/1PPP1PPP/R1B1K2R b KQ - 1 11,Nd5,23,25,2,1
rn1q1rk1/p4ppp/2p1p3/2bnN3/8/2N2Q2/1PPP1PPP/R1B1K2R w KQ - 2 12,Ra6,21,-472,-493,0
rn1q1rk1/p4ppp/R1p1p3/2bnN3/8/2N2Q2/1PPP1PPP/2B1K2R b K - 3 12,Nxa6,-459,-475,-16,1
r2q1rk1/p4ppp/n1p1p3/2bnN3/8/2N2Q2/1PPP1PPP/2B1K2R w K - 0 13,Nxc6,-486,-474,12,1
r2q1rk1/p4ppp/n1N1p3/2bn4/8/2N2Q2/1PPP1PPP/2B1K2R b K - 0 13,Qd6,-448,-401,47,1
r4rk1/p4ppp/n1Nqp3/2bn4/8/2N2Q2/1PPP1PPP/2B1K2R w K - 1 14,Na5,-475,-497,-22,1
r4rk1/p4ppp/n2qp3/N1bn4/8/2N2Q2/1PPP1PPP/2B1K2R b K - 2 14,Nxc3,-515,-452,63,1
r4rk1/p4ppp/n2qp3/N1b5/8/2n2Q2/1PPP1PPP/2B1K2R w K - 0 15,dxc3,-477,-508,-31,1
r4rk1/p4ppp/n2qp3/N1b5/8/2P2Q2/1PP2PPP/2B1K2R b K - 0 15,Bb6,-485,-429,56,1
r4rk1/p4ppp/nb1qp3/N7/8/2P2Q2/1PP2PPP/2B1K2R w K - 1 16,Nb7,-443,-484,-41,1
r4rk1/pN3ppp/nb1qp3/8/8/2P2Q2/1PP2PPP/2B1K2R b K - 2 16,Qc7,-508,-440,68,1
r4rk1/pNq2ppp/nb2p3/8/8/2P2Q2/1PP2PPP/2B1K2R w K - 3 17,O-O,-451,-601,-150,0
r4rk1/pNq2ppp/nb2p3/8/8/2P2Q2/1PP2PPP/2B2RK1 b - - 4 17,Nc5,-608,-485,123,1
r4rk1/pNq2ppp/1b2p3/2n5/8/2P2Q2/1PP2PPP/2B2RK1 w - - 5 18,Bf4,-486,-693,-207,0
r4rk1/pNq2ppp/1b2p3/2n5/5B2/2P2Q2/1PP2PPP/5RK1 b - - 6 18,Qxb7,-706,-676,30,1
r4rk1/pq3ppp/1b2p3/2n5/5B2/2P2Q2/1PP2PPP/5RK1 w - - 0 19,Qe2,-700,-694,6,1
r4rk1/pq3ppp/1b2p3/2n5/5B2/2P5/1PP1QPPP/5RK1 b - - 1 19,Na4,-682,-605,77,1
r4rk1/pq3ppp/1b2p3/8/n4B2/2P5/1PP1QPPP/5RK1 w - - 2 20,b3,-638,-714,-76,1
r4rk1/pq3ppp/1b2p3/8/n4B2/1PP5/2P1QPPP/5RK1 b - - 0 20,Nb2,-725,-466,259,1
r4rk1/pq3ppp/1b2p3/8/5B2/1PP5/1nP1QPPP/5RK1 w - - 1 21,Bc1,-507,-487,20,1
r4rk1/pq3ppp/1b2p3/8/8/1PP5/1nP1QPPP/2B2RK1 b - - 2 21,a5,-465,-430,35,1
r4rk1/1q3ppp/1b2p3/p7/8/1PP5/1nP1QPPP/2B2RK1 w - - 0 22,Bxb2,-436,-432,4,1
r4rk1/1q3ppp/1b2p3/p7/8/1PP5/1BP1QPPP/5RK1 b - - 0 22,Bc5,-481,-430,51,1
r4rk1/1q3ppp/4p3/p1b5/8/1PP5/1BP1QPPP/5RK1 w - - 1 23,c4,-448,-474,-26,1
r4rk1/1q3ppp/4p3/p1b5/2P5/1P6/1BP1QPPP/5RK1 b - - 0 23,a4,-426,-477,-51,1
r4rk1/1q3ppp/4p3/2b5/p1P5/1P6/1BP1QPPP/5RK1 w - - 0 24,Qg4,-424,-500,-76,1
r4rk1/1q3ppp/4p3/2b5/p1P3Q1/1P6/1BP2PPP/5RK1 b - - 1 24,axb3,-532,9999,10531,1
r4rk1/1q3ppp/4p3/2b5/2P3Q1/1p6/1BP2PPP/5RK1 w - - 0 25,Qxg7#,9999,10000,1,1
rnbqkbnr/pppppppp/8/8/8/8/PPPPPPPP/RNBQKBNR w KQkq - 0 1,e4,32,22,-10,1
rnbqkbnr/pppppppp/8/8/4P3/8/PPPP1PPP/RNBQKBNR b KQkq - 0 1,a6,26,71,45,1
rnbqkbnr/1ppppppp/p7/8/4P3/8/PPPP1PPP/RNBQKBNR w KQkq - 0 2,Nf3,70,43,-27,1
rnbqkbnr/1ppppppp/p7/8/4P3/5N2/PPPP1PPP/RNBQKB1R b KQkq - 1 2,e6,34,60,26,1
rnbqkbnr/1ppp1ppp/p3p3/8/4P3/5N2/PPPP1PPP/RNBQKB1R w KQkq - 0 3,Bc4,63,-20,-83,1
rnbqkbnr/1ppp1ppp/p3p3/8/2B1P3/5N2/PPPP1PPP/RNBQK2R b KQkq - 1 3,Nc6,-14,46,60,1
r1bqkbnr/1ppp1ppp/p1n1p3/8/2B1P3/5N2/PPPP1PPP/RNBQK2R w KQkq - 2 4,d4,37,25,-12,1
r1bqkbnr/1ppp1ppp/p1n1p3/8/2BPP3/5N2/PPP2PPP/RNBQK2R b KQkq - 0 4,h6,30,90,60,1
r1bqkbnr/1ppp1pp1/p1n1p2p/8/2BPP3/5N2/PPP2PPP/RNBQK2R w KQkq - 0 5,d5,85,81,-4,1
r1bqkbnr/1ppp1pp1/p1n1p2p/3P4/2B1P3/5N2/PPP2PPP/RNBQK2R b KQkq - 0 5,exd5,83,131,48,1
r1bqkbnr/1ppp1pp1/p1n4p/3p4/2B1P3/5N2/PPP2PPP/RNBQK2R w KQkq - 0 6,Bxd5,132,17,-115,0
r1bqkbnr/1ppp1pp1/p1n4p/3B4/4P3/5N2/PPP2PPP/RNBQK2R b KQkq - 0 6,Nce7,15,111,96,1
r1bqkbnr/1pppnpp1/p6p/3B4/4P3/5N2/PPP2PPP/RNBQK2R w KQkq - 1 7,Ne5,127,-21,-148,0
r1bqkbnr/1pppnpp1/p6p/3BN3/4P3/8/PPP2PPP/RNBQK2R b KQkq - 2 7,Nxd5,-46,-30,16,1
r1bqkbnr/1ppp1pp1/p6p/3nN3/4P3/8/PPP2PPP/RNBQK2R w KQkq - 0 8,exd5,-31,-30,1,1
r1bqkbnr/1ppp1pp1/p6p/3PN3/8/8/PPP2PPP/RNBQK2R b KQkq - 0 8,Qe7,-24,187,211,1
r1b1kbnr/1pppqpp1/p6p/3PN3/8/8/PPP2PPP/RNBQK2R w KQkq - 1 9,Bf4,175,-287,-462,0
r1b1kbnr/1pppqpp1/p6p/3PN3/5B2/8/PPP2PPP/RN1QK2R b KQkq - 2 9,Qb4+,-234,-46,188,1
r1b1kbnr/1ppp1pp1/p6p/3PN3/1q3B2/8/PPP2PPP/RN1QK2R w KQkq - 3 10,Nc3,-48,-279,-231,0
r1b1kbnr/1ppp1pp1/p6p/3PN3/1q3B2/2N5/PPP2PPP/R2QK2R b KQkq - 4 10,Qxf4,-247,-226,21,1
r1b1kbnr/1ppp1pp1/p6p/3PN3/5q2/2N5/PPP2PPP/R2QK2R w KQkq - 0 11,Qe2,-288,-244,44,1
r1b1kbnr/1ppp1pp1/p6p/3PN3/5q2/2N5/PPP1QPPP/R3K2R b KQkq - 1 11,Be7,-271,-214,57,1
r1b1k1nr/1pppbpp1/p6p/3PN3/5q2/2N5/PPP1QPPP/R3K2R w KQkq - 2 12,O-O,-197,-470,-273,0
r1b1k1nr/1pppbpp1/p6p/3PN3/5q2/2N5/PPP1QPPP/R4RK1 b kq - 3 12,Nf6,-483,-24,459,1
r1b1k2r/1pppbpp1/p4n1p/3PN3/5q2/2N5/PPP1QPPP/R4RK1 w kq - 4 13,g3,-213,-255,-42,1
r1b1k2r/1pppbpp1/p4n1p/3PN3/5q2/2N3P1/PPP1QP1P/R4RK1 b kq - 0 13,Qf5,-268,-266,2,1
r1b1k2r/1pppbpp1/p4n1p/3PNq2/8/2N3P1/PPP1QP1P/R4RK1 w kq - 1 14,f4,-288,-419,-131,0
r1b1k2r/1pppbpp1/p4n1p/3PNq2/5P2/2N3P1/PPP1Q2P/R4RK1 b kq - 0 14,d6,-408,-381,27,1
r1b1k2r/1pp1bpp1/p2p1n1p/3PNq2/5P2/2N3P1/PPP1Q2P/R4RK1 w kq - 0 15,Nc4,-412,-573,-161,0
r1b1k2r/1pp1bpp1/p2p1n1p/3P1q2/2N2P2/2N3P1/PPP1Q2P/R4RK1 b kq - 1 15,O-O,-540,-321,219,1
r1b2rk1/1pp1bpp1/p2p1n1p/3P1q2/2N2P2/2N3P1/PPP1Q2P/R4RK1 w - - 2 16,Nd2,-323,-697,-374,0
r1b2rk1/1pp1bpp1/p2p1n1p/3P1q2/5P2/2N3P1/PPPNQ2P/R4RK1 b - - 3 16,Qg6,-609,-334,275,1
r1b2rk1/1pp1bpp1/p2p1nqp/3P4/5P2/2N3P1/PPPNQ2P/R4RK1 w - - 4 17,Nf3,-312,-608,-296,0
r1b2rk1/1pp1bpp1/p2p1nqp/3P4/5P2/2N2NP1/PPP1Q2P/R4RK1 b - - 5 17,c6,-513,-151,362,1
r1b2rk1/1p2bpp1/p1pp1nqp/3P4/5P2/2N2NP1/PPP1Q2P/R4RK1 w - - 0 18,Nh4,-142,-249,-107,0
r1b2rk1/1p2bpp1/p1pp1nqp/3P4/5P1N/2N3P1/PPP1Q2P/R4RK1 b - - 1 18,Qh7,-237,-139,98,1
r1b2rk1/1p2bppq/p1pp1n1p/3P4/5P1N/2N3P1/PPP1Q2P/R4RK1 w - - 2 19,f5,-193,-502,-309,0
r1b2rk1/1p2bppq/p1pp1n1p/3P1P2/7N/2N3P1/PPP1Q2P/R4RK1 b - - 0 19,Bxf5,-490,-23,467,1
r4rk1/1p2bppq/p1pp1n1p/3P1b2/7N/2N3P1/PPP1Q2P/R4RK1 w - - 0 20,Qxe7,-23,-217,-194,0
r4rk1/1p2Qppq/p1pp1n1p/3P1b2/7N/2N3P1/PPP4P/R4RK1 b - - 0 20,Rae8,-240,-205,35,1
4rrk1/1p2Qppq/p1pp1n1p/3P1b2/7N/2N3P1/PPP4P/R4RK1 w - - 1 21,Qxd6,-208,-261,-53,1
4rrk1/1p3ppq/p1pQ1n1p/3P1b2/7N/2N3P1/PPP4P/R4RK1 b - - 0 21,Rd8,-231,-154,77,1
3r1rk1/1p3ppq/p1pQ1n1p/3P1b2/7N/2N3P1/PPP4P/R4RK1 w - - 1 22,Qe5,-141,-251,-110,0
3r1rk1/1p3ppq/p1p2n1p/3PQb2/7N/2N3P1/PPP4P/R4RK1 b - - 2 22,Rde8,-234,466,700,1
4rrk1/1p3ppq/p1p2n1p/3PQb2/7N/2N3P1/PPP4P/R4RK1 w - - 3 23,Qxf5,480,435,-45,1
4rrk1/1p3ppq/p1p2n1p/3P1Q2/7N/2N3P1/PPP4P/R4RK1 b - - 0 23,Qxf5,435,491,56,1
4rrk1/1p3pp1/p1p2n1p/3P1q2/7N/2N3P1/PPP4P/R4RK1 w - - 0 24,Nxf5,476,458,-18,1
4rrk1/1p3pp1/p1p2n1p/3P1N2/8/2N3P1/PPP4P/R4RK1 b - - 0 24,Ne4,454,483,29,1
4rrk1/1p3pp1/p1p4p/3P1N2/4n3/2N3P1/PPP4P/R4RK1 w - - 1 25,dxc6,499,464,-35,1
4rrk1/1p3pp1/p1P4p/5N2/4n3/2N3P1/PPP4P/R4RK1 b - - 0 25,bxc6,453,471,18,1
4rrk1/5pp1/p1p4p/5N2/4n3/2N3P1/PPP4P/R4RK1 w - - 0 26,Nxe4,525,512,-13,1
4rrk1/5pp1/p1p4p/5N2/4N3/6P1/PPP4P/R4RK1 b - - 0 26,Rxe4,501,492,-9,1
5rk1/5pp1/p1p4p/5N2/4r3/6P1/PPP4P/R4RK1 w - - 0 27,Nh4,476,456,-20,1
5rk1/5pp1/p1p4p/8/4r2N/6P1/PPP4P/R4RK1 b - - 1 27,g5,422,440,18,1
5rk1/5p2/p1p4p/6p1/4r2N/6P1/PPP4P/R4RK1 w - - 0 28,Rad1,468,22,-446,0
5rk1/5p2/p1p4p/6p1/4r2N/6P1/PPP4P/3R1RK1 b - - 1 28,Re7,31,494,463,1
5rk1/4rp2/p1p4p/6p1/7N/6P1/PPP4P/3R1RK1 w - - 2 29,Nf5,484,491,7,1
5rk1/4rp2/p1p4p/5Np1/8/6P1/PPP4P/3R1RK1 b - - 3 29,Rb7,481,571,90,1
5rk1/1r3p2/p1p4p/5Np1/8/6P1/PPP4P/3R1RK1 w - - 4 30,Nxh6+,562,479,-83,1
5rk1/1r3p2/p1p4N/6p1/8/6P1/PPP4P/3R1RK1 b - - 0 30,Kh7,480,492,12,1
5r2/1r3p1k/p1p4N/6p1/8/6P1/PPP4P/3R1RK1 w - - 1 31,Rd6,464,446,-18,1
5r2/1r3p1k/p1pR3N/6p1/8/6P1/PPP4P/5RK1 b - - 2 31,Re7,476,499,23,1
5r2/4rp1k/p1pR3N/6p1/8/6P1/PPP4P/5RK1 w - - 3 32,Nf5,496,450,-46,1
5r2/4rp1k/p1pR4/5Np1/8/6P1/PPP4P/5RK1 b - - 4 32,Re6,451,551,100,1
5r2/5p1k/p1pRr3/5Np1/8/6P1/PPP4P/5RK1 w - - 5 33,Rxe6,526,549,23,1
5r2/5p1k/p1p1R3/5Np1/8/6P1/PPP4P/5RK1 b - - 0 33,fxe6,533,548,15,1
5r2/7k/p1p1p3/5Np1/8/6P1/PPP4P/5RK1 w - - 0 34,Nd6,549,542,-7,1
5r2/7k/p1pNp3/6p1/8/6P1/PPP4P/5RK1 b - - 1 34,Rxf1+,518,587,69,1
8/7k/p1pNp3/6p1/8/6P1/PPP4P/5rK1 w - - 0 35,Kxf1,608,629,21,1
8/7k/p1pNp3/6p1/8/6P1/PPP4P/5K2 b - - 0 35,Kg6,629,654,25,1
rnbqkbnr/pppppppp/8/8/8/8/PPPPPPPP/RNBQKBNR w KQkq - 0 1,e4,30,35,5,1
rnbqkbnr/pppppppp/8/8/4P3/8/PPPP1PPP/RNBQKBNR b KQkq - 0 1,e5,31,32,1,1
rnbqkbnr/pppp1ppp/8/4p3/4P3/8/PPPP1PPP/RNBQKBNR w KQkq - 0 2,Bc4,32,-2,-34,1
rnbqkbnr/pppp1ppp/8/4p3/2B1P3/8/PPPP1PPP/RNBQK1NR b KQkq - 1 2,Nf6,-1,1,2,1
rnbqkb1r/pppp1ppp/5n2/4p3/2B1P3/8/PPPP1PPP/RNBQK1NR w KQkq - 2 3,d3,-1,-26,-25,1
rnbqkb1r/pppp1ppp/5n2/4p3/2B1P3/3P4/PPP2PPP/RNBQK1NR b KQkq - 0 3,Bc5,-14,15,29,1
rnbqk2r/pppp1ppp/5n2/2b1p3/2B1P3/3P4/PPP2PPP/RNBQK1NR w KQkq - 1 4,Be3,12,-23,-35,1
rnbqk2r/pppp1ppp/5n2/2b1p3/2B1P3/3PB3/PPP2PPP/RN1QK1NR b KQkq - 2 4,Bxe3,-47,-43,4,1
rnbqk2r/pppp1ppp/5n2/4p3/2B1P3/3Pb3/PPP2PPP/RN1QK1NR w KQkq - 0 5,fxe3,-41,-47,-6,1
rnbqk2r/pppp1ppp/5n2/4p3/2B1P3/3PP3/PPP3PP/RN1QK1NR b KQkq - 0 5,O-O,-50,-30,20,1
rnbq1rk1/pppp1ppp/5n2/4p3/2B1P3/3PP3/PPP3PP/RN1QK1NR w KQ - 1 6,Nf3,-27,-25,2,1
rnbq1rk1/pppp1ppp/5n2/4p3/2B1P3/3PPN2/PPP3PP/RN1QK2R b KQ - 2 6,d6,-36,-20,16,1
rnbq1rk1/ppp2ppp/3p1n2/4p3/2B1P3/3PPN2/PPP3PP/RN1QK2R w KQ - 0 7,O-O,-16,-12,4,1
rnbq1rk1/ppp2ppp/3p1n2/4p3/2B1P3/3PPN2/PPP3PP/RN1Q1RK1 b - - 1 7,a6,-14,3,17,1
rnbq1rk1/1pp2ppp/p2p1n2/4p3/2B1P3/3PPN2/PPP3PP/RN1Q1RK1 w - - 0 8,Nc3,5,-21,-26,1
rnbq1rk1/1pp2ppp/p2p1n2/4p3/2B1P3/2NPPN2/PPP3PP/R2Q1RK1 b - - 1 8,b5,-21,-10,11,1
rnbq1rk1/2p2ppp/p2p1n2/1p2p3/2B1P3/2NPPN2/PPP3PP/R2Q1RK1 w - - 0 9,Bb3,-17,-7,10,1
rnbq1rk1/2p2ppp/p2p1n2/1p2p3/4P3/1BNPPN2/PPP3PP/R2Q1RK1 b - - 1 9,c5,-7,19,26,1
rnbq1rk1/5ppp/p2p1n2/1pp1p3/4P3/1BNPPN2/PPP3PP/R2Q1RK1 w - - 0 10,Bd5,34,-26,-60,1
rnbq1rk1/5ppp/p2p1n2/1ppBp3/4P3/2NPPN2/PPP3PP/R2Q1RK1 b - - 1 10,Nxd5,-26,-18,8,1
rnbq1rk1/5ppp/p2p4/1ppnp3/4P3/2NPPN2/PPP3PP/R2Q1RK1 w - - 0 11,Nxd5,-17,-12,5,1
rnbq1rk1/5ppp/p2p4/1ppNp3/4P3/3PPN2/PPP3PP/R2Q1RK1 b - - 0 11,Be6,-13,-13,0,1
rn1q1rk1/5ppp/p2pb3/1ppNp3/4P3/3PPN2/PPP3PP/R2Q1RK1 w - - 1 12,Nc3,-16,-35,-19,1
rn1q1rk1/5ppp/p2pb3/1pp1p3/4P3/2NPPN2/PPP3PP/R2Q1RK1 b - - 2 12,Nc6,-22,-36,-14,1
r2q1rk1/5ppp/p1npb3/1pp1p3/4P3/2NPPN2/PPP3PP/R2Q1RK1 w - - 3 13,a3,-32,-37,-5,1
r2q1rk1/5ppp/p1npb3/1pp1p3/4P3/P1NPPN2/1PP3PP/R2Q1RK1 b - - 0 13,Rc8,-39,-24,15,1
2rq1rk1/5ppp/p1npb3/1pp1p3/4P3/P1NPPN2/1PP3PP/R2Q1RK1 w - - 1 14,Ng5,-34,-547,-513,0
2rq1rk1/5ppp/p1npb3/1pp1p1N1/4P3/P1NPP3/1PP3PP/R2Q1RK1 b - - 2 14,h6,-528,27,555,1
2rq1rk1/5pp1/p1npb2p/1pp1p1N1/4P3/P1NPP3/1PP3PP/R2Q1RK1 w - - 0 15,Nxe6,4,0,-4,1
2rq1rk1/5pp1/p1npN2p/1pp1p3/4P3/P1NPP3/1PP3PP/R2Q1RK1 b - - 0 15,fxe6,15,11,-4,1
2rq1rk1/6p1/p1npp2p/1pp1p3/4P3/P1NPP3/1PP3PP/R2Q1RK1 w - - 0 16,Rxf8+,17,3,-14,1
2rq1Rk1/6p1/p1npp2p/1pp1p3/4P3/P1NPP3/1PP3PP/R2Q2K1 b - - 0 16,Qxf8,-2,14,16,1
2r2qk1/6p1/p1npp2p/1pp1p3/4P3/P1NPP3/1PP3PP/R2Q2K1 w - - 0 17,Qf1,28,-10,-38,1
2r2qk1/6p1/p1npp2p/1pp1p3/4P3/P1NPP3/1PP3PP/R4QK1 b - - 1 17,Qe7,-7,4,11,1
2r3k1/4q1p1/p1npp2p/1pp1p3/4P3/P1NPP3/1PP3PP/R4QK1 w - - 2 18,Qf3,10,-17,-27,1
2r3k1/4q1p1/p1npp2p/1pp1p3/4P3/P1NPPQ2/1PP3PP/R5K1 b - - 3 18,Rf8,-10,2,12,1
5rk1/4q1p1/p1npp2p/1pp1p3/4P3/P1NPPQ2/1PP3PP/R5K1 w - - 4 19,Qh3,7,-49,-56,1
5rk1/4q1p1/p1npp2p/1pp1p3/4P3/P1NPP2Q/1PP3PP/R5K1 b - - 5 19,Qf6,-46,-11,35,1
5rk1/6p1/p1nppq1p/1pp1p3/4P3/P1NPP2Q/1PP3PP/R5K1 w - - 6 20,g3,-28,-415,-387,0
5rk1/6p1/p1nppq1p/1pp1p3/4P3/P1NPP1PQ/1PP4P/R5K1 b - - 0 20,Qf2+,-305,-321,-16,1
5rk1/6p1/p1npp2p/1pp1p3/4P3/P1NPP1PQ/1PP2q1P/R5K1 w - - 1 21,Kh1,-324,-318,6,1
5rk1/6p1/p1npp2p/1pp1p3/4P3/P1NPP1PQ/1PP2q1P/R6K b - - 2 21,Qf3+,-317,-325,-8,1
5rk1/6p1/p1npp2p/1pp1p3/4P3/P1NPPqPQ/1PP4P/R6K w - - 3 22,Qg2,-324,-324,0,1
5rk1/6p1/p1npp2p/1pp1p3/4P3/P1NPPqP1/1PP3QP/R6K b - - 4 22,Qxe3,-309,-317,-8,1
5rk1/6p1/p1npp2p/1pp1p3/4P3/P1NPq1P1/1PP3QP/R6K w - - 0 23,Rf1,-338,-328,10,1
5rk1/6p1/p1npp2p/1pp1p3/4P3/P1NPq1P1/1PP3QP/5R1K b - - 1 23,Rxf1+,-338,-341,-3,1
6k1/6p1/p1npp2p/1pp1p3/4P3/P1NPq1P1/1PP3QP/5r1K w - - 0 24,Qxf1,-321,-320,1,1
6k1/6p1/p1npp2p/1pp1p3/4P3/P1NPq1P1/1PP4P/5Q1K b - - 0 24,Nd4,-324,-319,5,1
6k1/6p1/p2pp2p/1pp1p3/3nP3/P1NPq1P1/1PP4P/5Q1K w - - 1 25,Qh3,-341,-509,-168,0
6k1/6p1/p2pp2p/1pp1p3/3nP3/P1NPq1PQ/1PP4P/7K b - - 2 25,Qf3+,-487,-408,79,1
6k1/6p1/p2pp2p/1pp1p3/3nP3/P1NP1qPQ/1PP4P/7K w - - 3 26,Qg2,-428,-439,-11,1
6k1/6p1/p2pp2p/1pp1p3/3nP3/P1NP1qP1/1PP3QP/7K b - - 4 26,Qxg2+,-420,-393,27,1
6k1/6p1/p2pp2p/1pp1p3/3nP3/P1NP2P1/1PP3qP/7K w - - 0 27,Kxg2,-386,-388,-2,1
6k1/6p1/p2pp2p/1pp1p3/3nP3/P1NP2P1/1PP3KP/8 b - - 0 27,Nxc2,-416,-361,55,1
6k1/6p1/p2pp2p/1pp1p3/4P3/P1NP2P1/1Pn3KP/8 w - - 0 28,Kf3,-359,-382,-23,1
6k1/6p1/p2pp2p/1pp1p3/4P3/P1NP1KP1/1Pn4P/8 b - - 1 28,Kf7,-376,-365,11,1
8/5kp1/p2pp2p/1pp1p3/4P3/P1NP1KP1/1Pn4P/8 w - - 2 29,Kg4,-351,-421,-70,1
8/5kp1/p2pp2p/1pp1p3/4P1K1/P1NP2P1/1Pn4P/8 b - - 3 29,Ne1,-457,-471,-14,1
8/5kp1/p2pp2p/1pp1p3/4P1K1/P1NP2P1/1P5P/4n3 w - - 4 30,a4,-490,-473,17,1
8/5kp1/p2pp2p/1pp1p3/P3P1K1/2NP2P1/1P5P/4n3 b - - 0 30,bxa4,-540,-453,87,1
8/5kp1/p2pp2p/2p1p3/p3P1K1/2NP2P1/1P5P/4n3 w - - 0 31,Nxa4,-476,-430,46,1
8/5kp1/p2pp2p/2p1p3/N3P1K1/3P2P1/1P5P/4n3 b - - 0 31,Nxd3,-445,-440,5,1
8/5kp1/p2pp2p/2p1p3/N3P1K1/3n2P1/1P5P/8 w - - 0 32,b3,-414,-527,-113,0
8/5kp1/p2pp2p/2p1p3/N3P1K1/1P1n2P1/7P/8 b - - 0 32,Kf6,-512,-423,89,1
8/6p1/p2ppk1p/2p1p3/N3P1K1/1P1n2P1/7P/8 w - - 1 33,Kh5,-464,-462,2,1
8/6p1/p2ppk1p/2p1p2K/N3P3/1P1n2P1/7P/8 b - - 2 33,Nc1,-501,-495,6,1
8/6p1/p2ppk1p/2p1p2K/N3P3/1P4P1/7P/2n5 w - - 3 34,g4,-497,-527,-30,1
8/6p1/p2ppk1p/2p1p2K/N3P1P1/1P6/7P/2n5 b - - 0 34,Nxb3,-527,-550,-23,1
8/6p1/p2ppk1p/2p1p2K/N3P1P1/1n6/7P/8 w - - 0 35,g5+,-523,-614,-91,1
8/6p1/p2ppk1p/2p1p1PK/N3P3/1n6/7P/8 b - - 0 35,hxg5,-591,-569,22,1
rnbqkbnr/pppppppp/8/8/8/8/PPPPPPPP/RNBQKBNR w KQkq - 0 1,d4,27,18,-9,1
rnbqkbnr/pppppppp/8/8/3P4/8/PPP1PPPP/RNBQKBNR b KQkq - 0 1,c5,22,59,37,1
rnbqkbnr/pp1ppppp/8/2p5/3P4/8/PPP1PPPP/RNBQKBNR w KQkq - 0 2,c4,64,-29,-93,1
rnbqkbnr/pp1ppppp/8/2p5/2PP4/8/PP2PPPP/RNBQKBNR b KQkq - 0 2,cxd4,-20,-15,5,1
rnbqkbnr/pp1ppppp/8/8/2Pp4/8/PP2PPPP/RNBQKBNR w KQkq - 0 3,e3,-16,-77,-61,1
rnbqkbnr/pp1ppppp/8/8/2Pp4/4P3/PP3PPP/RNBQKBNR b KQkq - 0 3,Nc6,-83,40,123,1
r1bqkbnr/pp1ppppp/2n5/8/2Pp4/4P3/PP3PPP/RNBQKBNR w KQkq - 1 4,exd4,47,47,0,1
r1bqkbnr/pp1ppppp/2n5/8/2PP4/8/PP3PPP/RNBQKBNR b KQkq - 0 4,e6,32,67,35,1
r1bqkbnr/pp1p1ppp/2n1p3/8/2PP4/8/PP3PPP/RNBQKBNR w KQkq - 0 5,Nf3,52,39,-13,1
r1bqkbnr/pp1p1ppp/2n1p3/8/2PP4/5N2/PP3PPP/RNBQKB1R b KQkq - 1 5,Bb4+,45,50,5,1
r1bqk1nr/pp1p1ppp/2n1p3/8/1bPP4/5N2/PP3PPP/RNBQKB1R w KQkq - 2 6,Nc3,33,26,-7,1
r1bqk1nr/pp1p1ppp/2n1p3/8/1bPP4/2N2N2/PP3PPP/R1BQKB1R b KQkq - 3 6,Bxc3+,21,75,54,1
r1bqk1nr/pp1p1ppp/2n1p3/8/2PP4/2b2N2/PP3PPP/R1BQKB1R w KQkq - 0 7,bxc3,89,87,-2,1
r1bqk1nr/pp1p1ppp/2n1p3/8/2PP4/2P2N2/P4PPP/R1BQKB1R b KQkq - 0 7,Nf6,65,83,18,1
r1bqk2r/pp1p1ppp/2n1pn2/8/2PP4/2P2N2/P4PPP/R1BQKB1R w KQkq - 1 8,d5,90,57,-33,1
r1bqk2r/pp1p1ppp/2n1pn2/3P4/2P5/2P2N2/P4PPP/R1BQKB1R b KQkq - 0 8,Ne7,57,108,51,1
r1bqk2r/pp1pnppp/4pn2/3P4/2P5/2P2N2/P4PPP/R1BQKB1R w KQkq - 1 9,d6,94,17,-77,1
r1bqk2r/pp1pnppp/3Ppn2/8/2P5/2P2N2/P4PPP/R1BQKB1R b KQkq - 0 9,Nc6,8,65,57,1
r1bqk2r/pp1p1ppp/2nPpn2/8/2P5/2P2N2/P4PPP/R1BQKB1R w KQkq - 1 10,c5,62,-104,-166,0
r1bqk2r/pp1p1ppp/2nPpn2/2P5/8/2P2N2/P4PPP/R1BQKB1R b KQkq - 0 10,Qa5,-114,-122,-8,1
r1b1k2r/pp1p1ppp/2nPpn2/q1P5/8/2P2N2/P4PPP/R1BQKB1R w KQkq - 1 11,Qc2,-119,-137,-18,1
r1b1k2r/pp1p1ppp/2nPpn2/q1P5/8/2P2N2/P1Q2PPP/R1B1KB1R b KQkq - 2 11,Qxc5,-141,-113,28,1
r1b1k2r/pp1p1ppp/2nPpn2/2q5/8/2P2N2/P1Q2PPP/R1B1KB1R w KQkq - 0 12,Bd3,-132,-183,-51,1
r1b1k2r/pp1p1ppp/2nPpn2/2q5/8/2PB1N2/P1Q2PPP/R1B1K2R b KQkq - 1 12,Qxd6,-172,-120,52,1
r1b1k2r/pp1p1ppp/2nqpn2/8/8/2PB1N2/P1Q2PPP/R1B1K2R w KQkq - 0 13,O-O,-111,-121,-10,1
r1b1k2r/pp1p1ppp/2nqpn2/8/8/2PB1N2/P1Q2PPP/R1B2RK1 b kq - 1 13,O-O,-122,-92,30,1
r1b2rk1/pp1p1ppp/2nqpn2/8/8/2PB1N2/P1Q2PPP/R1B2RK1 w - - 2 14,Be3,-83,-153,-70,1
r1b2rk1/pp1p1ppp/2nqpn2/8/8/2PBBN2/P1Q2PPP/R4RK1 b - - 3 14,Qe7,-176,-176,0,1
r1b2rk1/pp1pqppp/2n1pn2/8/8/2PBBN2/P1Q2PPP/R4RK1 w - - 4 15,a4,-166,-212,-46,1
r1b2rk1/pp1pqppp/2n1pn2/8/P7/2PBBN2/2Q2PPP/R4RK1 b - - 0 15,d5,-215,-220,-5,1
r1b2rk1/pp2qppp/2n1pn2/3p4/P7/2PBBN2/2Q2PPP/R4RK1 w - - 0 16,Nd4,-206,-236,-30,1
r1b2rk1/pp2qppp/2n1pn2/3p4/P2N4/2PBB3/2Q2PPP/R4RK1 b - - 1 16,Ne5,-224,-193,31,1
r1b2rk1/pp2qppp/4pn2/3pn3/P2N4/2PBB3/2Q2PPP/R4RK1 w - - 2 17,Be2,-172,-235,-63,1
r1b2rk1/pp2qppp/4pn2/3pn3/P2N4/2P1B3/2Q1BPPP/R4RK1 b - - 3 17,Neg4,-227,-211,16,1
r1b2rk1/pp2qppp/4pn2/3p4/P2N2n1/2P1B3/2Q1BPPP/R4RK1 w - - 4 18,Bd2,-210,-230,-20,1
r1b2rk1/pp2qppp/4pn2/3p4/P2N2n1/2P5/2QBBPPP/R4RK1 b - - 5 18,Ne5,-207,-190,17,1
r1b2rk1/pp2qppp/4pn2/3pn3/P2N4/2P5/2QBBPPP/R4RK1 w - - 6 19,f4,-227,-225,2,1
r1b2rk1/pp2qppp/4pn2/3pn3/P2N1P2/2P5/2QBB1PP/R4RK1 b - - 0 19,Nc4,-234,-223,11,1
r1b2rk1/pp2qppp/4pn2/3p4/P1nN1P2/2P5/2QBB1PP/R4RK1 w - - 1 20,Bc1,-226,-256,-30,1
r1b2rk1/pp2qppp/4pn2/3p4/P1nN1P2/2P5/2Q1B1PP/R1B2RK1 b - - 2 20,Nb6,-245,50,295,1
r1b2rk1/pp2qppp/1n2pn2/3p4/P2N1P2/2P5/2Q1B1PP/R1B2RK1 w - - 3 21,f5,70,-179,-249,0
r1b2rk1/pp2qppp/1n2pn2/3p1P2/P2N4/2P5/2Q1B1PP/R1B2RK1 b - - 0 21,Nbd7,-181,-83,98,1
r1b2rk1/pp1nqppp/4pn2/3p1P2/P2N4/2P5/2Q1B1PP/R1B2RK1 w - - 1 22,fxe6,-92,-102,-10,1
r1b2rk1/pp1nqppp/4Pn2/3p4/P2N4/2P5/2Q1B1PP/R1B2RK1 b - - 0 22,fxe6,-99,-97,2,1
r1b2rk1/pp1nq1pp/4pn2/3p4/P2N4/2P5/2Q1B1PP/R1B2RK1 w - - 0 23,Ba3,-75,-79,-4,1
r1b2rk1/pp1nq1pp/4pn2/3p4/P2N4/B1P5/2Q1B1PP/R4RK1 b - - 1 23,Nc5,-84,-80,4,1
r1b2rk1/pp2q1pp/4pn2/2np4/P2N4/B1P5/2Q1B1PP/R4RK1 w - - 2 24,Nxe6,-92,-365,-273,0
r1b2rk1/pp2q1pp/4Nn2/2np4/P7/B1P5/2Q1B1PP/R4RK1 b - - 0 24,Rd8,-407,382,789,1
r1br2k1/pp2q1pp/4Nn2/2np4/P7/B1P5/2Q1B1PP/R4RK1 w - - 1 25,Nxc5,369,371,2,1
rnbqkbnr/pppppppp/8/8/8/8/PPPPPPPP/RNBQKBNR w KQkq - 0 1,e4,28,30,2,1
rnbqkbnr/pppppppp/8/8/4P3/8/PPPP1PPP/RNBQKBNR b KQkq - 0 1,e5,29,22,-7,1
rnbqkbnr/pppp1ppp/8/4p3/4P3/8/PPPP1PPP/RNBQKBNR w KQkq - 0 2,Bc4,27,-4,-31,1
rnbqkbnr/pppp1ppp/8/4p3/2B1P3/8/PPPP1PPP/RNBQK1NR b KQkq - 1 2,Nf6,-2,-3,-1,1
rnbqkb1r/pppp1ppp/5n2/4p3/2B1P3/8/PPPP1PPP/RNBQK1NR w KQkq - 2 3,d3,-6,-13,-7,1
rnbqkb1r/pppp1ppp/5n2/4p3/2B1P3/3P4/PPP2PPP/RNBQK1NR b KQkq - 0 3,h6,5,45,40,1
rnbqkb1r/pppp1pp1/5n1p/4p3/2B1P3/3P4/PPP2PPP/RNBQK1NR w KQkq - 0 4,f4,1,-25,-26,1
rnbqkb1r/pppp1pp1/5n1p/4p3/2B1PP2/3P4/PPP3PP/RNBQK1NR b KQkq - 0 4,exf4,-6,2,8,1
rnbqkb1r/pppp1pp1/5n1p/8/2B1Pp2/3P4/PPP3PP/RNBQK1NR w KQkq - 0 5,Bxf4,-3,-3,0,1
rnbqkb1r/pppp1pp1/5n1p/8/2B1PB2/3P4/PPP3PP/RN1QK1NR b KQkq - 0 5,d6,-14,40,54,1
rnbqkb1r/ppp2pp1/3p1n1p/8/2B1PB2/3P4/PPP3PP/RN1QK1NR w KQkq - 0 6,Nc3,54,63,9,1
rnbqkb1r/ppp2pp1/3p1n1p/8/2B1PB2/2NP4/PPP3PP/R2QK1NR b KQkq - 1 6,a6,60,89,29,1
rnbqkb1r/1pp2pp1/p2p1n1p/8/2B1PB2/2NP4/PPP3PP/R2QK1NR w KQkq - 0 7,Nf3,83,89,6,1
rnbqkb1r/1pp2pp1/p2p1n1p/8/2B1PB2/2NP1N2/PPP3PP/R2QK2R b KQkq - 1 7,Nc6,80,106,26,1
r1bqkb1r/1pp2pp1/p1np1n1p/8/2B1PB2/2NP1N2/PPP3PP/R2QK2R w KQkq - 2 8,a3,115,69,-46,1
r1bqkb1r/1pp2pp1/p1np1n1p/8/2B1PB2/P1NP1N2/1PP3PP/R2QK2R b KQkq - 0 8,g5,67,69,2,1
r1bqkb1r/1pp2p2/p1np1n1p/6p1/2B1PB2/P1NP1N2/1PP3PP/R2QK2R w KQkq - 0 9,Be3,89,81,-8,1
r1bqkb1r/1pp2p2/p1np1n1p/6p1/2B1P3/P1NPBN2/1PP3PP/R2QK2R b KQkq - 1 9,Ng4,79,72,-7,1
r1bqkb1r/1pp2p2/p1np3p/6p1/2B1P1n1/P1NPBN2/1PP3PP/R2QK2R w KQkq - 2 10,Qe2,73,6,-67,1
r1bqkb1r/1pp2p2/p1np3p/6p1/2B1P1n1/P1NPBN2/1PP1Q1PP/R3K2R b KQkq - 3 10,Nxe3,-3,0,3,1
r1bqkb1r/1pp2p2/p1np3p/6p1/2B1P3/P1NPnN2/1PP1Q1PP/R3K2R w KQkq - 0 11,Qxe3,8,5,-3,1
r1bqkb1r/1pp2p2/p1np3p/6p1/2B1P3/P1NPQN2/1PP3PP/R3K2R b KQkq - 0 11,Bg7,9,12,3,1
r1bqk2r/1pp2pb1/p1np3p/6p1/2B1P3/P1NPQN2/1PP3PP/R3K2R w KQkq - 1 12,O-O,10,-79,-89,1
r1bqk2r/1pp2pb1/p1np3p/6p1/2B1P3/P1NPQN2/1PP3PP/R4RK1 b kq - 2 12,O-O,-86,5,91,1
r1bq1rk1/1pp2pb1/p1np3p/6p1/2B1P3/P1NPQN2/1PP3PP/R4RK1 w - - 3 13,Nd5,21,-207,-228,0
r1bq1rk1/1pp2pb1/p1np3p/3N2p1/2B1P3/P2PQN2/1PP3PP/R4RK1 b - - 4 13,Be6,-228,34,262,1
r2q1rk1/1pp2pb1/p1npb2p/3N2p1/2B1P3/P2PQN2/1PP3PP/R4RK1 w - - 5 14,c3,42,25,-17,1
r2q1rk1/1pp2pb1/p1npb2p/3N2p1/2B1P3/P1PPQN2/1P4PP/R4RK1 b - - 0 14,Bxd5,24,128,104,1
r2q1rk1/1pp2pb1/p1np3p/3b2p1/2B1P3/P1PPQN2/1P4PP/R4RK1 w - - 0 15,Bxd5,137,148,11,1
r2q1rk1/1pp2pb1/p1np3p/3B2p1/4P3/P1PPQN2/1P4PP/R4RK1 b - - 0 15,Ne7,145,163,18,1
r2q1rk1/1pp1npb1/p2p3p/3B2p1/4P3/P1PPQN2/1P4PP/R4RK1 w - - 1 16,Ba2,133,152,19,1
r2q1rk1/1pp1npb1/p2p3p/6p1/4P3/P1PPQN2/BP4PP/R4RK1 b - - 2 16,c6,139,221,82,1
r2q1rk1/1p2npb1/p1pp3p/6p1/4P3/P1PPQN2/BP4PP/R4RK1 w - - 0 17,Nd4,228,116,-112,0
r2q1rk1/1p2npb1/p1pp3p/6p1/3NP3/P1PPQ3/BP4PP/R4RK1 b - - 1 17,c5,120,256,136,1
r2q1rk1/1p2npb1/p2p3p/2p3p1/3NP3/P1PPQ3/BP4PP/R4RK1 w - - 0 18,Nf5,219,234,15,1
r2q1rk1/1p2npb1/p2p3p/2p2Np1/4P3/P1PPQ3/BP4PP/R4RK1 b - - 1 18,Nxf5,216,247,31,1
r2q1rk1/1p3pb1/p2p3p/2p2np1/4P3/P1PPQ3/BP4PP/R4RK1 w - - 0 19,Rxf5,203,198,-5,1
r2q1rk1/1p3pb1/p2p3p/2p2Rp1/4P3/P1PPQ3/BP4PP/R5K1 b - - 0 19,b5,217,220,3,1
r2q1rk1/5pb1/p2p3p/1pp2Rp1/4P3/P1PPQ3/BP4PP/R5K1 w - - 0 20,Raf1,240,227,-13,1
r2q1rk1/5pb1/p2p3p/1pp2Rp1/4P3/P1PPQ3/BP4PP/5RK1 b - - 1 20,c4,212,285,73,1
r2q1rk1/5pb1/p2p3p/1p3Rp1/2p1P3/P1PPQ3/BP4PP/5RK1 w - - 0 21,dxc4,291,297,6,1
r2q1rk1/5pb1/p2p3p/1p3Rp1/2P1P3/P1P1Q3/BP4PP/5RK1 b - - 0 21,Rb8,297,338,41,1
1r1q1rk1/5pb1/p2p3p/1p3Rp1/2P1P3/P1P1Q3/BP4PP/5RK1 w - - 1 22,c5,348,348,0,1
1r1q1rk1/5pb1/p2p3p/1pP2Rp1/4P3/P1P1Q3/BP4PP/5RK1 b - - 0 22,dxc5,358,397,39,1
1r1q1rk1/5pb1/p6p/1pp2Rp1/4P3/P1P1Q3/BP4PP/5RK1 w - - 0 23,Qxc5,339,286,-53,1
1r1q1rk1/5pb1/p6p/1pQ2Rp1/4P3/P1P5/BP4PP/5RK1 b - - 0 23,Kh8,287,310,23,1
1r1q1r1k/5pb1/p6p/1pQ2Rp1/4P3/P1P5/BP4PP/5RK1 w - - 1 24,Rxf7,331,228,-103,0
1r1q1r1k/5Rb1/p6p/1pQ3p1/4P3/P1P5/BP4PP/5RK1 b - - 0 24,Re8,228,351,123,1
1r1qr2k/5Rb1/p6p/1pQ3p1/4P3/P1P5/BP4PP/5RK1 w - - 1 25,Bb1,362,248,-114,0
1r1qr2k/5Rb1/p6p/1pQ3p1/4P3/P1P5/1P4PP/1B3RK1 b - - 2 25,Qb6,234,253,19,1
1r2r2k/5Rb1/pq5p/1pQ3p1/4P3/P1P5/1P4PP/1B3RK1 w - - 3 26,Qxb6,272,269,-3,1
1r2r2k/5Rb1/pQ5p/1p4p1/4P3/P1P5/1P4PP/1B3RK1 b - - 0 26,Rxb6,275,268,-7,1
4r2k/5Rb1/pr5p/1p4p1/4P3/P1P5/1P4PP/1B3RK1 w - - 0 27,Rd1,280,251,-29,1
4r2k/5Rb1/pr5p/1p4p1/4P3/P1P5/1P4PP/1B1R2K1 b - - 1 27,Rf6,248,252,4,1
4r2k/5Rb1/p4r1p/1p4p1/4P3/P1P5/1P4PP/1B1R2K1 w - - 2 28,Rxf6,216,244,28,1
4r2k/6b1/p4R1p/1p4p1/4P3/P1P5/1P4PP/1B1R2K1 b - - 0 28,Bxf6,239,228,-11,1
4r2k/8/p4b1p/1p4p1/4P3/P1P5/1P4PP/1B1R2K1 w - - 0 29,Rd6,251,167,-84,1
4r2k/8/p2R1b1p/1p4p1/4P3/P1P5/1P4PP/1B4K1 b - - 1 29,Be5,149,184,35,1
4r2k/8/p2R3p/1p2b1p1/4P3/P1P5/1P4PP/1B4K1 w - - 2 30,Rxa6,158,109,-49,1
4r2k/8/R6p/1p2b1p1/4P3/P1P5/1P4PP/1B4K1 b - - 0 30,Re7,135,350,215,1
7k/4r3/R6p/1p2b1p1/4P3/P1P5/1P4PP/1B4K1 w - - 1 31,Rxh6+,366,371,5,1
7k/4r3/7R/1p2b1p1/4P3/P1P5/1P4PP/1B4K1 b - - 0 31,Kg8,362,440,78,1
6k1/4r3/7R/1p2b1p1/4P3/P1P5/1P4PP/1B4K1 w - - 1 32,Rg6+,449,501,52,1
6k1/4r3/6R1/1p2b1p1/4P3/P1P5/1P4PP/1B4K1 b - - 2 32,Kh7,499,520,21,1
8/4r2k/6R1/1p2b1p1/4P3/P1P5/1P4PP/1B4K1 w - - 3 33,Rxg5,528,531,3,1
8/4r2k/8/1p2b1R1/4P3/P1P5/1P4PP/1B4K1 b - - 0 33,Kh6,530,556,26,1
8/4r3/7k/1p2b1R1/4P3/P1P5/1P4PP/1B4K1 w - - 1 34,Rf5,548,542,-6,1
8/4r3/7k/1p2bR2/4P3/P1P5/1P4PP/1B4K1 b - - 2 34,Bg7,514,590,76,1
8/4r1b1/7k/1p3R2/4P3/P1P5/1P4PP/1B4K1 w - - 3 35,g4,578,588,10,1
8/4r1b1/7k/1p3R2/4P1P1/P1P5/1P5P/1B4K1 b - - 0 35,Rd7,571,670,99,1
8/3r2b1/7k/1p3R2/4P1P1/P1P5/1P5P/1B4K1 w - - 1 36,h4,726,392,-334,0
8/3r2b1/7k/1p3R2/4P1PP/P1P5/1P6/1B4K1 b - - 0 36,Rd1+,363,391,28,1
8/6b1/7k/1p3R2/4P1PP/P1P5/1P6/1B1r2K1 w - - 1 37,Rf1,374,379,5,1
8/6b1/7k/1p6/4P1PP/P1P5/1P6/1B1r1RK1 b - - 2 37,Rxf1+,380,594,214,1
8/6b1/7k/1p6/4P1PP/P1P5/1P6/1B3rK1 w - - 0 38,Kxf1,616,593,-23,1
8/6b1/7k/1p6/4P1PP/P1P5/1P6/1B3K2 b - - 0 38,Be5,628,587,-41,1
8/8/7k/1p2b3/4P1PP/P1P5/1P6/1B3K2 w - - 1 39,Kf2,590,606,16,1
8/8/7k/1p2b3/4P1PP/P1P5/1P3K2/1B6 b - - 2 39,Bf4,606,623,17,1
8/8/7k/1p6/4PbPP/P1P5/1P3K2/1B6 w - - 3 40,Kf3,565,548,-17,1
8/8/7k/1p6/4PbPP/P1P2K2/1P6/1B6 b - - 4 40,Bc1,579,566,-13,1
8/8/7k/1p6/4P1PP/P1P2K2/1P6/1Bb5 w - - 5 41,b3,570,527,-43,1
8/8/7k/1p6/4P1PP/PPP2K2/8/1Bb5 b - - 0 41,Bxa3,514,507,-7,1
8/8/7k/1p6/4P1PP/bPP2K2/8/1B6 w - - 0 42,c4,526,453,-73,1
8/8/7k/1p6/2P1P1PP/bP3K2/8/1B6 b - - 0 42,bxc4,473,472,-1,1
8/8/7k/8/2p1P1PP/bP3K2/8/1B6 w - - 0 43,bxc4,492,522,30,1
8/8/7k/8/2P1P1PP/b4K2/8/1B6 b - - 0 43,Bc5,500,517,17,1
8/8/7k/2b5/2P1P1PP/5K2/8/1B6 w - - 1 44,Kf4,560,541,-19,1
8/8/7k/2b5/2P1PKPP/8/8/1B6 b - - 2 44,Kg6,571,578,7,1
8/8/6k1/2b5/2P1PKPP/8/8/1B6 w - - 3 45,h5+,561,593,32,1
8/8/6k1/2b4P/2P1PKP1/8/8/1B6 b - - 0 45,Kh6,597,631,34,1
8/8/7k/2b4P/2P1PKP1/8/8/1B6 w - - 1 46,Kf5,627,614,-13,1
rnbqkbnr/pppppppp/8/8/8/8/PPPPPPPP/RNBQKBNR w KQkq - 0 1,e4,30,31,1,1
rnbqkbnr/pppppppp/8/8/4P3/8/PPPP1PPP/RNBQKBNR b KQkq - 0 1,d5,28,70,42,1
rnbqkbnr/ppp1pppp/8/3p4/4P3/8/PPPP1PPP/RNBQKBNR w KQkq - 0 2,exd5,64,59,-5,1
rnbqkbnr/ppp1pppp/8/3P4/8/8/PPPP1PPP/RNBQKBNR b KQkq - 0 2,Nf6,61,71,10,1
rnbqkb1r/ppp1pppp/5n2/3P4/8/8/PPPP1PPP/RNBQKBNR w KQkq - 1 3,Nc3,69,20,-49,1
rnbqkb1r/ppp1pppp/5n2/3P4/8/2N5/PPPP1PPP/R1BQKBNR b KQkq - 2 3,Nxd5,16,20,4,1
rnbqkb1r/ppp1pppp/8/3n4/8/2N5/PPPP1PPP/R1BQKBNR w KQkq - 0 4,d4,30,26,-4,1
rnbqkb1r/ppp1pppp/8/3n4/3P4/2N5/PPP2PPP/R1BQKBNR b KQkq - 0 4,Nxc3,33,27,-6,1
rnbqkb1r/ppp1pppp/8/8/3P4/2n5/PPP2PPP/R1BQKBNR w KQkq - 0 5,bxc3,24,19,-5,1
rnbqkb1r/ppp1pppp/8/8/3P4/2P5/P1P2PPP/R1BQKBNR b KQkq - 0 5,Bf5,13,71,58,1
rn1qkb1r/ppp1pppp/8/5b2/3P4/2P5/P1P2PPP/R1BQKBNR w KQkq - 1 6,Nf3,86,47,-39,1
rn1qkb1r/ppp1pppp/8/5b2/3P4/2P2N2/P1P2PPP/R1BQKB1R b KQkq - 2 6,g6,28,70,42,1
rn1qkb1r/ppp1pp1p/6p1/5b2/3P4/2P2N2/P1P2PPP/R1BQKB1R w KQkq - 0 7,Bc4,73,40,-33,1
rn1qkb1r/ppp1pp1p/6p1/5b2/2BP4/2P2N2/P1P2PPP/R1BQK2R b KQkq - 1 7,Bg7,37,57,20,1
rn1qk2r/ppp1ppbp/6p1/5b2/2BP4/2P2N2/P1P2PPP/R1BQK2R w KQkq - 2 8,Nh4,35,1,-34,1
rn1qk2r/ppp1ppbp/6p1/5b2/2BP3N/2P5/P1P2PPP/R1BQK2R b KQkq - 3 8,Bd7,1,8,7,1
rn1qk2r/pppbppbp/6p1/8/2BP3N/2P5/P1P2PPP/R1BQK2R w KQkq - 4 9,O-O,12,-7,-19,1
rn1qk2r/pppbppbp/6p1/8/2BP3N/2P5/P1P2PPP/R1BQ1RK1 b kq - 5 9,O-O,-9,15,24,1
rn1q1rk1/pppbppbp/6p1/8/2BP3N/2P5/P1P2PPP/R1BQ1RK1 w - - 6 10,f4,33,-39,-72,1
rn1q1rk1/pppbppbp/6p1/8/2BP1P1N/2P5/P1P3PP/R1BQ1RK1 b - - 0 10,b5,-44,-39,5,1
rn1q1rk1/p1pbppbp/6p1/1p6/2BP1P1N/2P5/P1P3PP/R1BQ1RK1 w - - 0 11,Bb3,-37,-99,-62,1
rn1q1rk1/p1pbppbp/6p1/1p6/3P1P1N/1BP5/P1P3PP/R1BQ1RK1 b - - 1 11,a5,-83,-26,57,1
rn1q1rk1/2pbppbp/6p1/pp6/3P1P1N/1BP5/P1P3PP/R1BQ1RK1 w - - 0 12,a4,-36,-32,4,1
rn1q1rk1/2pbppbp/6p1/pp6/P2P1P1N/1BP5/2P3PP/R1BQ1RK1 b - - 0 12,bxa4,-46,-2,44,1
rn1q1rk1/2pbppbp/6p1/p7/p2P1P1N/1BP5/2P3PP/R1BQ1RK1 w - - 0 13,Bc4,-1,-11,-10,1
rn1q1rk1/2pbppbp/6p1/p7/p1BP1P1N/2P5/2P3PP/R1BQ1RK1 b - - 1 13,Na6,-20,184,204,1
r2q1rk1/2pbppbp/n5p1/p7/p1BP1P1N/2P5/2P3PP/R1BQ1RK1 w - - 2 14,f5,146,88,-58,1
r2q1rk1/2pbppbp/n5p1/p4P2/p1BP3N/2P5/2P3PP/R1BQ1RK1 b - - 0 14,Bxf5,131,259,128,1
r2q1rk1/2p1ppbp/n5p1/p4b2/p1BP3N/2P5/2P3PP/R1BQ1RK1 w - - 0 15,Nxf5,275,260,-15,1
r2q1rk1/2p1ppbp/n5p1/p4N2/p1BP4/2P5/2P3PP/R1BQ1RK1 b - - 0 15,gxf5,277,267,-10,1
r2q1rk1/2p1ppbp/n7/p4p2/p1BP4/2P5/2P3PP/R1BQ1RK1 w - - 0 16,Rxf5,284,272,-12,1
r2q1rk1/2p1ppbp/n7/p4R2/p1BP4/2P5/2P3PP/R1BQ2K1 b - - 0 16,c5,268,375,107,1
r2q1rk1/4ppbp/n7/p1p2R2/p1BP4/2P5/2P3PP/R1BQ2K1 w - - 0 17,Qg4,366,357,-9,1
r2q1rk1/4ppbp/n7/p1p2R2/p1BP2Q1/2P5/2P3PP/R1B3K1 b - - 1 17,cxd4,356,9998,9642,1
r2q1rk1/4ppbp/n7/p4R2/p1Bp2Q1/2P5/2P3PP/R1B3K1 w - - 0 18,Bh6,9998,9999,1,1
rnbqkbnr/pppppppp/8/8/8/8/PPPPPPPP/RNBQKBNR w KQkq - 0 1,d3,29,-15,-44,1
rnbqkbnr/pppppppp/8/8/8/3P4/PPP1PPPP/RNBQKBNR b KQkq - 0 1,d5,-21,-16,5,1
rnbqkbnr/ppp1pppp/8/3p4/8/3P4/PPP1PPPP/RNBQKBNR w KQkq - 0 2,e4,-21,-20,1,1
rnbqkbnr/ppp1pppp/8/3p4/4P3/3P4/PPP2PPP/RNBQKBNR b KQkq - 0 2,e5,-24,4,28,1
rnbqkbnr/ppp2ppp/8/3pp3/4P3/3P4/PPP2PPP/RNBQKBNR w KQkq - 0 3,exd5,19,7,-12,1
rnbqkbnr/ppp2ppp/8/3Pp3/8/3P4/PPP2PPP/RNBQKBNR b KQkq - 0 3,c6,0,65,65,1
rnbqkbnr/pp3ppp/2p5/3Pp3/8/3P4/PPP2PPP/RNBQKBNR w KQkq - 0 4,Nc3,54,-22,-76,1
rnbqkbnr/pp3ppp/2p5/3Pp3/8/2NP4/PPP2PPP/R1BQKBNR b KQkq - 1 4,Nf6,-8,36,44,1
rnbqkb1r/pp3ppp/2p2n2/3Pp3/8/2NP4/PPP2PPP/R1BQKBNR w KQkq - 2 5,g3,44,-65,-109,0
rnbqkb1r/pp3ppp/2p2n2/3Pp3/8/2NP2P1/PPP2P1P/R1BQKBNR b KQkq - 0 5,Bc5,-81,-38,43,1
rnbqk2r/pp3ppp/2p2n2/2bPp3/8/2NP2P1/PPP2P1P/R1BQKBNR w KQkq - 1 6,Bg2,-30,-35,-5,1
rnbqk2r/pp3ppp/2p2n2/2bPp3/8/2NP2P1/PPP2PBP/R1BQK1NR b KQkq - 2 6,cxd5,-39,-22,17,1
rnbqk2r/pp3ppp/5n2/2bpp3/8/2NP2P1/PPP2PBP/R1BQK1NR w KQkq - 0 7,Nh3,-30,-180,-150,0
rnbqk2r/pp3ppp/5n2/2bpp3/8/2NP2PN/PPP2PBP/R1BQK2R b KQkq - 1 7,O-O,-169,-16,153,1
rnbq1rk1/pp3ppp/5n2/2bpp3/8/2NP2PN/PPP2PBP/R1BQK2R w KQ - 2 8,O-O,-36,-198,-162,0
rnbq1rk1/pp3ppp/5n2/2bpp3/8/2NP2PN/PPP2PBP/R1BQ1RK1 b - - 3 8,Be6,-198,-59,139,1
rn1q1rk1/pp3ppp/4bn2/2bpp3/8/2NP2PN/PPP2PBP/R1BQ1RK1 w - - 4 9,Be3,-16,-235,-219,0
rn1q1rk1/pp3ppp/4bn2/2bpp3/8/2NPB1PN/PPP2PBP/R2Q1RK1 b - - 5 9,d4,-249,-198,51,1
rn1q1rk1/pp3ppp/4bn2/2b1p3/3p4/2NPB1PN/PPP2PBP/R2Q1RK1 w - - 0 10,Ne4,-230,-399,-169,0
rn1q1rk1/pp3ppp/4bn2/2b1p3/3pN3/3PB1PN/PPP2PBP/R2Q1RK1 b - - 1 10,Nxe4,-391,-377,14,1
rn1q1rk1/pp3ppp/4b3/2b1p3/3pn3/3PB1PN/PPP2PBP/R2Q1RK1 w - - 0 11,Bxe4,-409,-394,15,1
rn1q1rk1/pp3ppp/4b3/2b1p3/3pB3/3PB1PN/PPP2P1P/R2Q1RK1 b - - 0 11,dxe3,-410,-457,-47,1
rn1q1rk1/pp3ppp/4b3/2b1p3/4B3/3Pp1PN/PPP2P1P/R2Q1RK1 w - - 0 12,fxe3,-421,-539,-118,0
rn1q1rk1/pp3ppp/4b3/2b1p3/4B3/3PP1PN/PPP4P/R2Q1RK1 b - - 0 12,Nc6,-568,-450,118,1
r2q1rk1/pp3ppp/2n1b3/2b1p3/4B3/3PP1PN/PPP4P/R2Q1RK1 w - - 1 13,Kg2,-500,-551,-51,1
r2q1rk1/pp3ppp/2n1b3/2b1p3/4B3/3PP1PN/PPP3KP/R2Q1R2 b - - 2 13,Bd5,-564,-470,94,1
r2q1rk1/pp3ppp/2n5/2bbp3/4B3/3PP1PN/PPP3KP/R2Q1R2 w - - 3 14,Qh5,-483,-529,-46,1
r2q1rk1/pp3ppp/2n5/2bbp2Q/4B3/3PP1PN/PPP3KP/R4R2 b - - 4 14,Bxe4+,-548,-528,20,1
r2q1rk1/pp3ppp/2n5/2b1p2Q/4b3/3PP1PN/PPP3KP/R4R2 w - - 0 15,dxe4,-549,-520,29,1
r2q1rk1/pp3ppp/2n5/2b1p2Q/4P3/4P1PN/PPP3KP/R4R2 b - - 0 15,Qd2+,-520,-479,41,1
r4rk1/pp3ppp/2n5/2b1p2Q/4P3/4P1PN/PPPq2KP/R4R2 w - - 1 16,Rf2,-461,-540,-79,1
r4rk1/pp3ppp/2n5/2b1p2Q/4P3/4P1PN/PPPq1RKP/R7 b - - 2 16,Qxe3,-510,-549,-39,1
r4rk1/pp3ppp/2n5/2b1p2Q/4P3/4q1PN/PPP2RKP/R7 w - - 0 17,Ng5,-531,-671,-140,0
r4rk1/pp3ppp/2n5/2b1p1NQ/4P3/4q1P1/PPP2RKP/R7 b - - 1 17,Qxf2+,-691,-711,-20,1
r4rk1/pp3ppp/2n5/2b1p1NQ/4P3/6P1/PPP2qKP/R7 w - - 0 18,Kh3,-699,-745,-46,1
r4rk1/pp3ppp/2n5/2b1p1NQ/4P3/6PK/PPP2q1P/R7 b - - 1 18,h6,-766,-720,46,1
rnbqkbnr/pppppppp/8/8/8/8/PPPPPPPP/RNBQKBNR w KQkq - 0 1,e4,32,27,-5,1
rnbqkbnr/pppppppp/8/8/4P3/8/PPPP1PPP/RNBQKBNR b KQkq - 0 1,e5,18,43,25,1
rnbqkbnr/pppp1ppp/8/4p3/4P3/8/PPPP1PPP/RNBQKBNR w KQkq - 0 2,Nf3,20,26,6,1
rnbqkbnr/pppp1ppp/8/4p3/4P3/5N2/PPPP1PPP/RNBQKB1R b KQkq - 1 2,d6,17,59,42,1
rnbqkbnr/ppp2ppp/3p4/4p3/4P3/5N2/PPPP1PPP/RNBQKB1R w KQkq - 0 3,h3,52,32,-20,1
rnbqkbnr/ppp2ppp/3p4/4p3/4P3/5N1P/PPPP1PP1/RNBQKB1R b KQkq - 0 3,Nf6,31,28,-3,1
rnbqkb1r/ppp2ppp/3p1n2/4p3/4P3/5N1P/PPPP1PP1/RNBQKB1R w KQkq - 1 4,Nc3,23,27,4,1
rnbqkb1r/ppp2ppp/3p1n2/4p3/4P3/2N2N1P/PPPP1PP1/R1BQKB1R b KQkq - 2 4,Bd7,19,69,50,1
rn1qkb1r/pppb1ppp/3p1n2/4p3/4P3/2N2N1P/PPPP1PP1/R1BQKB1R w KQkq - 3 5,Bc4,89,37,-52,1
rn1qkb1r/pppb1ppp/3p1n2/4p3/2B1P3/2N2N1P/PPPP1PP1/R1BQK2R b KQkq - 4 5,Be7,44,57,13,1
rn1qk2r/pppbbppp/3p1n2/4p3/2B1P3/2N2N1P/PPPP1PP1/R1BQK2R w KQkq - 5 6,a3,45,31,-14,1
rn1qk2r/pppbbppp/3p1n2/4p3/2B1P3/P1N2N1P/1PPP1PP1/R1BQK2R b KQkq - 0 6,Bc6,23,68,45,1
rn1qk2r/ppp1bppp/2bp1n2/4p3/2B1P3/P1N2N1P/1PPP1PP1/R1BQK2R w KQkq - 1 7,d3,67,62,-5,1
rn1qk2r/ppp1bppp/2bp1n2/4p3/2B1P3/P1NP1N1P/1PP2PP1/R1BQK2R b KQkq - 0 7,Nbd7,59,104,45,1
r2qk2r/pppnbppp/2bp1n2/4p3/2B1P3/P1NP1N1P/1PP2PP1/R1BQK2R w KQkq - 1 8,O-O,105,69,-36,1
r2qk2r/pppnbppp/2bp1n2/4p3/2B1P3/P1NP1N1P/1PP2PP1/R1BQ1RK1 b kq - 2 8,O-O,73,73,0,1
r2q1rk1/pppnbppp/2bp1n2/4p3/2B1P3/P1NP1N1P/1PP2PP1/R1BQ1RK1 w - - 3 9,Be3,74,75,1,1
r2q1rk1/pppnbppp/2bp1n2/4p3/2B1P3/P1NPBN1P/1PP2PP1/R2Q1RK1 b - - 4 9,h6,73,90,17,1
r2q1rk1/pppnbpp1/2bp1n1p/4p3/2B1P3/P1NPBN1P/1PP2PP1/R2Q1RK1 w - - 0 10,Nh2,79,28,-51,1
r2q1rk1/pppnbpp1/2bp1n1p/4p3/2B1P3/P1NPB2P/1PP2PPN/R2Q1RK1 b - - 1 10,Nh7,26,90,64,1
r2q1rk1/pppnbppn/2bp3p/4p3/2B1P3/P1NPB2P/1PP2PPN/R2Q1RK1 w - - 2 11,Ne2,59,76,17,1
r2q1rk1/pppnbppn/2bp3p/4p3/2B1P3/P2PB2P/1PP1NPPN/R2Q1RK1 b - - 3 11,Bg5,76,81,5,1
r2q1rk1/pppn1ppn/2bp3p/4p1b1/2B1P3/P2PB2P/1PP1NPPN/R2Q1RK1 w - - 4 12,Ng3,75,8,-67,1
r2q1rk1/pppn1ppn/2bp3p/4p1b1/2B1P3/P2PB1NP/1PP2PPN/R2Q1RK1 b - - 5 12,Bxe3,23,15,-8,1
r2q1rk1/pppn1ppn/2bp3p/4p3/2B1P3/P2Pb1NP/1PP2PPN/R2Q1RK1 w - - 0 13,fxe3,18,20,2,1
r2q1rk1/pppn1ppn/2bp3p/4p3/2B1P3/P2PP1NP/1PP3PN/R2Q1RK1 b - - 0 13,Nhf6,14,65,51,1
r2q1rk1/pppn1pp1/2bp1n1p/4p3/2B1P3/P2PP1NP/1PP3PN/R2Q1RK1 w - - 1 14,Nf5,71,35,-36,1
r2q1rk1/pppn1pp1/2bp1n1p/4pN2/2B1P3/P2PP2P/1PP3PN/R2Q1RK1 b - - 2 14,Kh7,36,40,4,1
r2q1r2/pppn1ppk/2bp1n1p/4pN2/2B1P3/P2PP2P/1PP3PN/R2Q1RK1 w - - 3 15,Ng4,47,-13,-60,1
r2q1r2/pppn1ppk/2bp1n1p/4pN2/2B1P1N1/P2PP2P/1PP3P1/R2Q1RK1 b - - 4 15,Nxg4,-5,10,15,1
r2q1r2/pppn1ppk/2bp3p/4pN2/2B1P1n1/P2PP2P/1PP3P1/R2Q1RK1 w - - 0 16,Qxg4,10,10,0,1
r2q1r2/pppn1ppk/2bp3p/4pN2/2B1P1Q1/P2PP2P/1PP3P1/R4RK1 b - - 0 16,Qg5,19,66,47,1
r4r2/pppn1ppk/2bp3p/4pNq1/2B1P1Q1/P2PP2P/1PP3P1/R4RK1 w - - 1 17,Qe2,75,-84,-159,0
r4r2/pppn1ppk/2bp3p/4pNq1/2B1P3/P2PP2P/1PP1Q1P1/R4RK1 b - - 2 17,f6,-102,287,389,1
r4r2/pppn2pk/2bp1p1p/4pNq1/2B1P3/P2PP2P/1PP1Q1P1/R4RK1 w - - 0 18,Rf3,308,326,18,1
r4r2/pppn2pk/2bp1p1p/4pNq1/2B1P3/P2PPR1P/1PP1Q1P1/R5K1 b - - 1 18,Qg6,344,558,214,1
r4r2/pppn2pk/2bp1pqp/4pN2/2B1P3/P2PPR1P/1PP1Q1P1/R5K1 w - - 2 19,Rg3,561,544,-17,1
r4r2/pppn2pk/2bp1pqp/4pN2/2B1P3/P2PP1RP/1PP1Q1P1/R5K1 b - - 3 19,Qxg3,547,565,18,1
r4r2/pppn2pk/2bp1p1p/4pN2/2B1P3/P2PP1qP/1PP1Q1P1/R5K1 w - - 0 20,Nxg3,554,537,-17,1
r4r2/pppn2pk/2bp1p1p/4p3/2B1P3/P2PP1NP/1PP1Q1P1/R5K1 b - - 0 20,Rf7,541,712,171,1
rnbqkbnr/pppppppp/8/8/8/8/PPPPPPPP/RNBQKBNR w KQkq - 0 1,g3,29,-35,-64,1
rnbqkbnr/pppppppp/8/8/8/6P1/PPPPPP1P/RNBQKBNR b KQkq - 0 1,d5,-38,8,46,1
rnbqkbnr/ppp1pppp/8/3p4/8/6P1/PPPPPP1P/RNBQKBNR w KQkq - 0 2,Bg2,21,-42,-63,1
rnbqkbnr/ppp1pppp/8/3p4/8/6P1/PPPPPPBP/RNBQK1NR b KQkq - 1 2,Nf6,-39,28,67,1
rnbqkb1r/ppp1pppp/5n2/3p4/8/6P1/PPPPPPBP/RNBQK1NR w KQkq - 2 3,b3,14,-87,-101,0
rnbqkb1r/ppp1pppp/5n2/3p4/8/1P4P1/P1PPPPBP/RNBQK1NR b KQkq - 0 3,c6,-48,17,65,1
rnbqkb1r/pp2pppp/2p2n2/3p4/8/1P4P1/P1PPPPBP/RNBQK1NR w KQkq - 0 4,Bb2,-9,-15,-6,1
rnbqkb1r/pp2pppp/2p2n2/3p4/8/1P4P1/PBPPPPBP/RN1QK1NR b KQkq - 1 4,Bf5,-22,17,39,1
rn1qkb1r/pp2pppp/2p2n2/3p1b2/8/1P4P1/PBPPPPBP/RN1QK1NR w KQkq - 2 5,d3,8,17,9,1
rn1qkb1r/pp2pppp/2p2n2/3p1b2/8/1P1P2P1/PBP1PPBP/RN1QK1NR b KQkq - 0 5,Nbd7,15,17,2,1
r2qkb1r/pp1npppp/2p2n2/3p1b2/8/1P1P2P1/PBP1PPBP/RN1QK1NR w KQkq - 1 6,Nd2,22,-4,-26,1
r2qkb1r/pp1npppp/2p2n2/3p1b2/8/1P1P2P1/PBPNPPBP/R2QK1NR b KQkq - 2 6,e5,-9,26,35,1
r2qkb1r/pp1n1ppp/2p2n2/3ppb2/8/1P1P2P1/PBPNPPBP/R2QK1NR w KQkq - 0 7,e3,4,-56,-60,1
r2qkb1r/pp1n1ppp/2p2n2/3ppb2/8/1P1PP1P1/PBPN1PBP/R2QK1NR b KQkq - 0 7,Bd6,-47,-38,9,1
r2qk2r/pp1n1ppp/2pb1n2/3ppb2/8/1P1PP1P1/PBPN1PBP/R2QK1NR w KQkq - 1 8,Qe2,-39,-62,-23,1
r2qk2r/pp1n1ppp/2pb1n2/3ppb2/8/1P1PP1P1/PBPNQPBP/R3K1NR b KQkq - 2 8,O-O,-54,-53,1,1
r2q1rk1/pp1n1ppp/2pb1n2/3ppb2/8/1P1PP1P1/PBPNQPBP/R3K1NR w KQ - 3 9,h4,-64,-118,-54,1
r2q1rk1/pp1n1ppp/2pb1n2/3ppb2/7P/1P1PP1P1/PBPNQPB1/R3K1NR b KQ - 0 9,h5,-115,-44,71,1
r2q1rk1/pp1n1pp1/2pb1n2/3ppb1p/7P/1P1PP1P1/PBPNQPB1/R3K1NR w KQ - 0 10,Bh3,-65,-77,-12,1
r2q1rk1/pp1n1pp1/2pb1n2/3ppb1p/7P/1P1PP1PB/PBPNQP2/R3K1NR b KQ - 1 10,Bxh3,-94,-51,43,1
r2q1rk1/pp1n1pp1/2pb1n2/3pp2p/7P/1P1PP1Pb/PBPNQP2/R3K1NR w KQ - 0 11,Nxh3,-66,-70,-4,1
r2q1rk1/pp1n1pp1/2pb1n2/3pp2p/7P/1P1PP1PN/PBPNQP2/R3K2R b KQ - 0 11,g6,-80,-31,49,1
r2q1rk1/pp1n1p2/2pb1np1/3pp2p/7P/1P1PP1PN/PBPNQP2/R3K2R w KQ - 0 12,f3,-36,-124,-88,1
r2q1rk1/pp1n1p2/2pb1np1/3pp2p/7P/1P1PPPPN/PBPNQ3/R3K2R b KQ - 0 12,Nc5,-104,-53,51,1
r2q1rk1/pp3p2/2pb1np1/2npp2p/7P/1P1PPPPN/PBPNQ3/R3K2R w KQ - 1 13,g4,-69,-38,31,1
r2q1rk1/pp3p2/2pb1np1/2npp2p/6PP/1P1PPP1N/PBPNQ3/R3K2R b KQ - 0 13,hxg4,-39,60,99,1
r2q1rk1/pp3p2/2pb1np1/2npp3/6pP/1P1PPP1N/PBPNQ3/R3K2R w KQ - 0 14,fxg4,72,46,-26,1
r2q1rk1/pp3p2/2pb1np1/2npp3/6PP/1P1PP2N/PBPNQ3/R3K2R b KQ - 0 14,Qd7,66,136,70,1
r4rk1/pp1q1p2/2pb1np1/2npp3/6PP/1P1PP2N/PBPNQ3/R3K2R w KQ - 1 15,Nf2,140,69,-71,1
r4rk1/pp1q1p2/2pb1np1/2npp3/6PP/1P1PP3/PBPNQN2/R3K2R b KQ - 2 15,d4,52,177,125,1
r4rk1/pp1q1p2/2pb1np1/2n1p3/3p2PP/1P1PP3/PBPNQN2/R3K2R w KQ - 0 16,e4,177,-45,-222,0
r4rk1/pp1q1p2/2pb1np1/2n1p3/3pP1PP/1P1P4/PBPNQN2/R3K2R b KQ - 0 16,Nh7,-36,75,111,1
r4rk1/pp1q1p1n/2pb2p1/2n1p3/3pP1PP/1P1P4/PBPNQN2/R3K2R w KQ - 1 17,h5,64,-46,-110,0
r4rk1/pp1q1p1n/2pb2p1/2n1p2P/3pP1P1/1P1P4/PBPNQN2/R3K2R b KQ - 0 17,g5,-53,-9,44,1
r4rk1/pp1q1p1n/2pb4/2n1p1pP/3pP1P1/1P1P4/PBPNQN2/R3K2R w KQ - 0 18,Nh3,14,-49,-63,1
r4rk1/pp1q1p1n/2pb4/2n1p1pP/3pP1P1/1P1P3N/PBPNQ3/R3K2R b KQ - 1 18,Ne6,-59,-49,10,1
r4rk1/pp1q1p1n/2pbn3/4p1pP/3pP1P1/1P1P3N/PBPNQ3/R3K2R w KQ - 2 19,h6,-44,-111,-67,1
r4rk1/pp1q1p1n/2pbn2P/4p1p1/3pP1P1/1P1P3N/PBPNQ3/R3K2R b KQ - 0 19,Nf4,-111,-60,51,1
r4rk1/pp1q1p1n/2pb3P/4p1p1/3pPnP1/1P1P3N/PBPNQ3/R3K2R w KQ - 1 20,Nxf4,-55,-71,-16,1
r4rk1/pp1q1p1n/2pb3P/4p1p1/3pPNP1/1P1P4/PBPNQ3/R3K2R b KQ - 0 20,exf4,-89,80,169,1
r4rk1/pp1q1p1n/2pb3P/6p1/3pPpP1/1P1P4/PBPNQ3/R3K2R w KQ - 0 21,Bxd4,97,74,-23,1
r4rk1/pp1q1p1n/2pb3P/6p1/3BPpP1/1P1P4/P1PNQ3/R3K2R b KQ - 0 21,Rfe8,109,97,-12,1
r3r1k1/pp1q1p1n/2pb3P/6p1/3BPpP1/1P1P4/P1PNQ3/R3K2R w KQ - 1 22,O-O-O,110,106,-4,1
r3r1k1/pp1q1p1n/2pb3P/6p1/3BPpP1/1P1P4/P1PNQ3/2KR3R b - - 2 22,Be5,86,209,123,1
r3r1k1/pp1q1p1n/2p4P/4b1p1/3BPpP1/1P1P4/P1PNQ3/2KR3R w - - 3 23,Bxe5,149,162,13,1
r3r1k1/pp1q1p1n/2p4P/4B1p1/4PpP1/1P1P4/P1PNQ3/2KR3R b - - 0 23,Rxe5,166,187,21,1
r5k1/pp1q1p1n/2p4P/4r1p1/4PpP1/1P1P4/P1PNQ3/2KR3R w - - 0 24,d4,193,-41,-234,0
r5k1/pp1q1p1n/2p4P/4r1p1/3PPpP1/1P6/P1PNQ3/2KR3R b - - 0 24,Ra5,-29,266,295,1
r5k1/pp1q1p1n/2p4P/r5p1/3PPpP1/1P6/P1PNQ3/2KR3R w - - 1 25,Kb1,249,238,-11,1
r5k1/pp1q1p1n/2p4P/r5p1/3PPpP1/1P6/P1PNQ3/1K1R3R b - - 2 25,Qe7,245,280,35,1
r5k1/pp2qp1n/2p4P/r5p1/3PPpP1/1P6/P1PNQ3/1K1R3R w - - 3 26,e5,275,-32,-307,0
r5k1/pp2qp1n/2p4P/r3P1p1/3P1pP1/1P6/P1PNQ3/1K1R3R b - - 0 26,Qa3,-61,-48,13,1
r5k1/pp3p1n/2p4P/r3P1p1/3P1pP1/qP6/P1PNQ3/1K1R3R w - - 1 27,Nc4,-51,-104,-53,1
r5k1/pp3p1n/2p4P/r3P1p1/2NP1pP1/qP6/P1P1Q3/1K1R3R b - - 2 27,Qxa2+,-135,-70,65,1
r5k1/pp3p1n/2p4P/r3P1p1/2NP1pP1/1P6/q1P1Q3/1K1R3R w - - 0 28,Kc1,-67,-89,-22,1
r5k1/pp3p1n/2p4P/r3P1p1/2NP1pP1/1P6/q1P1Q3/2KR3R b - - 1 28,Qa1+,-74,-49,25,1
r5k1/pp3p1n/2p4P/r3P1p1/2NP1pP1/1P6/2P1Q3/q1KR3R w - - 2 29,Kd2,-34,-69,-35,1
r5k1/pp3p1n/2p4P/r3P1p1/2NP1pP1/1P6/2PKQ3/q2R3R b - - 3 29,Qa2,-74,372,446,1
r5k1/pp3p1n/2p4P/r3P1p1/2NP1pP1/1P6/q1PKQ3/3R3R w - - 4 30,Nxa5,453,197,-256,0
r5k1/pp3p1n/2p4P/N3P1p1/3P1pP1/1P6/q1PKQ3/3R3R b - - 0 30,Qxa5+,161,149,-12,1
r5k1/pp3p1n/2p4P/q3P1p1/3P1pP1/1P6/2PKQ3/3R3R w - - 0 31,Kd3,169,182,13,1
r5k1/pp3p1n/2p4P/q3P1p1/3P1pP1/1P1K4/2P1Q3/3R3R b - - 1 31,Qd5,152,288,136,1
r5k1/pp3p1n/2p4P/3qP1p1/3P1pP1/1P1K4/2P1Q3/3R3R w - - 2 32,Qe4,268,285,17,1
r5k1/pp3p1n/2p4P/3qP1p1/3PQpP1/1P1K4/2P5/3R3R b - - 3 32,Qb5+,308,322,14,1
r5k1/pp3p1n/2p4P/1q2P1p1/3PQpP1/1P1K4/2P5/3R3R w - - 4 33,Kd2,311,269,-42,1
r5k1/pp3p1n/2p4P/1q2P1p1/3PQpP1/1P6/2PK4/3R3R b - - 5 33,Rd8,244,310,66,1
3r2k1/pp3p1n/2p4P/1q2P1p1/3PQpP1/1P6/2PK4/3R3R w - - 6 34,Ke1,331,289,-42,1
3r2k1/pp3p1n/2p4P/1q2P1p1/3PQpP1/1P6/2P5/3RK2R b - - 7 34,Qb4+,259,284,25,1
3r2k1/pp3p1n/2p4P/4P1p1/1q1PQpP1/1P6/2P5/3RK2R w - - 8 35,Kf1,268,289,21,1
3r2k1/pp3p1n/2p4P/4P1p1/1q1PQpP1/1P6/2P5/3R1K1R b - - 9 35,Qb5+,299,300,1,1
3r2k1/pp3p1n/2p4P/1q2P1p1/3PQpP1/1P6/2P5/3R1K1R w - - 10 36,Qd3,293,68,-225,0
3r2k1/pp3p1n/2p4P/1q2P1p1/3P1pP1/1P1Q4/2P5/3R1K1R b - - 11 36,Qd5,56,280,224,1
3r2k1/pp3p1n/2p4P/3qP1p1/3P1pP1/1P1Q4/2P5/3R1K1R w - - 12 37,Rg1,297,261,-36,1
3r2k1/pp3p1n/2p4P/3qP1p1/3P1pP1/1P1Q4/2P5/3R1KR1 b - - 13 37,Nf8,253,259,6,1
3r1nk1/pp3p2/2p4P/3qP1p1/3P1pP1/1P1Q4/2P5/3R1KR1 w - - 14 38,Kf2,284,274,-10,1
3r1nk1/pp3p2/2p4P/3qP1p1/3P1pP1/1P1Q4/2P2K2/3R2R1 b - - 15 38,Ng6,283,396,113,1
3r2k1/pp3p2/2p3nP/3qP1p1/3P1pP1/1P1Q4/2P2K2/3R2R1 w - - 16 39,Qf5,416,395,-21,1
3r2k1/pp3p2/2p3nP/3qPQp1/3P1pP1/1P6/2P2K2/3R2R1 b - - 17 39,Qb5,396,9992,9596,1
3r2k1/pp3p2/2p3nP/1q2PQp1/3P1pP1/1P6/2P2K2/3R2R1 w - - 18 40,Qxg5,9996,452,-9544,0
rnbqkbnr/pppppppp/8/8/8/8/PPPPPPPP/RNBQKBNR w KQkq - 0 1,e4,36,30,-6,1
rnbqkbnr/pppppppp/8/8/4P3/8/PPPP1PPP/RNBQKBNR b KQkq - 0 1,d5,24,80,56,1
rnbqkbnr/ppp1pppp/8/3p4/4P3/8/PPPP1PPP/RNBQKBNR w KQkq - 0 2,e5,69,-5,-74,1
rnbqkbnr/ppp1pppp/8/3pP3/8/8/PPPP1PPP/RNBQKBNR b KQkq - 0 2,d4,-14,20,34,1
rnbqkbnr/ppp1pppp/8/4P3/3p4/8/PPPP1PPP/RNBQKBNR w KQkq - 0 3,Nf3,12,16,4,1
rnbqkbnr/ppp1pppp/8/4P3/3p4/5N2/PPPP1PPP/RNBQKB1R b KQkq - 1 3,c5,19,41,22,1
rnbqkbnr/pp2pppp/8/2p1P3/3p4/5N2/PPPP1PPP/RNBQKB1R w KQkq - 0 4,Bc4,35,1,-34,1
rnbqkbnr/pp2pppp/8/2p1P3/2Bp4/5N2/PPPP1PPP/RNBQK2R b KQkq - 1 4,Be6,2,184,182,1
rn1qkbnr/pp2pppp/4b3/2p1P3/2Bp4/5N2/PPPP1PPP/RNBQK2R w KQkq - 2 5,Bxe6,180,184,4,1
rn1qkbnr/pp2pppp/4B3/2p1P3/3p4/5N2/PPPP1PPP/RNBQK2R b KQkq - 0 5,fxe6,194,196,2,1
rn1qkbnr/pp2p1pp/4p3/2p1P3/3p4/5N2/PPPP1PPP/RNBQK2R w KQkq - 0 6,O-O,177,182,5,1
rn1qkbnr/pp2p1pp/4p3/2p1P3/3p4/5N2/PPPP1PPP/RNBQ1RK1 b kq - 1 6,c4,178,304,126,1
rn1qkbnr/pp2p1pp/4p3/4P3/2pp4/5N2/PPPP1PPP/RNBQ1RK1 w kq - 0 7,d3,276,271,-5,1
rn1qkbnr/pp2p1pp/4p3/4P3/2pp4/3P1N2/PPP2PPP/RNBQ1RK1 b kq - 0 7,b5,281,482,201,1
rn1qkbnr/p3p1pp/4p3/1p2P3/2pp4/3P1N2/PPP2PPP/RNBQ1RK1 w kq - 0 8,dxc4,486,490,4,1
rn1qkbnr/p3p1pp/4p3/1p2P3/2Pp4/5N2/PPP2PPP/RNBQ1RK1 b kq - 0 8,bxc4,515,517,2,1
rn1qkbnr/p3p1pp/4p3/4P3/2pp4/5N2/PPP2PPP/RNBQ1RK1 w kq - 0 9,Qe2,478,342,-136,0
rn1qkbnr/p3p1pp/4p3/4P3/2pp4/5N2/PPP1QPPP/RNB2RK1 b kq - 1 9,c3,330,444,114,1
rn1qkbnr/p3p1pp/4p3/4P3/3p4/2p2N2/PPP1QPPP/RNB2RK1 w kq - 0 10,bxc3,457,463,6,1
rn1qkbnr/p3p1pp/4p3/4P3/3p4/2P2N2/P1P1QPPP/RNB2RK1 b kq - 0 10,dxc3,453,430,-23,1
rn1qkbnr/p3p1pp/4p3/4P3/8/2p2N2/P1P1QPPP/RNB2RK1 w kq - 0 11,Nxc3,446,440,-6,1
rn1qkbnr/p3p1pp/4p3/4P3/8/2N2N2/P1P1QPPP/R1B2RK1 b kq - 0 11,g6,446,573,127,1
rn1qkbnr/p3p2p/4p1p1/4P3/8/2N2N2/P1P1QPPP/R1B2RK1 w kq - 0 12,Qe4,522,523,1,1
rn1qkbnr/p3p2p/4p1p1/4P3/4Q3/2N2N2/P1P2PPP/R1B2RK1 b kq - 1 12,Nd7,507,508,1,1
r2qkbnr/p2np2p/4p1p1/4P3/4Q3/2N2N2/P1P2PPP/R1B2RK1 w kq - 2 13,Rd1,508,471,-37,1
r2qkbnr/p2np2p/4p1p1/4P3/4Q3/2N2N2/P1P2PPP/R1BR2K1 b kq - 3 13,Qb6,480,848,368,1
r3kbnr/p2np2p/1q2p1p1/4P3/4Q3/2N2N2/P1P2PPP/R1BR2K1 w kq - 4 14,Qxa8+,810,808,-2,1
Q3kbnr/p2np2p/1q2p1p1/4P3/8/2N2N2/P1P2PPP/R1BR2K1 b k - 0 14,Kf7,807,887,80,1
Q4bnr/p2npk1p/1q2p1p1/4P3/8/2N2N2/P1P2PPP/R1BR2K1 w - - 1 15,Ng5+,882,906,24,1
Q4bnr/p2npk1p/1q2p1p1/4P1N1/8/2N5/P1P2PPP/R1BR2K1 b - - 2 15,Kg7,901,924,23,1
Q4bnr/p2np1kp/1q2p1p1/4P1N1/8/2N5/P1P2PPP/R1BR2K1 w - - 3 16,Rxd7,899,834,-65,1
Q4bnr/p2Rp1kp/1q2p1p1/4P1N1/8/2N5/P1P2PPP/R1B3K1 b - - 0 16,Qd4,860,1139,279,1
Q4bnr/p2Rp1kp/4p1p1/4P1N1/3q4/2N5/P1P2PPP/R1B3K1 w - - 1 17,Nxe6+,1215,1178,-37,1
Q4bnr/p2Rp1kp/4N1p1/4P3/3q4/2N5/P1P2PPP/R1B3K1 b - - 0 17,Kf7,1242,1217,-25,1
Q4bnr/p2Rpk1p/4N1p1/4P3/3q4/2N5/P1P2PPP/R1B3K1 w - - 1 18,Nxd4,1267,1173,-94,1
Q4bnr/p2Rpk1p/6p1/4P3/3N4/2N5/P1P2PPP/R1B3K1 b - - 0 18,Nf6,1185,1213,28,1
Q4b1r/p2Rpk1p/5np1/4P3/3N4/2N5/P1P2PPP/R1B3K1 w - - 1 19,exf6,1209,1361,152,1
Q4b1r/p2Rpk1p/5Pp1/8/3N4/2N5/P1P2PPP/R1B3K1 b - - 0 19,Kxf6,9995,9997,2,1
Q4b1r/p2Rp2p/5kp1/8/3N4/2N5/P1P2PPP/R1B3K1 w - - 0 20,Ne4+,9997,9996,-1,1
Q4b1r/p2Rp2p/5kp1/8/3NN3/8/P1P2PPP/R1B3K1 b - - 1 20,Ke5,9996,9999,3,1
Q4b1r/p2Rp2p/6p1/4k3/3NN3/8/P1P2PPP/R1B3K1 w - - 2 21,Qd5#,9999,10000,1,1
rnbqkbnr/pppppppp/8/8/8/8/PPPPPPPP/RNBQKBNR w KQkq - 0 1,e4,28,25,-3,1
rnbqkbnr/pppppppp/8/8/4P3/8/PPPP1PPP/RNBQKBNR b KQkq - 0 1,c6,27,46,19,1
rnbqkbnr/pp1ppppp/2p5/8/4P3/8/PPPP1PPP/RNBQKBNR w KQkq - 0 2,Bc4,41,-51,-92,1
rnbqkbnr/pp1ppppp/2p5/8/2B1P3/8/PPPP1PPP/RNBQK1NR b KQkq - 1 2,d5,-37,-39,-2,1
rnbqkbnr/pp2pppp/2p5/3p4/2B1P3/8/PPPP1PPP/RNBQK1NR w KQkq - 0 3,exd5,-38,-41,-3,1
rnbqkbnr/pp2pppp/2p5/3P4/2B5/8/PPPP1PPP/RNBQK1NR b KQkq - 0 3,cxd5,-40,-35,5,1
rnbqkbnr/pp2pppp/8/3p4/2B5/8/PPPP1PPP/RNBQK1NR w KQkq - 0 4,Bb3,-29,-33,-4,1
rnbqkbnr/pp2pppp/8/3p4/8/1B6/PPPP1PPP/RNBQK1NR b KQkq - 1 4,Nf6,-41,-34,7,1
rnbqkb1r/pp2pppp/5n2/3p4/8/1B6/PPPP1PPP/RNBQK1NR w KQkq - 2 5,h3,-29,-31,-2,1
rnbqkb1r/pp2pppp/5n2/3p4/8/1B5P/PPPP1PP1/RNBQK1NR b KQkq - 0 5,h5,-36,20,56,1
rnbqkb1r/pp2ppp1/5n2/3p3p/8/1B5P/PPPP1PP1/RNBQK1NR w KQkq - 0 6,Nf3,18,4,-14,1
rnbqkb1r/pp2ppp1/5n2/3p3p/8/1B3N1P/PPPP1PP1/RNBQK2R b KQkq - 1 6,g6,23,54,31,1
rnbqkb1r/pp2pp2/5np1/3p3p/8/1B3N1P/PPPP1PP1/RNBQK2R w KQkq - 0 7,d3,53,36,-17,1
rnbqkb1r/pp2pp2/5np1/3p3p/8/1B1P1N1P/PPP2PP1/RNBQK2R b KQkq - 0 7,Bg7,56,51,-5,1
rnbqk2r/pp2ppb1/5np1/3p3p/8/1B1P1N1P/PPP2PP1/RNBQK2R w KQkq - 1 8,O-O,39,41,2,1
rnbqk2r/pp2ppb1/5np1/3p3p/8/1B1P1N1P/PPP2PP1/RNBQ1RK1 b kq - 2 8,O-O,34,41,7,1
rnbq1rk1/pp2ppb1/5np1/3p3p/8/1B1P1N1P/PPP2PP1/RNBQ1RK1 w - - 3 9,c3,37,38,1,1
rnbq1rk1/pp2ppb1/5np1/3p3p/8/1BPP1N1P/PP3PP1/RNBQ1RK1 b - - 0 9,Nc6,33,35,2,1
r1bq1rk1/pp2ppb1/2n2np1/3p3p/8/1BPP1N1P/PP3PP1/RNBQ1RK1 w - - 1 10,Nbd2,32,-22,-54,1
r1bq1rk1/pp2ppb1/2n2np1/3p3p/8/1BPP1N1P/PP1N1PP1/R1BQ1RK1 b - - 2 10,Qc7,-4,44,48,1
r1b2rk1/ppq1ppb1/2n2np1/3p3p/8/1BPP1N1P/PP1N1PP1/R1BQ1RK1 w - - 3 11,Bc2,27,-57,-84,1
r1b2rk1/ppq1ppb1/2n2np1/3p3p/8/2PP1N1P/PPBN1PP1/R1BQ1RK1 b - - 4 11,Ne4,-45,488,533,1
r1b2rk1/ppq1ppb1/2n3p1/3p3p/4n3/2PP1N1P/PPBN1PP1/R1BQ1RK1 w - - 5 12,d4,481,89,-392,0
r1b2rk1/ppq1ppb1/2n3p1/3p3p/3Pn3/2P2N1P/PPBN1PP1/R1BQ1RK1 b - - 0 12,f5,54,90,36,1
r1b2rk1/ppq1p1b1/2n3p1/3p1p1p/3Pn3/2P2N1P/PPBN1PP1/R1BQ1RK1 w - - 0 13,Nh4,104,75,-29,1
r1b2rk1/ppq1p1b1/2n3p1/3p1p1p/3Pn2N/2P4P/PPBN1PP1/R1BQ1RK1 b - - 1 13,Rf6,62,215,153,1
r1b3k1/ppq1p1b1/2n2rp1/3p1p1p/3Pn2N/2P4P/PPBN1PP1/R1BQ1RK1 w - - 2 14,Nxe4,234,203,-31,1
r1b3k1/ppq1p1b1/2n2rp1/3p1p1p/3PN2N/2P4P/PPB2PP1/R1BQ1RK1 b - - 0 14,fxe4,235,213,-22,1
r1b3k1/ppq1p1b1/2n2rp1/3p3p/3Pp2N/2P4P/PPB2PP1/R1BQ1RK1 w - - 0 15,f3,206,121,-85,1
r1b3k1/ppq1p1b1/2n2rp1/3p3p/3Pp2N/2P2P1P/PPB3P1/R1BQ1RK1 b - - 0 15,g5,144,354,210,1
r1b3k1/ppq1p1b1/2n2r2/3p2pp/3Pp2N/2P2P1P/PPB3P1/R1BQ1RK1 w - - 0 16,Bxg5,376,383,7,1
r1b3k1/ppq1p1b1/2n2r2/3p2Bp/3Pp2N/2P2P1P/PPB3P1/R2Q1RK1 b - - 0 16,exf3,385,474,89,1
r1b3k1/ppq1p1b1/2n2r2/3p2Bp/3P3N/2P2p1P/PPB3P1/R2Q1RK1 w - - 0 17,Nxf3,473,433,-40,1
r1b3k1/ppq1p1b1/2n2r2/3p2Bp/3P4/2P2N1P/PPB3P1/R2Q1RK1 b - - 0 17,Qg3,416,488,72,1
r1b3k1/pp2p1b1/2n2r2/3p2Bp/3P4/2P2NqP/PPB3P1/R2Q1RK1 w - - 1 18,Bxf6,449,450,1,1
r1b3k1/pp2p1b1/2n2B2/3p3p/3P4/2P2NqP/PPB3P1/R2Q1RK1 b - - 0 18,exf6,477,563,86,1
r1b3k1/pp4b1/2n2p2/3p3p/3P4/2P2NqP/PPB3P1/R2Q1RK1 w - - 0 19,Rf2,528,452,-76,1
r1b3k1/pp4b1/2n2p2/3p3p/3P4/2P2NqP/PPB2RP1/R2Q2K1 b - - 1 19,Bxh3,432,467,35,1
r5k1/pp4b1/2n2p2/3p3p/3P4/2P2Nqb/PPB2RP1/R2Q2K1 w - - 0 20,Qe2,437,347,-90,1
r5k1/pp4b1/2n2p2/3p3p/3P4/2P2Nqb/PPB1QRP1/R5K1 b - - 1 20,Kf7,361,499,138,1
r7/pp3kb1/2n2p2/3p3p/3P4/2P2Nqb/PPB1QRP1/R5K1 w - - 2 21,Ne5+,481,503,22,1
r7/pp3kb1/2n2p2/3pN2p/3P4/2P3qb/PPB1QRP1/R5K1 b - - 3 21,Nxe5,477,500,23,1
r7/pp3kb1/5p2/3pn2p/3P4/2P3qb/PPB1QRP1/R5K1 w - - 0 22,dxe5,485,400,-85,1
r7/pp3kb1/5p2/3pP2p/8/2P3qb/PPB1QRP1/R5K1 b - - 0 22,Re8,382,597,215,1
4r3/pp3kb1/5p2/3pP2p/8/2P3qb/PPB1QRP1/R5K1 w - - 1 23,Qxh5+,557,546,-11,1
4r3/pp3kb1/5p2/3pP2Q/8/2P3qb/PPB2RP1/R5K1 b - - 0 23,Kf8,587,648,61,1
4rk2/pp4b1/5p2/3pP2Q/8/2P3qb/PPB2RP1/R5K1 w - - 1 24,Qxh3,631,523,-108,0
4rk2/pp4b1/5p2/3pP3/8/2P3qQ/PPB2RP1/R5K1 b - - 0 24,Qxh3,552,600,48,1
4rk2/pp4b1/5p2/3pP3/8/2P4q/PPB2RP1/R5K1 w - - 0 25,gxh3,572,570,-2,1
4rk2/pp4b1/5p2/3pP3/8/2P4P/PPB2R2/R5K1 b - - 0 25,Rxe5,566,545,-21,1
5k2/pp4b1/5p2/3pr3/8/2P4P/PPB2R2/R5K1 w - - 0 26,Kf1,572,538,-34,1
5k2/pp4b1/5p2/3pr3/8/2P4P/PPB2R2/R4K2 b - - 1 26,b5,538,576,38,1
5k2/p5b1/5p2/1p1pr3/8/2P4P/PPB2R2/R4K2 w - - 0 27,Rd1,598,563,-35,1
5k2/p5b1/5p2/1p1pr3/8/2P4P/PPB2R2/3R1K2 b - - 1 27,Bh6,569,606,37,1
5k2/p7/5p1b/1p1pr3/8/2P4P/PPB2R2/3R1K2 w - - 2 28,Rxf6+,687,662,-25,1
5k2/p7/5R1b/1p1pr3/8/2P4P/PPB5/3R1K2 b - - 0 28,Kg7,702,715,13,1
8/p5k1/5R1b/1p1pr3/8/2P4P/PPB5/3R1K2 w - - 1 29,Rg6+,715,668,-47,1
8/p5k1/6Rb/1p1pr3/8/2P4P/PPB5/3R1K2 b - - 2 29,Kh7,727,723,-4,1
8/p6k/6Rb/1p1pr3/8/2P4P/PPB5/3R1K2 w - - 3 30,Rg5+,753,744,-9,1
8/p6k/7b/1p1pr1R1/8/2P4P/PPB5/3R1K2 b - - 4 30,Kh8,748,775,27,1
7k/p7/7b/1p1pr1R1/8/2P4P/PPB5/3R1K2 w - - 5 31,Rxe5,769,772,3,1
rnbqkbnr/pppppppp/8/8/8/8/PPPPPPPP/RNBQKBNR w KQkq - 0 1,d4,31,19,-12,1
rnbqkbnr/pppppppp/8/8/3P4/8/PPP1PPPP/RNBQKBNR b KQkq - 0 1,e6,28,66,38,1
rnbqkbnr/pppp1ppp/4p3/8/3P4/8/PPP1PPPP/RNBQKBNR w KQkq - 0 2,c4,67,29,-38,1
rnbqkbnr/pppp1ppp/4p3/8/2PP4/8/PP2PPPP/RNBQKBNR b KQkq - 0 2,c5,18,106,88,1
rnbqkbnr/pp1p1ppp/4p3/2p5/2PP4/8/PP2PPPP/RNBQKBNR w KQkq - 0 3,e3,59,20,-39,1
rnbqkbnr/pp1p1ppp/4p3/2p5/2PP4/4P3/PP3PPP/RNBQKBNR b KQkq - 0 3,cxd4,16,24,8,1
rnbqkbnr/pp1p1ppp/4p3/8/2Pp4/4P3/PP3PPP/RNBQKBNR w KQkq - 0 4,exd4,27,21,-6,1
rnbqkbnr/pp1p1ppp/4p3/8/2PP4/8/PP3PPP/RNBQKBNR b KQkq - 0 4,Nf6,21,19,-2,1
rnbqkb1r/pp1p1ppp/4pn2/8/2PP4/8/PP3PPP/RNBQKBNR w KQkq - 1 5,Nc3,22,18,-4,1
rnbqkb1r/pp1p1ppp/4pn2/8/2PP4/2N5/PP3PPP/R1BQKBNR b KQkq - 2 5,g6,13,82,69,1
rnbqkb1r/pp1p1p1p/4pnp1/8/2PP4/2N5/PP3PPP/R1BQKBNR w KQkq - 0 6,Nf3,67,65,-2,1
rnbqkb1r/pp1p1p1p/4pnp1/8/2PP4/2N2N2/PP3PPP/R1BQKB1R b KQkq - 1 6,Bb4,75,153,78,1
rnbqk2r/pp1p1p1p/4pnp1/8/1bPP4/2N2N2/PP3PPP/R1BQKB1R w KQkq - 2 7,Be2,173,130,-43,1
rnbqk2r/pp1p1p1p/4pnp1/8/1bPP4/2N2N2/PP2BPPP/R1BQK2R b KQkq - 3 7,Qa5,143,212,69,1
rnb1k2r/pp1p1p1p/4pnp1/q7/1bPP4/2N2N2/PP2BPPP/R1BQK2R w KQkq - 4 8,Bd2,207,170,-37,1
rnb1k2r/pp1p1p1p/4pnp1/q7/1bPP4/2N2N2/PP1BBPPP/R2QK2R b KQkq - 5 8,Ng4,159,298,139,1
rnb1k2r/pp1p1p1p/4p1p1/q7/1bPP2n1/2N2N2/PP1BBPPP/R2QK2R w KQkq - 6 9,O-O,286,290,4,1
rnb1k2r/pp1p1p1p/4p1p1/q7/1bPP2n1/2N2N2/PP1BBPPP/R2Q1RK1 b kq - 7 9,Qd8,296,334,38,1
rnbqk2r/pp1p1p1p/4p1p1/8/1bPP2n1/2N2N2/PP1BBPPP/R2Q1RK1 w kq - 8 10,a3,298,304,6,1
rnbqk2r/pp1p1p1p/4p1p1/8/1bPP2n1/P1N2N2/1P1BBPPP/R2Q1RK1 b kq - 0 10,Bd6,308,334,26,1
rnbqk2r/pp1p1p1p/3bp1p1/8/2PP2n1/P1N2N2/1P1BBPPP/R2Q1RK1 w kq - 1 11,c5,365,348,-17,1
rnbqk2r/pp1p1p1p/3bp1p1/2P5/3P2n1/P1N2N2/1P1BBPPP/R2Q1RK1 b kq - 0 11,Bc7,370,479,109,1
rnbqk2r/ppbp1p1p/4p1p1/2P5/3P2n1/P1N2N2/1P1BBPPP/R2Q1RK1 w kq - 1 12,Ne4,486,347,-139,0
rnbqk2r/ppbp1p1p/4p1p1/2P5/3PN1n1/P4N2/1P1BBPPP/R2Q1RK1 b kq - 2 12,b6,318,352,34,1
rnbqk2r/p1bp1p1p/1p2p1p1/2P5/3PN1n1/P4N2/1P1BBPPP/R2Q1RK1 w kq - 0 13,h3,365,256,-109,0
rnbqk2r/p1bp1p1p/1p2p1p1/2P5/3PN1n1/P4N1P/1P1BBPP1/R2Q1RK1 b kq - 0 13,h5,268,469,201,1
rnbqk2r/p1bp1p2/1p2p1p1/2P4p/3PN1n1/P4N1P/1P1BBPP1/R2Q1RK1 w kq - 0 14,Bg5,405,345,-60,1
rnbqk2r/p1bp1p2/1p2p1p1/2P3Bp/3PN1n1/P4N1P/1P2BPP1/R2Q1RK1 b kq - 1 14,f6,354,342,-12,1
rnbqk2r/p1bp4/1p2ppp1/2P3Bp/3PN1n1/P4N1P/1P2BPP1/R2Q1RK1 w kq - 0 15,Bd2,367,289,-78,1
rnbqk2r/p1bp4/1p2ppp1/2P4p/3PN1n1/P4N1P/1P1BBPP1/R2Q1RK1 b kq - 1 15,bxc5,266,314,48,1
rnbqk2r/p1bp4/4ppp1/2p4p/3PN1n1/P4N1P/1P1BBPP1/R2Q1RK1 w kq - 0 16,dxc5,308,316,8,1
rnbqk2r/p1bp4/4ppp1/2P4p/4N1n1/P4N1P/1P1BBPP1/R2Q1RK1 b kq - 0 16,Bb7,305,282,-23,1
rn1qk2r/pbbp4/4ppp1/2P4p/4N1n1/P4N1P/1P1BBPP1/R2Q1RK1 w kq - 1 17,Nd6+,306,223,-83,1
rn1qk2r/pbbp4/3Nppp1/2P4p/6n1/P4N1P/1P1BBPP1/R2Q1RK1 b kq - 2 17,Bxd6,241,237,-4,1
rn1qk2r/pb1p4/3bppp1/2P4p/6n1/P4N1P/1P1BBPP1/R2Q1RK1 w kq - 0 18,cxd6,245,234,-11,1
rn1qk2r/pb1p4/3Pppp1/7p/6n1/P4N1P/1P1BBPP1/R2Q1RK1 b kq - 0 18,f5,244,352,108,1
rn1qk2r/pb1p4/3Pp1p1/5p1p/6n1/P4N1P/1P1BBPP1/R2Q1RK1 w kq - 0 19,Bc3,365,354,-11,1
rn1qk2r/pb1p4/3Pp1p1/5p1p/6n1/P1B2N1P/1P2BPP1/R2Q1RK1 b kq - 1 19,Rh7,314,451,137,1
rn1qk3/pb1p3r/3Pp1p1/5p1p/6n1/P1B2N1P/1P2BPP1/R2Q1RK1 w q - 2 20,Ne5,452,224,-228,0
rn1qk3/pb1p3r/3Pp1p1/4Np1p/6n1/P1B4P/1P2BPP1/R2Q1RK1 b q - 3 20,Nxe5,225,213,-12,1
rn1qk3/pb1p3r/3Pp1p1/4np1p/8/P1B4P/1P2BPP1/R2Q1RK1 w q - 0 21,Bxe5,244,198,-46,1
rn1qk3/pb1p3r/3Pp1p1/4Bp1p/8/P6P/1P2BPP1/R2Q1RK1 b q - 0 21,Nc6,208,223,15,1
r2qk3/pb1p3r/2nPp1p1/4Bp1p/8/P6P/1P2BPP1/R2Q1RK1 w q - 1 22,Bc3,229,236,7,1
r2qk3/pb1p3r/2nPp1p1/5p1p/8/P1B4P/1P2BPP1/R2Q1RK1 b q - 2 22,Qb6,233,289,56,1
r3k3/pb1p3r/1qnPp1p1/5p1p/8/P1B4P/1P2BPP1/R2Q1RK1 w q - 3 23,Qd2,299,286,-13,1
r3k3/pb1p3r/1qnPp1p1/5p1p/8/P1B4P/1P1QBPP1/R4RK1 b q - 4 23,O-O-O,302,346,44,1
rnbqkbnr/pppppppp/8/8/8/8/PPPPPPPP/RNBQKBNR w KQkq - 0 1,d3,38,-6,-44,1
rnbqkbnr/pppppppp/8/8/8/3P4/PPP1PPPP/RNBQKBNR b KQkq - 0 1,d5,-7,-7,0,1
rnbqkbnr/ppp1pppp/8/3p4/8/3P4/PPP1PPPP/RNBQKBNR w KQkq - 0 2,Nf3,-7,-11,-4,1
rnbqkbnr/ppp1pppp/8/3p4/8/3P1N2/PPP1PPPP/RNBQKB1R b KQkq - 1 2,Nf6,-18,-25,-7,1
rnbqkb1r/ppp1pppp/5n2/3p4/8/3P1N2/PPP1PPPP/RNBQKB1R w KQkq - 2 3,Nc3,-22,-47,-25,1
rnbqkb1r/ppp1pppp/5n2/3p4/8/2NP1N2/PPP1PPPP/R1BQKB1R b KQkq - 3 3,Bf5,-61,-8,53,1
rn1qkb1r/ppp1pppp/5n2/3p1b2/8/2NP1N2/PPP1PPPP/R1BQKB1R w KQkq - 4 4,d4,-13,-44,-31,1
rn1qkb1r/ppp1pppp/5n2/3p1b2/3P4/2N2N2/PPP1PPPP/R1BQKB1R b KQkq - 0 4,e6,-45,-40,5,1
rn1qkb1r/ppp2ppp/4pn2/3p1b2/3P4/2N2N2/PPP1PPPP/R1BQKB1R w KQkq - 0 5,e3,-31,-53,-22,1
rn1qkb1r/ppp2ppp/4pn2/3p1b2/3P4/2N1PN2/PPP2PPP/R1BQKB1R b KQkq - 0 5,Bb4,-49,-28,21,1
rn1qk2r/ppp2ppp/4pn2/3p1b2/1b1P4/2N1PN2/PPP2PPP/R1BQKB1R w KQkq - 1 6,Bd2,-31,-38,-7,1
rn1qk2r/ppp2ppp/4pn2/3p1b2/1b1P4/2N1PN2/PPPB1PPP/R2QKB1R b KQkq - 2 6,c5,-39,-30,9,1
rn1qk2r/pp3ppp/4pn2/2pp1b2/1b1P4/2N1PN2/PPPB1PPP/R2QKB1R w KQkq - 0 7,Bd3,-30,-56,-26,1
rn1qk2r/pp3ppp/4pn2/2pp1b2/1b1P4/2NBPN2/PPPB1PPP/R2QK2R b KQkq - 1 7,c4,-47,-34,13,1
rn1qk2r/pp3ppp/4pn2/3p1b2/1bpP4/2NBPN2/PPPB1PPP/R2QK2R w KQkq - 0 8,Bxf5,-40,-39,1,1
rn1qk2r/pp3ppp/4pn2/3p1B2/1bpP4/2N1PN2/PPPB1PPP/R2QK2R b KQkq - 0 8,exf5,-36,-29,7,1
rn1qk2r/pp3ppp/5n2/3p1p2/1bpP4/2N1PN2/PPPB1PPP/R2QK2R w KQkq - 0 9,O-O,-38,-29,9,1
rn1qk2r/pp3ppp/5n2/3p1p2/1bpP4/2N1PN2/PPPB1PPP/R2Q1RK1 b kq - 1 9,Nc6,-33,-41,-8,1
r2qk2r/pp3ppp/2n2n2/3p1p2/1bpP4/2N1PN2/PPPB1PPP/R2Q1RK1 w kq - 2 10,a3,-31,-52,-21,1
r2qk2r/pp3ppp/2n2n2/3p1p2/1bpP4/P1N1PN2/1PPB1PPP/R2Q1RK1 b kq - 0 10,Bd6,-56,-12,44,1
r2qk2r/pp3ppp/2nb1n2/3p1p2/2pP4/P1N1PN2/1PPB1PPP/R2Q1RK1 w kq - 1 11,Ne2,7,-68,-75,1
r2qk2r/pp3ppp/2nb1n2/3p1p2/2pP4/P3PN2/1PPBNPPP/R2Q1RK1 b kq - 2 11,Qc7,-63,-61,2,1
r3k2r/ppq2ppp/2nb1n2/3p1p2/2pP4/P3PN2/1PPBNPPP/R2Q1RK1 w kq - 3 12,c3,-59,-193,-134,0
r3k2r/ppq2ppp/2nb1n2/3p1p2/2pP4/P1P1PN2/1P1BNPPP/R2Q1RK1 b kq - 0 12,Ne4,-183,-175,8,1
r3k2r/ppq2ppp/2nb4/3p1p2/2pPn3/P1P1PN2/1P1BNPPP/R2Q1RK1 w kq - 1 13,g3,-169,-206,-37,1
r3k2r/ppq2ppp/2nb4/3p1p2/2pPn3/P1P1PNP1/1P1BNP1P/R2Q1RK1 b kq - 0 13,O-O,-209,-150,59,1
r4rk1/ppq2ppp/2nb4/3p1p2/2pPn3/P1P1PNP1/1P1BNP1P/R2Q1RK1 w - - 1 14,Bc1,-144,-201,-57,1
r4rk1/ppq2ppp/2nb4/3p1p2/2pPn3/P1P1PNP1/1P2NP1P/R1BQ1RK1 b - - 2 14,h6,-186,-18,168,1
r4rk1/ppq2pp1/2nb3p/3p1p2/2pPn3/P1P1PNP1/1P2NP1P/R1BQ1RK1 w - - 0 15,Nf4,-84,-133,-49,1
r4rk1/ppq2pp1/2nb3p/3p1p2/2pPnN2/P1P1PNP1/1P3P1P/R1BQ1RK1 b - - 1 15,Rfe8,-134,-39,95,1
r3r1k1/ppq2pp1/2nb3p/3p1p2/2pPnN2/P1P1PNP1/1P3P1P/R1BQ1RK1 w - - 2 16,Nxd5,-25,-33,-8,1
r3r1k1/ppq2pp1/2nb3p/3N1p2/2pPn3/P1P1PNP1/1P3P1P/R1BQ1RK1 b - - 0 16,Qd7,-20,-5,15,1
r3r1k1/pp1q1pp1/2nb3p/3N1p2/2pPn3/P1P1PNP1/1P3P1P/R1BQ1RK1 w - - 1 17,Nb4,-26,-51,-25,1
r3r1k1/pp1q1pp1/2nb3p/5p2/1NpPn3/P1P1PNP1/1P3P1P/R1BQ1RK1 b - - 2 17,Bxb4,-66,-9,57,1
r3r1k1/pp1q1pp1/2n4p/5p2/1bpPn3/P1P1PNP1/1P3P1P/R1BQ1RK1 w - - 0 18,axb4,-16,-17,-1,1
r3r1k1/pp1q1pp1/2n4p/5p2/1PpPn3/2P1PNP1/1P3P1P/R1BQ1RK1 b - - 0 18,a5,-19,-7,12,1
r3r1k1/1p1q1pp1/2n4p/p4p2/1PpPn3/2P1PNP1/1P3P1P/R1BQ1RK1 w - - 0 19,bxa5,-5,-35,-30,1
r3r1k1/1p1q1pp1/2n4p/P4p2/2pPn3/2P1PNP1/1P3P1P/R1BQ1RK1 b - - 0 19,Rxa5,-31,38,69,1
4r1k1/1p1q1pp1/2n4p/r4p2/2pPn3/2P1PNP1/1P3P1P/R1BQ1RK1 w - - 0 20,Qe1,19,-573,-592,0
4r1k1/1p1q1pp1/2n4p/r4p2/2pPn3/2P1PNP1/1P3P1P/R1B1QRK1 b - - 1 20,Rxa1,-577,-537,40,1
rnbqkbnr/pppppppp/8/8/8/8/PPPPPPPP/RNBQKBNR w KQkq - 0 1,e3,29,16,-13,1
rnbqkbnr/pppppppp/8/8/8/4P3/PPPP1PPP/RNBQKBNR b KQkq - 0 1,e5,22,15,-7,1
rnbqkbnr/pppp1ppp/8/4p3/8/4P3/PPPP1PPP/RNBQKBNR w KQkq - 0 2,Qf3,22,-93,-115,0
rnbqkbnr/pppp1ppp/8/4p3/8/4PQ2/PPPP1PPP/RNB1KBNR b KQkq - 1 2,Nc6,-100,-95,5,1
r1bqkbnr/pppp1ppp/2n5/4p3/8/4PQ2/PPPP1PPP/RNB1KBNR w KQkq - 2 3,Bb5,-85,-100,-15,1
r1bqkbnr/pppp1ppp/2n5/1B2p3/8/4PQ2/PPPP1PPP/RNB1K1NR b KQkq - 3 3,Nf6,-105,-95,10,1
r1bqkb1r/pppp1ppp/2n2n2/1B2p3/8/4PQ2/PPPP1PPP/RNB1K1NR w KQkq - 4 4,Nc3,-101,-93,8,1
r1bqkb1r/pppp1ppp/2n2n2/1B2p3/8/2N1PQ2/PPPP1PPP/R1B1K1NR b KQkq - 5 4,d5,-108,-79,29,1
r1bqkb1r/ppp2ppp/2n2n2/1B1pp3/8/2N1PQ2/PPPP1PPP/R1B1K1NR w KQkq - 0 5,d3,-100,-100,0,1
r1bqkb1r/ppp2ppp/2n2n2/1B1pp3/8/2NPPQ2/PPP2PPP/R1B1K1NR b KQkq - 0 5,Be7,-98,-82,16,1
r1bqk2r/ppp1bppp/2n2n2/1B1pp3/8/2NPPQ2/PPP2PPP/R1B1K1NR w KQkq - 1 6,e4,-90,-98,-8,1
r1bqk2r/ppp1bppp/2n2n2/1B1pp3/4P3/2NP1Q2/PPP2PPP/R1B1K1NR b KQkq - 0 6,dxe4,-101,48,149,1
r1bqk2r/ppp1bppp/2n2n2/1B2p3/4p3/2NP1Q2/PPP2PPP/R1B1K1NR w KQkq - 0 7,dxe4,34,-48,-82,1
r1bqk2r/ppp1bppp/2n2n2/1B2p3/4P3/2N2Q2/PPP2PPP/R1B1K1NR b KQkq - 0 7,O-O,-62,29,91,1
r1bq1rk1/ppp1bppp/2n2n2/1B2p3/4P3/2N2Q2/PPP2PPP/R1B1K1NR w KQ - 1 8,Qh3,30,-649,-679,0
r1bq1rk1/ppp1bppp/2n2n2/1B2p3/4P3/2N4Q/PPP2PPP/R1B1K1NR b KQ - 2 8,Bxh3,-630,-640,-10,1
rnbqkbnr/pppppppp/8/8/8/8/PPPPPPPP/RNBQKBNR w KQkq - 0 1,e4,24,20,-4,1
rnbqkbnr/pppppppp/8/8/4P3/8/PPPP1PPP/RNBQKBNR b KQkq - 0 1,e6,31,58,27,1
rnbqkbnr/pppp1ppp/4p3/8/4P3/8/PPPP1PPP/RNBQKBNR w KQkq - 0 2,d4,67,58,-9,1
rnbqkbnr/pppp1ppp/4p3/8/3PP3/8/PPP2PPP/RNBQKBNR b KQkq - 0 2,b6,69,113,44,1
rnbqkbnr/p1pp1ppp/1p2p3/8/3PP3/8/PPP2PPP/RNBQKBNR w KQkq - 0 3,Nf3,96,87,-9,1
rnbqkbnr/p1pp1ppp/1p2p3/8/3PP3/5N2/PPP2PPP/RNBQKB1R b KQkq - 1 3,Bb7,96,78,-18,1
rn1qkbnr/pbpp1ppp/1p2p3/8/3PP3/5N2/PPP2PPP/RNBQKB1R w KQkq - 2 4,Bd3,92,96,4,1
rn1qkbnr/pbpp1ppp/1p2p3/8/3PP3/3B1N2/PPP2PPP/RNBQK2R b KQkq - 3 4,g6,96,117,21,1
rn1qkbnr/pbpp1p1p/1p2p1p1/8/3PP3/3B1N2/PPP2PPP/RNBQK2R w KQkq - 0 5,O-O,110,90,-20,1
rn1qkbnr/pbpp1p1p/1p2p1p1/8/3PP3/3B1N2/PPP2PPP/RNBQ1RK1 b kq - 1 5,Nf6,94,193,99,1
rn1qkb1r/pbpp1p1p/1p2pnp1/8/3PP3/3B1N2/PPP2PPP/RNBQ1RK1 w kq - 2 6,Nc3,166,143,-23,1
rn1qkb1r/pbpp1p1p/1p2pnp1/8/3PP3/2NB1N2/PPP2PPP/R1BQ1RK1 b kq - 3 6,h5,135,189,54,1
rn1qkb1r/pbpp1p2/1p2pnp1/7p/3PP3/2NB1N2/PPP2PPP/R1BQ1RK1 w kq - 0 7,Bg5,184,165,-19,1
rn1qkb1r/pbpp1p2/1p2pnp1/6Bp/3PP3/2NB1N2/PPP2PPP/R2Q1RK1 b kq - 1 7,Bh6,170,276,106,1
rn1qk2r/pbpp1p2/1p2pnpb/6Bp/3PP3/2NB1N2/PPP2PPP/R2Q1RK1 w kq - 2 8,Bxh6,267,264,-3,1
rn1qk2r/pbpp1p2/1p2pnpB/7p/3PP3/2NB1N2/PPP2PPP/R2Q1RK1 b kq - 0 8,Rxh6,273,248,-25,1
rn1qk3/pbpp1p2/1p2pnpr/7p/3PP3/2NB1N2/PPP2PPP/R2Q1RK1 w q - 0 9,Qd2,274,251,-23,1
rn1qk3/pbpp1p2/1p2pnpr/7p/3PP3/2NB1N2/PPPQ1PPP/R4RK1 b q - 1 9,Ng4,251,298,47,1
rn1qk3/pbpp1p2/1p2p1pr/7p/3PP1n1/2NB1N2/PPPQ1PPP/R4RK1 w q - 2 10,h3,286,292,6,1
rn1qk3/pbpp1p2/1p2p1pr/7p/3PP1n1/2NB1N1P/PPPQ1PP1/R4RK1 b q - 0 10,Rh8,280,295,15,1
rn1qk2r/pbpp1p2/1p2p1p1/7p/3PP1n1/2NB1N1P/PPPQ1PP1/R4RK1 w q - 1 11,hxg4,307,230,-77,1
rn1qk2r/pbpp1p2/1p2p1p1/7p/3PP1P1/2NB1N2/PPPQ1PP1/R4RK1 b q - 0 11,hxg4,233,235,2,1
rn1qk2r/pbpp1p2/1p2p1p1/8/3PP1p1/2NB1N2/PPPQ1PP1/R4RK1 w q - 0 12,Nh2,249,191,-58,1
rn1qk2r/pbpp1p2/1p2p1p1/8/3PP1p1/2NB4/PPPQ1PPN/R4RK1 b q - 1 12,Qh4,218,195,-23,1
rn2k2r/pbpp1p2/1p2p1p1/8/3PP1pq/2NB4/PPPQ1PPN/R4RK1 w q - 2 13,Qf4,194,217,23,1
rn2k2r/pbpp1p2/1p2p1p1/8/3PPQpq/2NB4/PPP2PPN/R4RK1 b q - 3 13,g5,196,345,149,1
rn2k2r/pbpp1p2/1p2p3/6p1/3PPQpq/2NB4/PPP2PPN/R4RK1 w q - 0 14,Qg3,336,353,17,1
rn2k2r/pbpp1p2/1p2p3/6p1/3PP1pq/2NB2Q1/PPP2PPN/R4RK1 b q - 1 14,Qxh2+,336,435,99,1
rn2k2r/pbpp1p2/1p2p3/6p1/3PP1p1/2NB2Q1/PPP2PPq/R4RK1 w q - 0 15,Qxh2,446,459,13,1
rn2k2r/pbpp1p2/1p2p3/6p1/3PP1p1/2NB4/PPP2PPQ/R4RK1 b q - 0 15,Rxh2,451,421,-30,1
rn2k3/pbpp1p2/1p2p3/6p1/3PP1p1/2NB4/PPP2PPr/R4RK1 w q - 0 16,Kxh2,416,441,25,1
rn2k3/pbpp1p2/1p2p3/6p1/3PP1p1/2NB4/PPP2PPK/R4R2 b q - 0 16,Nc6,448,451,3,1
r3k3/pbpp1p2/1pn1p3/6p1/3PP1p1/2NB4/PPP2PPK/R4R2 w q - 1 17,d5,459,414,-45,1
r3k3/pbpp1p2/1pn1p3/3P2p1/4P1p1/2NB4/PPP2PPK/R4R2 b q - 0 17,Ne5,436,429,-7,1
r3k3/pbpp1p2/1p2p3/3Pn1p1/4P1p1/2NB4/PPP2PPK/R4R2 w q - 1 18,Kg3,426,430,4,1
r3k3/pbpp1p2/1p2p3/3Pn1p1/4P1p1/2NB2K1/PPP2PP1/R4R2 b q - 2 18,O-O-O,458,468,10,1
2kr4/pbpp1p2/1p2p3/3Pn1p1/4P1p1/2NB2K1/PPP2PP1/R4R2 w - - 3 19,b4,500,428,-72,1
2kr4/pbpp1p2/1p2p3/3Pn1p1/1P2P1p1/2NB2K1/P1P2PP1/R4R2 b - - 0 19,Rh8,424,480,56,1
2k4r/pbpp1p2/1p2p3/3Pn1p1/1P2P1p1/2NB2K1/P1P2PP1/R4R2 w - - 1 20,Rh1,475,498,23,1
2k4r/pbpp1p2/1p2p3/3Pn1p1/1P2P1p1/2NB2K1/P1P2PP1/R6R b - - 2 20,Rg8,460,467,7,1
2k3r1/pbpp1p2/1p2p3/3Pn1p1/1P2P1p1/2NB2K1/P1P2PP1/R6R w - - 3 21,a4,466,453,-13,1
2k3r1/pbpp1p2/1p2p3/3Pn1p1/PP2P1p1/2NB2K1/2P2PP1/R6R b - - 0 21,f5,456,480,24,1
2k3r1/pbpp4/1p2p3/3Pnpp1/PP2P1p1/2NB2K1/2P2PP1/R6R w - - 0 22,exf5,523,518,-5,1
2k3r1/pbpp4/1p2p3/3PnPp1/PP4p1/2NB2K1/2P2PP1/R6R b - - 0 22,exf5,511,597,86,1
2k3r1/pbpp4/1p6/3Pnpp1/PP4p1/2NB2K1/2P2PP1/R6R w - - 0 23,Bxf5,570,534,-36,1
2k3r1/pbpp4/1p6/3PnBp1/PP4p1/2N3K1/2P2PP1/R6R b - - 0 23,Rf8,580,634,54,1
2k2r2/pbpp4/1p6/3PnBp1/PP4p1/2N3K1/2P2PP1/R6R w - - 1 24,Bxg4,648,559,-89,1
2k2r2/pbpp4/1p6/3Pn1p1/PP4B1/2N3K1/2P2PP1/R6R b - - 0 24,Nc4,512,647,135,1
2k2r2/pbpp4/1p6/3P2p1/PPn3B1/2N3K1/2P2PP1/R6R w - - 1 25,f3,640,574,-66,1
2k2r2/pbpp4/1p6/3P2p1/PPn3B1/2N2PK1/2P3P1/R6R b - - 0 25,c6,589,600,11,1
2k2r2/pb1p4/1pp5/3P2p1/PPn3B1/2N2PK1/2P3P1/R6R w - - 0 26,Rh7,598,588,-10,1
2k2r2/pb1p3R/1pp5/3P2p1/PPn3B1/2N2PK1/2P3P1/R7 b - - 1 26,cxd5,546,606,60,1
2k2r2/pb1p3R/1p6/3p2p1/PPn3B1/2N2PK1/2P3P1/R7 w - - 0 27,Bxd7+,586,599,13,1
2k2r2/pb1B3R/1p6/3p2p1/PPn5/2N2PK1/2P3P1/R7 b - - 0 27,Kb8,567,623,56,1
1k3r2/pb1B3R/1p6/3p2p1/PPn5/2N2PK1/2P3P1/R7 w - - 1 28,Bg4,627,502,-125,0
1k3r2/pb5R/1p6/3p2p1/PPn3B1/2N2PK1/2P3P1/R7 b - - 2 28,Ne3,506,549,43,1
1k3r2/pb5R/1p6/3p2p1/PP4B1/2N1nPK1/2P3P1/R7 w - - 3 29,Re1,555,527,-28,1
1k3r2/pb5R/1p6/3p2p1/PP4B1/2N1nPK1/2P3P1/4R3 b - - 4 29,Nxc2,581,714,133,1
1k3r2/pb5R/1p6/3p2p1/PP4B1/2N2PK1/2n3P1/4R3 w - - 0 30,Ree7,680,679,-1,1
1k3r2/pb2R2R/1p6/3p2p1/PP4B1/2N2PK1/2n3P1/8 b - - 1 30,Bc6,665,638,-27,1
1k3r2/p3R2R/1pb5/3p2p1/PP4B1/2N2PK1/2n3P1/8 w - - 2 31,b5,661,545,-116,0
1k3r2/p3R2R/1pb5/1P1p2p1/P5B1/2N2PK1/2n3P1/8 b - - 0 31,Ba8,575,629,54,1
bk3r2/p3R2R/1p6/1P1p2p1/P5B1/2N2PK1/2n3P1/8 w - - 1 32,Be6,636,593,-43,1
bk3r2/p3R2R/1p2B3/1P1p2p1/P7/2N2PK1/2n3P1/8 b - - 2 32,d4,566,628,62,1
bk3r2/p3R2R/1p2B3/1P4p1/P2p4/2N2PK1/2n3P1/8 w - - 0 33,Bd5,621,408,-213,0
bk3r2/p3R2R/1p6/1P1B2p1/P2p4/2N2PK1/2n3P1/8 b - - 1 33,dxc3,495,433,-62,1
bk3r2/p3R2R/1p6/1P1B2p1/P7/2p2PK1/2n3P1/8 w - - 0 34,Bxa8,412,372,-40,1
Bk3r2/p3R2R/1p6/1P4p1/P7/2p2PK1/2n3P1/8 b - - 0 34,Kxa8,514,500,-14,1
k4r2/p3R2R/1p6/1P4p1/P7/2p2PK1/2n3P1/8 w - - 0 35,Rxa7+,507,439,-68,1
k4r2/R6R/1p6/1P4p1/P7/2p2PK1/2n3P1/8 b - - 0 35,Kb8,506,502,-4,1
1k3r2/R6R/1p6/1P4p1/P7/2p2PK1/2n3P1/8 w - - 1 36,Rab7+,527,500,-27,1
1k3r2/1R5R/1p6/1P4p1/P7/2p2PK1/2n3P1/8 b - - 2 36,Kc8,500,594,94,1
2k2r2/1R5R/1p6/1P4p1/P7/2p2PK1/2n3P1/8 w - - 3 37,Rbc7+,599,546,-53,1
2k2r2/2R4R/1p6/1P4p1/P7/2p2PK1/2n3P1/8 b - - 4 37,Kd8,545,643,98,1
3k1r2/2R4R/1p6/1P4p1/P7/2p2PK1/2n3P1/8 w - - 5 38,Rxc3,643,646,3,1
3k1r2/7R/1p6/1P4p1/P7/2R2PK1/2n3P1/8 b - - 0 38,Nd4,649,651,2,1
3k1r2/7R/1p6/1P4p1/P2n4/2R2PK1/6P1/8 w - - 1 39,Rd3,605,555,-50,1
rnbqkbnr/pppppppp/8/8/8/8/PPPPPPPP/RNBQKBNR w KQkq - 0 1,Nf3,30,15,-15,1
rnbqkbnr/pppppppp/8/8/8/5N2/PPPPPPPP/RNBQKB1R b KQkq - 1 1,Nf6,19,21,2,1
rnbqkb1r/pppppppp/5n2/8/8/5N2/PPPPPPPP/RNBQKB1R w KQkq - 2 2,c4,21,21,0,1
rnbqkb1r/pppppppp/5n2/8/2P5/5N2/PP1PPPPP/RNBQKB1R b KQkq - 0 2,g6,20,38,18,1
rnbqkb1r/pppppp1p/5np1/8/2P5/5N2/PP1PPPPP/RNBQKB1R w KQkq - 0 3,Nc3,32,28,-4,1
rnbqkb1r/pppppp1p/5np1/8/2P5/2N2N2/PP1PPPPP/R1BQKB1R b KQkq - 1 3,d6,26,50,24,1
rnbqkb1r/ppp1pp1p/3p1np1/8/2P5/2N2N2/PP1PPPPP/R1BQKB1R w KQkq - 0 4,d4,46,52,6,1
rnbqkb1r/ppp1pp1p/3p1np1/8/2PP4/2N2N2/PP2PPPP/R1BQKB1R b KQkq - 0 4,Bg7,49,44,-5,1
rnbqk2r/ppp1ppbp/3p1np1/8/2PP4/2N2N2/PP2PPPP/R1BQKB1R w KQkq - 1 5,e4,49,49,0,1
rnbqk2r/ppp1ppbp/3p1np1/8/2PPP3/2N2N2/PP3PPP/R1BQKB1R b KQkq - 0 5,Nbd7,44,75,31,1
r1bqk2r/pppnppbp/3p1np1/8/2PPP3/2N2N2/PP3PPP/R1BQKB1R w KQkq - 1 6,Be2,88,53,-35,1
r1bqk2r/pppnppbp/3p1np1/8/2PPP3/2N2N2/PP2BPPP/R1BQK2R b KQkq - 2 6,O-O,39,62,23,1
r1bq1rk1/pppnppbp/3p1np1/8/2PPP3/2N2N2/PP2BPPP/R1BQK2R w KQ - 3 7,O-O,70,53,-17,1
r1bq1rk1/pppnppbp/3p1np1/8/2PPP3/2N2N2/PP2BPPP/R1BQ1RK1 b - - 4 7,e5,52,60,8,1
r1bq1rk1/pppn1pbp/3p1np1/4p3/2PPP3/2N2N2/PP2BPPP/R1BQ1RK1 w - - 0 8,Re1,70,33,-37,1
r1bq1rk1/pppn1pbp/3p1np1/4p3/2PPP3/2N2N2/PP2BPPP/R1BQR1K1 b - - 1 8,Re8,61,43,-18,1
r1bqr1k1/pppn1pbp/3p1np1/4p3/2PPP3/2N2N2/PP2BPPP/R1BQR1K1 w - - 2 9,Bf1,42,45,3,1
r1bqr1k1/pppn1pbp/3p1np1/4p3/2PPP3/2N2N2/PP3PPP/R1BQRBK1 b - - 3 9,c5,44,83,39,1
r1bqr1k1/pp1n1pbp/3p1np1/2p1p3/2PPP3/2N2N2/PP3PPP/R1BQRBK1 w - - 0 10,d5,89,93,4,1
r1bqr1k1/pp1n1pbp/3p1np1/2pPp3/2P1P3/2N2N2/PP3PPP/R1BQRBK1 b - - 0 10,a6,90,108,18,1
r1bqr1k1/1p1n1pbp/p2p1np1/2pPp3/2P1P3/2N2N2/PP3PPP/R1BQRBK1 w - - 0 11,a3,103,94,-9,1
r1bqr1k1/1p1n1pbp/p2p1np1/2pPp3/2P1P3/P1N2N2/1P3PPP/R1BQRBK1 b - - 0 11,Nb6,90,131,41,1
r1bqr1k1/1p3pbp/pn1p1np1/2pPp3/2P1P3/P1N2N2/1P3PPP/R1BQRBK1 w - - 1 12,b4,128,125,-3,1
r1bqr1k1/1p3pbp/pn1p1np1/2pPp3/1PP1P3/P1N2N2/5PPP/R1BQRBK1 b - - 0 12,Qc7,133,146,13,1
r1b1r1k1/1pq2pbp/pn1p1np1/2pPp3/1PP1P3/P1N2N2/5PPP/R1BQRBK1 w - - 1 13,bxc5,135,128,-7,1
r1b1r1k1/1pq2pbp/pn1p1np1/2PPp3/2P1P3/P1N2N2/5PPP/R1BQRBK1 b - - 0 13,Qxc5,154,174,20,1
r1b1r1k1/1p3pbp/pn1p1np1/2qPp3/2P1P3/P1N2N2/5PPP/R1BQRBK1 w - - 0 14,Be3,164,100,-64,1
r1b1r1k1/1p3pbp/pn1p1np1/2qPp3/2P1P3/P1N1BN2/5PPP/R2QRBK1 b - - 1 14,Qc7,100,104,4,1
r1b1r1k1/1pq2pbp/pn1p1np1/3Pp3/2P1P3/P1N1BN2/5PPP/R2QRBK1 w - - 2 15,Nd2,107,37,-70,1
r1b1r1k1/1pq2pbp/pn1p1np1/3Pp3/2P1P3/P1N1B3/3N1PPP/R2QRBK1 b - - 3 15,Bd7,26,245,219,1
r3r1k1/1pqb1pbp/pn1p1np1/3Pp3/2P1P3/P1N1B3/3N1PPP/R2QRBK1 w - - 4 16,Rb1,233,220,-13,1
r3r1k1/1pqb1pbp/pn1p1np1/3Pp3/2P1P3/P1N1B3/3N1PPP/1R1QRBK1 b - - 5 16,Na4,226,541,315,1
r3r1k1/1pqb1pbp/p2p1np1/3Pp3/n1P1P3/P1N1B3/3N1PPP/1R1QRBK1 w - - 6 17,Nxa4,579,545,-34,1
r3r1k1/1pqb1pbp/p2p1np1/3Pp3/N1P1P3/P3B3/3N1PPP/1R1QRBK1 b - - 0 17,Bxa4,587,627,40,1
r3r1k1/1pq2pbp/p2p1np1/3Pp3/b1P1P3/P3B3/3N1PPP/1R1QRBK1 w - - 0 18,Qxa4,632,594,-38,1
rnbqkbnr/pppppppp/8/8/8/8/PPPPPPPP/RNBQKBNR w KQkq - 0 1,d4,39,30,-9,1
rnbqkbnr/pppppppp/8/8/3P4/8/PPP1PPPP/RNBQKBNR b KQkq - 0 1,d5,23,25,2,1
rnbqkbnr/ppp1pppp/8/3p4/3P4/8/PPP1PPPP/RNBQKBNR w KQkq - 0 2,e3,21,24,3,1
rnbqkbnr/ppp1pppp/8/3p4/3P4/4P3/PPP2PPP/RNBQKBNR b KQkq - 0 2,Nf6,22,12,-10,1
rnbqkb1r/ppp1pppp/5n2/3p4/3P4/4P3/PPP2PPP/RNBQKBNR w KQkq - 1 3,Ne2,16,-66,-82,1
rnbqkb1r/ppp1pppp/5n2/3p4/3P4/4P3/PPP1NPPP/RNBQKB1R b KQkq - 2 3,e6,-54,-35,19,1
rnbqkb1r/ppp2ppp/4pn2/3p4/3P4/4P3/PPP1NPPP/RNBQKB1R w KQkq - 0 4,Nbc3,-32,-52,-20,1
rnbqkb1r/ppp2ppp/4pn2/3p4/3P4/2N1P3/PPP1NPPP/R1BQKB1R b KQkq - 1 4,Bb4,-39,-14,25,1
rnbqk2r/ppp2ppp/4pn2/3p4/1b1P4/2N1P3/PPP1NPPP/R1BQKB1R w KQkq - 2 5,a3,-24,-36,-12,1
rnbqk2r/ppp2ppp/4pn2/3p4/1b1P4/P1N1P3/1PP1NPPP/R1BQKB1R b KQkq - 0 5,Bxc3+,-38,35,73,1
rnbqk2r/ppp2ppp/4pn2/3p4/3P4/P1b1P3/1PP1NPPP/R1BQKB1R w KQkq - 0 6,Nxc3,35,31,-4,1
rnbqk2r/ppp2ppp/4pn2/3p4/3P4/P1N1P3/1PP2PPP/R1BQKB1R b KQkq - 0 6,O-O,36,34,-2,1
rnbq1rk1/ppp2ppp/4pn2/3p4/3P4/P1N1P3/1PP2PPP/R1BQKB1R w KQ - 1 7,Bd3,36,25,-11,1
rnbq1rk1/ppp2ppp/4pn2/3p4/3P4/P1NBP3/1PP2PPP/R1BQK2R b KQ - 2 7,Re8,24,35,11,1
rnbqr1k1/ppp2ppp/4pn2/3p4/3P4/P1NBP3/1PP2PPP/R1BQK2R w KQ - 3 8,Qf3,43,-50,-93,1
rnbqr1k1/ppp2ppp/4pn2/3p4/3P4/P1NBPQ2/1PP2PPP/R1B1K2R b KQ - 4 8,e5,-47,44,91,1
rnbqr1k1/ppp2ppp/5n2/3pp3/3P4/P1NBPQ2/1PP2PPP/R1B1K2R w KQ - 0 9,dxe5,35,27,-8,1
rnbqr1k1/ppp2ppp/5n2/3pP3/8/P1NBPQ2/1PP2PPP/R1B1K2R b KQ - 0 9,Rxe5,29,33,4,1
rnbq2k1/ppp2ppp/5n2/3pr3/8/P1NBPQ2/1PP2PPP/R1B1K2R w KQ - 0 10,Qg3,30,0,-30,1
rnbq2k1/ppp2ppp/5n2/3pr3/8/P1NBP1Q1/1PP2PPP/R1B1K2R b KQ - 1 10,Nc6,5,15,10,1
r1bq2k1/ppp2ppp/2n2n2/3pr3/8/P1NBP1Q1/1PP2PPP/R1B1K2R w KQ - 2 11,Ne2,16,-137,-153,0
r1bq2k1/ppp2ppp/2n2n2/3pr3/8/P2BP1Q1/1PP1NPPP/R1B1K2R b KQ - 3 11,Ne4,-152,-33,119,1
r1bq2k1/ppp2ppp/2n5/3pr3/4n3/P2BP1Q1/1PP1NPPP/R1B1K2R w KQ - 4 12,Qf4,-4,-446,-442,0
r1bq2k1/ppp2ppp/2n5/3pr3/4nQ2/P2BP3/1PP1NPPP/R1B1K2R b KQ - 5 12,Rf5,-451,-445,6,1
r1bq2k1/ppp2ppp/2n5/3p1r2/4nQ2/P2BP3/1PP1NPPP/R1B1K2R w KQ - 6 13,Qg4,-449,-501,-52,1
r1bq2k1/ppp2ppp/2n5/3p1r2/4n1Q1/P2BP3/1PP1NPPP/R1B1K2R b KQ - 7 13,Ne5,-537,-531,6,1
r1bq2k1/ppp2ppp/8/3pnr2/4n1Q1/P2BP3/1PP1NPPP/R1B1K2R w KQ - 8 14,Qh3,-526,-594,-68,1
r1bq2k1/ppp2ppp/8/3pnr2/4n3/P2BP2Q/1PP1NPPP/R1B1K2R b KQ - 9 14,Nxf2,-596,-532,64,1
r1bq2k1/ppp2ppp/8/3pnr2/8/P2BP2Q/1PP1NnPP/R1B1K2R w KQ - 0 15,Qg3,-577,-692,-115,0
r1bq2k1/ppp2ppp/8/3pnr2/8/P2BP1Q1/1PP1NnPP/R1B1K2R b KQ - 1 15,Nxh1,-688,-659,29,1
r1bq2k1/ppp2ppp/8/3pnr2/8/P2BP1Q1/1PP1N1PP/R1B1K2n w Q - 0 16,Bxf5,-674,-633,41,1
r1bq2k1/ppp2ppp/8/3pnB2/8/P3P1Q1/1PP1N1PP/R1B1K2n b Q - 0 16,Nxg3,-649,-639,10,1
r1bq2k1/ppp2ppp/8/3pnB2/8/P3P1n1/1PP1N1PP/R1B1K3 w Q - 0 17,Nxg3,-659,-636,23,1
r1bq2k1/ppp2ppp/8/3pnB2/8/P3P1N1/1PP3PP/R1B1K3 b Q - 0 17,Qh4,-637,-668,-31,1
r1b3k1/ppp2ppp/8/3pnB2/7q/P3P1N1/1PP3PP/R1B1K3 w Q - 1 18,Bxc8,-697,-747,-50,1
r1B3k1/ppp2ppp/8/3pn3/7q/P3P1N1/1PP3PP/R1B1K3 b Q - 0 18,Qxh2,-754,-685,69,1
r1B3k1/ppp2ppp/8/3pn3/8/P3P1N1/1PP3Pq/R1B1K3 w Q - 0 19,Nf5,-699,-718,-19,1
r1B3k1/ppp2ppp/8/3pnN2/8/P3P3/1PP3Pq/R1B1K3 b Q - 1 19,Qg1+,-751,-718,33,1
r1B3k1/ppp2ppp/8/3pnN2/8/P3P3/1PP3P1/R1B1K1q1 w Q - 2 20,Ke2,-736,-9996,-9260,0
r1B3k1/ppp2ppp/8/3pnN2/8/P3P3/1PP1K1P1/R1B3q1 b - - 3 20,Qxg2+,-9996,-9997,-1,1
r1B3k1/ppp2ppp/8/3pnN2/8/P3P3/1PP1K1q1/R1B5 w - - 0 21,Ke1,-9997,-9998,-1,1
r1B3k1/ppp2ppp/8/3pnN2/8/P3P3/1PP3q1/R1B1K3 b - - 1 21,Nf3+,-9998,-9999,-1,1
r1B3k1/ppp2ppp/8/3p1N2/8/P3Pn2/1PP3q1/R1B1K3 w - - 2 22,Kd1,-9999,-9999,0,1
r1B3k1/ppp2ppp/8/3p1N2/8/P3Pn2/1PP3q1/R1BK4 b - - 3 22,Qf1#,-9999,-10000,-1,1
rnbqkbnr/pppppppp/8/8/8/8/PPPPPPPP/RNBQKBNR w KQkq - 0 1,f4,34,-24,-58,1
rnbqkbnr/pppppppp/8/8/5P2/8/PPPPP1PP/RNBQKBNR b KQkq - 0 1,c6,-25,21,46,1
rnbqkbnr/pp1ppppp/2p5/8/5P2/8/PPPPP1PP/RNBQKBNR w KQkq - 0 2,Nf3,23,-12,-35,1
rnbqkbnr/pp1ppppp/2p5/8/5P2/5N2/PPPPP1PP/RNBQKB1R b KQkq - 1 2,d5,-19,2,21,1
rnbqkbnr/pp2pppp/2p5/3p4/5P2/5N2/PPPPP1PP/RNBQKB1R w KQkq - 0 3,e4,-1,-129,-128,0
rnbqkbnr/pp2pppp/2p5/3p4/4PP2/5N2/PPPP2PP/RNBQKB1R b KQkq - 0 3,Nf6,-67,99,166,1
rnbqkb1r/pp2pppp/2p2n2/3p4/4PP2/5N2/PPPP2PP/RNBQKB1R w KQkq - 1 4,e5,103,95,-8,1
rnbqkb1r/pp2pppp/2p2n2/3pP3/5P2/5N2/PPPP2PP/RNBQKB1R b KQkq - 0 4,Nfd7,88,118,30,1
rnbqkb1r/pp1npppp/2p5/3pP3/5P2/5N2/PPPP2PP/RNBQKB1R w KQkq - 1 5,d4,120,115,-5,1
rnbqkb1r/pp1npppp/2p5/3pP3/3P1P2/5N2/PPP3PP/RNBQKB1R b KQkq - 0 5,e6,113,124,11,1
rnbqkb1r/pp1n1ppp/2p1p3/3pP3/3P1P2/5N2/PPP3PP/RNBQKB1R w KQkq - 0 6,c3,120,120,0,1
rnbqkb1r/pp1n1ppp/2p1p3/3pP3/3P1P2/2P2N2/PP4PP/RNBQKB1R b KQkq - 0 6,Be7,124,123,-1,1
rnbqk2r/pp1nbppp/2p1p3/3pP3/3P1P2/2P2N2/PP4PP/RNBQKB1R w KQkq - 1 7,Bd3,122,128,6,1
rnbqk2r/pp1nbppp/2p1p3/3pP3/3P1P2/2PB1N2/PP4PP/RNBQK2R b KQkq - 2 7,O-O,122,187,65,1
rnbq1rk1/pp1nbppp/2p1p3/3pP3/3P1P2/2PB1N2/PP4PP/RNBQK2R w KQ - 3 8,O-O,202,133,-69,1
rnbq1rk1/pp1nbppp/2p1p3/3pP3/3P1P2/2PB1N2/PP4PP/RNBQ1RK1 b - - 4 8,c5,136,151,15,1
rnbq1rk1/pp1nbppp/4p3/2ppP3/3P1P2/2PB1N2/PP4PP/RNBQ1RK1 w - - 0 9,Qc2,144,83,-61,1
rnbq1rk1/pp1nbppp/4p3/2ppP3/3P1P2/2PB1N2/PPQ3PP/RNB2RK1 b - - 1 9,cxd4,82,218,136,1
rnbq1rk1/pp1nbppp/4p3/3pP3/3p1P2/2PB1N2/PPQ3PP/RNB2RK1 w - - 0 10,Bxh7+,224,268,44,1
rnbq1rk1/pp1nbppB/4p3/3pP3/3p1P2/2P2N2/PPQ3PP/RNB2RK1 b - - 0 10,Kh8,261,249,-12,1
rnbq1r1k/pp1nbppB/4p3/3pP3/3p1P2/2P2N2/PPQ3PP/RNB2RK1 w - - 1 11,Bd3,261,125,-136,0
rnbq1r1k/pp1nbpp1/4p3/3pP3/3p1P2/2PB1N2/PPQ3PP/RNB2RK1 b - - 2 11,g6,136,319,183,1
rnbq1r1k/pp1nbp2/4p1p1/3pP3/3p1P2/2PB1N2/PPQ3PP/RNB2RK1 w - - 0 12,cxd4,282,275,-7,1
rnbq1r1k/pp1nbp2/4p1p1/3pP3/3P1P2/3B1N2/PPQ3PP/RNB2RK1 b - - 0 12,Kg7,306,301,-5,1
rnbq1r2/pp1nbpk1/4p1p1/3pP3/3P1P2/3B1N2/PPQ3PP/RNB2RK1 w - - 1 13,Ng5,306,213,-93,1
rnbq1r2/pp1nbpk1/4p1p1/3pP1N1/3P1P2/3B4/PPQ3PP/RNB2RK1 b - - 2 13,Bxg5,220,302,82,1
rnbq1r2/pp1n1pk1/4p1p1/3pP1b1/3P1P2/3B4/PPQ3PP/RNB2RK1 w - - 0 14,fxg5,325,322,-3,1
rnbq1r2/pp1n1pk1/4p1p1/3pP1P1/3P4/3B4/PPQ3PP/RNB2RK1 b - - 0 14,Nc6,320,325,5,1
r1bq1r2/pp1n1pk1/2n1p1p1/3pP1P1/3P4/3B4/PPQ3PP/RNB2RK1 w - - 1 15,Be3,318,270,-48,1
r1bq1r2/pp1n1pk1/2n1p1p1/3pP1P1/3P4/3BB3/PPQ3PP/RN3RK1 b - - 2 15,Nb4,279,288,9,1
r1bq1r2/pp1n1pk1/4p1p1/3pP1P1/1n1P4/3BB3/PPQ3PP/RN3RK1 w - - 3 16,Qe2,284,299,15,1
r1bq1r2/pp1n1pk1/4p1p1/3pP1P1/1n1P4/3BB3/PP2Q1PP/RN3RK1 b - - 4 16,Nxd3,296,290,-6,1
r1bq1r2/pp1n1pk1/4p1p1/3pP1P1/3P4/3nB3/PP2Q1PP/RN3RK1 w - - 0 17,Qxd3,270,272,2,1
r1bq1r2/pp1n1pk1/4p1p1/3pP1P1/3P4/3QB3/PP4PP/RN3RK1 b - - 0 17,a5,279,287,8,1
r1bq1r2/1p1n1pk1/4p1p1/p2pP1P1/3P4/3QB3/PP4PP/RN3RK1 w - - 0 18,Nd2,287,235,-52,1
r1bq1r2/1p1n1pk1/4p1p1/p2pP1P1/3P4/3QB3/PP1N2PP/R4RK1 b - - 1 18,b6,237,239,2,1
r1bq1r2/3n1pk1/1p2p1p1/p2pP1P1/3P4/3QB3/PP1N2PP/R4RK1 w - - 0 19,Nf3,239,22,-217,0
r1bq1r2/3n1pk1/1p2p1p1/p2pP1P1/3P4/3QBN2/PP4PP/R4RK1 b - - 1 19,Ba6,-38,-8,30,1
r2q1r2/3n1pk1/bp2p1p1/p2pP1P1/3P4/3QBN2/PP4PP/R4RK1 w - - 2 20,Qd2,-20,-55,-35,1
r2q1r2/3n1pk1/bp2p1p1/p2pP1P1/3P4/4BN2/PP1Q2PP/R4RK1 b - - 3 20,Bxf1,-43,-29,14,1
r2q1r2/3n1pk1/1p2p1p1/p2pP1P1/3P4/4BN2/PP1Q2PP/R4bK1 w - - 0 21,Rxf1,-16,-23,-7,1
r2q1r2/3n1pk1/1p2p1p1/p2pP1P1/3P4/4BN2/PP1Q2PP/5RK1 b - - 0 21,Rh8,-34,181,215,1
r2q3r/3n1pk1/1p2p1p1/p2pP1P1/3P4/4BN2/PP1Q2PP/5RK1 w - - 1 22,h4,176,121,-55,1
r2q3r/3n1pk1/1p2p1p1/p2pP1P1/3P3P/4BN2/PP1Q2P1/5RK1 b - - 0 22,Rh5,110,227,117,1
r2q4/3n1pk1/1p2p1p1/p2pP1Pr/3P3P/4BN2/PP1Q2P1/5RK1 w - - 1 23,g3,207,126,-81,1
r2q4/3n1pk1/1p2p1p1/p2pP1Pr/3P3P/4BNP1/PP1Q4/5RK1 b - - 0 23,Rc8,143,139,-4,1
2rq4/3n1pk1/1p2p1p1/p2pP1Pr/3P3P/4BNP1/PP1Q4/5RK1 w - - 1 24,Nh2,151,140,-11,1
2rq4/3n1pk1/1p2p1p1/p2pP1Pr/3P3P/4B1P1/PP1Q3N/5RK1 b - - 2 24,b5,146,148,2,1
2rq4/3n1pk1/4p1p1/pp1pP1Pr/3P3P/4B1P1/PP1Q3N/5RK1 w - - 0 25,Ng4,141,137,-4,1
2rq4/3n1pk1/4p1p1/pp1pP1Pr/3P2NP/4B1P1/PP1Q4/5RK1 b - - 1 25,Qc7,136,303,167,1
2r5/2qn1pk1/4p1p1/pp1pP1Pr/3P2NP/4B1P1/PP1Q4/5RK1 w - - 2 26,Nf6,299,-46,-345,0
2r5/2qn1pk1/4pNp1/pp1pP1Pr/3P3P/4B1P1/PP1Q4/5RK1 b - - 3 26,Nf8,-62,240,302,1
2r2n2/2q2pk1/4pNp1/pp1pP1Pr/3P3P/4B1P1/PP1Q4/5RK1 w - - 4 27,Nxh5+,284,282,-2,1
2r2n2/2q2pk1/4p1p1/pp1pP1PN/3P3P/4B1P1/PP1Q4/5RK1 b - - 0 27,gxh5,291,296,5,1
2r2n2/2q2pk1/4p3/pp1pP1Pp/3P3P/4B1P1/PP1Q4/5RK1 w - - 0 28,Qe2,283,283,0,1
2r2n2/2q2pk1/4p3/pp1pP1Pp/3P3P/4B1P1/PP2Q3/5RK1 b - - 1 28,Kg6,278,361,83,1
2r2n2/2q2p2/4p1k1/pp1pP1Pp/3P3P/4B1P1/PP2Q3/5RK1 w - - 2 29,g4,357,287,-70,1
2r2n2/2q2p2/4p1k1/pp1pP1Pp/3P2PP/4B3/PP2Q3/5RK1 b - - 0 29,hxg4,305,277,-28,1
2r2n2/2q2p2/4p1k1/pp1pP1P1/3P2pP/4B3/PP2Q3/5RK1 w - - 0 30,Qxg4,293,323,30,1
2r2n2/2q2p2/4p1k1/pp1pP1P1/3P2QP/4B3/PP6/5RK1 b - - 0 30,Nh7,302,502,200,1
2r5/2q2p1n/4p1k1/pp1pP1P1/3P2QP/4B3/PP6/5RK1 w - - 1 31,h5+,604,634,30,1
2r5/2q2p1n/4p1k1/pp1pP1PP/3P2Q1/4B3/PP6/5RK1 b - - 0 31,Kg7,586,622,36,1
2r5/2q2pkn/4p3/pp1pP1PP/3P2Q1/4B3/PP6/5RK1 w - - 1 32,g6,653,643,-10,1
2r5/2q2pkn/4p1P1/pp1pP2P/3P2Q1/4B3/PP6/5RK1 b - - 0 32,Kh8,664,769,105,1
2r4k/2q2p1n/4p1P1/pp1pP2P/3P2Q1/4B3/PP6/5RK1 w - - 1 33,Rxf7,785,741,-44,1
2r4k/2q2R1n/4p1P1/pp1pP2P/3P2Q1/4B3/PP6/6K1 b - - 0 33,Qd8,793,9997,9204,1
2rq3k/5R1n/4p1P1/pp1pP2P/3P2Q1/4B3/PP6/6K1 w - - 1 34,Rxh7+,9997,9998,1,1
2rq3k/7R/4p1P1/pp1pP2P/3P2Q1/4B3/PP6/6K1 b - - 0 34,Kg8,9998,9998,0,1
2rq2k1/7R/4p1P1/pp1pP2P/3P2Q1/4B3/PP6/6K1 w - - 1 35,h6,9998,593,-9405,0
2rq2k1/7R/4p1PP/pp1pP3/3P2Q1/4B3/PP6/6K1 b - - 0 35,Rc1+,729,1199,470,1
3q2k1/7R/4p1PP/pp1pP3/3P2Q1/4B3/PP6/2r3K1 w - - 1 36,Bxc1,9989,9990,1,1
3q2k1/7R/4p1PP/pp1pP3/3P2Q1/8/PP6/2B3K1 b - - 0 36,Qf8,9991,9998,7,1
5qk1/7R/4p1PP/pp1pP3/3P2Q1/8/PP6/2B3K1 w - - 1 37,Qg5,9998,9992,-6,1
5qk1/7R/4p1PP/pp1pP1Q1/3P4/8/PP6/2B3K1 b - - 2 37,b4,9992,9992,0,1
5qk1/7R/4p1PP/p2pP1Q1/1p1P4/8/PP6/2B3K1 w - - 0 38,Qf6,9995,9991,-4,1
5qk1/7R/4pQPP/p2pP3/1p1P4/8/PP6/2B3K1 b - - 1 38,Qxf6,9991,9991,0,1
6k1/7R/4pqPP/p2pP3/1p1P4/8/PP6/2B3K1 w - - 0 39,exf6,9991,9994,3,1
6k1/7R/4pPPP/p2p4/1p1P4/8/PP6/2B3K1 b - - 0 39,a4,9996,9997,1,1
6k1/7R/4pPPP/3p4/pp1P4/8/PP6/2B3K1 w - - 0 40,f7+,9997,9995,-2,1
6k1/5P1R/4p1PP/3p4/pp1P4/8/PP6/2B3K1 b - - 0 40,Kf8,9995,9995,0,1
5k2/5P1R/4p1PP/3p4/pp1P4/8/PP6/2B3K1 w - - 1 41,Rh8+,9995,9996,1,1
5k1R/5P2/4p1PP/3p4/pp1P4/8/PP6/2B3K1 b - - 2 41,Ke7,9996,9996,0,1
7R/4kP2/4p1PP/3p4/pp1P4/8/PP6/2B3K1 w - - 3 42,f8=Q+,9996,9997,1,1
5Q1R/4k3/4p1PP/3p4/pp1P4/8/PP6/2B3K1 b - - 0 42,Kd7,9997,9998,1,1
5Q1R/3k4/4p1PP/3p4/pp1P4/8/PP6/2B3K1 w - - 1 43,Qg7+,9998,9995,-3,1
7R/3k2Q1/4p1PP/3p4/pp1P4/8/PP6/2B3K1 b - - 2 43,Kc6,9995,9996,1,1
7R/6Q1/2k1p1PP/3p4/pp1P4/8/PP6/2B3K1 w - - 3 44,Re8,9996,1218,-8778,0
4R3/6Q1/2k1p1PP/3p4/pp1P4/8/PP6/2B3K1 b - - 4 44,Kb5,1155,9995,8840,1
4R3/6Q1/4p1PP/1k1p4/pp1P4/8/PP6/2B3K1 w - - 5 45,Qe7,9995,1192,-8803,0
4R3/4Q3/4p1PP/1k1p4/pp1P4/8/PP6/2B3K1 b - - 6 45,Kc4,1230,9991,8761,1
4R3/4Q3/4p1PP/3p4/ppkP4/8/PP6/2B3K1 w - - 7 46,Qxe6,9991,9993,2,1
4R3/8/4Q1PP/3p4/ppkP4/8/PP6/2B3K1 b - - 0 46,Kd3,9997,9998,1,1
4R3/8/4Q1PP/3p4/pp1P4/3k4/PP6/2B3K1 w - - 1 47,Qe3+,9998,1099,-8899,0
4R3/8/6PP/3p4/pp1P4/3kQ3/PP6/2B3K1 b - - 2 47,Kc2,9996,9996,0,1
4R3/8/6PP/3p4/pp1P4/4Q3/PPk5/2B3K1 w - - 3 48,Rc8+,9996,1125,-8871,0
2R5/8/6PP/3p4/pp1P4/4Q3/PPk5/2B3K1 b - - 4 48,Kb1,1331,1552,221,1
2R5/8/6PP/3p4/pp1P4/4Q3/PP6/1kB3K1 w - - 5 49,Rc5,1590,1127,-463,0
8/8/6PP/2Rp4/pp1P4/4Q3/PP6/1kB3K1 b - - 6 49,b3,1157,1434,277,1
8/8/6PP/2Rp4/p2P4/1p2Q3/PP6/1kB3K1 w - - 0 50,Qd3+,9980,1120,-8860,0
8/8/6PP/2Rp4/p2P4/1p1Q4/PP6/1kB3K1 b - - 1 50,Ka1,1134,1219,85,1
rnbqkbnr/pppppppp/8/8/8/8/PPPPPPPP/RNBQKBNR w KQkq - 0 1,c4,29,-18,-47,1
rnbqkbnr/pppppppp/8/8/2P5/8/PP1PPPPP/RNBQKBNR b KQkq - 0 1,Nf6,-11,24,35,1
rnbqkb1r/pppppppp/5n2/8/2P5/8/PP1PPPPP/RNBQKBNR w KQkq - 1 2,b3,25,-45,-70,1
rnbqkb1r/pppppppp/5n2/8/2P5/1P6/P2PPPPP/RNBQKBNR b KQkq - 0 2,g6,-29,0,29,1
rnbqkb1r/pppppp1p/5np1/8/2P5/1P6/P2PPPPP/RNBQKBNR w KQkq - 0 3,Bb2,-5,-10,-5,1
rnbqkb1r/pppppp1p/5np1/8/2P5/1P6/PB1PPPPP/RN1QKBNR b KQkq - 1 3,Bg7,-15,-3,12,1
rnbqk2r/ppppppbp/5np1/8/2P5/1P6/PB1PPPPP/RN1QKBNR w KQkq - 2 4,g4,8,-76,-84,1
rnbqk2r/ppppppbp/5np1/8/2P3P1/1P6/PB1PPP1P/RN1QKBNR b KQkq - 0 4,O-O,-76,-29,47,1
rnbq1rk1/ppppppbp/5np1/8/2P3P1/1P6/PB1PPP1P/RN1QKBNR w KQ - 1 5,g5,-25,-13,12,1
rnbq1rk1/ppppppbp/5np1/6P1/2P5/1P6/PB1PPP1P/RN1QKBNR b KQ - 0 5,Ne8,-37,-18,19,1
rnbqnrk1/ppppppbp/6p1/6P1/2P5/1P6/PB1PPP1P/RN1QKBNR w KQ - 1 6,Bxg7,-4,-5,-1,1
rnbqnrk1/ppppppBp/6p1/6P1/2P5/1P6/P2PPP1P/RN1QKBNR b KQ - 0 6,Nxg7,-18,-21,-3,1
rnbq1rk1/ppppppnp/6p1/6P1/2P5/1P6/P2PPP1P/RN1QKBNR w KQ - 0 7,Bg2,-3,-69,-66,1
rnbq1rk1/ppppppnp/6p1/6P1/2P5/1P6/P2PPPBP/RN1QK1NR b KQ - 1 7,e6,-46,45,91,1
rnbq1rk1/pppp1pnp/4p1p1/6P1/2P5/1P6/P2PPPBP/RN1QK1NR w KQ - 0 8,Nf3,43,39,-4,1
rnbq1rk1/pppp1pnp/4p1p1/6P1/2P5/1P3N2/P2PPPBP/RN1QK2R b KQ - 1 8,Qe7,40,59,19,1
rnb2rk1/ppppqpnp/4p1p1/6P1/2P5/1P3N2/P2PPPBP/RN1QK2R w KQ - 2 9,Nc3,61,67,6,1
rnb2rk1/ppppqpnp/4p1p1/6P1/2P5/1PN2N2/P2PPPBP/R2QK2R b KQ - 3 9,Nc6,45,82,37,1
r1b2rk1/ppppqpnp/2n1p1p1/6P1/2P5/1PN2N2/P2PPPBP/R2QK2R w KQ - 4 10,Ne4,94,-52,-146,0
r1b2rk1/ppppqpnp/2n1p1p1/6P1/2P1N3/1P3N2/P2PPPBP/R2QK2R b KQ - 5 10,d5,-51,114,165,1
r1b2rk1/ppp1qpnp/2n1p1p1/3p2P1/2P1N3/1P3N2/P2PPPBP/R2QK2R w KQ - 0 11,Nf6+,134,128,-6,1
r1b2rk1/ppp1qpnp/2n1pNp1/3p2P1/2P5/1P3N2/P2PPPBP/R2QK2R b KQ - 1 11,Kh8,116,118,2,1
r1b2r1k/ppp1qpnp/2n1pNp1/3p2P1/2P5/1P3N2/P2PPPBP/R2QK2R w KQ - 2 12,cxd5,101,95,-6,1
r1b2r1k/ppp1qpnp/2n1pNp1/3P2P1/8/1P3N2/P2PPPBP/R2QK2R b KQ - 0 12,exd5,91,92,1,1
r1b2r1k/ppp1qpnp/2n2Np1/3p2P1/8/1P3N2/P2PPPBP/R2QK2R w KQ - 0 13,O-O,128,-8,-136,0
r1b2r1k/ppp1qpnp/2n2Np1/3p2P1/8/1P3N2/P2PPPBP/R2Q1RK1 b - - 1 13,Bf5,-4,67,71,1
r4r1k/ppp1qpnp/2n2Np1/3p1bP1/8/1P3N2/P2PPPBP/R2Q1RK1 w - - 2 14,d3,88,0,-88,1
r4r1k/ppp1qpnp/2n2Np1/3p1bP1/8/1P1P1N2/P3PPBP/R2Q1RK1 b - - 0 14,Ne8,-1,181,182,1
r3nr1k/ppp1qp1p/2n2Np1/3p1bP1/8/1P1P1N2/P3PPBP/R2Q1RK1 w - - 1 15,Nxe8,165,-89,-254,0
r3Nr1k/ppp1qp1p/2n3p1/3p1bP1/8/1P1P1N2/P3PPBP/R2Q1RK1 b - - 0 15,Raxe8,-94,-103,-9,1
4rr1k/ppp1qp1p/2n3p1/3p1bP1/8/1P1P1N2/P3PPBP/R2Q1RK1 w - - 0 16,h4,-93,-228,-135,0
4rr1k/ppp1qp1p/2n3p1/3p1bP1/7P/1P1P1N2/P3PPB1/R2Q1RK1 b - - 0 16,h6,-200,-46,154,1
4rr1k/ppp1qp2/2n3pp/3p1bP1/7P/1P1P1N2/P3PPB1/R2Q1RK1 w - - 0 17,Re1,-70,-52,18,1
4rr1k/ppp1qp2/2n3pp/3p1bP1/7P/1P1P1N2/P3PPB1/R2QR1K1 b - - 1 17,hxg5,-55,-36,19,1
4rr1k/ppp1qp2/2n3p1/3p1bp1/7P/1P1P1N2/P3PPB1/R2QR1K1 w - - 0 18,hxg5,-43,-69,-26,1
4rr1k/ppp1qp2/2n3p1/3p1bP1/8/1P1P1N2/P3PPB1/R2QR1K1 b - - 0 18,Bg4,-64,-46,18,1
4rr1k/ppp1qp2/2n3p1/3p2P1/6b1/1P1P1N2/P3PPB1/R2QR1K1 w - - 1 19,e4,-42,-289,-247,0
4rr1k/ppp1qp2/2n3p1/3p2P1/4P1b1/1P1P1N2/P4PB1/R2QR1K1 b - - 0 19,Ne5,-274,-248,26,1
4rr1k/ppp1qp2/6p1/3pn1P1/4P1b1/1P1P1N2/P4PB1/R2QR1K1 w - - 1 20,exd5,-255,-365,-110,0
4rr1k/ppp1qp2/6p1/3Pn1P1/6b1/1P1P1N2/P4PB1/R2QR1K1 b - - 0 20,Bxf3,-412,-161,251,1
4rr1k/ppp1qp2/6p1/3Pn1P1/8/1P1P1b2/P4PB1/R2QR1K1 w - - 0 21,Bxf3,-144,-185,-41,1
4rr1k/ppp1qp2/6p1/3Pn1P1/8/1P1P1B2/P4P2/R2QR1K1 b - - 0 21,Nxf3+,-118,-83,35,1
4rr1k/ppp1qp2/6p1/3P2P1/8/1P1P1n2/P4P2/R2QR1K1 w - - 0 22,Qxf3,-66,-71,-5,1
4rr1k/ppp1qp2/6p1/3P2P1/8/1P1P1Q2/P4P2/R3R1K1 b - - 0 22,Qxg5+,-95,-78,17,1
4rr1k/ppp2p2/6p1/3P2q1/8/1P1P1Q2/P4P2/R3R1K1 w - - 0 23,Kf1,-80,-183,-103,0
4rr1k/ppp2p2/6p1/3P2q1/8/1P1P1Q2/P4P2/R3RK2 b - - 1 23,Rxe1+,-151,-60,91,1
5r1k/ppp2p2/6p1/3P2q1/8/1P1P1Q2/P4P2/R3rK2 w - - 0 24,Rxe1,-61,-85,-24,1
5r1k/ppp2p2/6p1/3P2q1/8/1P1P1Q2/P4P2/4RK2 b - - 0 24,Rd8,-64,338,402,1
3r3k/ppp2p2/6p1/3P2q1/8/1P1P1Q2/P4P2/4RK2 w - - 1 25,Qh3+,300,-201,-501,0
3r3k/ppp2p2/6p1/3P2q1/8/1P1P3Q/P4P2/4RK2 b - - 2 25,Kg7,-195,-191,4,1
3r4/ppp2pk1/6p1/3P2q1/8/1P1P3Q/P4P2/4RK2 w - - 3 26,d4,-197,-328,-131,0
3r4/ppp2pk1/6p1/3P2q1/3P4/1P5Q/P4P2/4RK2 b - - 0 26,Rxd5,-341,-335,6,1
8/ppp2pk1/6p1/3r2q1/3P4/1P5Q/P4P2/4RK2 w - - 0 27,Qc3,-325,-341,-16,1
8/ppp2pk1/6p1/3r2q1/3P4/1PQ5/P4P2/4RK2 b - - 1 27,c6,-328,-220,108,1
8/pp3pk1/2p3p1/3r2q1/3P4/1PQ5/P4P2/4RK2 w - - 0 28,Re5,-208,-197,11,1
8/pp3pk1/2p3p1/3rR1q1/3P4/1PQ5/P4P2/5K2 b - - 1 28,Qh4,-230,-191,39,1
8/pp3pk1/2p3p1/3rR3/3P3q/1PQ5/P4P2/5K2 w - - 2 29,Rxd5,-183,-151,32,1
8/pp3pk1/2p3p1/3R4/3P3q/1PQ5/P4P2/5K2 b - - 0 29,Qh1+,-153,-165,-12,1
8/pp3pk1/2p3p1/3R4/3P4/1PQ5/P4P2/5K1q w - - 1 30,Ke2,-154,-166,-12,1
8/pp3pk1/2p3p1/3R4/3P4/1PQ5/P3KP2/7q b - - 2 30,Qxd5,-168,-154,14,1
8/pp3pk1/2p3p1/3q4/3P4/1PQ5/P3KP2/8 w - - 0 31,Qc5,-164,-404,-240,0
8/pp3pk1/2p3p1/2Qq4/3P4/1P6/P3KP2/8 b - - 1 31,Qxc5,-438,-455,-17,1
8/pp3pk1/2p3p1/2q5/3P4/1P6/P3KP2/8 w - - 0 32,dxc5,-444,-441,3,1
8/pp3pk1/2p3p1/2P5/8/1P6/P3KP2/8 b - - 0 32,Kf6,-433,-432,1,1
8/pp3p2/2p2kp1/2P5/8/1P6/P3KP2/8 w - - 1 33,Kd3,-431,-437,-6,1
8/pp3p2/2p2kp1/2P5/8/1P1K4/P4P2/8 b - - 2 33,Ke5,-439,-437,2,1
8/pp3p2/2p3p1/2P1k3/8/1P1K4/P4P2/8 w - - 3 34,Kc4,-450,-466,-16,1
8/pp3p2/2p3p1/2P1k3/2K5/1P6/P4P2/8 b - - 4 34,f5,-459,-445,14,1
8/pp6/2p3p1/2P1kp2/2K5/1P6/P4P2/8 w - - 0 35,b4,-437,-476,-39,1
8/pp6/2p3p1/2P1kp2/1PK5/8/P4P2/8 b - - 0 35,f4,-467,-422,45,1
8/pp6/2p3p1/2P1k3/1PK2p2/8/P4P2/8 w - - 0 36,b5,-408,-496,-88,1
8/pp6/2p3p1/1PP1k3/2K2p2/8/P4P2/8 b - - 0 36,f3,-563,-468,95,1
8/pp6/2p3p1/1PP1k3/2K5/5p2/P4P2/8 w - - 0 37,bxc6,-446,-500,-54,1
8/pp6/2P3p1/2P1k3/2K5/5p2/P4P2/8 b - - 0 37,bxc6,-511,-528,-17,1
8/p7/2p3p1/2P1k3/2K5/5p2/P4P2/8 w - - 0 38,Kb4,-498,-597,-99,1
8/p7/2p3p1/2P1k3/1K6/5p2/P4P2/8 b - - 1 38,Kd5,-624,-511,113,1
8/p7/2p3p1/2Pk4/1K6/5p2/P4P2/8 w - - 2 39,Ka5,-538,-589,-51,1
8/p7/2p3p1/K1Pk4/8/5p2/P4P2/8 b - - 3 39,g5,-582,-616,-34,1
8/p7/2p5/K1Pk2p1/8/5p2/P4P2/8 w - - 0 40,Ka6,-630,-655,-25,1
8/p7/K1p5/2Pk2p1/8/5p2/P4P2/8 b - - 1 40,Kxc5,-674,-656,18,1
8/p7/K1p5/2k3p1/8/5p2/P4P2/8 w - - 0 41,Kxa7,-659,-702,-43,1
8/K7/2p5/2k3p1/8/5p2/P4P2/8 b - - 0 41,Kb4,-684,-531,153,1
8/K7/2p5/6p1/1k6/5p2/P4P2/8 w - - 1 42,Kb7,-549,-551,-2,1
8/1K6/2p5/6p1/1k6/5p2/P4P2/8 b - - 2 42,g4,-555,-547,8,1
8/1K6/2p5/8/1k4p1/5p2/P4P2/8 w - - 0 43,Kxc6,-540,-533,7,1
8/8/2K5/8/1k4p1/5p2/P4P2/8 b - - 0 43,g3,-549,-525,24,1
8/8/2K5/8/1k6/5pp1/P4P2/8 w - - 0 44,fxg3,-532,-528,4,1
rnbqkbnr/pppppppp/8/8/8/8/PPPPPPPP/RNBQKBNR w KQkq - 0 1,c4,37,-4,-41,1
rnbqkbnr/pppppppp/8/8/2P5/8/PP1PPPPP/RNBQKBNR b KQkq - 0 1,e6,-4,28,32,1
rnbqkbnr/pppp1ppp/4p3/8/2P5/8/PP1PPPPP/RNBQKBNR w KQkq - 0 2,e3,24,-7,-31,1
rnbqkbnr/pppp1ppp/4p3/8/2P5/4P3/PP1P1PPP/RNBQKBNR b KQkq - 0 2,d5,-1,-1,0,1
rnbqkbnr/ppp2ppp/4p3/3p4/2P5/4P3/PP1P1PPP/RNBQKBNR w KQkq - 0 3,cxd5,7,-4,-11,1
rnbqkbnr/ppp2ppp/4p3/3P4/8/4P3/PP1P1PPP/RNBQKBNR b KQkq - 0 3,exd5,-16,-7,9,1
rnbqkbnr/ppp2ppp/8/3p4/8/4P3/PP1P1PPP/RNBQKBNR w KQkq - 0 4,Nc3,-13,-22,-9,1
rnbqkbnr/ppp2ppp/8/3p4/8/2N1P3/PP1P1PPP/R1BQKBNR b KQkq - 1 4,Nf6,-17,-11,6,1
rnbqkb1r/ppp2ppp/5n2/3p4/8/2N1P3/PP1P1PPP/R1BQKBNR w KQkq - 2 5,a3,-14,-20,-6,1
rnbqkb1r/ppp2ppp/5n2/3p4/8/P1N1P3/1P1P1PPP/R1BQKBNR b KQkq - 0 5,Be7,-21,0,21,1
rnbqk2r/ppp1bppp/5n2/3p4/8/P1N1P3/1P1P1PPP/R1BQKBNR w KQkq - 1 6,Qc2,1,-85,-86,1
rnbqk2r/ppp1bppp/5n2/3p4/8/P1N1P3/1PQP1PPP/R1B1KBNR b KQkq - 2 6,O-O,-56,-32,24,1
rnbq1rk1/ppp1bppp/5n2/3p4/8/P1N1P3/1PQP1PPP/R1B1KBNR w KQ - 3 7,Bd3,-23,-87,-64,1
rnbq1rk1/ppp1bppp/5n2/3p4/8/P1NBP3/1PQP1PPP/R1B1K1NR b KQ - 4 7,d4,-92,-40,52,1
rnbq1rk1/ppp1bppp/5n2/8/3p4/P1NBP3/1PQP1PPP/R1B1K1NR w KQ - 0 8,exd4,-50,-113,-63,1
rnbq1rk1/ppp1bppp/5n2/8/3P4/P1NB4/1PQP1PPP/R1B1K1NR b KQ - 0 8,Qxd4,-102,-20,82,1
rnb2rk1/ppp1bppp/5n2/8/3q4/P1NB4/1PQP1PPP/R1B1K1NR w KQ - 0 9,Nf3,-22,-25,-3,1
rnb2rk1/ppp1bppp/5n2/8/3q4/P1NB1N2/1PQP1PPP/R1B1K2R b KQ - 1 9,Qg4,-25,-13,12,1
rnb2rk1/ppp1bppp/5n2/8/6q1/P1NB1N2/1PQP1PPP/R1B1K2R w KQ - 2 10,O-O,-3,-7,-4,1
rnb2rk1/ppp1bppp/5n2/8/6q1/P1NB1N2/1PQP1PPP/R1B2RK1 b - - 3 10,Nc6,-15,6,21,1
r1b2rk1/ppp1bppp/2n2n2/8/6q1/P1NB1N2/1PQP1PPP/R1B2RK1 w - - 4 11,Ne4,18,6,-12,1
r1b2rk1/ppp1bppp/2n2n2/8/4N1q1/P2B1N2/1PQP1PPP/R1B2RK1 b - - 5 11,Nh5,-4,51,55,1
r1b2rk1/ppp1bppp/2n5/7n/4N1q1/P2B1N2/1PQP1PPP/R1B2RK1 w - - 6 12,Ng3,44,14,-30,1
r1b2rk1/ppp1bppp/2n5/7n/6q1/P2B1NN1/1PQP1PPP/R1B2RK1 b - - 7 12,Nf4,8,203,195,1
r1b2rk1/ppp1bppp/2n5/8/5nq1/P2B1NN1/1PQP1PPP/R1B2RK1 w - - 8 13,Bxh7+,217,264,47,1
r1b2rk1/ppp1bppB/2n5/8/5nq1/P4NN1/1PQP1PPP/R1B2RK1 b - - 0 13,Kh8,259,230,-29,1
r1b2r1k/ppp1bppB/2n5/8/5nq1/P4NN1/1PQP1PPP/R1B2RK1 w - - 1 14,Bf5,234,-488,-722,0
r1b2r1k/ppp1bpp1/2n5/5B2/5nq1/P4NN1/1PQP1PPP/R1B2RK1 b - - 2 14,Bxf5,-520,-491,29,1
r4r1k/ppp1bpp1/2n5/5b2/5nq1/P4NN1/1PQP1PPP/R1B2RK1 w - - 0 15,Qxf5,-483,-611,-128,0
r4r1k/ppp1bpp1/2n5/5Q2/5nq1/P4NN1/1P1P1PPP/R1B2RK1 b - - 0 15,Ne2+,-560,-556,4,1
r4r1k/ppp1bpp1/2n5/5Q2/6q1/P4NN1/1P1PnPPP/R1B2RK1 w - - 1 16,Kh1,-553,-635,-82,1
r4r1k/ppp1bpp1/2n5/5Q2/6q1/P4NN1/1P1PnPPP/R1B2R1K b - - 2 16,Nxg3+,-637,-683,-46,1
r4r1k/ppp1bpp1/2n5/5Q2/6q1/P4Nn1/1P1P1PPP/R1B2R1K w - - 0 17,fxg3,-637,-687,-50,1
r4r1k/ppp1bpp1/2n5/5Q2/6q1/P4NP1/1P1P2PP/R1B2R1K b - - 0 17,Qxf5,-683,-674,9,1
r4r1k/ppp1bpp1/2n5/5q2/8/P4NP1/1P1P2PP/R1B2R1K w - - 0 18,d4,-654,-696,-42,1
r4r1k/ppp1bpp1/2n5/5q2/3P4/P4NP1/1P4PP/R1B2R1K b - - 0 18,Rad8,-687,-651,36,1
3r1r1k/ppp1bpp1/2n5/5q2/3P4/P4NP1/1P4PP/R1B2R1K w - - 1 19,Be3,-667,-668,-1,1
3r1r1k/ppp1bpp1/2n5/5q2/3P4/P3BNP1/1P4PP/R4R1K b - - 2 19,Bf6,-675,-596,79,1
3r1r1k/ppp2pp1/2n2b2/5q2/3P4/P3BNP1/1P4PP/R4R1K w - - 3 20,Ne5,-577,-571,6,1
3r1r1k/ppp2pp1/2n2b2/4Nq2/3P4/P3B1P1/1P4PP/R4R1K b - - 4 20,Qe4,-612,-633,-21,1
3r1r1k/ppp2pp1/2n2b2/4N3/3Pq3/P3B1P1/1P4PP/R4R1K w - - 5 21,Nxc6,-600,-656,-56,1
3r1r1k/ppp2pp1/2N2b2/8/3Pq3/P3B1P1/1P4PP/R4R1K b - - 0 21,Qxc6,-665,-656,9,1
3r1r1k/ppp2pp1/2q2b2/8/3P4/P3B1P1/1P4PP/R4R1K w - - 0 22,Rac1,-659,-667,-8,1
3r1r1k/ppp2pp1/2q2b2/8/3P4/P3B1P1/1P4PP/2R2R1K b - - 1 22,Qb6,-764,-647,117,1
3r1r1k/ppp2pp1/1q3b2/8/3P4/P3B1P1/1P4PP/2R2R1K w - - 2 23,b4,-662,-665,-3,1
3r1r1k/ppp2pp1/1q3b2/8/1P1P4/P3B1P1/6PP/2R2R1K b - - 0 23,Bxd4,-697,-678,19,1
3r1r1k/ppp2pp1/1q6/8/1P1b4/P3B1P1/6PP/2R2R1K w - - 0 24,Bxd4,-668,-683,-15,1
3r1r1k/ppp2pp1/1q6/8/1P1B4/P5P1/6PP/2R2R1K b - - 0 24,Qxd4,-659,-706,-47,1
3r1r1k/ppp2pp1/8/8/1P1q4/P5P1/6PP/2R2R1K w - - 0 25,h3,-703,-697,6,1
3r1r1k/ppp2pp1/8/8/1P1q4/P5PP/6P1/2R2R1K b - - 0 25,Qe5,-636,-615,21,1
3r1r1k/ppp2pp1/8/4q3/1P6/P5PP/6P1/2R2R1K w - - 1 26,Kh2,-630,-607,23,1
3r1r1k/ppp2pp1/8/4q3/1P6/P5PP/6PK/2R2R2 b - - 2 26,Rfe8,-630,-584,46,1
3rr2k/ppp2pp1/8/4q3/1P6/P5PP/6PK/2R2R2 w - - 3 27,Rf2,-580,-688,-108,0
3rr2k/ppp2pp1/8/4q3/1P6/P5PP/5RPK/2R5 b - - 4 27,Rd3,-712,-643,69,1
4r2k/ppp2pp1/8/4q3/1P6/P2r2PP/5RPK/2R5 w - - 5 28,Rcf1,-648,-758,-110,0
4r2k/ppp2pp1/8/4q3/1P6/P2r2PP/5RPK/5R2 b - - 6 28,Qxg3+,-743,-789,-46,1
4r2k/ppp2pp1/8/8/1P6/P2r2qP/5RPK/5R2 w - - 0 29,Kg1,-785,-810,-25,1
4r2k/ppp2pp1/8/8/1P6/P2r2qP/5RP1/5RK1 b - - 1 29,f6,-753,-705,48,1
rnbqkbnr/pppppppp/8/8/8/8/PPPPPPPP/RNBQKBNR w KQkq - 0 1,c3,27,3,-24,1
rnbqkbnr/pppppppp/8/8/8/2P5/PP1PPPPP/RNBQKBNR b KQkq - 0 1,d5,1,12,11,1
rnbqkbnr/ppp1pppp/8/3p4/8/2P5/PP1PPPPP/RNBQKBNR w KQkq - 0 2,b4,17,-117,-134,0
rnbqkbnr/ppp1pppp/8/3p4/1P6/2P5/P2PPPPP/RNBQKBNR b KQkq - 0 2,e5,-94,-90,4,1
rnbqkbnr/ppp2ppp/8/3pp3/1P6/2P5/P2PPPPP/RNBQKBNR w KQkq - 0 3,d4,-87,-127,-40,1
rnbqkbnr/ppp2ppp/8/3pp3/1P1P4/2P5/P3PPPP/RNBQKBNR b KQkq - 0 3,e4,-112,-103,9,1
rnbqkbnr/ppp2ppp/8/3p4/1P1Pp3/2P5/P3PPPP/RNBQKBNR w KQkq - 0 4,Bf4,-90,-85,5,1
rnbqkbnr/ppp2ppp/8/3p4/1P1PpB2/2P5/P3PPPP/RN1QKBNR b KQkq - 1 4,f6,-86,23,109,1
rnbqkbnr/ppp3pp/5p2/3p4/1P1PpB2/2P5/P3PPPP/RN1QKBNR w KQkq - 0 5,e3,32,24,-8,1
rnbqkbnr/ppp3pp/5p2/3p4/1P1PpB2/2P1P3/P4PPP/RN1QKBNR b KQkq - 0 5,h5,18,58,40,1
rnbqkbnr/ppp3p1/5p2/3p3p/1P1PpB2/2P1P3/P4PPP/RN1QKBNR w KQkq - 0 6,h4,65,61,-4,1
rnbqkbnr/ppp3p1/5p2/3p3p/1P1PpB1P/2P1P3/P4PP1/RN1QKBNR b KQkq - 0 6,g6,55,87,32,1
rnbqkbnr/ppp5/5pp1/3p3p/1P1PpB1P/2P1P3/P4PP1/RN1QKBNR w KQkq - 0 7,Nh3,89,32,-57,1
rnbqkbnr/ppp5/5pp1/3p3p/1P1PpB1P/2P1P2N/P4PP1/RN1QKB1R b KQkq - 1 7,Be7,30,76,46,1
rnbqk1nr/ppp1b3/5pp1/3p3p/1P1PpB1P/2P1P2N/P4PP1/RN1QKB1R w KQkq - 2 8,Qe2,79,4,-75,1
rnbqk1nr/ppp1b3/5pp1/3p3p/1P1PpB1P/2P1P2N/P3QPP1/RN2KB1R b KQkq - 3 8,c6,24,19,-5,1
rnbqk1nr/pp2b3/2p2pp1/3p3p/1P1PpB1P/2P1P2N/P3QPP1/RN2KB1R w KQkq - 0 9,b5,12,-17,-29,1
rnbqk1nr/pp2b3/2p2pp1/1P1p3p/3PpB1P/2P1P2N/P3QPP1/RN2KB1R b KQkq - 0 9,Bd7,-5,72,77,1
rn1qk1nr/pp1bb3/2p2pp1/1P1p3p/3PpB1P/2P1P2N/P3QPP1/RN2KB1R w KQkq - 1 10,a4,70,41,-29,1
rn1qk1nr/pp1bb3/2p2pp1/1P1p3p/P2PpB1P/2P1P2N/4QPP1/RN2KB1R b KQkq - 0 10,Qc8,46,135,89,1
rnq1k1nr/pp1bb3/2p2pp1/1P1p3p/P2PpB1P/2P1P2N/4QPP1/RN2KB1R w KQkq - 1 11,Bxb8,128,-74,-202,0
rBq1k1nr/pp1bb3/2p2pp1/1P1p3p/P2Pp2P/2P1P2N/4QPP1/RN2KB1R b KQkq - 0 11,Qxb8,-87,-70,17,1
rq2k1nr/pp1bb3/2p2pp1/1P1p3p/P2Pp2P/2P1P2N/4QPP1/RN2KB1R w KQkq - 0 12,Nf4,-77,-80,-3,1
rq2k1nr/pp1bb3/2p2pp1/1P1p3p/P2PpN1P/2P1P3/4QPP1/RN2KB1R b KQkq - 1 12,Bg4,-85,-31,54,1
rq2k1nr/pp2b3/2p2pp1/1P1p3p/P2PpNbP/2P1P3/4QPP1/RN2KB1R w KQkq - 2 13,f3,-27,-22,5,1
rq2k1nr/pp2b3/2p2pp1/1P1p3p/P2PpNbP/2P1PP2/4Q1P1/RN2KB1R b KQkq - 0 13,exf3,-22,-27,-5,1
rq2k1nr/pp2b3/2p2pp1/1P1p3p/P2P1NbP/2P1Pp2/4Q1P1/RN2KB1R w KQkq - 0 14,gxf3,-24,-34,-10,1
rq2k1nr/pp2b3/2p2pp1/1P1p3p/P2P1NbP/2P1PP2/4Q3/RN2KB1R b KQkq - 0 14,Bf5,-35,-44,-9,1
rq2k1nr/pp2b3/2p2pp1/1P1p1b1p/P2P1N1P/2P1PP2/4Q3/RN2KB1R w KQkq - 1 15,e4,-41,-123,-82,1
rq2k1nr/pp2b3/2p2pp1/1P1p1b1p/P2PPN1P/2P2P2/4Q3/RN2KB1R b KQkq - 0 15,dxe4,-111,-31,80,1
rq2k1nr/pp2b3/2p2pp1/1P3b1p/P2PpN1P/2P2P2/4Q3/RN2KB1R w KQkq - 0 16,fxe4,-32,-56,-24,1
rq2k1nr/pp2b3/2p2pp1/1P3b1p/P2PPN1P/2P5/4Q3/RN2KB1R b KQkq - 0 16,Qxf4,-57,-59,-2,1
r3k1nr/pp2b3/2p2pp1/1P3b1p/P2PPq1P/2P5/4Q3/RN2KB1R w KQkq - 0 17,exf5,-74,-70,4,1
r3k1nr/pp2b3/2p2pp1/1P3P1p/P2P1q1P/2P5/4Q3/RN2KB1R b KQkq - 0 17,Qxf5,-81,-33,48,1
r3k1nr/pp2b3/2p2pp1/1P3q1p/P2P3P/2P5/4Q3/RN2KB1R w KQkq - 0 18,Bh3,-37,-27,10,1
r3k1nr/pp2b3/2p2pp1/1P3q1p/P2P3P/2P4B/4Q3/RN2K2R b KQkq - 1 18,Qd5,-24,52,76,1
r3k1nr/pp2b3/2p2pp1/1P1q3p/P2P3P/2P4B/4Q3/RN2K2R w KQkq - 2 19,Rf1,18,-117,-135,0
r3k1nr/pp2b3/2p2pp1/1P1q3p/P2P3P/2P4B/4Q3/RN2KR2 b Qkq - 3 19,f5,-106,-123,-17,1
r3k1nr/pp2b3/2p3p1/1P1q1p1p/P2P3P/2P4B/4Q3/RN2KR2 w Qkq - 0 20,Bg2,-131,-132,-1,1
r3k1nr/pp2b3/2p3p1/1P1q1p1p/P2P3P/2P5/4Q1B1/RN2KR2 b Qkq - 1 20,Qd6,-153,-91,62,1
r3k1nr/pp2b3/2pq2p1/1P3p1p/P2P3P/2P5/4Q1B1/RN2KR2 w Qkq - 2 21,bxc6,-99,-92,7,1
r3k1nr/pp2b3/2Pq2p1/5p1p/P2P3P/2P5/4Q1B1/RN2KR2 b Qkq - 0 21,bxc6,-102,-78,24,1
r3k1nr/p3b3/2pq2p1/5p1p/P2P3P/2P5/4Q1B1/RN2KR2 w Qkq - 0 22,Nd2,-112,-104,8,1
r3k1nr/p3b3/2pq2p1/5p1p/P2P3P/2P5/3NQ1B1/R3KR2 b Qkq - 1 22,Qg3+,-102,0,102,1
r3k1nr/p3b3/2p3p1/5p1p/P2P3P/2P3q1/3NQ1B1/R3KR2 w Qkq - 2 23,Rf2,0,-223,-223,0
r3k1nr/p3b3/2p3p1/5p1p/P2P3P/2P3q1/3NQRB1/R3K3 b Qkq - 3 23,Rc8,-221,0,221,1
2r1k1nr/p3b3/2p3p1/5p1p/P2P3P/2P3q1/3NQRB1/R3K3 w Qk - 4 24,Qe6,0,0,0,1
2r1k1nr/p3b3/2p1Q1p1/5p1p/P2P3P/2P3q1/3N1RB1/R3K3 b Qk - 5 24,Qd6,2,423,421,1
2r1k1nr/p3b3/2pqQ1p1/5p1p/P2P3P/2P5/3N1RB1/R3K3 w Qk - 6 25,Qxc8+,466,467,1,1
2Q1k1nr/p3b3/2pq2p1/5p1p/P2P3P/2P5/3N1RB1/R3K3 b Qk - 0 25,Kf7,440,462,22,1
2Q3nr/p3bk2/2pq2p1/5p1p/P2P3P/2P5/3N1RB1/R3K3 w Q - 1 26,Nc4,477,432,-45,1
2Q3nr/p3bk2/2pq2p1/5p1p/P1NP3P/2P5/5RB1/R3K3 b Q - 2 26,Qg3,444,395,-49,1
2Q3nr/p3bk2/2p3p1/5p1p/P1NP3P/2P3q1/5RB1/R3K3 w Q - 3 27,Ne5+,482,499,17,1
2Q3nr/p3bk2/2p3p1/4Np1p/P2P3P/2P3q1/5RB1/R3K3 b Q - 4 27,Kg7,485,457,-28,1
2Q3nr/p3b1k1/2p3p1/4Np1p/P2P3P/2P3q1/5RB1/R3K3 w Q - 5 28,Nf3,493,162,-331,0
2Q3nr/p3b1k1/2p3p1/5p1p/P2P3P/2P2Nq1/5RB1/R3K3 b Q - 6 28,Bxh4,164,182,18,1
2Q3nr/p5k1/2p3p1/5p1p/P2P3b/2P2Nq1/5RB1/R3K3 w Q - 0 29,Qd7+,202,8,-194,0
6nr/p2Q2k1/2p3p1/5p1p/P2P3b/2P2Nq1/5RB1/R3K3 b Q - 1 29,Kh6,0,0,0,1
6nr/p2Q4/2p3pk/5p1p/P2P3b/2P2Nq1/5RB1/R3K3 w Q - 2 30,Nxh4,0,0,0,1
6nr/p2Q4/2p3pk/5p1p/P2P3N/2P3q1/5RB1/R3K3 b Q - 0 30,Qxc3+,0,0,0,1
6nr/p2Q4/2p3pk/5p1p/P2P3N/2q5/5RB1/R3K3 w Q - 0 31,Ke2,0,-183,-183,0
6nr/p2Q4/2p3pk/5p1p/P2P3N/2q5/4KRB1/R7 b - - 1 31,Nf6,-108,-108,0,1
7r/p2Q4/2p2npk/5p1p/P2P3N/2q5/4KRB1/R7 w - - 2 32,Nxf5+,-101,-269,-168,0
7r/p2Q4/2p2npk/5N1p/P2P4/2q5/4KRB1/R7 b - - 0 32,gxf5,-259,-242,17,1
7r/p2Q4/2p2n1k/5p1p/P2P4/2q5/4KRB1/R7 w - - 0 33,Qxf5,-281,-647,-366,0
7r/p7/2p2n1k/5Q1p/P2P4/2q5/4KRB1/R7 b - - 0 33,Re8+,-535,-526,9,1
4r3/p7/2p2n1k/5Q1p/P2P4/2q5/4KRB1/R7 w - - 1 34,Kd1,-565,-9999,-9434,0
4r3/p7/2p2n1k/5Q1p/P2P4/2q5/5RB1/R2K4 b - - 2 34,Qxa1+,-9999,-249,9750,1
4r3/p7/2p2n1k/5Q1p/P2P4/8/5RB1/q2K4 w - - 0 35,Kc2,-287,-277,10,1
4r3/p7/2p2n1k/5Q1p/P2P4/8/2K2RB1/q7 b - - 1 35,Qxa4+,-290,-300,-10,1
rnbqkbnr/pppppppp/8/8/8/8/PPPPPPPP/RNBQKBNR w KQkq - 0 1,e4,25,25,0,1
rnbqkbnr/pppppppp/8/8/4P3/8/PPPP1PPP/RNBQKBNR b KQkq - 0 1,e5,35,35,0,1
rnbqkbnr/pppp1ppp/8/4p3/4P3/8/PPPP1PPP/RNBQKBNR w KQkq - 0 2,Bc4,38,17,-21,1
rnbqkbnr/pppp1ppp/8/4p3/2B1P3/8/PPPP1PPP/RNBQK1NR b KQkq - 1 2,Nc6,7,40,33,1
r1bqkbnr/pppp1ppp/2n5/4p3/2B1P3/8/PPPP1PPP/RNBQK1NR w KQkq - 2 3,d3,24,14,-10,1
r1bqkbnr/pppp1ppp/2n5/4p3/2B1P3/3P4/PPP2PPP/RNBQK1NR b KQkq - 0 3,Bb4+,7,42,35,1
r1bqk1nr/pppp1ppp/2n5/4p3/1bB1P3/3P4/PPP2PPP/RNBQK1NR w KQkq - 1 4,c3,44,47,3,1
r1bqk1nr/pppp1ppp/2n5/4p3/1bB1P3/2PP4/PP3PPP/RNBQK1NR b KQkq - 0 4,Ba5,64,42,-22,1
r1bqk1nr/pppp1ppp/2n5/b3p3/2B1P3/2PP4/PP3PPP/RNBQK1NR w KQkq - 1 5,Bxf7+,36,-260,-296,0
r1bqk1nr/pppp1Bpp/2n5/b3p3/4P3/2PP4/PP3PPP/RNBQK1NR b KQkq - 0 5,Kxf7,-251,-291,-40,1
r1bq2nr/pppp1kpp/2n5/b3p3/4P3/2PP4/PP3PPP/RNBQK1NR w KQ - 0 6,Nh3,-281,-379,-98,1
r1bq2nr/pppp1kpp/2n5/b3p3/4P3/2PP3N/PP3PPP/RNBQK2R b KQ - 1 6,h6,-384,-346,38,1
r1bq2nr/pppp1kp1/2n4p/b3p3/4P3/2PP3N/PP3PPP/RNBQK2R w KQ - 0 7,f4,-327,-396,-69,1
r1bq2nr/pppp1kp1/2n4p/b3p3/4PP2/2PP3N/PP4PP/RNBQK2R b KQ - 0 7,Nf6,-398,-188,210,1
r1bq3r/pppp1kp1/2n2n1p/b3p3/4PP2/2PP3N/PP4PP/RNBQK2R w KQ - 1 8,fxe5,-165,-189,-24,1
r1bq3r/pppp1kp1/2n2n1p/b3P3/4P3/2PP3N/PP4PP/RNBQK2R b KQ - 0 8,Nxe5,-192,-244,-52,1
r1bq3r/pppp1kp1/5n1p/b3n3/4P3/2PP3N/PP4PP/RNBQK2R w KQ - 0 9,O-O,-264,-282,-18,1
r1bq3r/pppp1kp1/5n1p/b3n3/4P3/2PP3N/PP4PP/RNBQ1RK1 b - - 1 9,d6,-268,-258,10,1
r1bq3r/ppp2kp1/3p1n1p/b3n3/4P3/2PP3N/PP4PP/RNBQ1RK1 w - - 0 10,Bf4,-270,-409,-139,0
r1bq3r/ppp2kp1/3p1n1p/b3n3/4PB2/2PP3N/PP4PP/RN1Q1RK1 b - - 1 10,Bb6+,-408,-357,51,1
r1bq3r/ppp2kp1/1b1p1n1p/4n3/4PB2/2PP3N/PP4PP/RN1Q1RK1 w - - 2 11,d4,-358,-365,-7,1
r1bq3r/ppp2kp1/1b1p1n1p/4n3/3PPB2/2P4N/PP4PP/RN1Q1RK1 b - - 0 11,Ng6,-344,-337,7,1
r1bq3r/ppp2kp1/1b1p1nnp/8/3PPB2/2P4N/PP4PP/RN1Q1RK1 w - - 1 12,e5,-349,-383,-34,1
r1bq3r/ppp2kp1/1b1p1nnp/4P3/3P1B2/2P4N/PP4PP/RN1Q1RK1 b - - 0 12,dxe5,-407,-417,-10,1
r1bq3r/ppp2kp1/1b3nnp/4p3/3P1B2/2P4N/PP4PP/RN1Q1RK1 w - - 0 13,Qb3+,-371,-586,-215,0
r1bq3r/ppp2kp1/1b3nnp/4p3/3P1B2/1QP4N/PP4PP/RN3RK1 b - - 1 13,Be6,-562,-540,22,1
r2q3r/ppp2kp1/1b2bnnp/4p3/3P1B2/1QP4N/PP4PP/RN3RK1 w - - 2 14,Qd1,-540,-595,-55,1
r2q3r/ppp2kp1/1b2bnnp/4p3/3P1B2/2P4N/PP4PP/RN1Q1RK1 b - - 3 14,exf4,-584,-569,15,1
r2q3r/ppp2kp1/1b2bnnp/8/3P1p2/2P4N/PP4PP/RN1Q1RK1 w - - 0 15,Nxf4,-589,-586,3,1
r2q3r/ppp2kp1/1b2bnnp/8/3P1N2/2P5/PP4PP/RN1Q1RK1 b - - 0 15,Ne7,-576,-380,196,1
r2q3r/ppp1nkp1/1b2bn1p/8/3P1N2/2P5/PP4PP/RN1Q1RK1 w - - 1 16,Nd2,-399,-411,-12,1
r2q3r/ppp1nkp1/1b2bn1p/8/3P1N2/2P5/PP1N2PP/R2Q1RK1 b - - 2 16,Bg4,-410,-295,115,1
r2q3r/ppp1nkp1/1b3n1p/8/3P1Nb1/2P5/PP1N2PP/R2Q1RK1 w - - 3 17,Qc2,-273,-375,-102,0
r2q3r/ppp1nkp1/1b3n1p/8/3P1Nb1/2P5/PPQN2PP/R4RK1 b - - 4 17,Qd7,-393,-252,141,1
r6r/pppqnkp1/1b3n1p/8/3P1Nb1/2P5/PPQN2PP/R4RK1 w - - 5 18,Qg6+,-261,-713,-452,0
r6r/pppqnkp1/1b3nQp/8/3P1Nb1/2P5/PP1N2PP/R4RK1 b - - 6 18,Nxg6,-768,-723,45,1
r6r/pppq1kp1/1b3nnp/8/3P1Nb1/2P5/PP1N2PP/R4RK1 w - - 0 19,Nxg6,-763,-832,-69,1
r6r/pppq1kp1/1b3nNp/8/3P2b1/2P5/PP1N2PP/R4RK1 b - - 0 19,Kxg6,-791,-811,-20,1
rnbqkbnr/pppppppp/8/8/8/8/PPPPPPPP/RNBQKBNR w KQkq - 0 1,e4,29,30,1,1
rnbqkbnr/pppppppp/8/8/4P3/8/PPPP1PPP/RNBQKBNR b KQkq - 0 1,f6,34,146,112,1
rnbqkbnr/ppppp1pp/5p2/8/4P3/8/PPPP1PPP/RNBQKBNR w KQkq - 0 2,d4,144,142,-2,1
rnbqkbnr/ppppp1pp/5p2/8/3PP3/8/PPP2PPP/RNBQKBNR b KQkq - 0 2,e5,148,160,12,1
rnbqkbnr/pppp2pp/5p2/4p3/3PP3/8/PPP2PPP/RNBQKBNR w KQkq - 0 3,c3,155,65,-90,1
rnbqkbnr/pppp2pp/5p2/4p3/3PP3/2P5/PP3PPP/RNBQKBNR b KQkq - 0 3,h5,53,210,157,1
rnbqkbnr/pppp2p1/5p2/4p2p/3PP3/2P5/PP3PPP/RNBQKBNR w KQkq - 0 4,f3,200,70,-130,0
rnbqkbnr/pppp2p1/5p2/4p2p/3PP3/2P2P2/PP4PP/RNBQKBNR b KQkq - 0 4,d6,62,123,61,1
rnbqkbnr/ppp3p1/3p1p2/4p2p/3PP3/2P2P2/PP4PP/RNBQKBNR w KQkq - 0 5,g4,113,-152,-265,0
rnbqkbnr/ppp3p1/3p1p2/4p2p/3PP1P1/2P2P2/PP5P/RNBQKBNR b KQkq - 0 5,h4,-114,129,243,1
rnbqkbnr/ppp3p1/3p1p2/4p3/3PP1Pp/2P2P2/PP5P/RNBQKBNR w KQkq - 0 6,c4,124,49,-75,1
rnbqkbnr/ppp3p1/3p1p2/4p3/2PPP1Pp/5P2/PP5P/RNBQKBNR b KQkq - 0 6,Nc6,40,79,39,1
r1bqkbnr/ppp3p1/2np1p2/4p3/2PPP1Pp/5P2/PP5P/RNBQKBNR w KQkq - 1 7,Be3,95,-16,-111,0
r1bqkbnr/ppp3p1/2np1p2/4p3/2PPP1Pp/4BP2/PP5P/RN1QKBNR b KQkq - 2 7,exd4,-30,18,48,1
r1bqkbnr/ppp3p1/2np1p2/8/2PpP1Pp/4BP2/PP5P/RN1QKBNR w KQkq - 0 8,Bxd4,-7,-7,0,1
r1bqkbnr/ppp3p1/2np1p2/8/2PBP1Pp/5P2/PP5P/RN1QKBNR b KQkq - 0 8,b6,-16,108,124,1
r1bqkbnr/p1p3p1/1pnp1p2/8/2PBP1Pp/5P2/PP5P/RN1QKBNR w KQkq - 0 9,Nd2,81,-476,-557,0
r1bqkbnr/p1p3p1/1pnp1p2/8/2PBP1Pp/5P2/PP1N3P/R2QKBNR b KQkq - 1 9,Nxd4,-475,-441,34,1
r1bqkbnr/p1p3p1/1p1p1p2/8/2PnP1Pp/5P2/PP1N3P/R2QKBNR w KQkq - 0 10,Rc1,-450,-498,-48,1
r1bqkbnr/p1p3p1/1p1p1p2/8/2PnP1Pp/5P2/PP1N3P/2RQKBNR b Kkq - 1 10,Ba6,-511,-82,429,1
r2qkbnr/p1p3p1/bp1p1p2/8/2PnP1Pp/5P2/PP1N3P/2RQKBNR w Kkq - 2 11,Ne2,-79,-436,-357,0
r2qkbnr/p1p3p1/bp1p1p2/8/2PnP1Pp/5P2/PP1NN2P/2RQKB1R b Kkq - 3 11,Ne6,-399,-75,324,1
r2qkbnr/p1p3p1/bp1pnp2/8/2P1P1Pp/5P2/PP1NN2P/2RQKB1R w Kkq - 4 12,Rc3,-71,-367,-296,0
r2qkbnr/p1p3p1/bp1pnp2/8/2P1P1Pp/2R2P2/PP1NN2P/3QKB1R b Kkq - 5 12,g6,-350,-114,236,1
r2qkbnr/p1p5/bp1pnpp1/8/2P1P1Pp/2R2P2/PP1NN2P/3QKB1R w Kkq - 0 13,Ra3,-117,-443,-326,0
r2qkbnr/p1p5/bp1pnpp1/8/2P1P1Pp/R4P2/PP1NN2P/3QKB1R b Kkq - 1 13,Bb7,-396,-392,4,1
r2qkbnr/pbp5/1p1pnpp1/8/2P1P1Pp/R4P2/PP1NN2P/3QKB1R w Kkq - 2 14,Qb3,-395,-532,-137,0
r2qkbnr/pbp5/1p1pnpp1/8/2P1P1Pp/RQ3P2/PP1NN2P/4KB1R b Kkq - 3 14,Bh6,-501,-487,14,1
r2qk1nr/pbp5/1p1pnppb/8/2P1P1Pp/RQ3P2/PP1NN2P/4KB1R w Kkq - 4 15,Qc2,-429,-500,-71,1
r2qk1nr/pbp5/1p1pnppb/8/2P1P1Pp/R4P2/PPQNN2P/4KB1R b Kkq - 5 15,c5,-512,-417,95,1
r2qk1nr/pb6/1p1pnppb/2p5/2P1P1Pp/R4P2/PPQNN2P/4KB1R w Kkq - 0 16,b3,-441,-620,-179,0
r2qk1nr/pb6/1p1pnppb/2p5/2P1P1Pp/RP3P2/P1QNN2P/4KB1R b Kkq - 0 16,Bg5,-546,-415,131,1
r2qk1nr/pb6/1p1pnpp1/2p3b1/2P1P1Pp/RP3P2/P1QNN2P/4KB1R w Kkq - 1 17,f4,-420,-453,-33,1
r2qk1nr/pb6/1p1pnpp1/2p3b1/2P1PPPp/RP6/P1QNN2P/4KB1R b Kkq - 0 17,Nxf4,-447,-414,33,1
r2qk1nr/pb6/1p1p1pp1/2p3b1/2P1PnPp/RP6/P1QNN2P/4KB1R w Kkq - 0 18,Nxf4,-406,-446,-40,1
r2qk1nr/pb6/1p1p1pp1/2p3b1/2P1PNPp/RP6/P1QN3P/4KB1R b Kkq - 0 18,Bxf4,-435,-424,11,1
r2qk1nr/pb6/1p1p1pp1/2p5/2P1PbPp/RP6/P1QN3P/4KB1R w Kkq - 0 19,Kd1,-453,-493,-40,1
r2qk1nr/pb6/1p1p1pp1/2p5/2P1PbPp/RP6/P1QN3P/3K1B1R b kq - 1 19,Ne7,-506,-466,40,1
r2qk2r/pb2n3/1p1p1pp1/2p5/2P1PbPp/RP6/P1QN3P/3K1B1R w kq - 2 20,Bg2,-501,-554,-53,1
r2qk2r/pb2n3/1p1p1pp1/2p5/2P1PbPp/RP6/P1QN2BP/3K3R b kq - 3 20,a5,-580,-511,69,1
r2qk2r/1b2n3/1p1p1pp1/p1p5/2P1PbPp/RP6/P1QN2BP/3K3R w kq - 0 21,e5,-476,-660,-184,0
r2qk2r/1b2n3/1p1p1pp1/p1p1P3/2P2bPp/RP6/P1QN2BP/3K3R b kq - 0 21,Bxe5,-695,-314,381,1
r2qk2r/1b2n3/1p1p1pp1/p1p1b3/2P3Pp/RP6/P1QN2BP/3K3R w kq - 0 22,Bxb7,-283,-281,2,1
r2qk2r/1B2n3/1p1p1pp1/p1p1b3/2P3Pp/RP6/P1QN3P/3K3R b kq - 0 22,Bf4,-288,-128,160,1
r2qk2r/1B2n3/1p1p1pp1/p1p5/2P2bPp/RP6/P1QN3P/3K3R w kq - 1 23,Rf1,-104,-193,-89,1
r2qk2r/1B2n3/1p1p1pp1/p1p5/2P2bPp/RP6/P1QN3P/3K1R2 b kq - 2 23,Bxh2,-190,0,190,1
r2qk2r/1B2n3/1p1p1pp1/p1p5/2P3Pp/RP6/P1QN3b/3K1R2 w kq - 0 24,Rxf6,0,-163,-163,0
r2qk2r/1B2n3/1p1p1Rp1/p1p5/2P3Pp/RP6/P1QN3b/3K4 b kq - 0 24,g5,-182,106,288,1
r2qk2r/1B2n3/1p1p1R2/p1p3p1/2P3Pp/RP6/P1QN3b/3K4 w kq - 0 25,Rf5,34,-251,-285,0
r2qk2r/1B2n3/1p1p4/p1p2Rp1/2P3Pp/RP6/P1QN3b/3K4 b kq - 1 25,Nxf5,-210,82,292,1
r2qk2r/1B6/1p1p4/p1p2np1/2P3Pp/RP6/P1QN3b/3K4 w kq - 0 26,Qxf5,0,0,0,1
r2qk2r/1B6/1p1p4/p1p2Qp1/2P3Pp/RP6/P2N3b/3K4 b kq - 0 26,Rg8,0,449,449,1
r2qk1r1/1B6/1p1p4/p1p2Qp1/2P3Pp/RP6/P2N3b/3K4 w q - 1 27,Qh7,467,338,-129,0
r2qk1r1/1B5Q/1p1p4/p1p3p1/2P3Pp/RP6/P2N3b/3K4 b q - 2 27,Kf8,346,409,63,1
r2q1kr1/1B5Q/1p1p4/p1p3p1/2P3Pp/RP6/P2N3b/3K4 w - - 3 28,Qxh4,377,-718,-1095,0
r2q1kr1/1B6/1p1p4/p1p3p1/2P3PQ/RP6/P2N3b/3K4 b - - 0 28,gxh4,-701,-685,16,1
r2q1kr1/1B6/1p1p4/p1p5/2P3Pp/RP6/P2N3b/3K4 w - - 0 29,Nf3,-695,-841,-146,0
r2q1kr1/1B6/1p1p4/p1p5/2P3Pp/RP3N2/P6b/3K4 b - - 1 29,h3,-770,-730,40,1
r2q1kr1/1B6/1p1p4/p1p5/2P3P1/RP3N1p/P6b/3K4 w - - 0 30,Nxh2,-714,-697,17,1
r2q1kr1/1B6/1p1p4/p1p5/2P3P1/RP5p/P6N/3K4 b - - 0 30,Qg5,-700,-649,51,1
r4kr1/1B6/1p1p4/p1p3q1/2P3P1/RP5p/P6N/3K4 w - - 1 31,b4,-615,-613,2,1
r4kr1/1B6/1p1p4/p1p3q1/1PP3P1/R6p/P6N/3K4 b - - 0 31,Re8,-637,-640,-3,1
4rkr1/1B6/1p1p4/p1p3q1/1PP3P1/R6p/P6N/3K4 w - - 1 32,bxc5,-657,-669,-12,1
4rkr1/1B6/1p1p4/p1P3q1/2P3P1/R6p/P6N/3K4 b - - 0 32,Qf4,-643,-574,69,1
4rkr1/1B6/1p1p4/p1P5/2P2qP1/R6p/P6N/3K4 w - - 1 33,Rxh3,-581,-9995,-9414,0
4rkr1/1B6/1p1p4/p1P5/2P2qP1/7R/P6N/3K4 b - - 0 33,Qd4+,-9995,-9996,-1,1
4rkr1/1B6/1p1p4/p1P5/2Pq2P1/7R/P6N/3K4 w - - 1 34,Kc2,-9996,-9997,-1,1
4rkr1/1B6/1p1p4/p1P5/2Pq2P1/7R/P1K4N/8 b - - 2 34,Re2+,-9997,-9998,-1,1
5kr1/1B6/1p1p4/p1P5/2Pq2P1/7R/P1K1r2N/8 w - - 3 35,Kb3,-9998,-9998,0,1
5kr1/1B6/1p1p4/p1P5/2Pq2P1/1K5R/P3r2N/8 b - - 4 35,Qxc5,-9998,-892,9106,1
5kr1/1B6/1p1p4/p1q5/2P3P1/1K5R/P3r2N/8 w - - 0 36,Rf3+,-963,-1063,-100,1
5kr1/1B6/1p1p4/p1q5/2P3P1/1K3R2/P3r2N/8 b - - 1 36,Ke7,-1092,-9992,-8900,0
6r1/1B2k3/1p1p4/p1q5/2P3P1/1K3R2/P3r2N/8 w - - 2 37,a4,-9992,-9999,-7,1
6r1/1B2k3/1p1p4/p1q5/P1P3P1/1K3R2/4r2N/8 b - - 0 37,Qb4#,-9999,-10000,-1,1
rnbqkbnr/pppppppp/8/8/8/8/PPPPPPPP/RNBQKBNR w KQkq - 0 1,d4,31,22,-9,1
rnbqkbnr/pppppppp/8/8/3P4/8/PPP1PPPP/RNBQKBNR b KQkq - 0 1,g6,27,68,41,1
rnbqkbnr/pppppp1p/6p1/8/3P4/8/PPP1PPPP/RNBQKBNR w KQkq - 0 2,e3,72,22,-50,1
rnbqkbnr/pppppp1p/6p1/8/3P4/4P3/PPP2PPP/RNBQKBNR b KQkq - 0 2,Bg7,6,23,17,1
rnbqk1nr/ppppppbp/6p1/8/3P4/4P3/PPP2PPP/RNBQKBNR w KQkq - 1 3,b3,21,-27,-48,1
rnbqk1nr/ppppppbp/6p1/8/3P4/1P2P3/P1P2PPP/RNBQKBNR b KQkq - 0 3,c5,-26,-21,5,1
rnbqk1nr/pp1pppbp/6p1/2p5/3P4/1P2P3/P1P2PPP/RNBQKBNR w KQkq - 0 4,Bb2,-11,-27,-16,1
rnbqk1nr/pp1pppbp/6p1/2p5/3P4/1P2P3/PBP2PPP/RN1QKBNR b KQkq - 1 4,cxd4,-16,-15,1,1
rnbqk1nr/pp1pppbp/6p1/8/3p4/1P2P3/PBP2PPP/RN1QKBNR w KQkq - 0 5,exd4,-24,-38,-14,1
rnbqk1nr/pp1pppbp/6p1/8/3P4/1P6/PBP2PPP/RN1QKBNR b KQkq - 0 5,Nc6,-33,-13,20,1
r1bqk1nr/pp1pppbp/2n3p1/8/3P4/1P6/PBP2PPP/RN1QKBNR w KQkq - 1 6,Nf3,-8,-13,-5,1
r1bqk1nr/pp1pppbp/2n3p1/8/3P4/1P3N2/PBP2PPP/RN1QKB1R b KQkq - 2 6,d5,-11,-10,1,1
r1bqk1nr/pp2ppbp/2n3p1/3p4/3P4/1P3N2/PBP2PPP/RN1QKB1R w KQkq - 0 7,Bb5,-10,-16,-6,1
r1bqk1nr/pp2ppbp/2n3p1/1B1p4/3P4/1P3N2/PBP2PPP/RN1QK2R b KQkq - 1 7,Nf6,-22,-18,4,1
r1bqk2r/pp2ppbp/2n2np1/1B1p4/3P4/1P3N2/PBP2PPP/RN1QK2R w KQkq - 2 8,Ne5,-15,-24,-9,1
r1bqk2r/pp2ppbp/2n2np1/1B1pN3/3P4/1P6/PBP2PPP/RN1QK2R b KQkq - 3 8,Qc7,-36,-22,14,1
r1b1k2r/ppq1ppbp/2n2np1/1B1pN3/3P4/1P6/PBP2PPP/RN1QK2R w KQkq - 4 9,Nxc6,-33,-76,-43,1
r1b1k2r/ppq1ppbp/2N2np1/1B1p4/3P4/1P6/PBP2PPP/RN1QK2R b KQkq - 0 9,bxc6,-81,-89,-8,1
r1b1k2r/p1q1ppbp/2p2np1/1B1p4/3P4/1P6/PBP2PPP/RN1QK2R w KQkq - 0 10,Bd3,-76,-124,-48,1
r1b1k2r/p1q1ppbp/2p2np1/3p4/3P4/1P1B4/PBP2PPP/RN1QK2R b KQkq - 1 10,O-O,-102,-111,-9,1
r1b2rk1/p1q1ppbp/2p2np1/3p4/3P4/1P1B4/PBP2PPP/RN1QK2R w KQ - 2 11,Nd2,-119,-117,2,1
r1b2rk1/p1q1ppbp/2p2np1/3p4/3P4/1P1B4/PBPN1PPP/R2QK2R b KQ - 3 11,Bf5,-125,-31,94,1
r4rk1/p1q1ppbp/2p2np1/3p1b2/3P4/1P1B4/PBPN1PPP/R2QK2R w KQ - 4 12,Qe2,-7,-93,-86,1
r4rk1/p1q1ppbp/2p2np1/3p1b2/3P4/1P1B4/PBPNQPPP/R3K2R b KQ - 5 12,Bxd3,-74,-88,-14,1
r4rk1/p1q1ppbp/2p2np1/3p4/3P4/1P1b4/PBPNQPPP/R3K2R w KQ - 0 13,Qxd3,-69,-90,-21,1
r4rk1/p1q1ppbp/2p2np1/3p4/3P4/1P1Q4/PBPN1PPP/R3K2R b KQ - 0 13,c5,-88,-53,35,1
r4rk1/p1q1ppbp/5np1/2pp4/3P4/1P1Q4/PBPN1PPP/R3K2R w KQ - 0 14,dxc5,-49,-48,1,1
r4rk1/p1q1ppbp/5np1/2Pp4/8/1P1Q4/PBPN1PPP/R3K2R b KQ - 0 14,e5,-67,8,75,1
r4rk1/p1q2pbp/5np1/2Ppp3/8/1P1Q4/PBPN1PPP/R3K2R w KQ - 0 15,O-O-O,22,-107,-129,0
r4rk1/p1q2pbp/5np1/2Ppp3/8/1P1Q4/PBPN1PPP/2KR3R b - - 1 15,e4,-124,-20,104,1
r4rk1/p1q2pbp/5np1/2Pp4/4p3/1P1Q4/PBPN1PPP/2KR3R w - - 0 16,Qe3,-18,-36,-18,1
r4rk1/p1q2pbp/5np1/2Pp4/4p3/1P2Q3/PBPN1PPP/2KR3R b - - 1 16,Rac8,-26,-8,18,1
2r2rk1/p1q2pbp/5np1/2Pp4/4p3/1P2Q3/PBPN1PPP/2KR3R w - - 2 17,h3,-35,-45,-10,1
2r2rk1/p1q2pbp/5np1/2Pp4/4p3/1P2Q2P/PBPN1PP1/2KR3R b - - 0 17,Qxc5,-46,174,220,1
2r2rk1/p4pbp/5np1/2qp4/4p3/1P2Q2P/PBPN1PP1/2KR3R w - - 0 18,Qxc5,172,122,-50,1
2r2rk1/p4pbp/5np1/2Qp4/4p3/1P5P/PBPN1PP1/2KR3R b - - 0 18,Rxc5,88,98,10,1
5rk1/p4pbp/5np1/2rp4/4p3/1P5P/PBPN1PP1/2KR3R w - - 0 19,h4,91,-261,-352,0
5rk1/p4pbp/5np1/2rp4/4p2P/1P6/PBPN1PP1/2KR3R b - - 0 19,Ng4,-278,-172,106,1
5rk1/p4pbp/6p1/2rp4/4p1nP/1P6/PBPN1PP1/2KR3R w - - 1 20,Rdf1,-153,-297,-144,0
5rk1/p4pbp/6p1/2rp4/4p1nP/1P6/PBPN1PP1/2K2R1R b - - 2 20,e3,-275,-240,35,1
5rk1/p4pbp/6p1/2rp4/6nP/1P2p3/PBPN1PP1/2K2R1R w - - 0 21,fxe3,-313,-251,62,1
5rk1/p4pbp/6p1/2rp4/6nP/1P2P3/PBPN2P1/2K2R1R b - - 0 21,Nxe3,-254,-287,-33,1
5rk1/p4pbp/6p1/2rp4/7P/1P2n3/PBPN2P1/2K2R1R w - - 0 22,Rf2,-317,-906,-589,0
5rk1/p4pbp/6p1/2rp4/7P/1P2n3/PBPN1RP1/2K4R b - - 1 22,Rxc2+,-912,-936,-24,1
5rk1/p4pbp/6p1/3p4/7P/1P2n3/PBrN1RP1/2K4R w - - 0 23,Kb1,-968,-999,-31,1
5rk1/p4pbp/6p1/3p4/7P/1P2n3/PBrN1RP1/1K5R b - - 1 23,Rxb2+,-1024,-1091,-67,1
5rk1/p4pbp/6p1/3p4/7P/1P2n3/Pr1N1RP1/1K5R w - - 0 24,Kc1,-1027,-1101,-74,1
5rk1/p4pbp/6p1/3p4/7P/1P2n3/Pr1N1RP1/2K4R b - - 1 24,Rc2+,-1272,-1263,9,1
5rk1/p4pbp/6p1/3p4/7P/1P2n3/P1rN1RP1/2K4R w - - 2 25,Kb1,-1313,-1271,42,1
5rk1/p4pbp/6p1/3p4/7P/1P2n3/P1rN1RP1/1K5R b - - 3 25,Rfc8,-1302,-812,490,1
2r3k1/p4pbp/6p1/3p4/7P/1P2n3/P1rN1RP1/1K5R w - - 4 26,Re1,-814,-9998,-9184,0
2r3k1/p4pbp/6p1/3p4/7P/1P2n3/P1rN1RP1/1K2R3 b - - 5 26,Rb2+,-9998,-9999,-1,1
2r3k1/p4pbp/6p1/3p4/7P/1P2n3/Pr1N1RP1/1K2R3 w - - 6 27,Ka1,-9999,-9999,0,1
2r3k1/p4pbp/6p1/3p4/7P/1P2n3/Pr1N1RP1/K3R3 b - - 7 27,Nc2#,-9999,-10000,-1,1
rnbqkbnr/pppppppp/8/8/8/8/PPPPPPPP/RNBQKBNR w KQkq - 0 1,d4,33,27,-6,1
rnbqkbnr/pppppppp/8/8/3P4/8/PPP1PPPP/RNBQKBNR b KQkq - 0 1,e6,20,57,37,1
rnbqkbnr/pppp1ppp/4p3/8/3P4/8/PPP1PPPP/RNBQKBNR w KQkq - 0 2,Nf3,53,25,-28,1
rnbqkbnr/pppp1ppp/4p3/8/3P4/5N2/PPP1PPPP/RNBQKB1R b KQkq - 1 2,d5,21,26,5,1
rnbqkbnr/ppp2ppp/4p3/3p4/3P4/5N2/PPP1PPPP/RNBQKB1R w KQkq - 0 3,Bf4,23,12,-11,1
rnbqkbnr/ppp2ppp/4p3/3p4/3P1B2/5N2/PPP1PPPP/RN1QKB1R b KQkq - 1 3,Bd6,7,19,12,1
rnbqk1nr/ppp2ppp/3bp3/3p4/3P1B2/5N2/PPP1PPPP/RN1QKB1R w KQkq - 2 4,e3,14,16,2,1
rnbqk1nr/ppp2ppp/3bp3/3p4/3P1B2/4PN2/PPP2PPP/RN1QKB1R b KQkq - 0 4,Bxf4,13,22,9,1
rnbqk1nr/ppp2ppp/4p3/3p4/3P1b2/4PN2/PPP2PPP/RN1QKB1R w KQkq - 0 5,exf4,15,16,1,1
rnbqk1nr/ppp2ppp/4p3/3p4/3P1P2/5N2/PPP2PPP/RN1QKB1R b KQkq - 0 5,Nf6,13,20,7,1
rnbqk2r/ppp2ppp/4pn2/3p4/3P1P2/5N2/PPP2PPP/RN1QKB1R w KQkq - 1 6,c3,26,12,-14,1
rnbqk2r/ppp2ppp/4pn2/3p4/3P1P2/2P2N2/PP3PPP/RN1QKB1R b KQkq - 0 6,O-O,16,21,5,1
rnbq1rk1/ppp2ppp/4pn2/3p4/3P1P2/2P2N2/PP3PPP/RN1QKB1R w KQ - 1 7,Nbd2,19,19,0,1
rnbq1rk1/ppp2ppp/4pn2/3p4/3P1P2/2P2N2/PP1N1PPP/R2QKB1R b KQ - 2 7,Nbd7,13,31,18,1
r1bq1rk1/pppn1ppp/4pn2/3p4/3P1P2/2P2N2/PP1N1PPP/R2QKB1R w KQ - 3 8,Qc2,24,7,-17,1
r1bq1rk1/pppn1ppp/4pn2/3p4/3P1P2/2P2N2/PPQN1PPP/R3KB1R b KQ - 4 8,g6,4,22,18,1
r1bq1rk1/pppn1p1p/4pnp1/3p4/3P1P2/2P2N2/PPQN1PPP/R3KB1R w KQ - 0 9,Bd3,39,19,-20,1
r1bq1rk1/pppn1p1p/4pnp1/3p4/3P1P2/2PB1N2/PPQN1PPP/R3K2R b KQ - 1 9,c5,13,19,6,1
r1bq1rk1/pp1n1p1p/4pnp1/2pp4/3P1P2/2PB1N2/PPQN1PPP/R3K2R w KQ - 0 10,Be2,17,-9,-26,1
r1bq1rk1/pp1n1p1p/4pnp1/2pp4/3P1P2/2P2N2/PPQNBPPP/R3K2R b KQ - 1 10,cxd4,-13,-15,-2,1
r1bq1rk1/pp1n1p1p/4pnp1/3p4/3p1P2/2P2N2/PPQNBPPP/R3K2R w KQ - 0 11,Nxd4,-3,-25,-22,1
r1bq1rk1/pp1n1p1p/4pnp1/3p4/3N1P2/2P5/PPQNBPPP/R3K2R b KQ - 0 11,a6,-28,24,52,1
r1bq1rk1/1p1n1p1p/p3pnp1/3p4/3N1P2/2P5/PPQNBPPP/R3K2R w KQ - 0 12,Bd3,24,-22,-46,1
r1bq1rk1/1p1n1p1p/p3pnp1/3p4/3N1P2/2PB4/PPQN1PPP/R3K2R b KQ - 1 12,Qc7,-16,-11,5,1
r1b2rk1/1pqn1p1p/p3pnp1/3p4/3N1P2/2PB4/PPQN1PPP/R3K2R w KQ - 2 13,N4f3,-16,-208,-192,0
r1b2rk1/1pqn1p1p/p3pnp1/3p4/5P2/2PB1N2/PPQN1PPP/R3K2R b KQ - 3 13,b5,-204,-20,184,1
r1b2rk1/2qn1p1p/p3pnp1/1p1p4/5P2/2PB1N2/PPQN1PPP/R3K2R w KQ - 0 14,g3,-12,-24,-12,1
r1b2rk1/2qn1p1p/p3pnp1/1p1p4/5P2/2PB1NP1/PPQN1P1P/R3K2R b KQ - 0 14,Bb7,-36,-23,13,1
r4rk1/1bqn1p1p/p3pnp1/1p1p4/5P2/2PB1NP1/PPQN1P1P/R3K2R w KQ - 1 15,O-O,-13,-18,-5,1
r4rk1/1bqn1p1p/p3pnp1/1p1p4/5P2/2PB1NP1/PPQN1P1P/R4RK1 b - - 2 15,Nc5,-10,-1,9,1
r4rk1/1bq2p1p/p3pnp1/1pnp4/5P2/2PB1NP1/PPQN1P1P/R4RK1 w - - 3 16,Be2,6,-55,-61,1
r4rk1/1bq2p1p/p3pnp1/1pnp4/5P2/2P2NP1/PPQNBP1P/R4RK1 b - - 4 16,Nce4,-52,-19,33,1
r4rk1/1bq2p1p/p3pnp1/1p1p4/4nP2/2P2NP1/PPQNBP1P/R4RK1 w - - 5 17,Nxe4,-18,-45,-27,1
r4rk1/1bq2p1p/p3pnp1/1p1p4/4NP2/2P2NP1/PPQ1BP1P/R4RK1 b - - 0 17,Nxe4,-47,-19,28,1
r4rk1/1bq2p1p/p3p1p1/1p1p4/4nP2/2P2NP1/PPQ1BP1P/R4RK1 w - - 0 18,Nd2,-3,-34,-31,1
r4rk1/1bq2p1p/p3p1p1/1p1p4/4nP2/2P3P1/PPQNBP1P/R4RK1 b - - 1 18,Nf6,-26,9,35,1
r4rk1/1bq2p1p/p3pnp1/1p1p4/5P2/2P3P1/PPQNBP1P/R4RK1 w - - 2 19,Bf3,12,-17,-29,1
r4rk1/1bq2p1p/p3pnp1/1p1p4/5P2/2P2BP1/PPQN1P1P/R4RK1 b - - 3 19,Rad8,-12,3,15,1
3r1rk1/1bq2p1p/p3pnp1/1p1p4/5P2/2P2BP1/PPQN1P1P/R4RK1 w - - 4 20,Rac1,5,-4,-9,1
3r1rk1/1bq2p1p/p3pnp1/1p1p4/5P2/2P2BP1/PPQN1P1P/2R2RK1 b - - 5 20,e5,-9,33,42,1
3r1rk1/1bq2p1p/p4np1/1p1pp3/5P2/2P2BP1/PPQN1P1P/2R2RK1 w - - 0 21,fxe5,31,28,-3,1
3r1rk1/1bq2p1p/p4np1/1p1pP3/8/2P2BP1/PPQN1P1P/2R2RK1 b - - 0 21,Qxe5,33,51,18,1
3r1rk1/1b3p1p/p4np1/1p1pq3/8/2P2BP1/PPQN1P1P/2R2RK1 w - - 0 22,Nb3,41,35,-6,1
3r1rk1/1b3p1p/p4np1/1p1pq3/8/1NP2BP1/PPQ2P1P/2R2RK1 b - - 1 22,Qd6,35,35,0,1
3r1rk1/1b3p1p/p2q1np1/1p1p4/8/1NP2BP1/PPQ2P1P/2R2RK1 w - - 2 23,Rfe1,45,30,-15,1
3r1rk1/1b3p1p/p2q1np1/1p1p4/8/1NP2BP1/PPQ2P1P/2R1R1K1 b - - 3 23,Rc8,33,62,29,1
2r2rk1/1b3p1p/p2q1np1/1p1p4/8/1NP2BP1/PPQ2P1P/2R1R1K1 w - - 4 24,Qd2,54,48,-6,1
2r2rk1/1b3p1p/p2q1np1/1p1p4/8/1NP2BP1/PP1Q1P1P/2R1R1K1 b - - 5 24,Ba8,53,81,28,1
b1r2rk1/5p1p/p2q1np1/1p1p4/8/1NP2BP1/PP1Q1P1P/2R1R1K1 w - - 6 25,Rcd1,88,84,-4,1
b1r2rk1/5p1p/p2q1np1/1p1p4/8/1NP2BP1/PP1Q1P1P/3RR1K1 b - - 7 25,b4,70,243,173,1
b1r2rk1/5p1p/p2q1np1/3p4/1p6/1NP2BP1/PP1Q1P1P/3RR1K1 w - - 0 26,cxb4,235,247,12,1
rnbqkbnr/pppppppp/8/8/8/8/PPPPPPPP/RNBQKBNR w KQkq - 0 1,e4,31,38,7,1
rnbqkbnr/pppppppp/8/8/4P3/8/PPPP1PPP/RNBQKBNR b KQkq - 0 1,e6,35,43,8,1
rnbqkbnr/pppp1ppp/4p3/8/4P3/8/PPPP1PPP/RNBQKBNR w KQkq - 0 2,d4,37,44,7,1
rnbqkbnr/pppp1ppp/4p3/8/3PP3/8/PPP2PPP/RNBQKBNR b KQkq - 0 2,d5,37,34,-3,1
rnbqkbnr/ppp2ppp/4p3/3p4/3PP3/8/PPP2PPP/RNBQKBNR w KQkq - 0 3,exd5,44,17,-27,1
rnbqkbnr/ppp2ppp/4p3/3P4/3P4/8/PPP2PPP/RNBQKBNR b KQkq - 0 3,exd5,24,16,-8,1
rnbqkbnr/ppp2ppp/8/3p4/3P4/8/PPP2PPP/RNBQKBNR w KQkq - 0 4,c4,18,-11,-29,1
rnbqkbnr/ppp2ppp/8/3p4/2PP4/8/PP3PPP/RNBQKBNR b KQkq - 0 4,Bd6,-17,38,55,1
rnbqk1nr/ppp2ppp/3b4/3p4/2PP4/8/PP3PPP/RNBQKBNR w KQkq - 1 5,Nc3,25,34,9,1
rnbqk1nr/ppp2ppp/3b4/3p4/2PP4/2N5/PP3PPP/R1BQKBNR b KQkq - 2 5,Nf6,30,27,-3,1
rnbqk2r/ppp2ppp/3b1n2/3p4/2PP4/2N5/PP3PPP/R1BQKBNR w KQkq - 3 6,c5,32,12,-20,1
rnbqk2r/ppp2ppp/3b1n2/2Pp4/3P4/2N5/PP3PPP/R1BQKBNR b KQkq - 0 6,Be7,9,21,12,1
rnbqk2r/ppp1bppp/5n2/2Pp4/3P4/2N5/PP3PPP/R1BQKBNR w KQkq - 1 7,Nf3,19,12,-7,1
rnbqk2r/ppp1bppp/5n2/2Pp4/3P4/2N2N2/PP3PPP/R1BQKB1R b KQkq - 2 7,O-O,17,27,10,1
rnbq1rk1/ppp1bppp/5n2/2Pp4/3P4/2N2N2/PP3PPP/R1BQKB1R w KQ - 3 8,h3,23,18,-5,1
rnbq1rk1/ppp1bppp/5n2/2Pp4/3P4/2N2N1P/PP3PP1/R1BQKB1R b KQ - 0 8,b6,18,17,-1,1
rnbq1rk1/p1p1bppp/1p3n2/2Pp4/3P4/2N2N1P/PP3PP1/R1BQKB1R w KQ - 0 9,cxb6,19,6,-13,1
rnbq1rk1/p1p1bppp/1P3n2/3p4/3P4/2N2N1P/PP3PP1/R1BQKB1R b KQ - 0 9,axb6,2,16,14,1
rnbq1rk1/2p1bppp/1p3n2/3p4/3P4/2N2N1P/PP3PP1/R1BQKB1R w KQ - 0 10,Be2,10,-14,-24,1
rnbq1rk1/2p1bppp/1p3n2/3p4/3P4/2N2N1P/PP2BPP1/R1BQK2R b KQ - 1 10,c5,-20,-11,9,1
rnbq1rk1/4bppp/1p3n2/2pp4/3P4/2N2N1P/PP2BPP1/R1BQK2R w KQ - 0 11,Be3,-13,-22,-9,1
rnbq1rk1/4bppp/1p3n2/2pp4/3P4/2N1BN1P/PP2BPP1/R2QK2R b KQ - 1 11,c4,-15,17,32,1
rnbq1rk1/4bppp/1p3n2/3p4/2pP4/2N1BN1P/PP2BPP1/R2QK2R w KQ - 0 12,O-O,20,8,-12,1
rnbq1rk1/4bppp/1p3n2/3p4/2pP4/2N1BN1P/PP2BPP1/R2Q1RK1 b - - 1 12,Bd7,12,67,55,1
rn1q1rk1/3bbppp/1p3n2/3p4/2pP4/2N1BN1P/PP2BPP1/R2Q1RK1 w - - 2 13,a3,61,15,-46,1
rn1q1rk1/3bbppp/1p3n2/3p4/2pP4/P1N1BN1P/1P2BPP1/R2Q1RK1 b - - 0 13,b5,17,79,62,1
rn1q1rk1/3bbppp/5n2/1p1p4/2pP4/P1N1BN1P/1P2BPP1/R2Q1RK1 w - - 0 14,Re1,60,-12,-72,1
rn1q1rk1/3bbppp/5n2/1p1p4/2pP4/P1N1BN1P/1P2BPP1/R2QR1K1 b - - 1 14,Na6,-17,12,29,1
r2q1rk1/3bbppp/n4n2/1p1p4/2pP4/P1N1BN1P/1P2BPP1/R2QR1K1 w - - 2 15,Bg5,20,-11,-31,1
r2q1rk1/3bbppp/n4n2/1p1p2B1/2pP4/P1N2N1P/1P2BPP1/R2QR1K1 b - - 3 15,b4,-12,169,181,1
r2q1rk1/3bbppp/n4n2/3p2B1/1ppP4/P1N2N1P/1P2BPP1/R2QR1K1 w - - 0 16,axb4,145,113,-32,1
r2q1rk1/3bbppp/n4n2/3p2B1/1PpP4/2N2N1P/1P2BPP1/R2QR1K1 b - - 0 16,Nxb4,96,87,-9,1
r2q1rk1/3bbppp/5n2/3p2B1/1npP4/2N2N1P/1P2BPP1/R2QR1K1 w - - 0 17,Rxa8,103,107,4,1
R2q1rk1/3bbppp/5n2/3p2B1/1npP4/2N2N1P/1P2BPP1/3QR1K1 b - - 0 17,Qxa8,90,99,9,1
q4rk1/3bbppp/5n2/3p2B1/1npP4/2N2N1P/1P2BPP1/3QR1K1 w - - 0 18,Ne5,107,36,-71,1
q4rk1/3bbppp/5n2/3pN1B1/1npP4/2N4P/1P2BPP1/3QR1K1 b - - 1 18,Be6,32,43,11,1
q4rk1/4bppp/4bn2/3pN1B1/1npP4/2N4P/1P2BPP1/3QR1K1 w - - 2 19,Bf3,30,-19,-49,1
q4rk1/4bppp/4bn2/3pN1B1/1npP4/2N2B1P/1P3PP1/3QR1K1 b - - 3 19,Re8,-10,123,133,1
q3r1k1/4bppp/4bn2/3pN1B1/1npP4/2N2B1P/1P3PP1/3QR1K1 w - - 4 20,Qa1,110,-25,-135,0
q3r1k1/4bppp/4bn2/3pN1B1/1npP4/2N2B1P/1P3PP1/Q3R1K1 b - - 5 20,Qxa1,-24,-28,-4,1
4r1k1/4bppp/4bn2/3pN1B1/1npP4/2N2B1P/1P3PP1/q3R1K1 w - - 0 21,Rxa1,-22,-19,3,1
4r1k1/4bppp/4bn2/3pN1B1/1npP4/2N2B1P/1P3PP1/R5K1 b - - 0 21,h6,-22,-27,-5,1
4r1k1/4bpp1/4bn1p/3pN1B1/1npP4/2N2B1P/1P3PP1/R5K1 w - - 0 22,Bh4,-22,-64,-42,1
4r1k1/4bpp1/4bn1p/3pN3/1npP3B/2N2B1P/1P3PP1/R5K1 b - - 1 22,g5,-45,-52,-7,1
4r1k1/4bp2/4bn1p/3pN1p1/1npP3B/2N2B1P/1P3PP1/R5K1 w - - 0 23,Bg3,-57,-48,9,1
4r1k1/4bp2/4bn1p/3pN1p1/1npP4/2N2BBP/1P3PP1/R5K1 b - - 1 23,Nc2,-54,-45,9,1
4r1k1/4bp2/4bn1p/3pN1p1/2pP4/2N2BBP/1Pn2PP1/R5K1 w - - 2 24,Rd1,-40,-45,-5,1
4r1k1/4bp2/4bn1p/3pN1p1/2pP4/2N2BBP/1Pn2PP1/3R2K1 b - - 3 24,Nb4,-41,-42,-1,1
4r1k1/4bp2/4bn1p/3pN1p1/1npP4/2N2BBP/1P3PP1/3R2K1 w - - 4 25,Ra1,-45,-37,8,1
4r1k1/4bp2/4bn1p/3pN1p1/1npP4/2N2BBP/1P3PP1/R5K1 b - - 5 25,Nc2,-50,-42,8,1
4r1k1/4bp2/4bn1p/3pN1p1/2pP4/2N2BBP/1Pn2PP1/R5K1 w - - 6 26,Ra5,-49,-95,-46,1
4r1k1/4bp2/4bn1p/R2pN1p1/2pP4/2N2BBP/1Pn2PP1/6K1 b - - 7 26,Nxd4,-91,-47,44,1
4r1k1/4bp2/4bn1p/R2pN1p1/2pn4/2N2BBP/1P3PP1/6K1 w - - 0 27,Bxd5,-35,-33,2,1
4r1k1/4bp2/4bn1p/R2BN1p1/2pn4/2N3BP/1P3PP1/6K1 b - - 0 27,Nxd5,-39,-41,-2,1
4r1k1/4bp2/4b2p/R2nN1p1/2pn4/2N3BP/1P3PP1/6K1 w - - 0 28,Nxd5,-32,-26,6,1
4r1k1/4bp2/4b2p/R2NN1p1/2pn4/6BP/1P3PP1/6K1 b - - 0 28,Bxd5,-40,3,43,1
4r1k1/4bp2/7p/R2bN1p1/2pn4/6BP/1P3PP1/6K1 w - - 0 29,Rxd5,0,-9,-9,1
4r1k1/4bp2/7p/3RN1p1/2pn4/6BP/1P3PP1/6K1 b - - 0 29,Nf5,-5,29,34,1
4r1k1/4bp2/7p/3RNnp1/2p5/6BP/1P3PP1/6K1 w - - 1 30,Nxc4,28,30,2,1
4r1k1/4bp2/7p/3R1np1/2N5/6BP/1P3PP1/6K1 b - - 0 30,Nxg3,31,36,5,1
4r1k1/4bp2/7p/3R2p1/2N5/6nP/1P3PP1/6K1 w - - 0 31,fxg3,30,23,-7,1
4r1k1/4bp2/7p/3R2p1/2N5/6PP/1P4P1/6K1 b - - 0 31,Bf6,8,44,36,1
4r1k1/5p2/5b1p/3R2p1/2N5/6PP/1P4P1/6K1 w - - 1 32,Kh2,46,-1,-47,1
4r1k1/5p2/5b1p/3R2p1/2N5/6PP/1P4PK/8 b - - 2 32,Re2,2,19,17,1
6k1/5p2/5b1p/3R2p1/2N5/6PP/1P2r1PK/8 w - - 3 33,b3,34,36,2,1
6k1/5p2/5b1p/3R2p1/2N5/1P4PP/4r1PK/8 b - - 0 33,Kg7,26,60,34,1
8/5pk1/5b1p/3R2p1/2N5/1P4PP/4r1PK/8 w - - 1 34,Nd6,64,21,-43,1
8/5pk1/3N1b1p/3R2p1/8/1P4PP/4r1PK/8 b - - 2 34,Rb2,21,393,372,1
8/5pk1/3N1b1p/3R2p1/8/1P4PP/1r4PK/8 w - - 3 35,Rb5,411,45,-366,0
8/5pk1/3N1b1p/1R4p1/8/1P4PP/1r4PK/8 b - - 4 35,Be7,43,161,118,1
8/4bpk1/3N3p/1R4p1/8/1P4PP/1r4PK/8 w - - 5 36,Nf5+,175,178,3,1
8/4bpk1/7p/1R3Np1/8/1P4PP/1r4PK/8 b - - 6 36,Kf6,149,186,37,1
8/4bp2/5k1p/1R3Np1/8/1P4PP/1r4PK/8 w - - 7 37,Nxe7,185,44,-141,0
8/4Np2/5k1p/1R4p1/8/1P4PP/1r4PK/8 b - - 0 37,Kxe7,30,29,-1,1
8/4kp2/7p/1R4p1/8/1P4PP/1r4PK/8 w - - 0 38,Rb6,19,14,-5,1
8/4kp2/1R5p/6p1/8/1P4PP/1r4PK/8 b - - 1 38,f6,2,33,31,1
8/4k3/1R3p1p/6p1/8/1P4PP/1r4PK/8 w - - 0 39,b4,30,7,-23,1
8/4k3/1R3p1p/6p1/1P6/6PP/1r4PK/8 b - - 0 39,Kf7,1,32,31,1
8/5k2/1R3p1p/6p1/1P6/6PP/1r4PK/8 w - - 1 40,g4,33,12,-21,1
8/5k2/1R3p1p/6p1/1P4P1/7P/1r4PK/8 b - - 0 40,Kg6,8,30,22,1
8/8/1R3pkp/6p1/1P4P1/7P/1r4PK/8 w - - 1 41,b5,5,0,-5,1
8/8/1R3pkp/1P4p1/6P1/7P/1r4PK/8 b - - 0 41,Kg7,0,39,39,1
8/6k1/1R3p1p/1P4p1/6P1/7P/1r4PK/8 w - - 1 42,Rb8,64,58,-6,1
1R6/6k1/5p1p/1P4p1/6P1/7P/1r4PK/8 b - - 2 42,Rb4,54,167,113,1
1R6/6k1/5p1p/1P4p1/1r4P1/7P/6PK/8 w - - 3 43,b6,164,127,-37,1
1R6/6k1/1P3p1p/6p1/1r4P1/7P/6PK/8 b - - 0 43,Rb1,86,178,92,1
1R6/6k1/1P3p1p/6p1/6P1/7P/6PK/1r6 w - - 1 44,b7,195,0,-195,0
1R6/1P4k1/5p1p/6p1/6P1/7P/6PK/1r6 b - - 0 44,Rb3,27,43,16,1
1R6/1P4k1/5p1p/6p1/6P1/1r5P/6PK/8 w - - 1 45,Kg1,46,28,-18,1
1R6/1P4k1/5p1p/6p1/6P1/1r5P/6P1/6K1 b - - 2 45,Rb2,18,7,-11,1
1R6/1P4k1/5p1p/6p1/6P1/7P/1r4P1/6K1 w - - 3 46,Kf1,30,36,6,1
1R6/1P4k1/5p1p/6p1/6P1/7P/1r4P1/5K2 b - - 4 46,Kh7,0,8,8,1
1R6/1P5k/5p1p/6p1/6P1/7P/1r4P1/5K2 w - - 5 47,Ke1,0,0,0,1
1R6/1P5k/5p1p/6p1/6P1/7P/1r4P1/4K3 b - - 6 47,Kg7,0,0,0,1
1R6/1P4k1/5p1p/6p1/6P1/7P/1r4P1/4K3 w - - 7 48,Kd1,0,0,0,1
1R6/1P4k1/5p1p/6p1/6P1/7P/1r4P1/3K4 b - - 8 48,Rb6,0,0,0,1
1R6/1P4k1/1r3p1p/6p1/6P1/7P/6P1/3K4 w - - 9 49,Kc2,10,0,-10,1
1R6/1P4k1/1r3p1p/6p1/6P1/7P/2K3P1/8 b - - 10 49,Rc6+,7,6,-1,1
1R6/1P4k1/2r2p1p/6p1/6P1/7P/2K3P1/8 w - - 11 50,Kd3,0,0,0,1
1R6/1P4k1/2r2p1p/6p1/6P1/3K3P/6P1/8 b - - 12 50,Rb6,0,0,0,1
1R6/1P4k1/1r3p1p/6p1/6P1/3K3P/6P1/8 w - - 13 51,Kc4,0,0,0,1
1R6/1P4k1/1r3p1p/6p1/2K3P1/7P/6P1/8 b - - 14 51,Rb1,0,0,0,1
1R6/1P4k1/5p1p/6p1/2K3P1/7P/6P1/1r6 w - - 15 52,Kc5,0,0,0,1
1R6/1P4k1/5p1p/2K3p1/6P1/7P/6P1/1r6 b - - 16 52,Rc1+,0,0,0,1
1R6/1P4k1/5p1p/2K3p1/6P1/7P/6P1/2r5 w - - 17 53,Kd6,0,0,0,1
1R6/1P4k1/3K1p1p/6p1/6P1/7P/6P1/2r5 b - - 18 53,Rd1+,0,0,0,1
1R6/1P4k1/3K1p1p/6p1/6P1/7P/6P1/3r4 w - - 19 54,Ke7,0,0,0,1
1R6/1P2K1k1/5p1p/6p1/6P1/7P/6P1/3r4 b - - 20 54,Re1+,0,0,0,1
1R6/1P2K1k1/5p1p/6p1/6P1/7P/6P1/4r3 w - - 21 55,Kd7,0,0,0,1
1R6/1P1K2k1/5p1p/6p1/6P1/7P/6P1/4r3 b - - 22 55,Rd1+,0,0,0,1
1R6/1P1K2k1/5p1p/6p1/6P1/7P/6P1/3r4 w - - 23 56,Kc6,0,0,0,1
1R6/1P4k1/2K2p1p/6p1/6P1/7P/6P1/3r4 b - - 24 56,Rc1+,0,0,0,1
1R6/1P4k1/2K2p1p/6p1/6P1/7P/6P1/2r5 w - - 25 57,Kd5,0,0,0,1
1R6/1P4k1/5p1p/3K2p1/6P1/7P/6P1/2r5 b - - 26 57,Rd1+,0,0,0,1
1R6/1P4k1/5p1p/3K2p1/6P1/7P/6P1/3r4 w - - 27 58,Ke4,0,0,0,1
1R6/1P4k1/5p1p/6p1/4K1P1/7P/6P1/3r4 b - - 28 58,Rb1,0,0,0,1
1R6/1P4k1/5p1p/6p1/4K1P1/7P/6P1/1r6 w - - 29 59,Kf5,0,0,0,1
1R6/1P4k1/5p1p/5Kp1/6P1/7P/6P1/1r6 b - - 30 59,Rb5+,0,0,0,1
1R6/1P4k1/5p1p/1r3Kp1/6P1/7P/6P1/8 w - - 31 60,Ke6,0,0,0,1
1R6/1P4k1/4Kp1p/1r4p1/6P1/7P/6P1/8 b - - 32 60,Rb6+,0,0,0,1
1R6/1P4k1/1r2Kp1p/6p1/6P1/7P/6P1/8 w - - 33 61,Kd7,0,9,9,1
1R6/1P1K2k1/1r3p1p/6p1/6P1/7P/6P1/8 b - - 34 61,Rb1,0,0,0,1
1R6/1P1K2k1/5p1p/6p1/6P1/7P/6P1/1r6 w - - 35 62,Kc6,0,0,0,1
1R6/1P4k1/2K2p1p/6p1/6P1/7P/6P1/1r6 b - - 36 62,Rc1+,0,0,0,1
1R6/1P4k1/2K2p1p/6p1/6P1/7P/6P1/2r5 w - - 37 63,Kd5,0,0,0,1
1R6/1P4k1/5p1p/3K2p1/6P1/7P/6P1/2r5 b - - 38 63,Rd1+,0,0,0,1
1R6/1P4k1/5p1p/3K2p1/6P1/7P/6P1/3r4 w - - 39 64,Ke4,0,0,0,1
1R6/1P4k1/5p1p/6p1/4K1P1/7P/6P1/3r4 b - - 40 64,Rb1,0,0,0,1
1R6/1P4k1/5p1p/6p1/4K1P1/7P/6P1/1r6 w - - 41 65,Kf5,0,0,0,1
1R6/1P4k1/5p1p/5Kp1/6P1/7P/6P1/1r6 b - - 42 65,Rb6,0,0,0,1
1R6/1P4k1/1r3p1p/5Kp1/6P1/7P/6P1/8 w - - 43 66,h4,0,0,0,1
1R6/1P4k1/1r3p1p/5Kp1/6PP/8/6P1/8 b - - 0 66,gxh4,0,0,0,1
1R6/1P4k1/1r3p1p/5K2/6Pp/8/6P1/8 w - - 0 67,Kf4,0,0,0,1
1R6/1P4k1/1r3p1p/8/5KPp/8/6P1/8 b - - 1 67,Rb4+,0,0,0,1
1R6/1P4k1/5p1p/8/1r3KPp/8/6P1/8 w - - 2 68,Kf3,0,0,0,1
1R6/1P4k1/5p1p/8/1r4Pp/5K2/6P1/8 b - - 3 68,Rb3+,0,0,0,1
1R6/1P4k1/5p1p/8/6Pp/1r3K2/6P1/8 w - - 4 69,Kf2,0,0,0,1
1R6/1P4k1/5p1p/8/6Pp/1r6/5KP1/8 b - - 5 69,Rb2+,0,0,0,1
1R6/1P4k1/5p1p/8/6Pp/8/1r3KP1/8 w - - 6 70,Kg1,0,0,0,1
1R6/1P4k1/5p1p/8/6Pp/8/1r4P1/6K1 b - - 7 70,Rb6,0,0,0,1
1R6/1P4k1/1r3p1p/8/6Pp/8/6P1/6K1 w - - 8 71,Kh2,0,-6,-6,1
1R6/1P4k1/1r3p1p/8/6Pp/8/6PK/8 b - - 9 71,Kh7,-4,0,4,1
1R6/1P5k/1r3p1p/8/6Pp/8/6PK/8 w - - 10 72,Kh3,0,0,0,1
1R6/1P5k/1r3p1p/8/6Pp/7K/6P1/8 b - - 11 72,Rb3+,0,0,0,1
1R6/1P5k/5p1p/8/6Pp/1r5K/6P1/8 w - - 12 73,Kxh4,1,0,-1,1
1R6/1P5k/5p1p/8/6PK/1r6/6P1/8 b - - 0 73,Rb4,0,0,0,1
1R6/1P5k/5p1p/8/1r4PK/8/6P1/8 w - - 1 74,Kg3,0,0,0,1
1R6/1P5k/5p1p/8/1r4P1/6K1/6P1/8 b - - 2 74,Rb3+,0,0,0,1
1R6/1P5k/5p1p/8/6P1/1r4K1/6P1/8 w - - 3 75,Kh4,0,-9,-9,1
1R6/1P5k/5p1p/8/6PK/1r6/6P1/8 b - - 4 75,Rb4,0,0,0,1
1R6/1P5k/5p1p/8/1r4PK/8/6P1/8 w - - 5 76,Kh5,0,0,0,1
1R6/1P5k/5p1p/7K/1r4P1/8/6P1/8 b - - 6 76,f5,0,437,437,1
1R6/1P5k/7p/5p1K/1r4P1/8/6P1/8 w - - 0 77,gxf5,467,482,15,1
1R6/1P5k/7p/5P1K/1r6/8/6P1/8 b - - 0 77,Rb5,465,482,17,1
1R6/1P5k/7p/1r3P1K/8/8/6P1/8 w - - 1 78,g4,456,484,28,1
1R6/1P5k/7p/1r3P1K/6P1/8/8/8 b - - 0 78,Rb1,539,572,33,1
1R6/1P5k/7p/5P1K/6P1/8/8/1r6 w - - 1 79,Kh4,499,530,31,1
1R6/1P5k/7p/5P2/6PK/8/8/1r6 b - - 2 79,Rh1+,488,586,98,1
1R6/1P5k/7p/5P2/6PK/8/8/7r w - - 3 80,Kg3,550,550,0,1
1R6/1P5k/7p/5P2/6P1/6K1/8/7r b - - 4 80,Rb1,604,602,-2,1
1R6/1P5k/7p/5P2/6P1/6K1/8/1r6 w - - 5 81,Kf4,603,500,-103,0
1R6/1P5k/7p/5P2/5KP1/8/8/1r6 b - - 6 81,Rb4+,559,555,-4,1
1R6/1P5k/7p/5P2/1r3KP1/8/8/8 w - - 7 82,Ke5,567,569,2,1
1R6/1P5k/7p/4KP2/1r4P1/8/8/8 b - - 8 82,Rb5+,503,587,84,1
1R6/1P5k/7p/1r2KP2/6P1/8/8/8 w - - 9 83,Kf6,568,584,16,1
1R6/1P5k/5K1p/1r3P2/6P1/8/8/8 b - - 10 83,Rb6+,587,584,-3,1
1R6/1P5k/1r3K1p/5P2/6P1/8/8/8 w - - 11 84,Kf7,558,612,54,1
1R6/1P3K1k/1r5p/5P2/6P1/8/8/8 b - - 12 84,Rb1,543,561,18,1
1R6/1P3K1k/7p/5P2/6P1/8/8/1r6 w - - 13 85,f6,607,551,-56,1
1R6/1P3K1k/5P1p/8/6P1/8/8/1r6 b - - 0 85,Rb6,565,573,8,1
1R6/1P3K1k/1r3P1p/8/6P1/8/8/8 w - - 1 86,Ke7,645,620,-25,1
1R6/1P2K2k/1r3P1p/8/6P1/8/8/8 b - - 2 86,Rb1,587,676,89,1
1R6/1P2K2k/5P1p/8/6P1/8/8/1r6 w - - 3 87,f7,678,603,-75,1
1R6/1P2KP1k/7p/8/6P1/8/8/1r6 b - - 0 87,Re1+,633,610,-23,1
1R6/1P2KP1k/7p/8/6P1/8/8/4r3 w - - 1 88,Kf8,678,644,-34,1
1R3K2/1P3P1k/7p/8/6P1/8/8/4r3 b - - 2 88,Kg6,643,806,163,1
1R3K2/1P3P2/6kp/8/6P1/8/8/4r3 w - - 3 89,Kg8,759,820,61,1
1R4K1/1P3P2/6kp/8/6P1/8/8/4r3 b - - 4 89,Rf1,805,1034,229,1
1R4K1/1P3P2/6kp/8/6P1/8/8/5r2 w - - 5 90,f8=Q,1143,1366,223,1
1R3QK1/1P6/6kp/8/6P1/8/8/5r2 b - - 0 90,Rxf8+,9989,9992,3,1
rnbqkbnr/pppppppp/8/8/8/8/PPPPPPPP/RNBQKBNR w KQkq - 0 1,d4,34,21,-13,1
rnbqkbnr/pppppppp/8/8/3P4/8/PPP1PPPP/RNBQKBNR b KQkq - 0 1,b6,18,101,83,1
rnbqkbnr/p1pppppp/1p6/8/3P4/8/PPP1PPPP/RNBQKBNR w KQkq - 0 2,Nf3,99,22,-77,1
rnbqkbnr/p1pppppp/1p6/8/3P4/5N2/PPP1PPPP/RNBQKB1R b KQkq - 1 2,Bb7,21,25,4,1
rn1qkbnr/pbpppppp/1p6/8/3P4/5N2/PPP1PPPP/RNBQKB1R w KQkq - 2 3,Bf4,18,10,-8,1
rn1qkbnr/pbpppppp/1p6/8/3P1B2/5N2/PPP1PPPP/RN1QKB1R b KQkq - 3 3,g6,19,70,51,1
rn1qkbnr/pbpppp1p/1p4p1/8/3P1B2/5N2/PPP1PPPP/RN1QKB1R w KQkq - 0 4,e3,73,47,-26,1
rn1qkbnr/pbpppp1p/1p4p1/8/3P1B2/4PN2/PPP2PPP/RN1QKB1R b KQkq - 0 4,Bg7,57,42,-15,1
rn1qk1nr/pbppppbp/1p4p1/8/3P1B2/4PN2/PPP2PPP/RN1QKB1R w KQkq - 1 5,c3,53,7,-46,1
rn1qk1nr/pbppppbp/1p4p1/8/3P1B2/2P1PN2/PP3PPP/RN1QKB1R b KQkq - 0 5,d6,7,25,18,1
rn1qk1nr/pbp1ppbp/1p1p2p1/8/3P1B2/2P1PN2/PP3PPP/RN1QKB1R w KQkq - 0 6,Bd3,17,-37,-54,1
rn1qk1nr/pbp1ppbp/1p1p2p1/8/3P1B2/2PBPN2/PP3PPP/RN1QK2R b KQkq - 1 6,Nd7,-22,-9,13,1
r2qk1nr/pbpnppbp/1p1p2p1/8/3P1B2/2PBPN2/PP3PPP/RN1QK2R w KQkq - 2 7,Nbd2,-4,-18,-14,1
r2qk1nr/pbpnppbp/1p1p2p1/8/3P1B2/2PBPN2/PP1N1PPP/R2QK2R b KQkq - 3 7,e6,-24,29,53,1
r2qk1nr/pbpn1pbp/1p1pp1p1/8/3P1B2/2PBPN2/PP1N1PPP/R2QK2R w KQkq - 0 8,Qc2,47,42,-5,1
r2qk1nr/pbpn1pbp/1p1pp1p1/8/3P1B2/2PBPN2/PPQN1PPP/R3K2R b KQkq - 1 8,Qe7,38,42,4,1
r3k1nr/pbpnqpbp/1p1pp1p1/8/3P1B2/2PBPN2/PPQN1PPP/R3K2R w KQkq - 2 9,h4,38,-66,-104,0
r3k1nr/pbpnqpbp/1p1pp1p1/8/3P1B1P/2PBPN2/PPQN1PP1/R3K2R b KQkq - 0 9,h5,-56,78,134,1
r3k1nr/pbpnqpb1/1p1pp1p1/7p/3P1B1P/2PBPN2/PPQN1PP1/R3K2R w KQkq - 0 10,Ng5,95,32,-63,1
r3k1nr/pbpnqpb1/1p1pp1p1/6Np/3P1B1P/2PBP3/PPQN1PP1/R3K2R b KQkq - 1 10,e5,45,50,5,1
r3k1nr/pbpnqpb1/1p1p2p1/4p1Np/3P1B1P/2PBP3/PPQN1PP1/R3K2R w KQkq - 0 11,Bg3,50,50,0,1
r3k1nr/pbpnqpb1/1p1p2p1/4p1Np/3P3P/2PBP1B1/PPQN1PP1/R3K2R b KQkq - 1 11,f6,34,440,406,1
r3k1nr/pbpnq1b1/1p1p1pp1/4p1Np/3P3P/2PBP1B1/PPQN1PP1/R3K2R w KQkq - 0 12,Ngf3,449,4,-445,0
r3k1nr/pbpnq1b1/1p1p1pp1/4p2p/3P3P/2PBPNB1/PPQN1PP1/R3K2R b KQkq - 1 12,f5,-5,4,9,1
r3k1nr/pbpnq1b1/1p1p2p1/4pp1p/3P3P/2PBPNB1/PPQN1PP1/R3K2R w KQkq - 0 13,dxe5,-16,-45,-29,1
r3k1nr/pbpnq1b1/1p1p2p1/4Pp1p/7P/2PBPNB1/PPQN1PP1/R3K2R b KQkq - 0 13,dxe5,-52,-66,-14,1
r3k1nr/pbpnq1b1/1p4p1/4pp1p/7P/2PBPNB1/PPQN1PP1/R3K2R w KQkq - 0 14,Ng5,-66,-66,0,1
r3k1nr/pbpnq1b1/1p4p1/4ppNp/7P/2PBP1B1/PPQN1PP1/R3K2R b KQkq - 1 14,O-O-O,-60,-56,4,1
2kr2nr/pbpnq1b1/1p4p1/4ppNp/7P/2PBP1B1/PPQN1PP1/R3K2R w KQ - 2 15,Nc4,-63,-220,-157,0
2kr2nr/pbpnq1b1/1p4p1/4ppNp/2N4P/2PBP1B1/PPQ2PP1/R3K2R b KQ - 3 15,e4,-211,-24,187,1
2kr2nr/pbpnq1b1/1p4p1/5pNp/2N1p2P/2PBP1B1/PPQ2PP1/R3K2R w KQ - 0 16,Be2,-18,-40,-22,1
2kr2nr/pbpnq1b1/1p4p1/5pNp/2N1p2P/2P1P1B1/PPQ1BPP1/R3K2R b KQ - 1 16,Ngf6,-40,-89,-49,1
2kr3r/pbpnq1b1/1p3np1/5pNp/2N1p2P/2P1P1B1/PPQ1BPP1/R3K2R w KQ - 2 17,a4,-80,-90,-10,1
2kr3r/pbpnq1b1/1p3np1/5pNp/P1N1p2P/2P1P1B1/1PQ1BPP1/R3K2R b KQ - 0 17,Nd5,-109,-122,-13,1
2kr3r/pbpnq1b1/1p4p1/3n1pNp/P1N1p2P/2P1P1B1/1PQ1BPP1/R3K2R w KQ - 1 18,a5,-126,-136,-10,1
2kr3r/pbpnq1b1/1p4p1/P2n1pNp/2N1p2P/2P1P1B1/1PQ1BPP1/R3K2R b KQ - 0 18,Nc5,-118,-39,79,1
2kr3r/pbp1q1b1/1p4p1/P1nn1pNp/2N1p2P/2P1P1B1/1PQ1BPP1/R3K2R w KQ - 1 19,axb6,-11,-29,-18,1
2kr3r/pbp1q1b1/1P4p1/2nn1pNp/2N1p2P/2P1P1B1/1PQ1BPP1/R3K2R b KQ - 0 19,axb6,-36,-16,20,1
2kr3r/1bp1q1b1/1p4p1/2nn1pNp/2N1p2P/2P1P1B1/1PQ1BPP1/R3K2R w KQ - 0 20,b4,0,-329,-329,0
2kr3r/1bp1q1b1/1p4p1/2nn1pNp/1PN1p2P/2P1P1B1/2Q1BPP1/R3K2R b KQ - 0 20,Na6,-320,180,500,1
2kr3r/1bp1q1b1/np4p1/3n1pNp/1PN1p2P/2P1P1B1/2Q1BPP1/R3K2R w KQ - 1 21,O-O,101,59,-42,1
2kr3r/1bp1q1b1/np4p1/3n1pNp/1PN1p2P/2P1P1B1/2Q1BPP1/R4RK1 b - - 2 21,Bxc3,71,330,259,1
2kr3r/1bp1q3/np4p1/3n1pNp/1PN1p2P/2b1P1B1/2Q1BPP1/R4RK1 w - - 0 22,Ra4,379,-100,-479,0
2kr3r/1bp1q3/np4p1/3n1pNp/RPN1p2P/2b1P1B1/2Q1BPP1/5RK1 b - - 1 22,Ndxb4,-118,506,624,1
2kr3r/1bp1q3/np4p1/5pNp/RnN1p2P/2b1P1B1/2Q1BPP1/5RK1 w - - 0 23,Qxc3,527,541,14,1
2kr3r/1bp1q3/np4p1/5pNp/RnN1p2P/2Q1P1B1/4BPP1/5RK1 b - - 0 23,c5,575,9999,9424,1
2kr3r/1b2q3/np4p1/2p2pNp/RnN1p2P/2Q1P1B1/4BPP1/5RK1 w - - 0 24,Rfa1,9999,667,-9332,0
2kr3r/1b2q3/np4p1/2p2pNp/RnN1p2P/2Q1P1B1/4BPP1/R5K1 b - - 1 24,Bc6,671,808,137,1
2kr3r/4q3/npb3p1/2p2pNp/RnN1p2P/2Q1P1B1/4BPP1/R5K1 w - - 2 25,Rxa6,785,784,-1,1
2kr3r/4q3/Rpb3p1/2p2pNp/1nN1p2P/2Q1P1B1/4BPP1/R5K1 b - - 0 25,Nxa6,825,9996,9171,1
2kr3r/4q3/npb3p1/2p2pNp/2N1p2P/2Q1P1B1/4BPP1/R5K1 w - - 0 26,Rxa6,9996,746,-9250,0
2kr3r/4q3/Rpb3p1/2p2pNp/2N1p2P/2Q1P1B1/4BPP1/6K1 b - - 0 26,Bb5,744,833,89,1
2kr3r/4q3/Rp4p1/1bp2pNp/2N1p2P/2Q1P1B1/4BPP1/6K1 w - - 1 27,Nxb6+,831,949,118,1
2kr3r/4q3/RN4p1/1bp2pNp/4p2P/2Q1P1B1/4BPP1/6K1 b - - 0 27,Kb7,947,1015,68,1
3r3r/1k2q3/RN4p1/1bp2pNp/4p2P/2Q1P1B1/4BPP1/6K1 w - - 1 28,Bxb5,1086,875,-211,0
3r3r/1k2q3/RN4p1/1Bp2pNp/4p2P/2Q1P1B1/5PP1/6K1 b - - 0 28,c4,892,1205,313,1
3r3r/1k2q3/RN4p1/1B3pNp/2p1p2P/2Q1P1B1/5PP1/6K1 w - - 0 29,Nxc4,9992,9993,1,1
3r3r/1k2q3/R5p1/1B3pNp/2N1p2P/2Q1P1B1/5PP1/6K1 b - - 0 29,Qc5,9993,9998,5,1
3r3r/1k6/R5p1/1Bq2pNp/2N1p2P/2Q1P1B1/5PP1/6K1 w - - 1 30,Rb6+,9998,9996,-2,1
3r3r/1k6/1R4p1/1Bq2pNp/2N1p2P/2Q1P1B1/5PP1/6K1 b - - 2 30,Ka7,9996,9999,3,1
3r3r/k7/1R4p1/1Bq2pNp/2N1p2P/2Q1P1B1/5PP1/6K1 w - - 3 31,Qa5#,9999,10000,1,1
rnbqkbnr/pppppppp/8/8/8/8/PPPPPPPP/RNBQKBNR w KQkq - 0 1,d4,29,24,-5,1
rnbqkbnr/pppppppp/8/8/3P4/8/PPP1PPPP/RNBQKBNR b KQkq - 0 1,d5,28,29,1,1
rnbqkbnr/ppp1pppp/8/3p4/3P4/8/PPP1PPPP/RNBQKBNR w KQkq - 0 2,c4,25,30,5,1
rnbqkbnr/ppp1pppp/8/3p4/2PP4/8/PP2PPPP/RNBQKBNR b KQkq - 0 2,c6,33,35,2,1
rnbqkbnr/pp2pppp/2p5/3p4/2PP4/8/PP2PPPP/RNBQKBNR w KQkq - 0 3,Nc3,35,19,-16,1
rnbqkbnr/pp2pppp/2p5/3p4/2PP4/2N5/PP2PPPP/R1BQKBNR b KQkq - 1 3,e6,33,49,16,1
rnbqkbnr/pp3ppp/2p1p3/3p4/2PP4/2N5/PP2PPPP/R1BQKBNR w KQkq - 0 4,Nf3,36,18,-18,1
rnbqkbnr/pp3ppp/2p1p3/3p4/2PP4/2N2N2/PP2PPPP/R1BQKB1R b KQkq - 1 4,f5,16,90,74,1
rnbqkbnr/pp4pp/2p1p3/3p1p2/2PP4/2N2N2/PP2PPPP/R1BQKB1R w KQkq - 0 5,Bf4,89,94,5,1
rnbqkbnr/pp4pp/2p1p3/3p1p2/2PP1B2/2N2N2/PP2PPPP/R2QKB1R b KQkq - 1 5,Nf6,99,103,4,1
rnbqkb1r/pp4pp/2p1pn2/3p1p2/2PP1B2/2N2N2/PP2PPPP/R2QKB1R w KQkq - 2 6,e3,104,95,-9,1
rnbqkb1r/pp4pp/2p1pn2/3p1p2/2PP1B2/2N1PN2/PP3PPP/R2QKB1R b KQkq - 0 6,Bd6,97,90,-7,1
rnbqk2r/pp4pp/2pbpn2/3p1p2/2PP1B2/2N1PN2/PP3PPP/R2QKB1R w KQkq - 1 7,cxd5,94,57,-37,1
rnbqk2r/pp4pp/2pbpn2/3P1p2/3P1B2/2N1PN2/PP3PPP/R2QKB1R b KQkq - 0 7,cxd5,49,158,109,1
rnbqk2r/pp4pp/3bpn2/3p1p2/3P1B2/2N1PN2/PP3PPP/R2QKB1R w KQkq - 0 8,Ne5,168,67,-101,0
rnbqk2r/pp4pp/3bpn2/3pNp2/3P1B2/2N1P3/PP3PPP/R2QKB1R b KQkq - 1 8,Nc6,62,63,1,1
r1bqk2r/pp4pp/2nbpn2/3pNp2/3P1B2/2N1P3/PP3PPP/R2QKB1R w KQkq - 2 9,Bb5,75,67,-8,1
r1bqk2r/pp4pp/2nbpn2/1B1pNp2/3P1B2/2N1P3/PP3PPP/R2QK2R b KQkq - 3 9,Bd7,58,73,15,1
r2qk2r/pp1b2pp/2nbpn2/1B1pNp2/3P1B2/2N1P3/PP3PPP/R2QK2R w KQkq - 4 10,Bxc6,72,71,-1,1
r2qk2r/pp1b2pp/2Bbpn2/3pNp2/3P1B2/2N1P3/PP3PPP/R2QK2R b KQkq - 0 10,bxc6,52,139,87,1
r2qk2r/p2b2pp/2pbpn2/3pNp2/3P1B2/2N1P3/PP3PPP/R2QK2R w KQkq - 0 11,O-O,154,120,-34,1
r2qk2r/p2b2pp/2pbpn2/3pNp2/3P1B2/2N1P3/PP3PPP/R2Q1RK1 b kq - 1 11,O-O,111,192,81,1
r2q1rk1/p2b2pp/2pbpn2/3pNp2/3P1B2/2N1P3/PP3PPP/R2Q1RK1 w - - 2 12,h3,187,60,-127,0
r2q1rk1/p2b2pp/2pbpn2/3pNp2/3P1B2/2N1P2P/PP3PP1/R2Q1RK1 b - - 0 12,Ne4,72,128,56,1
r2q1rk1/p2b2pp/2pbp3/3pNp2/3PnB2/2N1P2P/PP3PP1/R2Q1RK1 w - - 1 13,Rc1,178,155,-23,1
r2q1rk1/p2b2pp/2pbp3/3pNp2/3PnB2/2N1P2P/PP3PP1/2RQ1RK1 b - - 2 13,Nxc3,173,239,66,1
r2q1rk1/p2b2pp/2pbp3/3pNp2/3P1B2/2n1P2P/PP3PP1/2RQ1RK1 w - - 0 14,Rxc3,240,224,-16,1
r2q1rk1/p2b2pp/2pbp3/3pNp2/3P1B2/2R1P2P/PP3PP1/3Q1RK1 b - - 0 14,Rc8,225,238,13,1
2rq1rk1/p2b2pp/2pbp3/3pNp2/3P1B2/2R1P2P/PP3PP1/3Q1RK1 w - - 1 15,Qa4,264,228,-36,1
2rq1rk1/p2b2pp/2pbp3/3pNp2/Q2P1B2/2R1P2P/PP3PP1/5RK1 b - - 2 15,Bxe5,216,244,28,1
2rq1rk1/p2b2pp/2p1p3/3pbp2/Q2P1B2/2R1P2P/PP3PP1/5RK1 w - - 0 16,Bxe5,231,237,6,1
2rq1rk1/p2b2pp/2p1p3/3pBp2/Q2P4/2R1P2P/PP3PP1/5RK1 b - - 0 16,c5,227,231,4,1
2rq1rk1/p2b2pp/4p3/2ppBp2/Q2P4/2R1P2P/PP3PP1/5RK1 w - - 0 17,Qxa7,214,213,-1,1
2rq1rk1/Q2b2pp/4p3/2ppBp2/3P4/2R1P2P/PP3PP1/5RK1 b - - 0 17,c4,225,245,20,1
2rq1rk1/Q2b2pp/4p3/3pBp2/2pP4/2R1P2P/PP3PP1/5RK1 w - - 0 18,b3,215,241,26,1
2rq1rk1/Q2b2pp/4p3/3pBp2/2pP4/1PR1P2P/P4PP1/5RK1 b - - 0 18,Ra8,241,242,1,1
r2q1rk1/Q2b2pp/4p3/3pBp2/2pP4/1PR1P2P/P4PP1/5RK1 w - - 1 19,Qc5,224,220,-4,1
r2q1rk1/3b2pp/4p3/2QpBp2/2pP4/1PR1P2P/P4PP1/5RK1 b - - 2 19,Rxa2,237,329,92,1
3q1rk1/3b2pp/4p3/2QpBp2/2pP4/1PR1P2P/r4PP1/5RK1 w - - 0 20,bxc4,302,291,-11,1
3q1rk1/3b2pp/4p3/2QpBp2/2PP4/2R1P2P/r4PP1/5RK1 b - - 0 20,dxc4,272,282,10,1
3q1rk1/3b2pp/4p3/2Q1Bp2/2pP4/2R1P2P/r4PP1/5RK1 w - - 0 21,Qxc4,282,278,-4,1
3q1rk1/3b2pp/4p3/4Bp2/2QP4/2R1P2P/r4PP1/5RK1 b - - 0 21,Qe8,274,610,336,1
4qrk1/3b2pp/4p3/4Bp2/2QP4/2R1P2P/r4PP1/5RK1 w - - 1 22,d5,590,162,-428,0
4qrk1/3b2pp/4p3/3PBp2/2Q5/2R1P2P/r4PP1/5RK1 b - - 0 22,Ra8,146,204,58,1
r3qrk1/3b2pp/4p3/3PBp2/2Q5/2R1P2P/5PP1/5RK1 w - - 1 23,d6,232,97,-135,0
r3qrk1/3b2pp/3Pp3/4Bp2/2Q5/2R1P2P/5PP1/5RK1 b - - 0 23,Bb5,70,141,71,1
r3qrk1/6pp/3Pp3/1b2Bp2/2Q5/2R1P2P/5PP1/5RK1 w - - 1 24,Qh4,58,-54,-112,0
r3qrk1/6pp/3Pp3/1b2Bp2/7Q/2R1P2P/5PP1/5RK1 b - - 2 24,Bxf1,-5,9,14,1
r3qrk1/6pp/3Pp3/4Bp2/7Q/2R1P2P/5PP1/5bK1 w - - 0 25,Rc7,39,-24,-63,1
r3qrk1/2R3pp/3Pp3/4Bp2/7Q/4P2P/5PP1/5bK1 b - - 1 25,Rf7,-22,0,22,1
r3q1k1/2R2rpp/3Pp3/4Bp2/7Q/4P2P/5PP1/5bK1 w - - 2 26,Re7,-34,-294,-260,0
r3q1k1/4Rrpp/3Pp3/4Bp2/7Q/4P2P/5PP1/5bK1 b - - 3 26,Rxe7,-326,-305,21,1
r3q1k1/4r1pp/3Pp3/4Bp2/7Q/4P2P/5PP1/5bK1 w - - 0 27,dxe7,-313,-327,-14,1
r3q1k1/4P1pp/4p3/4Bp2/7Q/4P2P/5PP1/5bK1 b - - 0 27,Bb5,-324,-315,9,1
r3q1k1/4P1pp/4p3/1b2Bp2/7Q/4P2P/5PP1/6K1 w - - 1 28,Qg5,-338,-351,-13,1
r3q1k1/4P1pp/4p3/1b2BpQ1/8/4P2P/5PP1/6K1 b - - 2 28,Qf7,-346,-332,14,1
r5k1/4Pqpp/4p3/1b2BpQ1/8/4P2P/5PP1/6K1 w - - 3 29,h4,-381,-455,-74,1
r5k1/4Pqpp/4p3/1b2BpQ1/7P/4P3/5PP1/6K1 b - - 0 29,Be8,-468,-397,71,1
r3b1k1/4Pqpp/4p3/4BpQ1/7P/4P3/5PP1/6K1 w - - 1 30,g4,-380,-459,-79,1
r3b1k1/4Pqpp/4p3/4BpQ1/6PP/4P3/5P2/6K1 b - - 0 30,fxg4,-441,-376,65,1
r3b1k1/4Pqpp/4p3/4B1Q1/6pP/4P3/5P2/6K1 w - - 0 31,Qxg4,-417,-502,-85,1
r3b1k1/4Pqpp/4p3/4B3/6QP/4P3/5P2/6K1 b - - 0 31,Ra2,-474,-499,-25,1
4b1k1/4Pqpp/4p3/4B3/6QP/4P3/r4P2/6K1 w - - 1 32,h5,-501,-9996,-9495,0
4b1k1/4Pqpp/4p3/4B2P/6Q1/4P3/r4P2/6K1 b - - 0 32,Qxf2+,-9996,-9997,-1,1
4b1k1/4P1pp/4p3/4B2P/6Q1/4P3/r4q2/6K1 w - - 0 33,Kh1,-9997,-9997,0,1
4b1k1/4P1pp/4p3/4B2P/6Q1/4P3/r4q2/7K b - - 1 33,Qh2+,-9997,421,10418,1
4b1k1/4P1pp/4p3/4B2P/6Q1/4P3/r6q/7K w - - 2 34,Bxh2,388,421,33,1
4b1k1/4P1pp/4p3/7P/6Q1/4P3/r6B/7K b - - 0 34,Rxh2+,440,558,118,1
4b1k1/4P1pp/4p3/7P/6Q1/4P3/7r/7K w - - 0 35,Kxh2,564,582,18,1
4b1k1/4P1pp/4p3/7P/6Q1/4P3/7K/8 b - - 0 35,g5,604,9996,9392,1
4b1k1/4P2p/4p3/6pP/6Q1/4P3/7K/8 w - g6 0 36,Qxe6+,9996,9997,1,1
4b1k1/4P2p/4Q3/6pP/8/4P3/7K/8 b - - 0 36,Kg7,9997,9997,0,1
4b3/4P1kp/4Q3/6pP/8/4P3/7K/8 w - - 1 37,Qe5+,9997,709,-9288,0
4b3/4P1kp/8/4Q1pP/8/4P3/7K/8 b - - 2 37,Kf7,706,664,-42,1
4b3/4Pk1p/8/4Q1pP/8/4P3/7K/8 w - - 3 38,Qxg5,728,676,-52,1
4b3/4Pk1p/8/6QP/8/4P3/7K/8 b - - 0 38,Bd7,704,714,10,1
8/3bPk1p/8/6QP/8/4P3/7K/8 w - - 1 39,h6,749,747,-2,1
8/3bPk1p/7P/6Q1/8/4P3/7K/8 b - - 0 39,Be8,747,805,58,1
4b3/4Pk1p/7P/6Q1/8/4P3/7K/8 w - - 1 40,Qg7+,857,820,-37,1
4b3/4PkQp/7P/8/8/4P3/7K/8 b - - 2 40,Ke6,832,854,22,1
4b3/4P1Qp/4k2P/8/8/4P3/7K/8 w - - 3 41,Qxh7,871,887,16,1
4b3/4P2Q/4k2P/8/8/4P3/7K/8 b - - 0 41,Kd7,889,980,91,1
rnbqkbnr/pppppppp/8/8/8/8/PPPPPPPP/RNBQKBNR w KQkq - 0 1,e4,38,30,-8,1
rnbqkbnr/pppppppp/8/8/4P3/8/PPPP1PPP/RNBQKBNR b KQkq - 0 1,c5,33,36,3,1
rnbqkbnr/pp1ppppp/8/2p5/4P3/8/PPPP1PPP/RNBQKBNR w KQkq - 0 2,f4,30,6,-24,1
rnbqkbnr/pp1ppppp/8/2p5/4PP2/8/PPPP2PP/RNBQKBNR b KQkq - 0 2,Nc6,-9,-13,-4,1
r1bqkbnr/pp1ppppp/2n5/2p5/4PP2/8/PPPP2PP/RNBQKBNR w KQkq - 1 3,Nf3,-17,-16,1,1
r1bqkbnr/pp1ppppp/2n5/2p5/4PP2/5N2/PPPP2PP/RNBQKB1R b KQkq - 2 3,g6,-8,8,16,1
r1bqkbnr/pp1ppp1p/2n3p1/2p5/4PP2/5N2/PPPP2PP/RNBQKB1R w KQkq - 0 4,c3,15,-29,-44,1
r1bqkbnr/pp1ppp1p/2n3p1/2p5/4PP2/2P2N2/PP1P2PP/RNBQKB1R b KQkq - 0 4,Bg7,-42,-4,38,1
r1bqk1nr/pp1pppbp/2n3p1/2p5/4PP2/2P2N2/PP1P2PP/RNBQKB1R w KQkq - 1 5,Bb5,-4,-26,-22,1
r1bqk1nr/pp1pppbp/2n3p1/1Bp5/4PP2/2P2N2/PP1P2PP/RNBQK2R b KQkq - 2 5,Qc7,-24,25,49,1
r1b1k1nr/ppqpppbp/2n3p1/1Bp5/4PP2/2P2N2/PP1P2PP/RNBQK2R w KQkq - 3 6,d3,16,-22,-38,1
r1b1k1nr/ppqpppbp/2n3p1/1Bp5/4PP2/2PP1N2/PP4PP/RNBQK2R b KQkq - 0 6,e6,-22,23,45,1
r1b1k1nr/ppqp1pbp/2n1p1p1/1Bp5/4PP2/2PP1N2/PP4PP/RNBQK2R w KQkq - 0 7,Be3,25,-15,-40,1
r1b1k1nr/ppqp1pbp/2n1p1p1/1Bp5/4PP2/2PPBN2/PP4PP/RN1QK2R b KQkq - 1 7,b6,-12,15,27,1
r1b1k1nr/p1qp1pbp/1pn1p1p1/1Bp5/4PP2/2PPBN2/PP4PP/RN1QK2R w KQkq - 0 8,Nbd2,11,11,0,1
r1b1k1nr/p1qp1pbp/1pn1p1p1/1Bp5/4PP2/2PPBN2/PP1N2PP/R2QK2R b KQkq - 1 8,Nge7,10,26,16,1
r1b1k2r/p1qpnpbp/1pn1p1p1/1Bp5/4PP2/2PPBN2/PP1N2PP/R2QK2R w KQkq - 2 9,Qc2,57,-36,-93,1
r1b1k2r/p1qpnpbp/1pn1p1p1/1Bp5/4PP2/2PPBN2/PPQN2PP/R3K2R b KQkq - 3 9,d5,-29,17,46,1
r1b1k2r/p1q1npbp/1pn1p1p1/1Bpp4/4PP2/2PPBN2/PPQN2PP/R3K2R w KQkq - 0 10,e5,14,5,-9,1
r1b1k2r/p1q1npbp/1pn1p1p1/1BppP3/5P2/2PPBN2/PPQN2PP/R3K2R b KQkq - 0 10,Nf5,9,48,39,1
r1b1k2r/p1q2pbp/1pn1p1p1/1BppPn2/5P2/2PPBN2/PPQN2PP/R3K2R w KQkq - 1 11,Bf2,40,41,1,1
r1b1k2r/p1q2pbp/1pn1p1p1/1BppPn2/5P2/2PP1N2/PPQN1BPP/R3K2R b KQkq - 2 11,Bd7,30,39,9,1
r3k2r/p1qb1pbp/1pn1p1p1/1BppPn2/5P2/2PP1N2/PPQN1BPP/R3K2R w KQkq - 3 12,g4,22,-46,-68,1
r3k2r/p1qb1pbp/1pn1p1p1/1BppPn2/5PP1/2PP1N2/PPQN1B1P/R3K2R b KQkq - 0 12,Nfe7,-37,-63,-26,1
r3k2r/p1qbnpbp/1pn1p1p1/1BppP3/5PP1/2PP1N2/PPQN1B1P/R3K2R w KQkq - 1 13,h4,-57,-204,-147,0
r3k2r/p1qbnpbp/1pn1p1p1/1BppP3/5PPP/2PP1N2/PPQN1B2/R3K2R b KQkq - 0 13,f6,-194,-43,151,1
r3k2r/p1qbn1bp/1pn1ppp1/1BppP3/5PPP/2PP1N2/PPQN1B2/R3K2R w KQkq - 0 14,f5,-42,-169,-127,0
r3k2r/p1qbn1bp/1pn1ppp1/1BppPP2/6PP/2PP1N2/PPQN1B2/R3K2R b KQkq - 0 14,Nxe5,-184,-135,49,1
r3k2r/p1qbn1bp/1p2ppp1/1BppnP2/6PP/2PP1N2/PPQN1B2/R3K2R w KQkq - 0 15,Bxd7+,-118,-147,-29,1
r3k2r/p1qBn1bp/1p2ppp1/2ppnP2/6PP/2PP1N2/PPQN1B2/R3K2R b KQkq - 0 15,Kxd7,-164,-112,52,1
r6r/p1qkn1bp/1p2ppp1/2ppnP2/6PP/2PP1N2/PPQN1B2/R3K2R w KQ - 0 16,fxe6+,-99,-103,-4,1
r6r/p1qkn1bp/1p2Ppp1/2ppn3/6PP/2PP1N2/PPQN1B2/R3K2R b KQ - 0 16,Kxe6,-121,-89,32,1
r6r/p1q1n1bp/1p2kpp1/2ppn3/6PP/2PP1N2/PPQN1B2/R3K2R w KQ - 0 17,O-O-O,-95,-268,-173,0
r6r/p1q1n1bp/1p2kpp1/2ppn3/6PP/2PP1N2/PPQN1B2/2KR3R b - - 1 17,Nxg4,-238,-265,-27,1
r6r/p1q1n1bp/1p2kpp1/2pp4/6nP/2PP1N2/PPQN1B2/2KR3R w - - 0 18,Rde1+,-268,-308,-40,1
r6r/p1q1n1bp/1p2kpp1/2pp4/6nP/2PP1N2/PPQN1B2/2K1R2R b - - 1 18,Kd7,-326,319,645,1
r6r/p1qkn1bp/1p3pp1/2pp4/6nP/2PP1N2/PPQN1B2/2K1R2R w - - 2 19,Bg1,319,-237,-556,0
r6r/p1qkn1bp/1p3pp1/2pp4/6nP/2PP1N2/PPQN4/2K1R1BR b - - 3 19,Nf5,-248,304,552,1
r6r/p1qk2bp/1p3pp1/2pp1n2/6nP/2PP1N2/PPQN4/2K1R1BR w - - 4 20,Qa4+,306,314,8,1
r6r/p1qk2bp/1p3pp1/2pp1n2/Q5nP/2PP1N2/PP1N4/2K1R1BR b - - 5 20,Qc6,307,286,-21,1
r6r/p2k2bp/1pq2pp1/2pp1n2/Q5nP/2PP1N2/PP1N4/2K1R1BR w - - 6 21,Qxg4,304,280,-24,1
r6r/p2k2bp/1pq2pp1/2pp1n2/6QP/2PP1N2/PP1N4/2K1R1BR b - - 0 21,Rae8,309,312,3,1
4r2r/p2k2bp/1pq2pp1/2pp1n2/6QP/2PP1N2/PP1N4/2K1R1BR w - - 1 22,Bh2,319,256,-63,1
4r2r/p2k2bp/1pq2pp1/2pp1n2/6QP/2PP1N2/PP1N3B/2K1R2R b - - 2 22,Bh6,227,309,82,1
4r2r/p2k3p/1pq2ppb/2pp1n2/6QP/2PP1N2/PP1N3B/2K1R2R w - - 3 23,Kb1,307,221,-86,1
4r2r/p2k3p/1pq2ppb/2pp1n2/6QP/2PP1N2/PP1N3B/1K2R2R b - - 4 23,Kd8,193,315,122,1
3kr2r/p6p/1pq2ppb/2pp1n2/6QP/2PP1N2/PP1N3B/1K2R2R w - - 5 24,h5,248,179,-69,1
3kr2r/p6p/1pq2ppb/2pp1n1P/6Q1/2PP1N2/PP1N3B/1K2R2R b - - 0 24,Ne3,203,364,161,1
3kr2r/p6p/1pq2ppb/2pp3P/6Q1/2PPnN2/PP1N3B/1K2R2R w - - 1 25,Qg3,346,347,1,1
3kr2r/p6p/1pq2ppb/2pp3P/8/2PPnNQ1/PP1N3B/1K2R2R b - - 2 25,g5,377,428,51,1
3kr2r/p6p/1pq2p1b/2pp2pP/8/2PPnNQ1/PP1N3B/1K2R2R w - - 0 26,Qb8+,392,400,8,1
1Q1kr2r/p6p/1pq2p1b/2pp2pP/8/2PPnN2/PP1N3B/1K2R2R b - - 1 26,Qc8,406,502,96,1
1Qqkr2r/p6p/1p3p1b/2pp2pP/8/2PPnN2/PP1N3B/1K2R2R w - - 2 27,Qxa7,502,425,-77,1
2qkr2r/Q6p/1p3p1b/2pp2pP/8/2PPnN2/PP1N3B/1K2R2R b - - 0 27,Re6,365,441,76,1
2qk3r/Q6p/1p2rp1b/2pp2pP/8/2PPnN2/PP1N3B/1K2R2R w - - 1 28,Qf7,407,256,-151,0
rnbqkbnr/pppppppp/8/8/8/8/PPPPPPPP/RNBQKBNR w KQkq - 0 1,e4,31,34,3,1
rnbqkbnr/pppppppp/8/8/4P3/8/PPPP1PPP/RNBQKBNR b KQkq - 0 1,c5,24,37,13,1
rnbqkbnr/pp1ppppp/8/2p5/4P3/8/PPPP1PPP/RNBQKBNR w KQkq - 0 2,e5,30,-52,-82,1
rnbqkbnr/pp1ppppp/8/2p1P3/8/8/PPPP1PPP/RNBQKBNR b KQkq - 0 2,d6,-63,-22,41,1
rnbqkbnr/pp2pppp/3p4/2p1P3/8/8/PPPP1PPP/RNBQKBNR w KQkq - 0 3,f4,-21,-60,-39,1
rnbqkbnr/pp2pppp/3p4/2p1P3/5P2/8/PPPP2PP/RNBQKBNR b KQkq - 0 3,e6,-61,-41,20,1
rnbqkbnr/pp3ppp/3pp3/2p1P3/5P2/8/PPPP2PP/RNBQKBNR w KQkq - 0 4,Nc3,-49,-62,-13,1
rnbqkbnr/pp3ppp/3pp3/2p1P3/5P2/2N5/PPPP2PP/R1BQKBNR b KQkq - 1 4,dxe5,-56,-44,12,1
rnbqkbnr/pp3ppp/4p3/2p1p3/5P2/2N5/PPPP2PP/R1BQKBNR w KQkq - 0 5,fxe5,-40,-63,-23,1
rnbqkbnr/pp3ppp/4p3/2p1P3/8/2N5/PPPP2PP/R1BQKBNR b KQkq - 0 5,Qd4,-30,176,206,1
rnb1kbnr/pp3ppp/4p3/2p1P3/3q4/2N5/PPPP2PP/R1BQKBNR w KQkq - 1 6,Bb5+,178,178,0,1
rnb1kbnr/pp3ppp/4p3/1Bp1P3/3q4/2N5/PPPP2PP/R1BQK1NR b KQkq - 2 6,Bd7,184,192,8,1
rn2kbnr/pp1b1ppp/4p3/1Bp1P3/3q4/2N5/PPPP2PP/R1BQK1NR w KQkq - 3 7,Nf3,173,168,-5,1
rn2kbnr/pp1b1ppp/4p3/1Bp1P3/3q4/2N2N2/PPPP2PP/R1BQK2R b KQkq - 4 7,Qg4,174,170,-4,1
rn2kbnr/pp1b1ppp/4p3/1Bp1P3/6q1/2N2N2/PPPP2PP/R1BQK2R w KQkq - 5 8,Qe2,173,91,-82,1
rn2kbnr/pp1b1ppp/4p3/1Bp1P3/6q1/2N2N2/PPPPQ1PP/R1B1K2R b KQkq - 6 8,a6,89,98,9,1
rn2kbnr/1p1b1ppp/p3p3/1Bp1P3/6q1/2N2N2/PPPPQ1PP/R1B1K2R w KQkq - 0 9,h3,113,-315,-428,0
rn2kbnr/1p1b1ppp/p3p3/1Bp1P3/6q1/2N2N1P/PPPPQ1P1/R1B1K2R b KQkq - 0 9,Qf5,-333,182,515,1
rn2kbnr/1p1b1ppp/p3p3/1Bp1Pq2/8/2N2N1P/PPPPQ1P1/R1B1K2R w KQkq - 1 10,Bxd7+,198,202,4,1
rn2kbnr/1p1B1ppp/p3p3/2p1Pq2/8/2N2N1P/PPPPQ1P1/R1B1K2R b KQkq - 0 10,Nxd7,192,197,5,1
r3kbnr/1p1n1ppp/p3p3/2p1Pq2/8/2N2N1P/PPPPQ1P1/R1B1K2R w KQkq - 0 11,d3,178,128,-50,1
r3kbnr/1p1n1ppp/p3p3/2p1Pq2/8/2NP1N1P/PPP1Q1P1/R1B1K2R b KQkq - 0 11,Ne7,165,544,379,1
r3kb1r/1p1nnppp/p3p3/2p1Pq2/8/2NP1N1P/PPP1Q1P1/R1B1K2R w KQkq - 1 12,Bg5,540,61,-479,0
r3kb1r/1p1nnppp/p3p3/2p1PqB1/8/2NP1N1P/PPP1Q1P1/R3K2R b KQkq - 2 12,h6,87,103,16,1
r3kb1r/1p1nnpp1/p3p2p/2p1PqB1/8/2NP1N1P/PPP1Q1P1/R3K2R w KQkq - 0 13,Bh4,99,20,-79,1
r3kb1r/1p1nnpp1/p3p2p/2p1Pq2/7B/2NP1N1P/PPP1Q1P1/R3K2R b KQkq - 1 13,Qf4,13,65,52,1
r3kb1r/1p1nnpp1/p3p2p/2p1P3/5q1B/2NP1N1P/PPP1Q1P1/R3K2R w KQkq - 2 14,Bf2,31,0,-31,1
r3kb1r/1p1nnpp1/p3p2p/2p1P3/5q2/2NP1N1P/PPP1QBP1/R3K2R b KQkq - 3 14,g5,0,145,145,1
r3kb1r/1p1nnp2/p3p2p/2p1P1p1/5q2/2NP1N1P/PPP1QBP1/R3K2R w KQkq - 0 15,g3,169,94,-75,1
r3kb1r/1p1nnp2/p3p2p/2p1P1p1/5q2/2NP1NPP/PPP1QB2/R3K2R b KQkq - 0 15,Qb4,102,108,6,1
r3kb1r/1p1nnp2/p3p2p/2p1P1p1/1q6/2NP1NPP/PPP1QB2/R3K2R w KQkq - 1 16,O-O-O,101,101,0,1
r3kb1r/1p1nnp2/p3p2p/2p1P1p1/1q6/2NP1NPP/PPP1QB2/2KR3R b kq - 2 16,Bg7,106,152,46,1
r3k2r/1p1nnpb1/p3p2p/2p1P1p1/1q6/2NP1NPP/PPP1QB2/2KR3R w kq - 3 17,a3,159,139,-20,1
r3k2r/1p1nnpb1/p3p2p/2p1P1p1/1q6/P1NP1NPP/1PP1QB2/2KR3R b kq - 0 17,Qa5,158,149,-9,1
r3k2r/1p1nnpb1/p3p2p/q1p1P1p1/8/P1NP1NPP/1PP1QB2/2KR3R w kq - 1 18,h4,134,52,-82,1
r3k2r/1p1nnpb1/p3p2p/q1p1P1p1/7P/P1NP1NP1/1PP1QB2/2KR3R b kq - 0 18,b5,63,184,121,1
r3k2r/3nnpb1/p3p2p/qpp1P1p1/7P/P1NP1NP1/1PP1QB2/2KR3R w kq - 0 19,hxg5,204,190,-14,1
r3k2r/3nnpb1/p3p2p/qpp1P1P1/8/P1NP1NP1/1PP1QB2/2KR3R b kq - 0 19,b4,203,194,-9,1
r3k2r/3nnpb1/p3p2p/q1p1P1P1/1p6/P1NP1NP1/1PP1QB2/2KR3R w kq - 0 20,axb4,186,221,35,1
r3k2r/3nnpb1/p3p2p/q1p1P1P1/1P6/2NP1NP1/1PP1QB2/2KR3R b kq - 0 20,cxb4,219,207,-12,1
r3k2r/3nnpb1/p3p2p/q3P1P1/1p6/2NP1NP1/1PP1QB2/2KR3R w kq - 0 21,Nb1,182,0,-182,0
r3k2r/3nnpb1/p3p2p/q3P1P1/1p6/3P1NP1/1PP1QB2/1NKR3R b kq - 1 21,hxg5,-1,85,86,1
r3k2r/3nnpb1/p3p3/q3P1p1/1p6/3P1NP1/1PP1QB2/1NKR3R w kq - 0 22,Nd4,101,-163,-264,0
r3k2r/3nnpb1/p3p3/q3P1p1/1p1N4/3P2P1/1PP1QB2/1NKR3R b kq - 1 22,Bxe5,-164,-30,134,1
r3k2r/3nnp2/p3p3/q3b1p1/1p1N4/3P2P1/1PP1QB2/1NKR3R w kq - 0 23,Nb3,3,-137,-140,0
r3k2r/3nnp2/p3p3/q3b1p1/1p6/1N1P2P1/1PP1QB2/1NKR3R b kq - 1 23,Qd5,-158,-156,2,1
r3k2r/3nnp2/p3p3/3qb1p1/1p6/1N1P2P1/1PP1QB2/1NKR3R w kq - 2 24,d4,-188,-501,-313,0
r3k2r/3nnp2/p3p3/3qb1p1/1p1P4/1N4P1/1PP1QB2/1NKR3R b kq - 0 24,Bf6,-534,-139,395,1
r3k2r/3nnp2/p3pb2/3q2p1/1p1P4/1N4P1/1PP1QB2/1NKR3R w kq - 1 25,Nc5,-146,-537,-391,0
r3k2r/3nnp2/p3pb2/2Nq2p1/1p1P4/6P1/1PP1QB2/1NKR3R b kq - 2 25,Nxc5,-572,-168,404,1
r3k2r/4np2/p3pb2/2nq2p1/1p1P4/6P1/1PP1QB2/1NKR3R w kq - 0 26,dxc5,-197,-588,-391,0
r3k2r/4np2/p3pb2/2Pq2p1/1p6/6P1/1PP1QB2/1NKR3R b kq - 0 26,Qc6,-574,-37,537,1
r3k2r/4np2/p1q1pb2/2P3p1/1p6/6P1/1PP1QB2/1NKR3R w kq - 1 27,Rxh8+,-53,-75,-22,1
r3k2R/4np2/p1q1pb2/2P3p1/1p6/6P1/1PP1QB2/1NKR4 b q - 0 27,Bxh8,-80,-75,5,1
r3k2b/4np2/p1q1p3/2P3p1/1p6/6P1/1PP1QB2/1NKR4 w q - 0 28,Qh5,-72,-96,-24,1
r3k2b/4np2/p1q1p3/2P3pQ/1p6/6P1/1PP2B2/1NKR4 b q - 1 28,Bf6,-115,-123,-8,1
r3k3/4np2/p1q1pb2/2P3pQ/1p6/6P1/1PP2B2/1NKR4 w q - 2 29,Qe2,-130,-157,-27,1
rnbqkbnr/pppppppp/8/8/8/8/PPPPPPPP/RNBQKBNR w KQkq - 0 1,d4,31,18,-13,1
rnbqkbnr/pppppppp/8/8/3P4/8/PPP1PPPP/RNBQKBNR b KQkq - 0 1,e5,22,131,109,1
rnbqkbnr/pppp1ppp/8/4p3/3P4/8/PPP1PPPP/RNBQKBNR w KQkq - 0 2,d5,138,-22,-160,0
rnbqkbnr/pppp1ppp/8/3Pp3/8/8/PPP1PPPP/RNBQKBNR b KQkq - 0 2,d6,-32,24,56,1
rnbqkbnr/ppp2ppp/3p4/3Pp3/8/8/PPP1PPPP/RNBQKBNR w KQkq - 0 3,e4,21,19,-2,1
rnbqkbnr/ppp2ppp/3p4/3Pp3/4P3/8/PPP2PPP/RNBQKBNR b KQkq - 0 3,c6,17,44,27,1
rnbqkbnr/pp3ppp/2pp4/3Pp3/4P3/8/PPP2PPP/RNBQKBNR w KQkq - 0 4,c4,56,56,0,1
rnbqkbnr/pp3ppp/2pp4/3Pp3/2P1P3/8/PP3PPP/RNBQKBNR b KQkq - 0 4,f5,46,52,6,1
rnbqkbnr/pp4pp/2pp4/3Ppp2/2P1P3/8/PP3PPP/RNBQKBNR w KQkq - 0 5,exf5,64,73,9,1
rnbqkbnr/pp4pp/2pp4/3PpP2/2P5/8/PP3PPP/RNBQKBNR b KQkq - 0 5,Bxf5,86,86,0,1
rn1qkbnr/pp4pp/2pp4/3Ppb2/2P5/8/PP3PPP/RNBQKBNR w KQkq - 0 6,Nc3,72,46,-26,1
rn1qkbnr/pp4pp/2pp4/3Ppb2/2P5/2N5/PP3PPP/R1BQKBNR b KQkq - 1 6,Nf6,43,61,18,1
rn1qkb1r/pp4pp/2pp1n2/3Ppb2/2P5/2N5/PP3PPP/R1BQKBNR w KQkq - 2 7,f3,59,-5,-64,1
rn1qkb1r/pp4pp/2pp1n2/3Ppb2/2P5/2N2P2/PP4PP/R1BQKBNR b KQkq - 0 7,Be7,0,14,14,1
rn1qk2r/pp2b1pp/2pp1n2/3Ppb2/2P5/2N2P2/PP4PP/R1BQKBNR w KQkq - 1 8,Bd3,11,-17,-28,1
rn1qk2r/pp2b1pp/2pp1n2/3Ppb2/2P5/2NB1P2/PP4PP/R1BQK1NR b KQkq - 2 8,Qd7,-50,32,82,1
rn2k2r/pp1qb1pp/2pp1n2/3Ppb2/2P5/2NB1P2/PP4PP/R1BQK1NR w KQkq - 3 9,Nge2,43,41,-2,1
rn2k2r/pp1qb1pp/2pp1n2/3Ppb2/2P5/2NB1P2/PP2N1PP/R1BQK2R b KQkq - 4 9,cxd5,43,51,8,1
rn2k2r/pp1qb1pp/3p1n2/3ppb2/2P5/2NB1P2/PP2N1PP/R1BQK2R w KQkq - 0 10,cxd5,71,46,-25,1
rn2k2r/pp1qb1pp/3p1n2/3Ppb2/8/2NB1P2/PP2N1PP/R1BQK2R b KQkq - 0 10,Na6,49,401,352,1
r3k2r/pp1qb1pp/n2p1n2/3Ppb2/8/2NB1P2/PP2N1PP/R1BQK2R w KQkq - 1 11,Bb5,425,401,-24,1
r3k2r/pp1qb1pp/n2p1n2/1B1Ppb2/8/2N2P2/PP2N1PP/R1BQK2R b KQkq - 2 11,Nc5,379,537,158,1
r3k2r/pp1qb1pp/3p1n2/1BnPpb2/8/2N2P2/PP2N1PP/R1BQK2R w KQkq - 3 12,Bxd7+,533,503,-30,1
r3k2r/pp1Bb1pp/3p1n2/2nPpb2/8/2N2P2/PP2N1PP/R1BQK2R b KQkq - 0 12,Kxd7,537,542,5,1
r6r/pp1kb1pp/3p1n2/2nPpb2/8/2N2P2/PP2N1PP/R1BQK2R w KQ - 0 13,O-O,537,524,-13,1
r6r/pp1kb1pp/3p1n2/2nPpb2/8/2N2P2/PP2N1PP/R1BQ1RK1 b - - 1 13,Bd8,571,607,36,1
r2b3r/pp1k2pp/3p1n2/2nPpb2/8/2N2P2/PP2N1PP/R1BQ1RK1 w - - 2 14,Ng3,607,613,6,1
r2b3r/pp1k2pp/3p1n2/2nPpb2/8/2N2PN1/PP4PP/R1BQ1RK1 b - - 3 14,Bg6,605,585,-20,1
r2b3r/pp1k2pp/3p1nb1/2nPp3/8/2N2PN1/PP4PP/R1BQ1RK1 w - - 4 15,Nge4,567,512,-55,1
r2b3r/pp1k2pp/3p1nb1/2nPp3/4N3/2N2P2/PP4PP/R1BQ1RK1 b - - 5 15,Bb6,548,560,12,1
r6r/pp1k2pp/1b1p1nb1/2nPp3/4N3/2N2P2/PP4PP/R1BQ1RK1 w - - 6 16,Kh1,553,518,-35,1
r6r/pp1k2pp/1b1p1nb1/2nPp3/4N3/2N2P2/PP4PP/R1BQ1R1K b - - 7 16,Rhf8,520,547,27,1
r4r2/pp1k2pp/1b1p1nb1/2nPp3/4N3/2N2P2/PP4PP/R1BQ1R1K w - - 8 17,b4,571,484,-87,1
r4r2/pp1k2pp/1b1p1nb1/2nPp3/1P2N3/2N2P2/P5PP/R1BQ1R1K b - - 0 17,Ncxe4,480,466,-14,1
r4r2/pp1k2pp/1b1p1nb1/3Pp3/1P2n3/2N2P2/P5PP/R1BQ1R1K w - - 0 18,Nxe4,457,475,18,1
r4r2/pp1k2pp/1b1p1nb1/3Pp3/1P2N3/5P2/P5PP/R1BQ1R1K b - - 0 18,Bd4,486,506,20,1
r4r2/pp1k2pp/3p1nb1/3Pp3/1P1bN3/5P2/P5PP/R1BQ1R1K w - - 1 19,Rb1,513,459,-54,1
r4r2/pp1k2pp/3p1nb1/3Pp3/1P1bN3/5P2/P5PP/1RBQ1R1K b - - 2 19,Nxe4,482,513,31,1
r4r2/pp1k2pp/3p2b1/3Pp3/1P1bn3/5P2/P5PP/1RBQ1R1K w - - 0 20,fxe4,511,472,-39,1
r4r2/pp1k2pp/3p2b1/3Pp3/1P1bP3/8/P5PP/1RBQ1R1K b - - 0 20,Kc7,527,584,57,1
r4r2/ppk3pp/3p2b1/3Pp3/1P1bP3/8/P5PP/1RBQ1R1K w - - 1 21,Rxf8,524,472,-52,1
r4R2/ppk3pp/3p2b1/3Pp3/1P1bP3/8/P5PP/1RBQ3K b - - 0 21,Rxf8,491,463,-28,1
5r2/ppk3pp/3p2b1/3Pp3/1P1bP3/8/P5PP/1RBQ3K w - - 0 22,Qc2+,405,397,-8,1
5r2/ppk3pp/3p2b1/3Pp3/1P1bP3/8/P1Q3PP/1RB4K b - - 1 22,Kb8,403,415,12,1
1k3r2/pp4pp/3p2b1/3Pp3/1P1bP3/8/P1Q3PP/1RB4K w - - 2 23,Bb2,470,382,-88,1
1k3r2/pp4pp/3p2b1/3Pp3/1P1bP3/8/PBQ3PP/1R5K b - - 3 23,Rf2,424,436,12,1
1k6/pp4pp/3p2b1/3Pp3/1P1bP3/8/PBQ2rPP/1R5K w - - 4 24,Qxf2,367,234,-133,0
1k6/pp4pp/3p2b1/3Pp3/1P1bP3/8/PB3QPP/1R5K b - - 0 24,Bxf2,212,202,-10,1
1k6/pp4pp/3p2b1/3Pp3/1P2P3/8/PB3bPP/1R5K w - - 0 25,Rf1,240,231,-9,1
1k6/pp4pp/3p2b1/3Pp3/1P2P3/8/PB3bPP/5R1K b - - 1 25,Bb6,252,244,-8,1
1k6/pp4pp/1b1p2b1/3Pp3/1P2P3/8/PB4PP/5R1K w - - 2 26,Re1,225,254,29,1
1k6/pp4pp/1b1p2b1/3Pp3/1P2P3/8/PB4PP/4R2K b - - 3 26,Kc7,243,263,20,1
8/ppk3pp/1b1p2b1/3Pp3/1P2P3/8/PB4PP/4R2K w - - 4 27,a4,247,267,20,1
8/ppk3pp/1b1p2b1/3Pp3/PP2P3/8/1B4PP/4R2K b - - 0 27,Kd7,272,294,22,1
8/pp1k2pp/1b1p2b1/3Pp3/PP2P3/8/1B4PP/4R2K w - - 1 28,a5,297,294,-3,1
8/pp1k2pp/1b1p2b1/P2Pp3/1P2P3/8/1B4PP/4R2K b - - 0 28,Bf2,307,286,-21,1
8/pp1k2pp/3p2b1/P2Pp3/1P2P3/8/1B3bPP/4R2K w - - 1 29,Re2,287,289,2,1
8/pp1k2pp/3p2b1/P2Pp3/1P2P3/8/1B2RbPP/7K b - - 2 29,Bh4,301,274,-27,1
8/pp1k2pp/3p2b1/P2Pp3/1P2P2b/8/1B2R1PP/7K w - - 3 30,g3,273,289,16,1
8/pp1k2pp/3p2b1/P2Pp3/1P2P2b/6P1/1B2R2P/7K b - - 0 30,Be7,290,313,23,1
8/pp1kb1pp/3p2b1/P2Pp3/1P2P3/6P1/1B2R2P/7K w - - 1 31,Kg2,302,311,9,1
8/pp1kb1pp/3p2b1/P2Pp3/1P2P3/6P1/1B2R1KP/8 b - - 2 31,Kc7,302,312,10,1
8/ppk1b1pp/3p2b1/P2Pp3/1P2P3/6P1/1B2R1KP/8 w - - 3 32,b5,306,297,-9,1
8/ppk1b1pp/3p2b1/PP1Pp3/4P3/6P1/1B2R1KP/8 b - - 0 32,b6,288,310,22,1
8/p1k1b1pp/1p1p2b1/PP1Pp3/4P3/6P1/1B2R1KP/8 w - - 0 33,a6,295,232,-63,1
8/p1k1b1pp/Pp1p2b1/1P1Pp3/4P3/6P1/1B2R1KP/8 b - - 0 33,Kd8,215,268,53,1
3k4/p3b1pp/Pp1p2b1/1P1Pp3/4P3/6P1/1B2R1KP/8 w - - 1 34,Ba3,277,227,-50,1
3k4/p3b1pp/Pp1p2b1/1P1Pp3/4P3/B5P1/4R1KP/8 b - - 2 34,Be8,228,272,44,1
3kb3/p3b1pp/Pp1p4/1P1Pp3/4P3/B5P1/4R1KP/8 w - - 3 35,Rb2,281,258,-23,1
3kb3/p3b1pp/Pp1p4/1P1Pp3/4P3/B5P1/1R4KP/8 b - - 4 35,Bg6,276,279,3,1
3k4/p3b1pp/Pp1p2b1/1P1Pp3/4P3/B5P1/1R4KP/8 w - - 5 36,Kf3,265,258,-7,1
